FIELD,Field 1,YEAR,DISCYR,Field 2,Orig Oil Reserves,Orig Gas Reserves,Orig BOE Reserves,Field 3,CUMOIL,CUMGAS,CUMBOE,Field 4,Oil Reserves,Gas Reserves,BOE Reserves,FCLASS
AC024,,1998,1998,,7798119,9357743,9463198,,0,0,0,,7798119,9357743,9463198,PDP
AC024,,1999,1998,,8459206,7190325,9738623,,0,0,0,,8459206,7190325,9738623,PDP
AC024,,2000,1998,,4967694,7451541,6293591,,0,0,0,,4967694,7451541,6293591,PDP
AC024,,2001,1998,,7125984,5700787,8140359,,0,0,0,,7125984,5700787,8140359,PDP
AC024,,2002,1998,,7125984,5700787,8140359,,1600948,1305359,1833218,,5525036,4395428,6307141,PDP
AC024,,2003,1998,,7125984,5344488,8076961,,4104374,3130467,4661397,,3021610,2214021,3415564,PDP
AC024,,2004,1998,,9639114,7036553,10891170,,6415958,4739432,7259273,,3223156,2297121,3631897,PDP
AC024,,2005,1998,,9639114,7036553,10891170,,7869363,5755718,8893512,,1769751,1280835,1997658,PDP
AC024,,2006,1998,,10442374,7936204,11854510,,8871740,6473620,10023630,,1570634,1462584,1830880,PDP
AC024,,2007,1998,,10832000,8069840,12267915,,9370215,6906017,10599044,,1461785,1163823,1668871,PDP
AC024,,2008,1998,,10832000,8069840,12267915,,9730589,7235128,11017978,,1101411,834712,1249937,PDP
AC024,,2009,1998,,10832000,8069840,12267915,,9942118,7375129,11254419,,889882,694711,1013496,PDP
AC024,,2010,1998,,10832000,8069840,12267915,,9968955,7404889,11286551,,863045,664951,981364,PDP
AC024,,2011,1998,,10832000,8069840,12267915,,9980770,7423406,11301661,,851230,646434,966254,PDP
AC024,,2012,1998,,12129011,7653406,13490827,,10200492,7457071,11527373,,1928519,196335,1963454,PDP
AC024,,2013,1998,,12129011,7653406,13490827,,10642406,7491445,11975403,,1486605,161961,1515424,PDP
AC024,,2014,1998,,12129011,7653406,13490827,,11073786,7563598,12419622,,1055225,89808,1071205,PDP
AC024,,2015,1998,,12129011,7859599,13527516,,11490984,7774489,12874345,,638027,85110,653171,PDP
AC024,,2016,1998,,12423779,8410898,13920380,,11867812,8163062,13320314,,555967,247836,600066,PDP
AC024,,2017,1998,,12845315,8863267,14422409,,12202525,8403079,13697735,,642790,460188,724674,PDP
AC024,,2017,1998,,12845315,8863267,14422409,,12202525,8403079,13697735,,642790,460188,724674,PDP
AC025,,1997,1997,,61995806,74394967,75233345,,0,0,0,,61995806,74394967,75233345,PDP
AC025,,1998,1997,,71009713,76095234,84549791,,0,0,0,,71009713,76095234,84549791,PDP
AC025,,1999,1997,,60277030,113583767,80487665,,0,0,0,,60277030,113583767,80487665,PDP
AC025,,2000,1997,,63717129,100660960,81628332,,953164,1306100,1185566,,62763965,99354860,80442766,PDP
AC025,,2001,1997,,52881899,71557937,65614628,,12109170,15067456,14790212,,40772729,56490481,50824416,PDP
AC025,,2002,1997,,52881899,71557937,65614628,,28053902,35040996,34288955,,24827997,36516941,31325673,PDP
AC025,,2003,1997,,54867598,72846885,67829678,,35915418,44588583,43849330,,18952180,28258302,23980348,PDP
AC025,,2004,1997,,60494992,77074465,74209310,,42371934,52270543,51672742,,18123058,24803922,22536568,PDP
AC025,,2005,1997,,61901840,78748614,75914049,,47696724,57992208,58015622,,14205116,20756406,17898427,PDP
AC025,,2006,1997,,61901840,78748614,75914049,,51749854,62492119,62869448,,10151986,16256495,13044601,PDP
AC025,,2007,1997,,61901331,73662584,75008552,,54416823,64997896,65982285,,7484508,8664688,9026267,PDP
AC025,,2008,1997,,71749270,84090144,86711929,,56836316,67180678,68790173,,14912954,16909466,17921756,PDP
AC025,,2009,1997,,71749270,84090144,86711929,,58557962,69230361,70876532,,13191308,14859783,15835398,PDP
AC025,,2010,1997,,71749270,84090144,86711929,,60523004,70896296,73138003,,11226266,13193848,13573926,PDP
AC025,,2011,1997,,71749270,84090144,86711929,,62762314,74061263,75940475,,8986956,10028881,10771454,PDP
AC025,,2012,1997,,78338700,88757747,94131893,,67071304,78370007,81016145,,11267396,10387740,13115748,PDP
AC025,,2013,1997,,106770741,121059034,128311495,,70505216,81551547,85016167,,36265525,39507487,43295328,PDP
AC025,,2014,1997,,94886556,104177401,113423460,,73435724,84295386,88434902,,21450832,19882015,24988557,PDP
AC025,,2015,1997,,94886556,104177401,113423460,,75677419,86371884,91046082,,19209137,17805517,22377379,PDP
AC025,,2016,1997,,90940903,99543103,108653198,,77405750,87898775,93046101,,13535153,11644328,15607097,PDP
AC025,,2017,1997,,89043978,97610954,106412475,,78811154,89135755,94671609,,10232824,8475199,11740866,PDP
AC025,,2017,1997,,89043978,97610954,106412475,,78811154,89135755,94671609,,10232824,8475199,11740866,PDP
AC065,,1998,1997,,432326,22480947,4432495,,0,0,0,,432326,22480947,4432495,PDN
AC065,,1999,1997,,432326,22480947,4432495,,0,0,0,,432326,22480947,4432495,PDN
AC065,,2000,1997,,432326,22480947,4432495,,0,0,0,,432326,22480947,4432495,PDN
AC065,,2001,1997,,433866,22561038,4448286,,0,0,0,,433866,22561038,4448286,PDN
AC065,,2002,1997,,657356,23993485,4926659,,0,0,0,,657356,23993485,4926659,PDN
AC065,,2003,1997,,1332034,42984726,8980562,,1268,0,1268,,1330766,42984726,8979294,PDN
AC065,,2004,1997,,1016843,34953977,7236412,,402381,12984189,2712735,,614462,21969788,4523677,PDN
AC065,,2005,1997,,1151459,42057058,8634921,,679830,22914840,4757204,,471629,19142218,3877717,PDN
AC065,,2006,1997,,1151459,42057058,8634921,,831969,29042779,5999723,,319490,13014279,2635198,PDN
AC065,,2007,1997,,1151459,42057058,8634921,,957016,33814353,6973805,,194443,8242705,1661116,PDN
AC065,,2008,1997,,1290554,50452903,10267939,,1026796,37450890,7690655,,263758,13002013,2577284,PDN
AC065,,2009,1997,,1316243,51457219,10472332,,1092866,40504135,8300007,,223377,10953084,2172324,PDN
AC065,,2010,1997,,1316243,51457219,10472332,,1141145,42906773,8775802,,175098,8550446,1696530,PDN
AC065,,2011,1997,,1316243,51457219,10472332,,1175230,44867851,9158833,,141013,6589368,1313498,PDN
AC065,,2012,1997,,1316243,51457219,10472332,,1198055,46299441,9436390,,118188,5157778,1035942,PDN
AC065,,2013,1997,,1316243,51457219,10472332,,1216373,47759441,9714494,,99870,3697778,757838,PDN
AC065,,2014,1997,,1316243,51457219,10472332,,1227715,48852694,9920365,,88528,2604525,551967,PDN
AC065,,2015,1997,,1231565,49078953,9964475,,1231565,49078953,9964475,,0,0,0,PDN
AC065,,2016,1997,,1231565,49087574,9966009,,1231565,49087574,9966009,,0,0,0,PDN
AC065,,2017,1997,,1231565,49087574,9966009,,1231565,49087574,9966009,,0,0,0,PDN
AC065,,2017,1997,,1231565,49087574,9966009,,1231565,49087574,9966009,,0,0,0,PDN
AC857,,2002,2002,,235104715,219171480,274103199,,0,0,0,,235104715,219171480,274103199,PDP
AC857,,2003,2002,,235104715,219171480,274103199,,0,0,0,,235104715,219171480,274103199,PDP
AC857,,2004,2002,,251353507,286638318,302356766,,0,0,0,,251353507,286638318,302356766,PDP
AC857,,2005,2002,,272480678,330265925,331246857,,0,0,0,,272480678,330265925,331246857,PDP
AC857,,2006,2002,,272480678,328253924,330888850,,0,0,0,,272480678,328253924,330888850,PDP
AC857,,2007,2002,,272480676,328253926,330888848,,0,0,0,,272480676,328253926,330888848,PDP
AC857,,2008,2002,,298489979,354893114,361638220,,0,0,0,,298489979,354893114,361638220,PDP
AC857,,2009,2002,,279421938,317630767,335939868,,0,0,0,,279421938,317630767,335939868,PDP
AC857,,2010,2002,,266558930,345249279,327991187,,977642,1822238,1301884,,265581288,343427041,326689303,PDP
AC857,,2011,2002,,266558930,345249279,327991187,,10123346,17718882,13276172,,256435584,327530397,314715015,PDP
AC857,,2012,2002,,278745379,365961413,343863069,,28197210,45273883,36253062,,250548169,320687530,307610008,PDP
AC857,,2013,2002,,266624662,357983302,330322759,,50166856,77520221,63960490,,216457806,280463081,266362269,PDP
AC857,,2014,2002,,231190456,305857291,285613461,,72942972,114621747,93338301,,158247484,191235544,192275160,PDP
AC857,,2015,2002,,231190456,305857291,285613461,,96263976,168249626,126201631,,134926480,137607665,159411831,PDP
AC857,,2016,2002,,169513024,334827310,229090838,,117402908,216552974,155935465,,52110116,118274336,73155373,PDP
AC857,,2017,2002,,217968060,439674391,296201938,,138367878,256632364,184032000,,79600182,183042027,112169939,PDP
AC857,,2017,2002,,217968060,439674391,296201938,,138367878,256632364,184032000,,79600182,183042027,112169939,PDP
AC859,,2004,2004,,97807283,201972038,133745368,,0,0,0,,97807283,201972038,133745368,PDP
AC859,,2005,2004,,97807283,201972038,133745368,,0,0,0,,97807283,201972038,133745368,PDP
AC859,,2006,2004,,97750238,201854243,133667363,,0,0,0,,97750238,201854243,133667363,PDP
AC859,,2007,2004,,97750238,201854243,133667363,,0,0,0,,97750238,201854243,133667363,PDP
AC859,,2008,2004,,98197535,125225875,120479719,,0,0,0,,98197535,125225875,120479719,PDP
AC859,,2009,2004,,76201189,119710448,97501980,,0,0,0,,76201189,119710448,97501980,PDP
AC859,,2010,2004,,76201189,119710448,97501980,,47781,23430,51950,,76153408,119687018,97450030,PDP
AC859,,2011,2004,,76201189,119710448,97501980,,2245085,1494841,2511070,,73956104,118215607,94990908,PDP
AC859,,2012,2004,,76201189,119710448,97501980,,7197863,8603584,8728750,,69003326,111106864,88773231,PDP
AC859,,2013,2004,,76201189,119710448,97501980,,12397026,17517481,15514015,,63804163,102192967,81987964,PDP
AC859,,2014,2004,,54788060,77689061,68611737,,16245161,22163874,20188910,,38542899,55525187,48422825,PDP
AC859,,2015,2004,,54788060,77689061,68611737,,19409549,24198471,23715326,,35378511,53490590,44896410,PDP
AC859,,2016,2004,,38013360,48209531,46591568,,21424445,28659038,26523919,,16588915,19550493,20067651,PDP
AC859,,2017,2004,,38013360,48209531,46591568,,22961741,31506314,28567846,,15051619,16703217,18023722,PDP
AC859,,2017,2004,,38013360,48209531,46591568,,22961741,31506314,28567846,,15051619,16703217,18023722,PDP
AT037,,2001,2001,,6553,65532517,11667143,,0,0,0,,6553,65532517,11667143,PDN
AT037,,2002,2001,,6553,65530595,11666801,,0,0,0,,6553,65530595,11666801,PDN
AT037,,2003,2001,,6553,65530595,11666801,,0,0,0,,6553,65530595,11666801,PDN
AT037,,2004,2001,,135118,68099552,12252476,,0,0,0,,135118,68099552,12252476,PDN
AT037,,2005,2001,,135118,68099552,12252476,,0,0,0,,135118,68099552,12252476,PDN
AT037,,2006,2001,,86299,67398670,12078945,,0,0,0,,86299,67398670,12078945,PDN
AT037,,2007,2001,,120291,148161419,26483533,,6342,16986462,3028844,,113949,131174957,23454689,PDN
AT037,,2008,2001,,113638,148161419,26476880,,15794,50135353,8936675,,97844,98026066,17540205,PDN
AT037,,2009,2001,,108485,151027029,26981621,,22465,70391161,12547582,,86020,80635868,14434039,PDN
AT037,,2010,2001,,108485,151027029,26981621,,25719,81102191,14456714,,82766,69924838,12524907,PDN
AT037,,2011,2001,,108485,151027029,26981621,,26841,87499693,15596181,,81644,63527336,11385440,PDN
AT037,,2012,2001,,108485,151027029,26981621,,27626,92841654,16547493,,80859,58185375,10434128,PDN
AT037,,2013,2001,,108485,151027029,26981621,,28063,97331126,17346768,,80422,53695903,9634852,PDN
AT037,,2014,2001,,28086,97838617,17437092,,28086,97838617,17437092,,0,0,0,PDN
AT037,,2015,2001,,28086,97838617,17437092,,28086,97838617,17437092,,0,0,0,PDN
AT037,,2016,2001,,28086,97838617,17437092,,28086,97838617,17437092,,0,0,0,PDN
AT037,,2017,2001,,28086,97838617,17437092,,28086,97838617,17437092,,0,0,0,PDN
AT037,,2017,2001,,28086,97838617,17437092,,28086,97838617,17437092,,0,0,0,PDN
AT063,,2000,2000,,28717603,66095806,40478423,,0,0,0,,28717603,66095806,40478423,PDN
AT063,,2001,2000,,28715880,66091669,40475963,,0,0,0,,28715880,66091669,40475963,PDN
AT063,,2002,2000,,28913996,66555855,40756675,,0,0,0,,28913996,66555855,40756675,PDN
AT063,,2003,2000,,28913996,66555855,40756675,,0,0,0,,28913996,66555855,40756675,PDN
AT063,,2004,2000,,28913996,66555855,40756675,,0,0,0,,28913996,66555855,40756675,PDN
AT063,,2005,2000,,31094326,71579258,43830849,,0,0,0,,31094326,71579258,43830849,PDN
AT063,,2006,2000,,31094326,71579258,43830849,,0,0,0,,31094326,71579258,43830849,PDN
AT063,,2007,2000,,31094326,71579258,43830849,,0,0,0,,31094326,71579258,43830849,PDN
AT063,,2008,2000,,31094326,71579258,43830849,,0,0,0,,31094326,71579258,43830849,PDN
AT063,,2009,2000,,1113400,1141235,1316466,,0,0,0,,1113400,1141235,1316466,PDN
AT063,,2010,2000,,1113400,1141235,1316466,,545410,589365,650280,,567990,551870,666188,PDN
AT063,,2011,2000,,1113400,1141235,1316466,,717313,759818,852512,,396087,381417,463955,PDN
AT063,,2012,2000,,1113400,1141235,1316466,,755924,798155,897945,,357476,343080,418523,PDN
AT063,,2013,2000,,1113400,1141235,1316466,,755924,798155,897945,,357476,343080,418523,PDN
AT063,,2014,2000,,1113400,1141235,1316466,,774260,811079,918580,,339140,330156,397887,PDN
AT063,,2015,2000,,1113400,1141235,1316466,,815541,842842,965513,,297859,298393,350953,PDN
AT063,,2016,2000,,1113400,1141235,1316466,,833955,864183,987725,,279445,277052,328743,PDN
AT063,,2017,2000,,833956,864183,987725,,833956,864183,987725,,0,0,0,PDN
AT063,,2017,2000,,250187,259255,296318,,250187,259255,296318,,0,0,0,PDN
AT261,,2002,2002,,143071,71535356,12871782,,0,0,0,,143071,71535356,12871782,PDN
AT261,,2003,2002,,143071,71535356,12871782,,0,0,0,,143071,71535356,12871782,PDN
AT261,,2004,2002,,159705,80491202,14481983,,0,0,0,,159705,80491202,14481983,PDN
AT261,,2005,2002,,156946,79100692,14231802,,0,0,0,,156946,79100692,14231802,PDN
AT261,,2006,2002,,87686,79100692,14162542,,0,0,0,,87686,79100692,14162542,PDN
AT261,,2007,2002,,87686,79100692,14162542,,1672,3634582,648395,,86014,75466110,13514147,PDN
AT261,,2008,2002,,87686,79100692,14162542,,8086,24959121,4449211,,79600,54141571,9713331,PDN
AT261,,2009,2002,,63647,67683599,12106992,,14354,43939183,7832714,,49293,23744416,4274278,PDN
AT261,,2010,2002,,59543,97545198,17416339,,20616,66283364,11814809,,38927,31261834,5601530,PDN
AT261,,2011,2002,,59543,97545198,17416339,,22373,77811377,13867814,,37170,19733821,3548526,PDN
AT261,,2012,2002,,59543,97544207,17416163,,22568,78909105,14063334,,36975,18635102,3352829,PDN
AT261,,2013,2002,,22568,78909105,14063334,,22568,78909105,14063334,,0,0,0,PDN
AT261,,2014,2002,,22568,78909105,14063334,,22568,78909105,14063334,,0,0,0,PDN
AT261,,2015,2002,,22568,78909105,14063334,,22568,78909105,14063334,,0,0,0,PDN
AT261,,2016,2002,,22568,78909105,14063334,,22568,78909105,14063334,,0,0,0,PDN
AT261,,2017,2002,,22568,78909105,14063334,,22568,78909105,14063334,,0,0,0,PDN
AT261,,2017,2002,,22568,78909105,14063334,,22568,78909105,14063334,,0,0,0,PDN
AT349,,2003,2003,,399917,202757859,36477828,,0,0,0,,399917,202757859,36477828,PDN
AT349,,2004,2003,,451283,227447046,40922288,,0,0,0,,451283,227447046,40922288,PDN
AT349,,2005,2003,,451283,227447046,40922288,,0,0,0,,451283,227447046,40922288,PDN
AT349,,2006,2003,,451283,227447046,40922288,,0,0,0,,451283,227447046,40922288,PDN
AT349,,2007,2003,,451283,227447046,40922288,,1117,6862633,1222226,,450166,220584413,39700062,PDN
AT349,,2008,2003,,451283,227447046,40922288,,12861,39589042,7057175,,438422,187858004,33865113,PDN
AT349,,2009,2003,,460237,231959590,41734186,,25427,77798192,13868521,,434810,154161398,27865663,PDN
AT349,,2010,2003,,460237,231959590,41734186,,37093,117976812,21029408,,423144,113982778,20704777,PDN
AT349,,2011,2003,,240300,159985396,28707453,,42879,152232837,27130573,,197421,7752559,1576880,PDN
AT349,,2012,2003,,84431,459913896,81919644,,46628,176938159,31530287,,37803,282975737,50389358,PDN
AT349,,2013,2003,,84431,459913896,81919644,,49886,210988403,37592307,,34545,248925493,44327337,PDN
AT349,,2014,2003,,84431,459913896,81919644,,54136,242480938,43200211,,30295,217432958,38719433,PDN
AT349,,2015,2003,,54136,250726354,44667366,,54136,250723737,44666900,,0,2617,466,PDN
AT349,,2016,2003,,54136,250726354,44667366,,54136,250726354,44667366,,0,0,0,PDN
AT349,,2017,2003,,54136,250726354,44667366,,54136,250726354,44667366,,0,0,0,PDN
AT349,,2017,2003,,54136,250726354,44667366,,54136,250726354,44667366,,0,0,0,PDN
AT426,,2004,2001,,44457,22228621,3999728,,0,0,0,,44457,22228621,3999728,PDN
AT426,,2005,2001,,44457,22228621,3999728,,0,0,0,,44457,22228621,3999728,PDN
AT426,,2006,2001,,44457,22228621,3999728,,0,0,0,,44457,22228621,3999728,PDN
AT426,,2007,2001,,44457,22228621,3999728,,0,0,0,,44457,22228621,3999728,PDN
AT426,,2008,2001,,19774,197742000,35205183,,48,22556400,4013642,,19726,175185600,31191541,PDN
AT426,,2009,2001,,19774,197742000,35205183,,48,58784229,10459875,,19726,138957771,24745308,PDN
AT426,,2010,2001,,48,149343000,26573536,,48,83828440,14916141,,0,65514560,11657395,PDN
AT426,,2011,2001,,48,136918000,24362681,,48,106923436,19025570,,0,29994564,5337111,PDN
AT426,,2012,2001,,48,133376000,23732432,,48,125737127,22373202,,0,7638873,1359230,PDN
AT426,,2013,2001,,48,136571000,24300938,,48,130324017,23189375,,0,6246983,1111563,PDN
AT426,,2014,2001,,48,131248784,23353924,,48,131248784,23353924,,0,0,0,PDN
AT426,,2015,2001,,48,131248784,23353924,,48,131248784,23353924,,0,0,0,PDN
AT426,,2016,2001,,48,131248784,23353924,,48,131248784,23353924,,0,0,0,PDN
AT426,,2017,2001,,48,131248784,23353924,,48,131248784,23353924,,0,0,0,PDN
AT426,,2017,2001,,48,131248784,23353924,,48,131248784,23353924,,0,0,0,PDN
AT575,,1995,1995,,323892590,291503331,375761510,,0,0,0,,323892590,291503331,375761510,PDP
AT575,,1996,1995,,323892590,291503331,375761510,,0,0,0,,323892590,291503331,375761510,PDP
AT575,,1997,1995,,96091299,86482169,111479585,,0,0,0,,96091299,86482169,111479585,PDP
AT575,,1998,1995,,96106391,237379709,138344773,,0,0,0,,96106391,237379709,138344773,PDP
AT575,,1999,1995,,96106391,237379709,138344773,,0,0,0,,96106391,237379709,138344773,PDP
AT575,,2000,1995,,96106391,237379709,138344773,,0,0,0,,96106391,237379709,138344773,PDP
AT575,,2001,1995,,177544331,220097518,216707590,,0,0,0,,177544331,220097518,216707590,PDP
AT575,,2002,1995,,177544331,220097518,216707590,,0,0,0,,177544331,220097518,216707590,PDP
AT575,,2003,1995,,177544331,220097518,216707590,,0,0,0,,177544331,220097518,216707590,PDP
AT575,,2004,1995,,47740194,42888941,55371678,,0,0,0,,47740194,42888941,55371678,PDP
AT575,,2005,1995,,47740194,42888941,55371678,,0,0,0,,47740194,42888941,55371678,PDP
AT575,,2006,1995,,73397365,62108943,84448778,,0,0,0,,73397365,62108943,84448778,PDP
AT575,,2007,1995,,80950561,68022944,93054288,,10755,0,10755,,80939806,68022944,93043533,PDP
AT575,,2008,1995,,57121354,52658794,66491246,,5225926,4177640,5969278,,51895428,48481154,60521968,PDP
AT575,,2009,1995,,50613697,49775533,59470554,,11261604,8992315,12861660,,39352093,40783218,46608895,PDP
AT575,,2010,1995,,49346977,48128797,57910820,,15784704,12546074,18017102,,33562273,35582723,39893719,PDP
AT575,,2011,1995,,46647489,45881362,54811432,,19717172,15633340,22498905,,26930317,30248022,32312528,PDP
AT575,,2012,1995,,46647489,45881359,54811431,,23369149,18653207,26688224,,23278340,27228152,28123207,PDP
AT575,,2013,1995,,46647489,45881359,54811431,,26816183,21622665,30663632,,19831306,24258694,24147799,PDP
AT575,,2014,1995,,46647489,45881359,54811431,,29941791,24209466,34249525,,16705698,21671893,20561907,PDP
AT575,,2015,1995,,46647491,45881835,54811518,,33100688,26754119,37861207,,13546803,19127716,16950312,PDP
AT575,,2016,1995,,46647491,45881835,54811518,,35951521,28975080,41107229,,10695970,16906755,13704289,PDP
AT575,,2017,1995,,64376407,50075555,73286648,,38329388,30896505,43826987,,26047019,19179050,29459661,PDP
AT575,,2017,1995,,64376407,50075555,73286648,,38329388,30896505,43826987,,26047019,19179050,29459661,PDP
BA001A,,1975,1970,,3634702,84514430,18672857,,664993,24195270,4970201,,2969709,60319160,13702656,PDN
BA001A,,1976,1970,,3634702,84514430,18672857,,876945,33552376,6847119,,2757757,50962054,11825738,PDN
BA001A,,1977,1970,,4527320,104840820,23182270,,1718131,41501530,9102745,,2809189,63339290,14079525,PDN
BA001A,,1978,1970,,4527320,104840820,23182270,,1828305,47635836,10304432,,2699015,57204984,12877838,PDN
BA001A,,1979,1970,,3851320,104840820,22506270,,1244352,51873688,10474546,,2606968,52967132,12031724,PDN
BA001A,,1980,1970,,3880728,105440820,22642440,,1305774,54884008,11071612,,2574954,50556812,11570828,PDN
BA001A,,1981,1970,,2394734,94431757,19197538,,1335753,56966294,11472104,,1058981,37465463,7725434,PDN
BA001A,,1982,1970,,2384678,94029537,19115912,,1344667,57482994,11572958,,1040011,36546543,7542954,PDN
BA001A,,1983,1970,,2384678,94029537,19115912,,1344667,57475189,11571569,,1040011,36554348,7544343,PDN
BA001A,,1984,1970,,1344667,57475189,11571569,,1344667,57475189,11571569,,0,0,0,PDN
BA001A,,1985,1970,,1344667,57475189,11571569,,1344667,57475189,11571569,,0,0,0,PDN
BA001A,,1986,1970,,1344667,57475189,11571569,,1344667,57475189,11571569,,0,0,0,PDN
BA001A,,1987,1970,,1344667,57475189,11571569,,1344667,57475189,11571569,,0,0,0,PDN
BA001A,,1988,1970,,1344667,57475189,11571569,,1344667,57475189,11571569,,0,0,0,PDN
BA001A,,1989,1970,,1344667,57475189,11571569,,1344667,57475189,11571569,,0,0,0,PDN
BA001A,,1990,1970,,1344667,57475189,11571569,,1344667,57475189,11571569,,0,0,0,PDN
BA001A,,1991,1970,,1344667,57475189,11571569,,1344667,57475189,11571569,,0,0,0,PDN
BA001A,,1992,1970,,1344667,57475189,11571569,,1344667,57475189,11571569,,0,0,0,PDN
BA001A,,1993,1970,,1344667,57475189,11571569,,1344667,57475189,11571569,,0,0,0,PDN
BA001A,,1994,1970,,1344667,57475189,11571569,,1344667,57475189,11571569,,0,0,0,PDN
BA001A,,1995,1970,,1344667,57475189,11571569,,1344667,57475189,11571569,,0,0,0,PDN
BA001A,,1996,1970,,1344667,57475189,11571569,,1344667,57475189,11571569,,0,0,0,PDN
BA001A,,1997,1970,,1344667,57475189,11571569,,1344667,57475189,11571569,,0,0,0,PDN
BA001A,,1998,1970,,1344667,57475189,11571569,,1344667,57475189,11571569,,0,0,0,PDN
BA001A,,1999,1970,,1344667,57475189,11571569,,1344667,57475189,11571569,,0,0,0,PDN
BA001A,,2000,1970,,1344667,57475189,11571569,,1344667,57475189,11571569,,0,0,0,PDN
BA001A,,2001,1970,,1344667,57475189,11571569,,1344667,57475189,11571569,,0,0,0,PDN
BA001A,,2002,1970,,1344667,57475189,11571569,,1344667,57475189,11571569,,0,0,0,PDN
BA001A,,2003,1970,,1344667,57475189,11571569,,1344667,57475189,11571569,,0,0,0,PDN
BA001A,,2004,1970,,1344667,57475189,11571569,,1344667,57475189,11571569,,0,0,0,PDN
BA001A,,2005,1970,,1344667,57475189,11571569,,1344667,57475189,11571569,,0,0,0,PDN
BA001A,,2006,1970,,1344667,57475189,11571569,,1344667,57475189,11571569,,0,0,0,PDN
BA001A,,2007,1970,,1344667,57475189,11571569,,1344667,57475189,11571569,,0,0,0,PDN
BA001A,,2008,1970,,1344667,57475189,11571569,,1344667,57475189,11571569,,0,0,0,PDN
BA001A,,2009,1970,,1344667,58626258,11776385,,1344667,58626258,11776385,,0,0,0,PDN
BA001A,,2010,1970,,1344667,58626258,11776385,,1344667,58626258,11776385,,0,0,0,PDN
BA001A,,2011,1970,,1344667,58626258,11776385,,1344667,58626258,11776385,,0,0,0,PDN
BA001A,,2012,1970,,1344667,58626258,11776385,,1344667,58626258,11776385,,0,0,0,PDN
BA001A,,2013,1970,,1344667,58626258,11776385,,1344667,58626258,11776385,,0,0,0,PDN
BA001A,,2014,1970,,1344667,58626258,11776385,,1344667,58626258,11776385,,0,0,0,PDN
BA001A,,2015,1970,,1344667,58626258,11776385,,1344667,58626258,11776385,,0,0,0,PDN
BA001A,,2016,1970,,1344667,58626258,11776385,,1344667,58626258,11776385,,0,0,0,PDN
BA001A,,2017,1970,,1344667,58626258,11776385,,1344667,58626258,11776385,,0,0,0,PDN
BA001A,,2017,1970,,1344667,58626258,11776385,,1344667,58626258,11776385,,0,0,0,PDN
BA002A,,1990,1989,,318625,37377985,6969512,,24488,3629172,670248,,294137,33748813,6299264,PDN
BA002A,,1991,1989,,318625,37377985,6969512,,39997,8757792,1598323,,278628,28620193,5371189,PDN
BA002A,,1992,1989,,318625,37377985,6969512,,50842,13854267,2516014,,267783,23523718,4453498,PDN
BA002A,,1993,1989,,318625,37377985,6969512,,56094,16619047,3013220,,262531,20758938,3956292,PDN
BA002A,,1994,1989,,318625,37377985,6969512,,59585,17576318,3187044,,259040,19801667,3782468,PDN
BA002A,,1995,1989,,309230,36275829,6764004,,60384,17894926,3244535,,248846,18380903,3519469,PDN
BA002A,,1996,1989,,60384,17894927,3244535,,60384,17894927,3244535,,0,0,0,PDN
BA002A,,1997,1989,,60384,17894927,3244535,,60384,17894927,3244535,,0,0,0,PDN
BA002A,,1998,1989,,60384,17894927,3244535,,60384,17894927,3244535,,0,0,0,PDN
BA002A,,1999,1989,,60384,17894927,3244535,,60384,17894927,3244535,,0,0,0,PDN
BA002A,,2000,1989,,60384,17894927,3244535,,60384,17894927,3244535,,0,0,0,PDN
BA002A,,2001,1989,,60384,17894927,3244535,,60384,17894927,3244535,,0,0,0,PDN
BA002A,,2002,1989,,60384,17894927,3244535,,60384,17894927,3244535,,0,0,0,PDN
BA002A,,2003,1989,,60384,17894927,3244535,,60384,17894927,3244535,,0,0,0,PDN
BA002A,,2004,1989,,69597,19973819,3623657,,60384,17894927,3244535,,9213,2078892,379122,PDN
BA002A,,2005,1989,,69658,19987519,3626156,,64938,18798432,3409855,,4720,1189087,216301,PDN
BA002A,,2006,1989,,68983,20017313,3630782,,67924,19952976,3618276,,1059,64337,12506,PDN
BA002A,,2007,1989,,67924,19953139,3618305,,67924,19953139,3618305,,0,0,0,PDN
BA002A,,2008,1989,,67924,19953139,3618305,,67924,19953139,3618305,,0,0,0,PDN
BA002A,,2009,1989,,67924,20311517,3682073,,67924,20311517,3682073,,0,0,0,PDN
BA002A,,2010,1989,,67924,20311517,3682073,,67924,20311517,3682073,,0,0,0,PDN
BA002A,,2011,1989,,67924,20311517,3682073,,67924,20311517,3682073,,0,0,0,PDN
BA002A,,2012,1989,,67924,20311517,3682073,,67924,20311517,3682073,,0,0,0,PDN
BA002A,,2013,1989,,67924,20311517,3682073,,67924,20311517,3682073,,0,0,0,PDN
BA002A,,2014,1989,,67924,20311517,3682073,,67924,20311517,3682073,,0,0,0,PDN
BA002A,,2015,1989,,67924,20311517,3682073,,67924,20311517,3682073,,0,0,0,PDN
BA002A,,2016,1989,,67924,20311517,3682073,,67924,20311517,3682073,,0,0,0,PDN
BA002A,,2017,1989,,67924,20311517,3682073,,67924,20311517,3682073,,0,0,0,PDN
BA002A,,2017,1989,,67924,20311517,3682073,,67924,20311517,3682073,,0,0,0,PDN
BA007A,,1983,1969,,10049,10048673,1798069,,0,0,0,,10049,10048673,1798069,PDN
BA007A,,1984,1969,,66010,21075115,3816030,,6569,3897476,700070,,59441,17177639,3115960,PDN
BA007A,,1985,1969,,66010,21075115,3816030,,11965,5768481,1038385,,54045,15306634,2777645,PDN
BA007A,,1986,1969,,47818,17482546,3158591,,24222,9635747,1738768,,23596,7846799,1419823,PDN
BA007A,,1987,1969,,87757,28919322,5233544,,44450,15129025,2736447,,43307,13790297,2497097,PDN
BA007A,,1988,1969,,87757,28919322,5233544,,65678,20306296,3678898,,22079,8613026,1554646,PDN
BA007A,,1989,1969,,190005,40492655,7395104,,80003,23757884,4307384,,110002,16734771,3087720,PDN
BA007A,,1990,1969,,181746,36243074,6630692,,89313,26225935,4755849,,92433,10017139,1874843,PDN
BA007A,,1991,1969,,181746,36243074,6630692,,99073,28558132,5180591,,82673,7684942,1450101,PDN
BA007A,,1992,1969,,146810,39092199,7102717,,109411,31115671,5646007,,37399,7976528,1456710,PDN
BA007A,,1993,1969,,146810,39092199,7102717,,119425,33489911,6078484,,27385,5602288,1024233,PDN
BA007A,,1994,1969,,146810,39092199,7102717,,126320,35492393,6441692,,20490,3599806,661025,PDN
BA007A,,1995,1969,,147203,39178509,7118468,,130937,36953159,6706232,,16266,2225350,412236,PDN
BA007A,,1996,1969,,147203,39178509,7118468,,132858,37597910,6822878,,14345,1580599,295590,PDN
BA007A,,1997,1969,,147203,39178509,7118468,,134405,38086665,6911392,,12798,1091844,207076,PDN
BA007A,,1998,1969,,167535,46254119,8397805,,141282,40387895,7327740,,26253,5866224,1070065,PDN
BA007A,,1999,1969,,165792,52255855,9463987,,150540,44105176,7998436,,15252,8150679,1465551,PDN
BA007A,,2000,1969,,184653,54141979,9818457,,156491,47275085,8568428,,28162,6866894,1250029,PDN
BA007A,,2001,1969,,184653,54141979,9818457,,158831,48715257,8827026,,25822,5426722,991431,PDN
BA007A,,2002,1969,,183385,53842623,9763923,,161073,49636568,8993203,,22312,4206055,770720,PDN
BA007A,,2003,1969,,183385,53842623,9763923,,162169,50088424,9074700,,21216,3754199,689223,PDN
BA007A,,2004,1969,,165986,52746599,9551502,,162806,50389066,9128832,,3180,2357533,422670,PDN
BA007A,,2005,1969,,163540,50757178,9195066,,163390,50660538,9177721,,150,96640,17345,PDN
BA007A,,2006,1969,,163540,50757178,9195066,,163540,50757178,9195066,,0,0,0,PDN
BA007A,,2007,1969,,163540,50757178,9195066,,163540,50757178,9195066,,0,0,0,PDN
BA007A,,2008,1969,,163540,50757178,9195066,,163540,50757178,9195066,,0,0,0,PDN
BA007A,,2009,1969,,163540,51541189,9334570,,163540,51541189,9334570,,0,0,0,PDN
BA007A,,2010,1969,,163540,51541189,9334570,,163540,51541189,9334570,,0,0,0,PDN
BA007A,,2011,1969,,163540,51541189,9334570,,163540,51541189,9334570,,0,0,0,PDN
BA007A,,2012,1969,,163540,51541189,9334570,,163540,51541189,9334570,,0,0,0,PDN
BA007A,,2013,1969,,163540,51541189,9334570,,163540,51541189,9334570,,0,0,0,PDN
BA007A,,2014,1969,,163540,51541189,9334570,,163540,51541189,9334570,,0,0,0,PDN
BA007A,,2015,1969,,163540,51541189,9334570,,163540,51541189,9334570,,0,0,0,PDN
BA007A,,2016,1969,,163540,51541189,9334570,,163540,51541189,9334570,,0,0,0,PDN
BA007A,,2017,1969,,163540,51541189,9334570,,163540,51541189,9334570,,0,0,0,PDN
BA007A,,2017,1969,,163540,51541189,9334570,,163540,51541189,9334570,,0,0,0,PDN
BA017A,,1979,1974,,0,20000000,3558719,,0,0,0,,0,20000000,3558719,PDN
BA017A,,1980,1974,,20000,20000000,3578719,,0,0,0,,20000,20000000,3578719,PDN
BA017A,,1981,1974,,20000,20000000,3578719,,10465,1318815,245130,,9535,18681185,3333589,PDN
BA017A,,1982,1974,,683134,71951162,13485832,,157941,19022956,3542809,,525193,52928206,9943023,PDN
BA017A,,1983,1974,,843066,87692464,16446707,,280957,35203480,6544921,,562109,52488984,9901786,PDN
BA017A,,1984,1974,,1006112,153484091,28316448,,367002,52311170,9675039,,639110,101172921,18641409,PDN
BA017A,,1985,1974,,1006112,153484091,28316448,,422011,63744653,11764476,,584101,89739438,16551972,PDN
BA017A,,1986,1974,,1006112,153484091,28316448,,451609,69829540,12876794,,554503,83654551,15439654,PDN
BA017A,,1987,1974,,1006112,153484091,28316448,,470374,74003571,13638269,,535738,79480520,14678179,PDN
BA017A,,1988,1974,,585783,91867717,16932352,,492360,77931390,14359155,,93423,13936327,2573197,PDN
BA017A,,1989,1974,,568123,91287018,16811365,,507726,80766336,14878960,,60397,10520682,1932405,PDN
BA017A,,1990,1974,,562067,90808415,16720148,,511488,81643178,15038744,,50579,9165237,1681404,PDN
BA017A,,1991,1974,,511574,81664001,15042535,,511574,81664001,15042535,,0,0,0,PDN
BA017A,,1992,1974,,511574,81664001,15042535,,511574,81664001,15042535,,0,0,0,PDN
BA017A,,1993,1974,,511574,81664001,15042535,,511574,81664001,15042535,,0,0,0,PDN
BA017A,,1994,1974,,511574,81664001,15042535,,511574,81664001,15042535,,0,0,0,PDN
BA017A,,1995,1974,,511574,81664001,15042535,,511574,81664001,15042535,,0,0,0,PDN
BA017A,,1996,1974,,511574,81664001,15042535,,511574,81664001,15042535,,0,0,0,PDN
BA017A,,1997,1974,,511574,81664001,15042535,,511574,81664001,15042535,,0,0,0,PDN
BA017A,,1998,1974,,511574,81664001,15042535,,511574,81664001,15042535,,0,0,0,PDN
BA017A,,1999,1974,,511574,81664001,15042535,,511574,81664001,15042535,,0,0,0,PDN
BA017A,,2000,1974,,511574,81664001,15042535,,511574,81664001,15042535,,0,0,0,PDN
BA017A,,2001,1974,,597035,95306515,17555490,,511574,81664001,15042535,,85461,13642514,2512955,PDN
BA017A,,2002,1974,,638123,97369533,17963662,,511574,81664001,15042535,,126549,15705532,2921127,PDN
BA017A,,2003,1974,,638123,97369533,17963662,,516945,82206068,15144359,,121178,15163465,2819303,PDN
BA017A,,2004,1974,,638123,97369533,17963662,,526787,83693166,15418809,,111336,13676367,2544853,PDN
BA017A,,2005,1974,,638123,97369533,17963662,,537524,85431518,15738862,,100599,11938015,2224800,PDN
BA017A,,2006,1974,,616387,98614554,18163460,,543545,86986531,16021575,,72842,11628023,2141885,PDN
BA017A,,2007,1974,,547926,88352490,16269010,,545597,87923933,16190425,,2329,428557,78585,PDN
BA017A,,2008,1974,,574364,92510082,17035233,,545937,87925539,16191051,,28427,4584543,844182,PDN
BA017A,,2009,1974,,551628,90508377,16656321,,547543,89828914,16531335,,4085,679463,124986,PDN
BA017A,,2010,1974,,551628,90508377,16656321,,548233,89977076,16558388,,3395,531301,97933,PDN
BA017A,,2011,1974,,551617,90502979,16655349,,551617,90502979,16655349,,0,0,0,PDN
BA017A,,2012,1974,,551617,90502979,16655349,,551617,90502979,16655349,,0,0,0,PDN
BA017A,,2013,1974,,551617,90502979,16655349,,551617,90502979,16655349,,0,0,0,PDN
BA017A,,2014,1974,,551617,90502979,16655349,,551617,90502979,16655349,,0,0,0,PDN
BA017A,,2015,1974,,551617,90502979,16655349,,551617,90502979,16655349,,0,0,0,PDN
BA017A,,2016,1974,,551617,90502979,16655349,,551617,90502979,16655349,,0,0,0,PDN
BA017A,,2017,1974,,551617,90502979,16655349,,551617,90502979,16655349,,0,0,0,PDN
BA017A,,2017,1974,,551617,90502979,16655349,,551617,90502979,16655349,,0,0,0,PDN
BA020A,,1981,1978,,44000,44000000,7873181,,0,0,0,,44000,44000000,7873181,PDN
BA020A,,1982,1978,,81423,87417744,15636182,,10142,20065269,3580475,,71281,67352475,12055707,PDN
BA020A,,1983,1978,,68782,162000000,28894405,,29469,64382066,11485353,,39313,97617934,17409052,PDN
BA020A,,1984,1978,,68782,162000000,28894405,,36132,84869579,15137481,,32650,77130421,13756924,PDN
BA020A,,1985,1978,,238283,297854208,53237252,,14714,18240764,3260402,,223569,279613444,49976850,PDN
BA020A,,1986,1978,,238283,297854208,53237252,,58791,88722024,15845628,,179492,209132184,37391624,PDN
BA020A,,1987,1978,,238283,297854208,53237252,,95004,145807943,26039478,,143279,152046265,27197774,PDN
BA020A,,1988,1978,,177063,274600000,49038273,,118220,182460382,32584480,,58843,92139618,16453793,PDN
BA020A,,1989,1978,,172558,266194400,47538110,,135961,210394265,37572663,,36597,55800135,9965447,PDN
BA020A,,1990,1978,,172558,266194400,47538110,,148789,231680244,41373032,,23769,34514156,6165078,PDN
BA020A,,1991,1978,,172558,266194400,47538110,,156010,244417800,43646722,,16548,21776600,3891388,PDN
BA020A,,1992,1978,,172558,266194400,47538110,,161329,253829839,45326781,,11229,12364561,2211329,PDN
BA020A,,1993,1978,,177219,280005600,50000279,,165552,260493882,46516777,,11667,19511718,3483502,PDN
BA020A,,1994,1978,,177219,280005600,50000279,,167949,264068820,47155284,,9270,15936780,2844995,PDN
BA020A,,1995,1978,,177219,280005600,50000279,,168569,266204655,47535945,,8650,13800945,2464334,PDN
BA020A,,1996,1978,,178286,281691151,50301267,,168904,267894222,47836915,,9382,13796929,2464352,PDN
BA020A,,1997,1978,,178286,281691151,50301267,,169758,269469391,48118048,,8528,12221760,2183219,PDN
BA020A,,1998,1978,,178286,281691151,50301267,,170676,270893369,48372343,,7610,10797782,1928924,PDN
BA020A,,1999,1978,,195457,342795670,61191128,,173432,274094688,48944729,,22025,68700982,12246399,PDN
BA020A,,2000,1978,,177669,282121206,50377172,,174124,275432441,49183455,,3545,6688765,1193717,PDN
BA020A,,2001,1978,,250098,469722394,83830595,,174945,275977965,49281344,,75153,193744429,34549251,PDN
BA020A,,2002,1978,,211084,448851402,80077882,,193446,302097065,53947372,,17638,146754337,26130510,PDN
BA020A,,2003,1978,,208365,435807033,77754100,,198908,343063797,61242288,,9457,92743236,16511812,PDN
BA020A,,2004,1978,,208365,435807033,77754100,,201574,368950837,65851189,,6791,66856196,11902911,PDN
BA020A,,2005,1978,,208365,435807033,77754100,,203186,380368716,67884452,,5179,55438317,9869648,PDN
BA020A,,2006,1978,,204215,394487821,70397777,,203480,385092360,68725252,,735,9395461,1672525,PDN
BA020A,,2007,1978,,204215,394487821,70397777,,203480,386587654,68991319,,735,7900167,1406458,PDN
BA020A,,2008,1978,,203480,386587769,68991339,,203480,386587769,68991339,,0,0,0,PDN
BA020A,,2009,1978,,203480,392004035,69955087,,203480,392004035,69955087,,0,0,0,PDN
BA020A,,2010,1978,,203480,392004035,69955087,,203480,392004035,69955087,,0,0,0,PDN
BA020A,,2011,1978,,203480,392004035,69955087,,203480,392004035,69955087,,0,0,0,PDN
BA020A,,2012,1978,,203480,392004035,69955087,,203480,392004035,69955087,,0,0,0,PDN
BA020A,,2013,1978,,203480,392004035,69955087,,203480,392004035,69955087,,0,0,0,PDN
BA020A,,2014,1978,,203480,392004035,69955087,,203480,392004035,69955087,,0,0,0,PDN
BA020A,,2015,1978,,203480,392004035,69955087,,203480,392004035,69955087,,0,0,0,PDN
BA020A,,2016,1978,,203480,392004035,69955087,,203480,392004035,69955087,,0,0,0,PDN
BA020A,,2017,1978,,203480,392004035,69955087,,203480,392004035,69955087,,0,0,0,PDN
BA020A,,2017,1978,,203480,392004035,69955087,,203480,392004035,69955087,,0,0,0,PDN
BA021A,,1992,1979,,10479,7293432,1308243,,730,571413,102405,,9749,6722019,1205838,PDN
BA021A,,1993,1979,,10479,7293432,1308243,,4152,4968849,888289,,6327,2324583,419954,PDN
BA021A,,1994,1979,,9955,11521613,2060064,,6228,8113434,1449900,,3727,3408179,610164,PDN
BA021A,,1995,1979,,12984,18115064,3236305,,6768,10854351,1938147,,6216,7260713,1298158,PDN
BA021A,,1996,1979,,33523,53453884,9544890,,10724,16473250,2941907,,22799,36980634,6602983,PDN
BA021A,,1997,1979,,43590,53321356,9531376,,19291,25914922,4630487,,24299,27406434,4900889,PDN
BA021A,,1998,1979,,43590,53321356,9531376,,30024,33048969,5910623,,13566,20272387,3620753,PDN
BA021A,,1999,1979,,50424,63063733,11271729,,39190,40554303,7255258,,11234,22509430,4016471,PDN
BA021A,,2000,1979,,101810,61890044,11114273,,43680,43695996,7818768,,58130,18194048,3295505,PDN
BA021A,,2001,1979,,60809,59260810,10605437,,46338,46832128,8379457,,14471,12428682,2225980,PDN
BA021A,,2002,1979,,60809,59260810,10605437,,47055,47312806,8465704,,13754,11948004,2139733,PDN
BA021A,,2003,1979,,92886,67086160,12029925,,48196,48126383,8611609,,44690,18959777,3418316,PDN
BA021A,,2004,1979,,96172,67086160,12033211,,52722,51152298,9154554,,43450,15933862,2878657,PDN
BA021A,,2005,1979,,100982,64851551,11640404,,54409,52915012,9469892,,46573,11936539,2170512,PDN
BA021A,,2006,1979,,66502,64453645,11535122,,55199,54148550,9690172,,11303,10305095,1844950,PDN
BA021A,,2007,1979,,64296,63174474,11305306,,55815,55178204,9874001,,8481,7996270,1431305,PDN
BA021A,,2008,1979,,64796,64630652,11564912,,56031,55644866,9957253,,8765,8985786,1607659,PDN
BA021A,,2009,1979,,58534,60162842,10763665,,56579,56755969,10155505,,1955,3406873,608160,PDN
BA021A,,2010,1979,,58534,60162842,10763665,,57558,57950537,10369041,,976,2212305,394625,PDN
BA021A,,2011,1979,,58534,60162842,10763665,,57897,58894131,10537279,,637,1268711,226386,PDN
BA021A,,2012,1979,,58534,60162842,10763665,,58115,59315370,10612451,,419,847472,151215,PDN
BA021A,,2013,1979,,58534,60162842,10763665,,58328,59766551,10692945,,206,396291,70720,PDN
BA021A,,2014,1979,,59132,60978328,10909368,,58529,60064220,10746112,,603,914108,163256,PDN
BA021A,,2015,1979,,58551,60141957,10759966,,58551,60141957,10759966,,0,0,0,PDN
BA021A,,2016,1979,,58551,60141957,10759966,,58551,60141957,10759966,,0,0,0,PDN
BA021A,,2017,1979,,58551,60141957,10759966,,58551,60141957,10759966,,0,0,0,PDN
BA021A,,2017,1979,,58551,60141957,10759966,,58551,60141957,10759966,,0,0,0,PDN
BA022A,,1982,1979,,7000,7000000,1252552,,0,0,0,,7000,7000000,1252552,PDN
BA022A,,1983,1979,,859127,135547488,24977897,,3233,929751,168669,,855894,134617737,24809228,PDN
BA022A,,1984,1979,,1230604,219862888,40352114,,95141,19242807,3519128,,1135463,200620081,36832986,PDN
BA022A,,1985,1979,,2367417,337848623,62482830,,303017,40331781,7479490,,2064400,297516842,55003340,PDN
BA022A,,1986,1979,,2387897,337848623,62503310,,419379,55291322,10257693,,1968518,282557301,52245617,PDN
BA022A,,1987,1979,,2347470,343702153,63504437,,479984,66503812,12313403,,1867486,277198341,51191034,PDN
BA022A,,1988,1979,,878690,248885149,45164304,,513257,72939300,13491780,,365433,175945849,31672524,PDN
BA022A,,1989,1979,,742579,153612266,28075722,,532093,77631620,14345549,,210486,75980646,13730173,PDN
BA022A,,1990,1979,,831490,163933278,30001112,,560521,83327130,15387412,,270969,80606148,14613700,PDN
BA022A,,1991,1979,,966591,181426321,33248855,,602334,90162947,16645563,,364257,91263374,16603292,PDN
BA022A,,1992,1979,,910674,161537457,29653994,,632822,97412328,17965976,,277852,64125129,11688018,PDN
BA022A,,1993,1979,,796310,139627559,25641071,,653201,102164806,18831992,,143109,37462753,6809079,PDN
BA022A,,1994,1979,,798253,139528200,25625335,,660916,104692472,19289470,,137337,34835728,6335865,PDN
BA022A,,1995,1979,,764091,123105287,22668946,,664864,106086332,19541436,,99227,17018955,3127510,PDN
BA022A,,1996,1979,,819218,203767424,37076767,,675458,108416127,19966584,,143760,95351297,17110183,PDN
BA022A,,1997,1979,,786479,147278692,26992652,,682705,110750112,20389131,,103774,36528580,6603521,PDN
BA022A,,1998,1979,,789360,149240191,27344554,,688439,112090503,20633368,,100921,37149688,6711186,PDN
BA022A,,1999,1979,,786901,149040736,27306605,,695787,114621221,21091022,,91114,34419515,6215583,PDN
BA022A,,2000,1979,,746737,140608323,25766012,,701029,116351624,21404165,,45708,24256699,4361847,PDN
BA022A,,2001,1979,,794691,151757367,27797781,,733263,119024001,21911911,,61428,32733366,5885870,PDN
BA022A,,2002,1979,,814423,149122829,27348734,,745632,121162296,22304759,,68791,27960533,5043975,PDN
BA022A,,2003,1979,,816606,149878137,27485314,,753218,122069895,22473840,,63388,27808242,5011474,PDN
BA022A,,2004,1979,,816606,149878137,27485314,,753928,122559913,22561742,,62678,27318224,4923572,PDN
BA022A,,2005,1979,,805326,150610035,27604265,,754593,122789340,22603230,,50733,27820695,5001035,PDN
BA022A,,2006,1979,,795671,147609035,27060624,,755301,123211368,22679032,,40370,24397667,4381592,PDN
BA022A,,2007,1979,,781368,134844141,24774987,,755974,123419661,22716768,,25394,11424480,2058219,PDN
BA022A,,2008,1979,,767919,130549082,23997293,,756615,123675826,22762990,,11304,6873256,1234303,PDN
BA022A,,2009,1979,,756862,126132695,23200402,,756862,126132695,23200402,,0,0,0,PDN
BA022A,,2010,1979,,756862,126132695,23200402,,756862,126132695,23200402,,0,0,0,PDN
BA022A,,2011,1979,,756862,126132695,23200402,,756862,126132695,23200402,,0,0,0,PDN
BA022A,,2012,1979,,756861,126132695,23200399,,756861,126132695,23200399,,0,0,0,PDN
BA022A,,2013,1979,,756861,126132695,23200399,,756861,126132695,23200399,,0,0,0,PDN
BA022A,,2014,1979,,756861,126132695,23200399,,756861,126132695,23200399,,0,0,0,PDN
BA022A,,2015,1979,,756861,126132695,23200399,,756861,126132695,23200399,,0,0,0,PDN
BA022A,,2016,1979,,756861,126132695,23200399,,756861,126132695,23200399,,0,0,0,PDN
BA022A,,2017,1979,,756861,126132695,23200399,,756861,126132695,23200399,,0,0,0,PDN
BA022A,,2017,1979,,756861,126132695,23200399,,756861,126132695,23200399,,0,0,0,PDN
BA052A,,1985,1983,,195500,19549989,3674146,,0,26937,4793,,195500,19523052,3669353,PDN
BA052A,,1986,1983,,895804,178265108,32615574,,60940,12342645,2257140,,834864,165922463,30358434,PDN
BA052A,,1987,1983,,895804,178265108,32615574,,98768,20377839,3724718,,797036,157887269,28890856,PDN
BA052A,,1988,1983,,895804,178265108,32615574,,159603,35727182,6516753,,736201,142537926,26098821,PDN
BA052A,,1989,1983,,895804,178265108,32615574,,194195,43013951,7847923,,701609,135251157,24767651,PDN
BA052A,,1990,1983,,972350,234458551,42690953,,227541,51818212,9447863,,744809,182640339,33243090,PDN
BA052A,,1991,1983,,1060948,236225777,43094004,,266141,61120309,11141641,,794807,175105468,31952363,PDN
BA052A,,1992,1983,,1060948,236225777,43094004,,329505,75486179,13761209,,731443,160739598,29332795,PDN
BA052A,,1993,1983,,831542,219026305,39804194,,410055,97555959,17768767,,421487,121470346,22035427,PDN
BA052A,,1994,1983,,839880,223909067,40681351,,462848,112911524,20553867,,377032,110997543,20127484,PDN
BA052A,,1995,1983,,793305,222232754,40336500,,510554,127050196,23117350,,282751,95182558,17219150,PDN
BA052A,,1996,1983,,745294,194394944,35335142,,548144,138674038,25223240,,197150,55720906,10111902,PDN
BA052A,,1997,1983,,745134,194351645,35327277,,581633,152276023,27677011,,163501,42075622,7650266,PDN
BA052A,,1998,1983,,746795,194151805,35293380,,605032,159244937,28940430,,141763,34906868,6352950,PDN
BA052A,,1999,1983,,722304,184011101,33464493,,626162,163109730,29649246,,96142,20901371,3815247,PDN
BA052A,,2000,1983,,705780,182593476,33195723,,634069,165195121,30028219,,71711,17398355,3167504,PDN
BA052A,,2001,1983,,706369,182790222,33231319,,631888,164298761,29866543,,74481,18491461,3364776,PDN
BA052A,,2002,1983,,706369,182790222,33231319,,633651,164876798,29971160,,72718,17913424,3260159,PDN
BA052A,,2003,1983,,704135,185498565,33710997,,635165,165341504,30055361,,68970,20157061,3655636,PDN
BA052A,,2004,1983,,756328,194589263,35380752,,648370,170505615,30987447,,107958,24083648,4393305,PDN
BA052A,,2005,1983,,733923,192258167,34943561,,656143,173955700,31609115,,77780,18302467,3334446,PDN
BA052A,,2006,1983,,711635,188490248,34250825,,660863,176658989,32094847,,50772,11831259,2155978,PDN
BA052A,,2007,1983,,684625,185358774,33666613,,665167,180089531,32709568,,19458,5269243,957045,PDN
BA052A,,2008,1983,,687826,186927974,33949031,,669380,181999849,33053695,,18446,4928125,895336,PDN
BA052A,,2009,1983,,672596,186681816,33890000,,671345,186200004,33803017,,1251,481812,86983,PDN
BA052A,,2010,1983,,672596,186681816,33890000,,672596,186681816,33890000,,0,0,0,PDN
BA052A,,2011,1983,,672596,186681816,33890000,,672596,186681816,33890000,,0,0,0,PDN
BA052A,,2012,1983,,672596,186681816,33890000,,672596,186681816,33890000,,0,0,0,PDN
BA052A,,2013,1983,,672596,186681816,33890000,,672596,186681816,33890000,,0,0,0,PDN
BA052A,,2014,1983,,672596,186681816,33890000,,672596,186681816,33890000,,0,0,0,PDN
BA052A,,2015,1983,,672596,186681816,33890000,,672596,186681816,33890000,,0,0,0,PDN
BA052A,,2016,1983,,672596,186681816,33890000,,672596,186681816,33890000,,0,0,0,PDN
BA052A,,2017,1983,,672596,186681816,33890000,,672596,186681816,33890000,,0,0,0,PDN
BA052A,,2017,1983,,672596,186681816,33890000,,672596,186681816,33890000,,0,0,0,PDN
BA070A,,1977,1968,,210900,210900000,37737590,,0,0,0,,210900,210900000,37737590,PDN
BA070A,,1978,1968,,247049,173220353,31069176,,0,0,0,,247049,173220353,31069176,PDN
BA070A,,1979,1968,,247049,173220353,31069176,,44165,25579116,4595609,,202884,147641237,26473567,PDN
BA070A,,1980,1968,,247049,173220353,31069176,,71074,46858184,8408829,,175975,126362169,22660347,PDN
BA070A,,1981,1968,,212835,157036469,28155267,,78604,56217570,10081730,,134231,100818899,18073537,PDN
BA070A,,1982,1968,,222157,161496279,28958150,,87095,64189256,11508671,,135062,97307023,17449479,PDN
BA070A,,1983,1968,,306884,186866204,33557098,,103345,73481199,13178291,,203539,113385005,20378807,PDN
BA070A,,1984,1968,,304186,198013114,35537836,,120945,85066806,15257387,,183241,112946308,20280449,PDN
BA070A,,1985,1968,,304687,199152015,35740989,,129185,93122450,16699016,,175502,106029565,19041973,PDN
BA070A,,1986,1968,,328961,218277962,39168456,,140555,101211784,18149769,,188406,117066178,21018687,PDN
BA070A,,1987,1968,,421953,311632889,55872645,,157557,115955688,20790242,,264396,195677201,35082403,PDN
BA070A,,1988,1968,,424326,315523086,56567224,,165075,125978610,22581198,,259251,189544476,33986026,PDN
BA070A,,1989,1968,,391736,306078979,54854188,,179598,136595058,24484768,,212138,169483921,30369420,PDN
BA070A,,1990,1968,,331685,225607209,40475316,,186947,144628559,25921566,,144738,80978650,14553750,PDN
BA070A,,1991,1968,,340755,246151075,44139879,,196255,157337125,28192185,,144500,88813950,15947694,PDN
BA070A,,1992,1968,,366213,254613594,45671123,,205922,167520248,30013795,,160291,87093346,15657328,PDN
BA070A,,1993,1968,,367009,251655363,45145543,,211394,174077291,31186001,,155615,77578072,13959542,PDN
BA070A,,1994,1968,,250049,211440163,37872854,,220499,183008481,32784286,,29550,28431682,5088568,PDN
BA070A,,1995,1968,,301220,215108692,38576788,,224027,188640045,33789871,,77193,26468647,4786917,PDN
BA070A,,1996,1968,,341403,225452531,40457512,,226321,192087314,34405558,,115082,33365217,6051954,PDN
BA070A,,1997,1968,,340674,226540872,40650438,,228844,195794664,35067752,,111830,30746208,5582686,PDN
BA070A,,1998,1968,,263168,227250382,40699179,,230481,197944095,35451850,,32687,29306287,5247329,PDN
BA070A,,1999,1968,,372166,271499431,48681674,,232792,200927358,35984991,,139374,70572073,12696683,PDN
BA070A,,2000,1968,,289234,242901548,43510150,,235453,203107918,36375652,,53781,39793630,7134498,PDN
BA070A,,2001,1968,,289821,244369107,43771869,,237358,205730351,36844182,,52463,38638756,6927687,PDN
BA070A,,2002,1968,,285820,239873782,42967988,,238951,207112455,37091701,,46869,32761327,5876287,PDN
BA070A,,2003,1968,,287162,241217545,43208434,,242564,209460150,37513053,,44598,31757395,5695381,PDN
BA070A,,2004,1968,,287729,242483833,43434319,,244458,211025819,37793536,,43271,31458014,5640783,PDN
BA070A,,2005,1968,,282217,241916202,43327805,,245416,211978899,37964081,,36801,29937303,5363724,PDN
BA070A,,2006,1968,,278086,233805793,41880540,,246261,212979177,38142912,,31825,20826616,3737628,PDN
BA070A,,2007,1968,,276032,231508743,41469759,,246785,213439165,38225284,,29247,18069578,3244475,PDN
BA070A,,2008,1968,,261115,222355331,39826121,,247503,214226059,38366019,,13612,8129272,1460102,PDN
BA070A,,2009,1968,,258388,226077103,40485630,,254257,220354499,39463242,,4131,5722604,1022388,PDN
BA070A,,2010,1968,,258388,226077103,40485630,,256225,221965299,39751829,,2163,4111804,733801,PDN
BA070A,,2011,1968,,258388,226077103,40485630,,256662,222796221,39900117,,1726,3280882,585513,PDN
BA070A,,2012,1968,,258388,226077103,40485630,,257145,223597508,40043178,,1243,2479595,442452,PDN
BA070A,,2013,1968,,258388,226077103,40485630,,257496,224344291,40176409,,892,1732812,309222,PDN
BA070A,,2014,1968,,257555,224509446,40205855,,257555,224509446,40205855,,0,0,0,PDN
BA070A,,2015,1968,,257585,224509446,40205885,,257585,224509446,40205885,,0,0,0,PDN
BA070A,,2016,1968,,257585,224509446,40205885,,257585,224509446,40205885,,0,0,0,PDN
BA070A,,2017,1968,,257585,224509446,40205885,,257585,224509446,40205885,,0,0,0,PDN
BA070A,,2017,1968,,257585,224509446,40205885,,257585,224509446,40205885,,0,0,0,PDN
BA076A,,1975,1969,,2098947,165750000,31591830,,964759,83852982,15885218,,1134188,81897018,15706612,PDN
BA076A,,1976,1969,,2098947,165750000,31591830,,1004592,103737124,19463155,,1094355,62012876,12128675,PDN
BA076A,,1977,1969,,2098947,165750000,31591830,,1858381,122110724,23586268,,240566,43639276,8005562,PDN
BA076A,,1978,1969,,2124400,187200000,35434009,,1898407,139074963,26644842,,225993,48125037,8789167,PDN
BA076A,,1979,1969,,400148,201314497,36221233,,289364,152365466,27400657,,110784,48949031,8820576,PDN
BA076A,,1980,1969,,400148,201314497,36221233,,305256,160652069,28891033,,94892,40662428,7330200,PDN
BA076A,,1981,1969,,414161,219450000,39462204,,325331,171850569,30903724,,88830,47599431,8558480,PDN
BA076A,,1982,1969,,414161,219450000,39462204,,334155,178729908,32136630,,80006,40720092,7325574,PDN
BA076A,,1983,1969,,414161,219450000,39462204,,342761,183417728,32979367,,71400,36032272,6482837,PDN
BA076A,,1984,1969,,414161,219450000,39462204,,347640,185869269,33420464,,66521,33580731,6041740,PDN
BA076A,,1985,1969,,414161,219450000,39462204,,350828,187627149,33736442,,63333,31822851,5725762,PDN
BA076A,,1986,1969,,414161,219450000,39462204,,353245,189139703,34007996,,60916,30310297,5454208,PDN
BA076A,,1987,1969,,414161,219450000,39462204,,355679,190421369,34238485,,58482,29028631,5223719,PDN
BA076A,,1988,1969,,414161,219450000,39462204,,357176,191145344,34368803,,56985,28304656,5093401,PDN
BA076A,,1989,1969,,357177,191160897,34371571,,357177,191160897,34371571,,0,0,0,PDN
BA076A,,1990,1969,,357177,191160897,34371571,,357177,191160897,34371571,,0,0,0,PDN
BA076A,,1991,1969,,357177,191160897,34371571,,357177,191160897,34371571,,0,0,0,PDN
BA076A,,1992,1969,,357177,191160897,34371571,,357177,191160897,34371571,,0,0,0,PDN
BA076A,,1993,1969,,357177,191160897,34371571,,357177,191160897,34371571,,0,0,0,PDN
BA076A,,1994,1969,,357177,191160897,34371571,,357177,191160897,34371571,,0,0,0,PDN
BA076A,,1995,1969,,357177,191160897,34371571,,357177,191160897,34371571,,0,0,0,PDN
BA076A,,1996,1969,,357177,191160897,34371571,,357177,191160897,34371571,,0,0,0,PDN
BA076A,,1997,1969,,357177,191160897,34371571,,357177,191160897,34371571,,0,0,0,PDN
BA076A,,1998,1969,,357177,191160897,34371571,,357177,191160897,34371571,,0,0,0,PDN
BA076A,,1999,1969,,357177,191160897,34371571,,357177,191160897,34371571,,0,0,0,PDN
BA076A,,2000,1969,,357177,191160897,34371571,,357177,191160897,34371571,,0,0,0,PDN
BA076A,,2001,1969,,357177,191160897,34371571,,357177,191160897,34371571,,0,0,0,PDN
BA076A,,2002,1969,,357177,191160897,34371571,,357177,191160897,34371571,,0,0,0,PDN
BA076A,,2003,1969,,357177,191160897,34371571,,357177,191160897,34371571,,0,0,0,PDN
BA076A,,2004,1969,,357177,191160897,34371571,,357177,191160897,34371571,,0,0,0,PDN
BA076A,,2005,1969,,357177,191160897,34371571,,357177,191160897,34371571,,0,0,0,PDN
BA076A,,2006,1969,,357177,191160897,34371571,,357177,191160897,34371571,,0,0,0,PDN
BA076A,,2007,1969,,357177,191700380,34467565,,357177,191170111,34373211,,0,530269,94354,PDN
BA076A,,2008,1969,,361531,194817578,35026580,,357177,191699182,34467352,,4354,3118396,559228,PDN
BA076A,,2009,1969,,359026,196622465,35345230,,357602,195863321,35208727,,1424,759144,136503,PDN
BA076A,,2010,1969,,359026,196622465,35345230,,358947,196595454,35340345,,79,27011,4885,PDN
BA076A,,2011,1969,,359058,196622465,35345262,,359058,196622465,35345262,,0,0,0,PDN
BA076A,,2012,1969,,359058,196622465,35345262,,359058,196622465,35345262,,0,0,0,PDN
BA076A,,2013,1969,,359058,196622465,35345262,,359058,196622465,35345262,,0,0,0,PDN
BA076A,,2014,1969,,359058,196622465,35345262,,359058,196622465,35345262,,0,0,0,PDN
BA076A,,2015,1969,,359058,196622465,35345262,,359058,196622465,35345262,,0,0,0,PDN
BA076A,,2016,1969,,359058,196622465,35345262,,359058,196622465,35345262,,0,0,0,PDN
BA076A,,2017,1969,,359058,196622465,35345262,,359058,196622465,35345262,,0,0,0,PDN
BA076A,,2017,1969,,359058,196622465,35345262,,359058,196622465,35345262,,0,0,0,PDN
BA105A,,1975,1971,,0,24991800,4446940,,0,0,0,,0,24991800,4446940,PDP
BA105A,,1976,1971,,0,24991800,4446940,,0,0,0,,0,24991800,4446940,PDP
BA105A,,1977,1971,,326803,27750000,5264525,,50181,5091071,956066,,276622,22658929,4308459,PDP
BA105A,,1978,1971,,326803,27750000,5264525,,85053,9406236,1758760,,241750,18343764,3505765,PDP
BA105A,,1979,1971,,326803,27750000,5264525,,109308,12080684,2258896,,217495,15669316,3005629,PDP
BA105A,,1980,1971,,326803,27750000,5264525,,134975,14341720,2686882,,191828,13408280,2577643,PDP
BA105A,,1981,1971,,265800,28480000,5333416,,160549,16036513,3014021,,105251,12443487,2319395,PDP
BA105A,,1982,1971,,324507,30288619,5713941,,180863,17326048,3263790,,143644,12962571,2450151,PDP
BA105A,,1983,1971,,324507,30288619,5713941,,192064,18015610,3397689,,132443,12273009,2316252,PDP
BA105A,,1984,1971,,324507,30288619,5713941,,228994,18850303,3583140,,95513,11438316,2130801,PDP
BA105A,,1985,1971,,374565,30288619,5763999,,237083,19426808,3693810,,137482,10861811,2070189,PDP
BA105A,,1986,1971,,374565,30288619,5763999,,240204,19781312,3760010,,134361,10507307,2003989,PDP
BA105A,,1987,1971,,374739,30388620,5781967,,242345,20001358,3801305,,132394,10387262,1980662,PDP
BA105A,,1988,1971,,309293,29921313,5633370,,245604,20285011,3855037,,63689,9636302,1778333,PDP
BA105A,,1989,1971,,311576,30059492,5660240,,258071,22126232,4195123,,53505,7933260,1465117,PDP
BA105A,,1990,1971,,312368,30333175,5709730,,267571,24002762,4538525,,44797,6330413,1171205,PDP
BA105A,,1991,1971,,317609,30333175,5714971,,275621,25503008,4813523,,41988,4830167,901448,PDP
BA105A,,1992,1971,,489280,247760409,44574762,,282263,26814480,5053523,,207017,220945929,39521239,PDP
BA105A,,1993,1971,,597083,244135817,44037620,,317330,48357490,8921866,,279753,195778327,35115754,PDP
BA105A,,1994,1971,,597281,244281298,44063704,,368393,95738095,17403641,,228888,148543203,26660063,PDP
BA105A,,1995,1971,,602750,248290050,44782474,,423873,138585544,25083222,,178877,109704506,19699252,PDP
BA105A,,1996,1971,,998907,466541287,84013371,,487043,180205245,32552033,,511864,286336042,51461338,PDP
BA105A,,1997,1971,,1033443,438092835,78985905,,545924,215247612,38846211,,487519,222845223,40139694,PDP
BA105A,,1998,1971,,1033443,438092835,78985905,,596532,244337540,44072963,,436911,193755295,34912942,PDP
BA105A,,1999,1971,,1043519,439838390,79306578,,632568,266888884,48121693,,410951,172949506,31184885,PDP
BA105A,,2000,1971,,913393,377783434,68134645,,659421,285671059,51490570,,253972,92112375,16644075,PDP
BA105A,,2001,1971,,950304,373488887,67407401,,683184,300148470,54090385,,267120,73340417,13317016,PDP
BA105A,,2002,1971,,953410,373554729,67422223,,707942,311670283,56165288,,245468,61884446,11256935,PDP
BA105A,,2003,1971,,928284,368848062,66559612,,730825,323168149,58234054,,197459,45679913,8325558,PDP
BA105A,,2004,1971,,927154,378499073,68275744,,746152,333100666,60016733,,181002,45398407,8259011,PDP
BA105A,,2005,1971,,949777,381059998,68754047,,761366,342941005,61782897,,188411,38118993,6971150,PDP
BA105A,,2006,1971,,949758,381057732,68753625,,773145,351287088,63279744,,176613,29770644,5473881,PDP
BA105A,,2007,1971,,944754,380207294,68597297,,787206,357662922,64428295,,157548,22544372,4169002,PDP
BA105A,,2008,1971,,978656,392659955,70846975,,798785,363923265,65553814,,179871,28736690,5293161,PDP
BA105A,,2009,1971,,998456,413256525,74531644,,808542,374334566,67416117,,189914,38921959,7115528,PDP
BA105A,,2010,1971,,998456,413256525,74531644,,818155,380593118,68539351,,180301,32663407,5992294,PDP
BA105A,,2011,1971,,998456,413256525,74531644,,826378,387115345,69708111,,172078,26141180,4823533,PDP
BA105A,,2012,1971,,998456,413256525,74531644,,837134,393637171,70879335,,161322,19619354,3652309,PDP
BA105A,,2013,1971,,1014487,416511533,75126859,,844561,399698763,71965337,,169926,16812770,3161521,PDP
BA105A,,2014,1971,,1014489,416512381,75127012,,853316,404842057,72889269,,161173,11670324,2237743,PDP
BA105A,,2015,1971,,1011147,419212637,75604142,,859885,409532727,73730477,,151262,9679910,1873665,PDP
BA105A,,2016,1971,,1010156,427385411,77057382,,863537,413701876,74475970,,146619,13683535,2581411,PDP
BA105A,,2017,1971,,1025108,427875084,77159465,,871289,417226391,75110860,,153819,10648693,2048603,PDP
BA105A,,2017,1971,,1025108,427875084,77159465,,871289,417226391,75110860,,153819,10648693,2048603,PDP
BA133A,,1977,1973,,170644,170643600,30534274,,0,0,0,,170644,170643600,30534274,PDP
BA133A,,1978,1973,,806165,118660500,21920133,,38639,3462670,654772,,767526,115197830,21265361,PDP
BA133A,,1979,1973,,865219,118660500,21979187,,135613,16070608,2995152,,729606,102589892,18984035,PDP
BA133A,,1980,1973,,867755,121350500,22460371,,161115,21664342,4015980,,706640,99686158,18444391,PDP
BA133A,,1981,1973,,579619,111124395,20352643,,179484,25777086,4766154,,400135,85347309,15586489,PDP
BA133A,,1982,1973,,632032,120001471,21984607,,191726,28990144,5350115,,440306,91011327,16634492,PDP
BA133A,,1983,1973,,638663,127143628,23262084,,214676,32227800,5949160,,423987,94915828,17312924,PDP
BA133A,,1984,1973,,1039987,132212392,24565324,,240093,36569067,6747044,,799894,95643325,17818280,PDP
BA133A,,1985,1973,,1141790,141812601,26375349,,255239,40554476,7471338,,886551,101258125,18904011,PDP
BA133A,,1986,1973,,1317530,294419198,53705288,,297207,53118040,9748816,,1020323,241301158,43956472,PDP
BA133A,,1987,1973,,1347463,296297958,54069520,,347111,65970269,12085593,,1000352,230327689,41983927,PDP
BA133A,,1988,1973,,1347623,297462242,54276848,,393790,80678784,14749446,,953833,216783458,39527402,PDP
BA133A,,1989,1973,,1352389,306357113,55864331,,465443,116773583,21243661,,886946,189583530,34620670,PDP
BA133A,,1990,1973,,1463434,318521269,58139816,,552687,159793109,28985625,,910747,158728160,29154191,PDP
BA133A,,1991,1973,,955701,366806274,66223721,,625719,203486632,36833305,,329982,163319642,29390416,PDP
BA133A,,1992,1973,,942016,373391950,67381865,,701665,254689102,46020011,,240351,118702848,21361854,PDP
BA133A,,1993,1973,,945789,374873075,67649183,,771519,301107229,54349318,,174270,73765846,13299865,PDP
BA133A,,1994,1973,,1074805,451673075,81443680,,840191,348040937,62769183,,234614,103632138,18674497,PDP
BA133A,,1995,1973,,1098403,492351187,88705376,,902606,394766784,71145806,,195797,97584403,17559570,PDP
BA133A,,1996,1973,,1357861,631645623,113750321,,967705,440730636,79389526,,390156,190914987,34360795,PDP
BA133A,,1997,1973,,1357855,631644997,113750203,,1030495,485269662,87377410,,327360,146375335,26372793,PDP
BA133A,,1998,1973,,1412367,631050575,113698946,,1089684,527557435,94961114,,322683,103493140,18737832,PDP
BA133A,,1999,1973,,1544049,725090557,130563721,,1156699,568572784,102326234,,387350,156517773,28237487,PDP
BA133A,,2000,1973,,1505632,730549109,131496576,,1220605,609841019,109733242,,285027,120708090,21763334,PDP
BA133A,,2001,1973,,1552356,760252031,136828518,,1276121,647549044,116498371,,276235,112702987,20330147,PDP
BA133A,,2002,1973,,1557509,758764301,136568950,,1322031,674284302,121301444,,235478,84479999,15267506,PDP
BA133A,,2003,1973,,1663830,840685532,151252003,,1385412,708112728,127384118,,278418,132572804,23867885,PDP
BA133A,,2004,1973,,1556335,853274385,153384517,,1431249,741159980,133310249,,125086,112114405,20074268,PDP
BA133A,,2005,1973,,1572577,861488052,154862266,,1465457,767016975,137945346,,107120,94471077,16916920,PDP
BA133A,,2006,1973,,1564094,860611773,154697861,,1500025,792702274,142550252,,64069,67909499,12147609,PDP
BA133A,,2007,1973,,1562738,859618294,154519730,,1530304,812800326,146156697,,32434,46817968,8363033,PDP
BA133A,,2008,1973,,1630513,877267278,157727893,,1553555,828474964,148969029,,76958,48792314,8758864,PDP
BA133A,,2009,1973,,1661539,913570757,164218612,,1577969,853547917,153454822,,83570,60022840,10763790,PDP
BA133A,,2010,1973,,1661539,913644062,164231656,,1595629,866714065,155815211,,65910,46929997,8416444,PDP
BA133A,,2011,1973,,1661131,913736575,164247709,,1608278,878346707,157897726,,52853,35389868,6349982,PDP
BA133A,,2012,1973,,1661447,914173369,164325746,,1622891,888648714,159745436,,38556,25524655,4580309,PDP
BA133A,,2013,1973,,1661447,914173369,164325746,,1630933,895731945,161013839,,30514,18441424,3311906,PDP
BA133A,,2014,1973,,1654834,914173369,164319133,,1639623,902209502,162175120,,15211,11963867,2144013,PDP
BA133A,,2015,1973,,1654834,914173369,164319133,,1646612,908888871,163370608,,8222,5284498,948523,PDP
BA133A,,2016,1973,,1655147,924137948,166092503,,1650089,915004711,164462313,,5058,9133237,1630189,PDP
BA133A,,2017,1973,,1663285,930535950,167239076,,1657831,919889426,165339221,,5454,10646524,1899853,PDP
BA133A,,2017,1973,,1663285,930535950,167239076,,1657831,919889426,165339221,,5454,10646524,1899853,PDP
BA364,,1992,1991,,195586,22165086,4139551,,39354,4360584,815259,,156232,17804502,3324292,PDN
BA364,,1993,1991,,211718,24706052,4607813,,97975,13671756,2530672,,113743,11034296,2077141,PDN
BA364,,1994,1991,,211061,29822150,5517493,,107243,16959801,3125001,,103818,12862349,2392492,PDN
BA364,,1995,1991,,188411,28991107,5346971,,124250,20693622,3806389,,64161,8297485,1540582,PDN
BA364,,1996,1991,,152113,27238473,4998816,,131417,22545172,4143013,,20696,4693301,855803,PDN
BA364,,1997,1991,,152123,27240435,4999175,,135185,23685757,4349733,,16938,3554678,649442,PDN
BA364,,1998,1991,,152123,27240435,4999175,,135185,23802132,4370440,,16938,3438303,628735,PDN
BA364,,1999,1991,,152693,27431156,5033682,,135185,23892002,4386431,,17508,3539154,647251,PDN
BA364,,2000,1991,,144442,26009305,4772432,,135185,23952467,4397190,,9257,2056838,375242,PDN
BA364,,2001,1991,,135185,23986677,4403277,,135185,23975844,4401349,,0,10833,1928,PDN
BA364,,2002,1991,,135185,23986677,4403277,,135185,23984755,4402935,,0,1922,342,PDN
BA364,,2003,1991,,135185,23986677,4403277,,135185,23986677,4403277,,0,0,0,PDN
BA364,,2004,1991,,135185,23986677,4403277,,135185,23986677,4403277,,0,0,0,PDN
BA364,,2005,1991,,135185,23986677,4403277,,135185,23986677,4403277,,0,0,0,PDN
BA364,,2006,1991,,135185,23986677,4403277,,135185,23986677,4403277,,0,0,0,PDN
BA364,,2007,1991,,135185,23986677,4403277,,135185,23986677,4403277,,0,0,0,PDN
BA364,,2008,1991,,135185,23986677,4403277,,135185,23986677,4403277,,0,0,0,PDN
BA364,,2009,1991,,135185,24462592,4487958,,135185,24462592,4487958,,0,0,0,PDN
BA364,,2010,1991,,135185,24462592,4487958,,135185,24462592,4487958,,0,0,0,PDN
BA364,,2011,1991,,135185,24462592,4487958,,135185,24462592,4487958,,0,0,0,PDN
BA364,,2012,1991,,135185,24462592,4487958,,135185,24462592,4487958,,0,0,0,PDN
BA364,,2013,1991,,135185,24462592,4487958,,135185,24462592,4487958,,0,0,0,PDN
BA364,,2014,1991,,135185,24462592,4487958,,135185,24462592,4487958,,0,0,0,PDN
BA364,,2015,1991,,135185,24462592,4487958,,135185,24462592,4487958,,0,0,0,PDN
BA364,,2016,1991,,135185,24462592,4487958,,135185,24462592,4487958,,0,0,0,PDN
BA364,,2017,1991,,135185,24462592,4487958,,135185,24462592,4487958,,0,0,0,PDN
BA364,,2017,1991,,135185,24462592,4487958,,135185,24462592,4487958,,0,0,0,PDN
BA376,,1988,1986,,48614,10938007,1994879,,0,0,0,,48614,10938007,1994879,PDN
BA376,,1989,1986,,48614,10938007,1994879,,0,0,0,,48614,10938007,1994879,PDN
BA376,,1990,1986,,48614,10938007,1994879,,958,250979,45616,,47656,10687028,1949263,PDN
BA376,,1991,1986,,129920,21001718,3866880,,29693,4035740,747796,,100227,16965978,3119084,PDN
BA376,,1992,1986,,197161,32493564,5978934,,49011,7168192,1324490,,148150,25325372,4654444,PDN
BA376,,1993,1986,,197078,32363772,5955756,,54802,8547313,1575676,,142276,23816459,4380080,PDN
BA376,,1994,1986,,205763,33809461,6221681,,62212,9897039,1823251,,143551,23912422,4398430,PDN
BA376,,1995,1986,,203070,34990158,6429077,,65819,11345161,2084531,,137251,23644997,4344546,PDN
BA376,,1996,1986,,142135,27439991,5024696,,71257,12915007,2369301,,70878,14524984,2655395,PDN
BA376,,1997,1986,,142102,27432262,5023287,,75354,14216769,2605028,,66748,13215493,2418259,PDN
BA376,,1998,1986,,144428,28453452,5207320,,76655,15120474,2767131,,67773,13332978,2440189,PDN
BA376,,1999,1986,,165014,40928936,7447743,,82470,17141563,3132570,,82544,23787373,4315173,PDN
BA376,,2000,1986,,169048,38923329,7094907,,91017,19423146,3547093,,78031,19500183,3547814,PDN
BA376,,2001,1986,,166136,37200548,6785451,,103621,24923425,4538394,,62515,12277123,2247057,PDN
BA376,,2002,1986,,176110,46238611,8403621,,108861,28045906,5099236,,67249,18192705,3304385,PDN
BA376,,2003,1986,,192327,50173433,9119984,,112508,29365917,5337760,,79819,20807516,3782224,PDN
BA376,,2004,1986,,187392,45731494,8324669,,115231,30203760,5489566,,72161,15527734,2835103,PDN
BA376,,2005,1986,,187392,45731494,8324669,,118453,31373795,5700979,,68939,14357699,2623690,PDN
BA376,,2006,1986,,168295,43536561,7915015,,121099,32349697,5877273,,47196,11186864,2037742,PDN
BA376,,2007,1986,,163231,41974172,7631945,,122146,32971977,5989046,,41085,9002195,1642899,PDN
BA376,,2008,1986,,165243,43301928,7870212,,123079,33680693,6116085,,42164,9621235,1754127,PDN
BA376,,2009,1986,,133985,39269902,7121514,,124050,34633030,6286512,,9935,4636872,835001,PDN
BA376,,2010,1986,,127296,36259976,6579251,,124495,35112962,6372355,,2801,1147014,206896,PDN
BA376,,2011,1986,,127296,36259976,6579251,,126873,36012341,6534764,,423,247635,44486,PDN
BA376,,2012,1986,,127296,36259976,6579251,,127296,36259976,6579251,,0,0,0,PDN
BA376,,2013,1986,,127296,36259976,6579251,,127296,36259976,6579251,,0,0,0,PDN
BA376,,2014,1986,,127296,36259976,6579251,,127296,36259976,6579251,,0,0,0,PDN
BA376,,2015,1986,,127296,36259976,6579251,,127296,36259976,6579251,,0,0,0,PDN
BA376,,2016,1986,,127296,36259976,6579251,,127296,36259976,6579251,,0,0,0,PDN
BA376,,2017,1986,,127296,36259976,6579251,,127296,36259976,6579251,,0,0,0,PDN
BA376,,2017,1986,,127296,36259976,6579251,,127296,36259976,6579251,,0,0,0,PDN
BA397,,1991,1991,,6265,62652688,11154430,,0,0,0,,6265,62652688,11154430,PDN
BA397,,1992,1991,,6265,62652688,11154430,,323,193432,34742,,5942,62459256,11119688,PDN
BA397,,1993,1991,,60734,62652688,11208899,,7726,10433930,1864297,,53008,52218758,9344602,PDN
BA397,,1994,1991,,60734,62652688,11208899,,9608,14680932,2621873,,51126,47971756,8587026,PDN
BA397,,1995,1991,,68019,136491117,24354695,,9838,16176628,2888242,,58181,120314489,21466453,PDN
BA397,,1996,1991,,40702,52292415,9345402,,10260,18714782,3340292,,30442,33577633,6005110,PDN
BA397,,1997,1991,,40702,52292415,9345402,,11210,20664090,3688094,,29492,31628325,5657308,PDN
BA397,,1998,1991,,41781,46982452,8401648,,12014,21947938,3917341,,29767,25034514,4484307,PDN
BA397,,1999,1991,,13860,26428513,4716442,,12395,22587167,4031464,,1465,3841346,684978,PDN
BA397,,2000,1991,,13461,24698635,4408236,,12426,23073511,4118033,,1035,1625124,290203,PDN
BA397,,2001,1991,,143576,44295860,8025402,,12426,23496018,4193212,,131150,20799842,3832190,PDN
BA397,,2002,1991,,143576,44295860,8025402,,12906,27135270,4841246,,130670,17160590,3184156,PDN
BA397,,2003,1991,,143576,45843270,8300741,,13359,30641562,5465594,,130217,15201708,2835147,PDN
BA397,,2004,1991,,143576,45843270,8300741,,13764,32523025,5800779,,129812,13320245,2499962,PDN
BA397,,2005,1991,,141666,38106192,6922127,,13816,33870830,6040654,,127850,4235362,881473,PDN
BA397,,2006,1991,,141666,38156262,6931036,,13816,34304317,6117787,,127850,3851945,813249,PDN
BA397,,2007,1991,,13946,35595047,6347584,,13816,34738404,6195027,,130,856643,152557,PDN
BA397,,2008,1991,,13817,36711606,6546131,,13817,35286634,6292577,,0,1424972,253554,PDN
BA397,,2009,1991,,13817,36074021,6432682,,13817,36074021,6432682,,0,0,0,PDN
BA397,,2010,1991,,13817,36074021,6432682,,13817,36074021,6432682,,0,0,0,PDN
BA397,,2011,1991,,13817,36074021,6432682,,13817,36074021,6432682,,0,0,0,PDN
BA397,,2012,1991,,13817,36074021,6432682,,13817,36074021,6432682,,0,0,0,PDN
BA397,,2013,1991,,13817,36074021,6432682,,13817,36074021,6432682,,0,0,0,PDN
BA397,,2014,1991,,13817,36074021,6432682,,13817,36074021,6432682,,0,0,0,PDN
BA397,,2015,1991,,13817,36074021,6432682,,13817,36074021,6432682,,0,0,0,PDN
BA397,,2016,1991,,13817,36074021,6432682,,13817,36074021,6432682,,0,0,0,PDN
BA397,,2017,1991,,13817,36074021,6432682,,13817,36074021,6432682,,0,0,0,PDN
BA397,,2017,1991,,13817,36074021,6432682,,13817,36074021,6432682,,0,0,0,PDN
BA398,,1994,1986,,96582,8672121,1639664,,8807,692530,132033,,87775,7979591,1507631,PDN
BA398,,1995,1986,,96582,8672121,1639664,,11069,834830,159615,,85513,7837291,1480049,PDN
BA398,,1996,1986,,11069,834830,159615,,11069,834830,159615,,0,0,0,PDN
BA398,,1997,1986,,11069,834830,159615,,11069,834830,159615,,0,0,0,PDN
BA398,,1998,1986,,11069,834830,159615,,11069,834830,159615,,0,0,0,PDN
BA398,,1999,1986,,11069,834830,159615,,11069,834830,159615,,0,0,0,PDN
BA398,,2000,1986,,11069,834830,159615,,11069,834830,159615,,0,0,0,PDN
BA398,,2001,1986,,11069,834830,159615,,11069,834830,159615,,0,0,0,PDN
BA398,,2002,1986,,11069,834830,159615,,11069,834830,159615,,0,0,0,PDN
BA398,,2003,1986,,16077,35333282,6303138,,11707,4576930,826107,,4370,30756352,5477031,PDN
BA398,,2004,1986,,12795,10757986,1927027,,11800,5016213,904365,,995,5741773,1022662,PDN
BA398,,2005,1986,,12795,10757986,1927027,,11830,5083264,916325,,965,5674722,1010702,PDN
BA398,,2006,1986,,12795,10757986,1927027,,11856,5152893,928741,,939,5605093,998286,PDN
BA398,,2007,1986,,12795,10757986,1927027,,11896,5241090,944474,,899,5516896,982553,PDN
BA398,,2008,1986,,11949,5302620,955476,,11873,5182537,934033,,76,120083,21443,PDN
BA398,,2009,1986,,11901,5228431,942226,,11901,5228431,942226,,0,0,0,PDN
BA398,,2010,1986,,11901,5228431,942226,,11901,5228431,942226,,0,0,0,PDN
BA398,,2011,1986,,11901,5228431,942226,,11901,5228431,942226,,0,0,0,PDN
BA398,,2012,1986,,11901,5228431,942226,,11901,5228431,942226,,0,0,0,PDN
BA398,,2013,1986,,11901,5228431,942226,,11901,5228431,942226,,0,0,0,PDN
BA398,,2014,1986,,11901,5228431,942226,,11901,5228431,942226,,0,0,0,PDN
BA398,,2015,1986,,11901,5228431,942226,,11901,5228431,942226,,0,0,0,PDN
BA398,,2016,1986,,11901,5228431,942226,,11901,5228431,942226,,0,0,0,PDN
BA398,,2017,1986,,11901,5228431,942226,,11901,5228431,942226,,0,0,0,PDN
BA398,,2017,1986,,11901,5228431,942226,,11901,5228431,942226,,0,0,0,PDN
BA399,,1990,1989,,4630,14951776,2665088,,548,200870,36290,,4082,14750906,2628798,PDN
BA399,,1991,1989,,118573,84853733,15217102,,16722,10573735,1898170,,101851,74279998,13318932,PDN
BA399,,1992,1989,,109148,61644620,11077942,,25940,18916696,3391900,,83208,42727924,7686042,PDN
BA399,,1993,1989,,139381,76665517,13780932,,53970,31156955,5597912,,85411,45508562,8183020,PDN
BA399,,1994,1989,,185921,87363285,15730990,,67547,38426979,6905088,,118374,48936306,8825902,PDN
BA399,,1995,1989,,157081,84376038,15170611,,90708,46460712,8357739,,66373,37915326,6812872,PDN
BA399,,1996,1989,,129963,65826400,11842846,,109967,54085212,9733670,,19996,11741188,2109176,PDN
BA399,,1997,1989,,166972,80430522,14478453,,128571,61230836,11023738,,38401,19199686,3454715,PDN
BA399,,1998,1989,,170831,81678219,14704322,,138977,65763286,11840629,,31854,15914933,2863693,PDN
BA399,,1999,1989,,263478,90351796,16340310,,147918,70366780,12668697,,115560,19985016,3671613,PDN
BA399,,2000,1989,,236047,86289762,15590097,,158195,75133963,13527228,,77852,11155799,2062869,PDN
BA399,,2001,1989,,264658,95988095,17344390,,165059,77777567,14004484,,99599,18210528,3339906,PDN
BA399,,2002,1989,,257507,94306420,17038009,,175619,81013744,14590876,,81888,13292676,2447133,PDN
BA399,,2003,1989,,276429,102174375,18456923,,180072,84399822,15197834,,96357,17774553,3259089,PDN
BA399,,2004,1989,,276530,102392299,18495800,,184482,87355327,15728134,,92048,15036972,2767666,PDN
BA399,,2005,1989,,244961,96945936,17495128,,187181,89313873,16079329,,57780,7632063,1415799,PDN
BA399,,2006,1989,,223273,98815994,17806190,,189595,90615343,16313322,,33678,8200651,1492868,PDN
BA399,,2007,1989,,202143,95020477,17109701,,190191,91176048,16413687,,11952,3844429,696014,PDN
BA399,,2008,1989,,209715,99445867,17904709,,192588,92115314,16583213,,17127,7330553,1321496,PDN
BA399,,2009,1989,,227936,107921060,19430975,,196351,95146479,17126334,,31585,12774581,2304642,PDN
BA399,,2010,1989,,208060,100542272,18098147,,199554,96707356,17407272,,8506,3834916,690876,PDN
BA399,,2011,1989,,208060,100542272,18098147,,201942,98035882,17646053,,6118,2506390,452095,PDN
BA399,,2012,1989,,208060,100538788,18097526,,208060,100537920,18097372,,0,868,154,PDN
BA399,,2013,1989,,208060,100537920,18097372,,208060,100537920,18097372,,0,0,0,PDN
BA399,,2014,1989,,208060,100537920,18097372,,208060,100537920,18097372,,0,0,0,PDN
BA399,,2015,1989,,208060,100537920,18097372,,208060,100537920,18097372,,0,0,0,PDN
BA399,,2016,1989,,208060,100537920,18097372,,208060,100537920,18097372,,0,0,0,PDN
BA399,,2017,1989,,208060,100537920,18097372,,208060,100537920,18097372,,0,0,0,PDN
BA399,,2017,1989,,208060,100537920,18097372,,208060,100537920,18097372,,0,0,0,PDN
BA412,,1986,1983,,7430,1575263,287726,,0,0,0,,7430,1575263,287726,PDN
BA412,,1987,1983,,7430,1575263,287726,,0,0,0,,7430,1575263,287726,PDN
BA412,,1989,1983,,30848,11675237,2108292,,59,9425,1736,,30789,11665812,2106556,PDN
BA412,,1990,1983,,186481,37427456,6846171,,47989,9479903,1734804,,138492,27947553,5111367,PDN
BA412,,1991,1983,,287162,56069705,10263978,,76627,18185517,3312484,,210535,37884188,6951494,PDN
BA412,,1992,1983,,324304,67898473,12405883,,100935,26385415,4795849,,223369,41513058,7610034,PDN
BA412,,1993,1983,,331447,71092993,12981446,,120054,32942595,5981726,,211393,38150398,6999720,PDN
BA412,,1994,1983,,325164,72144707,13162300,,130563,39103440,7088470,,194601,33041267,6073830,PDN
BA412,,1995,1983,,160399,59739023,10790118,,136085,43199599,7822846,,24314,16539424,2967272,PDN
BA412,,1996,1983,,170881,63279844,11430640,,140909,45537383,8243646,,29972,17742461,3186994,PDN
BA412,,1997,1983,,167957,60045765,10852257,,144052,47381635,8574948,,23905,12664130,2277309,PDN
BA412,,1998,1983,,167957,60045765,10852257,,145840,48475697,8771409,,22117,11570068,2080848,PDN
BA412,,1999,1983,,156912,55789043,10083788,,146697,49106976,8884593,,10215,6682067,1199195,PDN
BA412,,2000,1983,,155315,53339285,9646291,,147171,49425040,8941662,,8144,3914245,704629,PDN
BA412,,2001,1983,,155627,52983355,9583270,,147509,49609458,8974815,,8118,3373897,608455,PDN
BA412,,2002,1983,,155676,53004613,9587102,,148207,49821268,9013201,,7469,3183345,573901,PDN
BA412,,2003,1983,,155676,53004613,9587102,,148241,49830246,9014833,,7435,3174367,572269,PDN
BA412,,2004,1983,,155676,53004613,9587102,,149549,50292213,9098341,,6127,2712400,488761,PDN
BA412,,2005,1983,,155676,53004613,9587102,,150016,50615020,9156247,,5660,2389593,430855,PDN
BA412,,2006,1983,,151530,51149552,9252874,,150100,50659652,9164273,,1430,489900,88601,PDN
BA412,,2007,1983,,153187,51385664,9296544,,152458,51193128,9261556,,729,192536,34988,PDN
BA412,,2008,1983,,153187,51385664,9296544,,153102,51361480,9292155,,85,24184,4389,PDN
BA412,,2009,1983,,153123,52334459,9465305,,153123,52334459,9465305,,0,0,0,PDN
BA412,,2010,1983,,153123,52334459,9465305,,153123,52334459,9465305,,0,0,0,PDN
BA412,,2011,1983,,153123,52334459,9465305,,153123,52334459,9465305,,0,0,0,PDN
BA412,,2012,1983,,153123,52334459,9465305,,153123,52334459,9465305,,0,0,0,PDN
BA412,,2013,1983,,153123,52334459,9465305,,153123,52334459,9465305,,0,0,0,PDN
BA412,,2014,1983,,153123,52334459,9465305,,153123,52334459,9465305,,0,0,0,PDN
BA412,,2015,1983,,153123,52334459,9465305,,153123,52334459,9465305,,0,0,0,PDN
BA412,,2016,1983,,153123,52334459,9465305,,153123,52334459,9465305,,0,0,0,PDN
BA412,,2017,1983,,153123,52334459,9465305,,153123,52334459,9465305,,0,0,0,PDN
BA412,,2017,1983,,153123,52334459,9465305,,153123,52334459,9465305,,0,0,0,PDN
BA413,,1992,1989,,19272,3992887,729750,,8243,1792349,327166,,11029,2200538,402584,PDN
BA413,,1993,1989,,27629,6120328,1116655,,18263,4025843,734605,,9366,2094485,382050,PDN
BA413,,1994,1989,,36681,8724977,1589168,,31410,7602289,1384130,,5271,1122688,205038,PDN
BA413,,1995,1989,,71508,27098376,4893283,,44869,11761747,2137707,,26639,15336629,2755576,PDN
BA413,,1996,1989,,71490,27093617,4892418,,57583,15164677,2755924,,13907,11928940,2136494,PDN
BA413,,1997,1989,,71508,27098376,4893283,,62101,16292514,2961125,,9407,10805862,1932158,PDN
BA413,,1998,1989,,62440,16330906,2968295,,62440,16330906,2968295,,0,0,0,PDN
BA413,,1999,1989,,62440,16330906,2968295,,62440,16330906,2968295,,0,0,0,PDN
BA413,,2000,1989,,62440,16330906,2968295,,62440,16330906,2968295,,0,0,0,PDN
BA413,,2001,1989,,62440,16330906,2968295,,62440,16330906,2968295,,0,0,0,PDN
BA413,,2002,1989,,62440,16330906,2968295,,62440,16330906,2968295,,0,0,0,PDN
BA413,,2003,1989,,62440,16330906,2968295,,62440,16330906,2968295,,0,0,0,PDN
BA413,,2004,1989,,62440,16330906,2968295,,62440,16330906,2968295,,0,0,0,PDN
BA413,,2005,1989,,62440,16330906,2968295,,62440,16330906,2968295,,0,0,0,PDN
BA413,,2006,1989,,62440,16330906,2968295,,62440,16330906,2968295,,0,0,0,PDN
BA413,,2007,1989,,62440,16330906,2968295,,62440,16330906,2968295,,0,0,0,PDN
BA413,,2008,1989,,62440,16330906,2968295,,62440,16330906,2968295,,0,0,0,PDN
BA413,,2009,1989,,62440,16657967,3026491,,62440,16657967,3026491,,0,0,0,PDN
BA413,,2010,1989,,62440,16657967,3026491,,62440,16657967,3026491,,0,0,0,PDN
BA413,,2011,1989,,62440,16657967,3026491,,62440,16657967,3026491,,0,0,0,PDN
BA413,,2012,1989,,62440,16657967,3026491,,62440,16657967,3026491,,0,0,0,PDN
BA413,,2013,1989,,62440,16657967,3026491,,62440,16657967,3026491,,0,0,0,PDN
BA413,,2014,1989,,62440,16657967,3026491,,62440,16657967,3026491,,0,0,0,PDN
BA413,,2015,1989,,62440,16657967,3026491,,62440,16657967,3026491,,0,0,0,PDN
BA413,,2016,1989,,62440,16657967,3026491,,62440,16657967,3026491,,0,0,0,PDN
BA413,,2017,1989,,62440,16657967,3026491,,62440,16657967,3026491,,0,0,0,PDN
BA413,,2017,1989,,62440,16657967,3026491,,62440,16657967,3026491,,0,0,0,PDN
BA431,,1991,1991,,109348,26589632,4840599,,0,0,0,,109348,26589632,4840599,PDN
BA431,,1992,1991,,109348,26589632,4840599,,0,0,0,,109348,26589632,4840599,PDN
BA431,,1993,1991,,109348,26589632,4840599,,50239,10602953,1936885,,59109,15986679,2903714,PDN
BA431,,1994,1991,,109348,26589632,4840599,,83720,19950909,3633704,,25628,6638723,1206895,PDN
BA431,,1995,1991,,142460,37453752,6806829,,101364,26649291,4843231,,41096,10804461,1963598,PDN
BA431,,1996,1991,,141810,37282517,6775710,,110094,30980000,5622550,,31716,6302517,1153160,PDN
BA431,,1997,1991,,141810,37282517,6775710,,112920,32978750,5981025,,28890,4303767,794685,PDN
BA431,,1998,1991,,141810,37282517,6775710,,114146,34028731,6169080,,27664,3253786,606630,PDN
BA431,,1999,1991,,141810,37282517,6775710,,114690,34757370,6299275,,27120,2525147,476435,PDN
BA431,,2000,1991,,114817,35101844,6360697,,114746,34913540,6327120,,71,188304,33577,PDN
BA431,,2001,1991,,114750,34955954,6334671,,114750,34955954,6334671,,0,0,0,PDN
BA431,,2002,1991,,114750,34955954,6334671,,114750,34955954,6334671,,0,0,0,PDN
BA431,,2003,1991,,114750,34955954,6334671,,114750,34955954,6334671,,0,0,0,PDN
BA431,,2004,1991,,114750,34955954,6334671,,114750,34955954,6334671,,0,0,0,PDN
BA431,,2005,1991,,114750,34955954,6334671,,114750,34955954,6334671,,0,0,0,PDN
BA431,,2006,1991,,114750,34955954,6334671,,114750,34955954,6334671,,0,0,0,PDN
BA431,,2007,1991,,114750,34955954,6334671,,114750,34955954,6334671,,0,0,0,PDN
BA431,,2008,1991,,114750,34955954,6334671,,114750,34955954,6334671,,0,0,0,PDN
BA431,,2009,1991,,114750,35634000,6455319,,114750,35634000,6455319,,0,0,0,PDN
BA431,,2010,1991,,114750,35634000,6455319,,114750,35634000,6455319,,0,0,0,PDN
BA431,,2011,1991,,114750,35634000,6455319,,114750,35634000,6455319,,0,0,0,PDN
BA431,,2012,1991,,114750,35634000,6455319,,114750,35634000,6455319,,0,0,0,PDN
BA431,,2013,1991,,114750,35634000,6455319,,114750,35634000,6455319,,0,0,0,PDN
BA431,,2014,1991,,114750,35634000,6455319,,114750,35634000,6455319,,0,0,0,PDN
BA431,,2015,1991,,114750,35634000,6455319,,114750,35634000,6455319,,0,0,0,PDN
BA431,,2016,1991,,114750,35634000,6455319,,114750,35634000,6455319,,0,0,0,PDN
BA431,,2017,1991,,114750,35634000,6455319,,114750,35634000,6455319,,0,0,0,PDN
BA431,,2017,1991,,114750,35634000,6455319,,114750,35634000,6455319,,0,0,0,PDN
BA437,,1981,1980,,29173,20081540,3602401,,859,113456,21047,,28314,19968084,3581354,PDN
BA437,,1982,1980,,116885,19790493,3638325,,34336,6508291,1192395,,82549,13282202,2445930,PDN
BA437,,1983,1980,,125924,21251370,3907307,,67835,14229478,2599771,,58089,7021892,1307536,PDN
BA437,,1984,1980,,175027,37747029,6891580,,93616,21222805,3869916,,81411,16524224,3021664,PDN
BA437,,1985,1980,,220712,46941531,8573298,,108508,25658776,4674127,,112204,21282755,3899171,PDN
BA437,,1986,1980,,271342,57003500,10414314,,149673,34399800,6270634,,121669,22603700,4143680,PDN
BA437,,1987,1980,,330710,72947749,13310737,,195704,47470021,8642327,,135006,25477728,4668410,PDN
BA437,,1988,1980,,289754,66554868,12132257,,206771,52720320,9587611,,82983,13834548,2544646,PDN
BA437,,1989,1980,,326854,88131828,16008674,,214074,56092434,10194934,,112780,32039394,5813740,PDN
BA437,,1990,1980,,272887,76099319,13813691,,200124,52582551,9556450,,72763,23516768,4257241,PDN
BA437,,1991,1980,,261386,70563729,12817210,,209982,56118271,10195439,,51404,14445458,2621771,PDN
BA437,,1992,1980,,316359,80924263,14715694,,215797,58485468,10622464,,100562,22438795,4093230,PDN
BA437,,1993,1980,,263803,76003623,13787579,,224426,62646947,11371570,,39377,13356676,2416009,PDN
BA437,,1994,1980,,263803,76003623,13787579,,226730,64402956,11686331,,37073,11600667,2101248,PDN
BA437,,1995,1980,,261301,75762735,13742215,,228175,65045224,11802058,,33126,10717511,1940157,PDN
BA437,,1996,1980,,247099,71492045,12968103,,228985,65642279,11909106,,18114,5849766,1058997,PDN
BA437,,1997,1980,,247127,71492045,12968131,,229377,65813491,11939963,,17750,5678554,1028168,PDN
BA437,,1998,1980,,247127,71492045,12968131,,229629,65830758,11943287,,17498,5661287,1024844,PDN
BA437,,1999,1980,,244427,71004040,12878598,,229853,66692999,12096935,,14574,4311041,781663,PDN
BA437,,2000,1980,,229869,66862229,12127063,,229869,66862229,12127063,,0,0,0,PDN
BA437,,2001,1980,,229869,66862229,12127063,,229869,66862229,12127063,,0,0,0,PDN
BA437,,2002,1980,,229869,66862229,12127063,,229869,66862229,12127063,,0,0,0,PDN
BA437,,2003,1980,,229869,66862229,12127063,,229869,66862229,12127063,,0,0,0,PDN
BA437,,2004,1980,,229869,66862229,12127063,,229869,66862229,12127063,,0,0,0,PDN
BA437,,2005,1980,,229869,66862229,12127063,,229869,66862229,12127063,,0,0,0,PDN
BA437,,2006,1980,,229869,66862229,12127063,,229869,66862229,12127063,,0,0,0,PDN
BA437,,2007,1980,,234250,68281945,12384062,,231426,67373430,12219581,,2824,908515,164481,PDN
BA437,,2008,1980,,235472,69261010,12559495,,233963,68629046,12445537,,1509,631964,113958,PDN
BA437,,2009,1980,,235472,70579379,12794081,,235378,70478580,12776051,,94,100799,18030,PDN
BA437,,2010,1980,,235472,70579379,12794081,,235406,70529389,12785120,,66,49990,8961,PDN
BA437,,2011,1980,,235472,70579379,12794081,,235472,70579379,12794081,,0,0,0,PDN
BA437,,2012,1980,,235472,70579379,12794081,,235472,70579379,12794081,,0,0,0,PDN
BA437,,2013,1980,,235472,70579379,12794081,,235472,70579379,12794081,,0,0,0,PDN
BA437,,2014,1980,,235472,70579379,12794081,,235472,70579379,12794081,,0,0,0,PDN
BA437,,2015,1980,,235472,70579379,12794081,,235472,70579379,12794081,,0,0,0,PDN
BA437,,2016,1980,,235472,70579379,12794081,,235472,70579379,12794081,,0,0,0,PDN
BA437,,2017,1980,,235472,70579379,12794081,,235472,70579379,12794081,,0,0,0,PDN
BA437,,2017,1980,,235472,70579379,12794081,,235472,70579379,12794081,,0,0,0,PDN
BA451,,1983,1979,,284048,56809454,10392492,,16478,2377913,439594,,267570,54431541,9952898,PDN
BA451,,1984,1979,,607024,100018643,18403936,,44748,7400605,1361582,,562276,92618038,17042354,PDN
BA451,,1985,1979,,621451,100018643,18418363,,57834,9752696,1793189,,563617,90265947,16625174,PDN
BA451,,1986,1979,,621451,98938188,18226111,,58193,9801347,1802205,,563258,89136841,16423906,PDN
BA451,,1987,1979,,621451,98938188,18226111,,58193,9801347,1802205,,563258,89136841,16423906,PDN
BA451,,1988,1979,,621451,98938188,18226111,,59249,9927220,1825658,,562202,89010968,16400453,PDN
BA451,,1989,1979,,607024,98938188,18211684,,154719,31217176,5709377,,452305,67721012,12502307,PDN
BA451,,1990,1979,,607024,98938188,18211684,,206055,48442954,8825798,,400969,50495234,9385886,PDN
BA451,,1991,1979,,684444,152794316,27872045,,248506,64375667,11703251,,435938,88418649,16168794,PDN
BA451,,1992,1979,,684444,152794316,27872045,,279210,76781777,13941448,,405234,76012539,13930597,PDN
BA451,,1993,1979,,392800,116135809,21057535,,295348,84498131,15330603,,97452,31637678,5726932,PDN
BA451,,1994,1979,,432895,130661078,23682197,,309329,91708529,16627573,,123566,38952549,7054624,PDN
BA451,,1995,1979,,435356,132588690,24027650,,325304,100844416,18269150,,110052,31744274,5758500,PDN
BA451,,1996,1979,,423551,131614477,23842497,,336546,106872128,19352939,,87005,24742349,4489558,PDN
BA451,,1997,1979,,428285,130848266,23710895,,352795,113110772,20479267,,75490,17737494,3231628,PDN
BA451,,1998,1979,,419003,137338660,24856487,,365730,120301646,21771717,,53273,17037014,3084770,PDN
BA451,,1999,1979,,472074,149259691,27030738,,382138,125613929,22733371,,89936,23645762,4297367,PDN
BA451,,2000,1979,,513559,159954990,28975301,,406515,132553783,23992597,,107044,27401207,4982704,PDN
BA451,,2001,1979,,513559,159954990,28975301,,417512,137430984,24871424,,96047,22524006,4103877,PDN
BA451,,2002,1979,,512873,160695009,29106291,,426063,140764950,25473207,,86810,19930059,3633084,PDN
BA451,,2003,1979,,513132,164467801,29777865,,432848,143430511,25954291,,80284,21037290,3823574,PDN
BA451,,2004,1979,,450889,148828656,26932856,,435635,144498783,26147162,,15254,4329873,785694,PDN
BA451,,2005,1979,,450833,148828468,26932767,,436639,145347479,26299180,,14194,3480989,633587,PDN
BA451,,2006,1979,,446655,147960225,26774097,,437365,145945063,26406237,,9290,2015162,367860,PDN
BA451,,2007,1979,,440726,147337555,26657373,,437988,146253346,26461715,,2738,1084209,195658,PDN
BA451,,2008,1979,,440589,147297968,26650192,,438341,146377412,26484144,,2248,920556,166048,PDN
BA451,,2009,1979,,438706,148849935,26924458,,438615,148848064,26924035,,91,1871,424,PDN
BA451,,2010,1979,,438706,148849935,26924458,,438635,148849304,26924275,,71,631,183,PDN
BA451,,2011,1979,,438706,148849935,26924458,,438706,148849935,26924458,,0,0,0,PDN
BA451,,2012,1979,,438706,148849935,26924458,,438706,148849935,26924458,,0,0,0,PDN
BA451,,2013,1979,,438706,148849935,26924458,,438706,148849935,26924458,,0,0,0,PDN
BA451,,2014,1979,,438706,148849935,26924458,,438706,148849935,26924458,,0,0,0,PDN
BA451,,2015,1979,,438706,148849935,26924458,,438706,148849935,26924458,,0,0,0,PDN
BA451,,2016,1979,,438706,148849935,26924458,,438706,148849935,26924458,,0,0,0,PDN
BA451,,2017,1979,,438706,148849935,26924458,,438706,148849935,26924458,,0,0,0,PDN
BA451,,2017,1979,,438706,148849935,26924458,,438706,148849935,26924458,,0,0,0,PDN
BA453,,1984,1981,,92061,9837407,1842489,,0,0,0,,92061,9837407,1842489,PDN
BA453,,1985,1981,,98398,11082432,2070361,,0,0,0,,98398,11082432,2070361,PDN
BA453,,1986,1981,,98398,11082432,2070361,,0,0,0,,98398,11082432,2070361,PDN
BA453,,1987,1981,,98398,11082432,2070361,,205,201531,36065,,98193,10880901,2034296,PDN
BA453,,1988,1981,,110273,13754343,2557665,,9204,2157628,393124,,101069,11596715,2164541,PDN
BA453,,1989,1981,,312599,59620706,10921266,,55475,10652298,1950902,,257124,48968408,8970364,PDN
BA453,,1990,1981,,228958,45513136,8327381,,103329,21912053,4002271,,125629,23601083,4325110,PDN
BA453,,1991,1981,,264920,55123744,10073415,,140444,30406294,5550817,,124476,24717450,4522598,PDN
BA453,,1992,1981,,308495,71875289,13097692,,157512,35545751,6482379,,150983,36329538,6615313,PDN
BA453,,1993,1981,,312119,72909832,13285399,,186000,44721304,8143527,,126119,28188528,5141872,PDN
BA453,,1994,1981,,318865,75912191,13826372,,205119,52561603,9557717,,113746,23350588,4268655,PDN
BA453,,1995,1981,,247836,70066795,12715237,,215741,57610596,10466737,,32095,12456199,2248500,PDN
BA453,,1996,1981,,276261,79881235,14490004,,227713,63698025,11561881,,48548,16183210,2928123,PDN
BA453,,1997,1981,,276199,79863858,14486850,,240181,69697425,12641858,,36018,10166433,1844992,PDN
BA453,,1998,1981,,278186,80292243,14565062,,248894,74001155,13416359,,29292,6291088,1148703,PDN
BA453,,1999,1981,,300584,88290859,16010701,,256396,76533193,13874402,,44188,11757666,2136299,PDN
BA453,,2000,1981,,289683,85855396,15566444,,261242,78769577,14277181,,28441,7085819,1289263,PDN
BA453,,2001,1981,,287081,86913941,15752195,,264990,80642243,14614144,,22091,6271698,1138051,PDN
BA453,,2002,1981,,294243,91437325,16564230,,267239,82058621,14868417,,27004,9378704,1695813,PDN
BA453,,2003,1981,,331779,111532302,20177385,,271800,83640060,15154373,,59979,27892242,5023012,PDN
BA453,,2004,1981,,313425,104468041,18902045,,272630,84441017,15297722,,40795,20027024,3604323,PDN
BA453,,2005,1981,,284126,87839677,15913962,,275266,85551116,15497885,,8860,2288561,416077,PDN
BA453,,2006,1981,,290780,89459750,16208885,,276920,86383450,15647641,,13860,3076300,561244,PDN
BA453,,2007,1981,,289828,89232733,16167539,,278256,86916494,15743824,,11572,2316239,423715,PDN
BA453,,2008,1981,,289215,89079457,16139652,,279177,87317354,15816073,,10038,1762103,323579,PDN
BA453,,2009,1981,,281656,89512329,16209115,,280869,89296553,16169934,,787,215776,39182,PDN
BA453,,2010,1981,,281656,89512329,16209115,,281656,89512329,16209115,,0,0,0,PDN
BA453,,2011,1981,,281656,89512329,16209115,,281656,89512329,16209115,,0,0,0,PDN
BA453,,2012,1981,,281656,89512329,16209115,,281656,89512329,16209115,,0,0,0,PDN
BA453,,2013,1981,,281656,89512329,16209115,,281656,89512329,16209115,,0,0,0,PDN
BA453,,2014,1981,,281656,89512329,16209115,,281656,89512329,16209115,,0,0,0,PDN
BA453,,2015,1981,,281656,89512329,16209115,,281656,89512329,16209115,,0,0,0,PDN
BA453,,2016,1981,,281656,89512329,16209115,,281656,89512329,16209115,,0,0,0,PDN
BA453,,2017,1981,,281656,89512329,16209115,,281656,89512329,16209115,,0,0,0,PDN
BA453,,2017,1981,,281656,89512329,16209115,,281656,89512329,16209115,,0,0,0,PDN
BA455,,1993,1987,,437,11075833,1971226,,5,281750,50138,,432,10794083,1921088,PDN
BA455,,1994,1987,,437,11075833,1971226,,16,681783,121330,,421,10394050,1849896,PDN
BA455,,1995,1987,,437,10982227,1954570,,71,709256,126273,,366,10272971,1828297,PDN
BA455,,1996,1987,,437,10999155,1957582,,71,710635,126519,,366,10288520,1831063,PDN
BA455,,1997,1987,,71,710977,126579,,71,710977,126579,,0,0,0,PDN
BA455,,1998,1987,,71,710977,126579,,71,710977,126579,,0,0,0,PDN
BA455,,1999,1987,,71,710977,126579,,71,710977,126579,,0,0,0,PDN
BA455,,2000,1987,,71,710977,126579,,71,710977,126579,,0,0,0,PDN
BA455,,2001,1987,,71,710977,126579,,71,710977,126579,,0,0,0,PDN
BA455,,2002,1987,,71,710977,126579,,71,710977,126579,,0,0,0,PDN
BA455,,2003,1987,,71,710977,126579,,71,710977,126579,,0,0,0,PDN
BA455,,2004,1987,,71,710977,126579,,71,710977,126579,,0,0,0,PDN
BA455,,2005,1987,,71,710977,126579,,71,710977,126579,,0,0,0,PDN
BA455,,2006,1987,,71,710977,126579,,71,710977,126579,,0,0,0,PDN
BA455,,2007,1987,,71,710977,126579,,71,710977,126579,,0,0,0,PDN
BA455,,2008,1987,,71,710977,126579,,71,710977,126579,,0,0,0,PDN
BA455,,2009,1987,,71,725219,129114,,71,725219,129114,,0,0,0,PDN
BA455,,2010,1987,,71,725219,129114,,71,725219,129114,,0,0,0,PDN
BA455,,2011,1987,,71,725219,129114,,71,725219,129114,,0,0,0,PDN
BA455,,2012,1987,,71,725219,129114,,71,725219,129114,,0,0,0,PDN
BA455,,2013,1987,,71,725219,129114,,71,725219,129114,,0,0,0,PDN
BA455,,2014,1987,,71,725219,129114,,71,725219,129114,,0,0,0,PDN
BA455,,2015,1987,,71,725219,129114,,71,725219,129114,,0,0,0,PDN
BA455,,2016,1987,,71,725219,129114,,71,725219,129114,,0,0,0,PDN
BA455,,2017,1987,,71,725219,129114,,71,725219,129114,,0,0,0,PDN
BA455,,2017,1987,,71,725219,129114,,71,725219,129114,,0,0,0,PDN
BA475,,1991,1991,,8899,2144658,390511,,0,0,0,,8899,2144658,390511,PDN
BA475,,1992,1991,,43403,10927290,1987761,,7909,2036229,370227,,35494,8891061,1617534,PDN
BA475,,1993,1991,,43403,10927290,1987761,,12153,3756382,680548,,31250,7170908,1307213,PDN
BA475,,1994,1991,,43403,10927290,1987761,,13644,4920202,889125,,29759,6007088,1098636,PDN
BA475,,1995,1991,,43378,10921336,1986676,,14124,5426858,979757,,29254,5494478,1006919,PDN
BA475,,1996,1991,,33211,8665259,1575072,,16739,6194305,1118929,,16472,2470954,456143,PDN
BA475,,1997,1991,,29492,9790488,1771572,,21475,7583440,1370842,,8017,2207048,400730,PDN
BA475,,1998,1991,,29492,9790488,1771572,,23585,8403542,1518877,,5907,1386946,252695,PDN
BA475,,1999,1991,,33526,11494680,2078843,,24895,8896667,1607932,,8631,2598013,470911,PDN
BA475,,2000,1991,,33526,11494680,2078843,,25984,9393020,1697340,,7542,2101660,381503,PDN
BA475,,2001,1991,,32500,11232497,2031165,,26720,9654837,1744663,,5780,1577660,286502,PDN
BA475,,2002,1991,,32500,11232497,2031165,,27034,9777886,1766871,,5466,1454611,264294,PDN
BA475,,2003,1991,,32500,11232497,2031165,,27281,9881114,1785486,,5219,1351383,245679,PDN
BA475,,2004,1991,,27312,9884993,1786208,,27312,9884993,1786208,,0,0,0,PDN
BA475,,2005,1991,,27312,9884993,1786208,,27312,9884993,1786208,,0,0,0,PDN
BA475,,2006,1991,,27312,9884993,1786208,,27312,9884993,1786208,,0,0,0,PDN
BA475,,2007,1991,,27312,9884993,1786208,,27312,9884993,1786208,,0,0,0,PDN
BA475,,2008,1991,,27312,9884993,1786208,,27312,9884993,1786208,,0,0,0,PDN
BA475,,2009,1991,,27312,10051567,1815847,,27312,10051567,1815847,,0,0,0,PDN
BA475,,2010,1991,,27312,10051567,1815847,,27312,10051567,1815847,,0,0,0,PDN
BA475,,2011,1991,,27312,10051567,1815847,,27312,10051567,1815847,,0,0,0,PDN
BA475,,2012,1991,,27312,10051567,1815847,,27312,10051567,1815847,,0,0,0,PDN
BA475,,2013,1991,,27312,10051567,1815847,,27312,10051567,1815847,,0,0,0,PDN
BA475,,2014,1991,,27312,10051567,1815847,,27312,10051567,1815847,,0,0,0,PDN
BA475,,2015,1991,,27312,10051567,1815847,,27312,10051567,1815847,,0,0,0,PDN
BA475,,2016,1991,,27312,10051567,1815847,,27312,10051567,1815847,,0,0,0,PDN
BA475,,2017,1991,,27312,10051567,1815847,,27312,10051567,1815847,,0,0,0,PDN
BA475,,2017,1991,,27312,10051567,1815847,,27312,10051567,1815847,,0,0,0,PDN
BA491,,1989,1988,,24220,9445855,1704977,,0,0,0,,24220,9445855,1704977,PDP
BA491,,1990,1988,,24220,9445855,1704977,,0,0,0,,24220,9445855,1704977,PDP
BA491,,1991,1988,,348989,58311527,10724706,,31522,5939263,1088330,,317467,52372264,9636376,PDP
BA491,,1992,1988,,341715,44621750,8281528,,44801,10226942,1864542,,296914,34394808,6416986,PDP
BA491,,1993,1988,,85499,29366414,5310840,,49426,13798841,2504736,,36073,15567573,2806104,PDP
BA491,,1994,1988,,87376,28966495,5241557,,50548,16214638,2935715,,36828,12751857,2305842,PDP
BA491,,1995,1988,,90814,28694117,5196529,,54409,19094669,3452037,,36405,9599448,1744492,PDP
BA491,,1996,1988,,86002,30788480,5564379,,56624,21198103,3828528,,29378,9590377,1735851,PDP
BA491,,1997,1988,,86638,30806255,5568178,,58181,22430029,4049289,,28457,8376226,1518889,PDP
BA491,,1998,1988,,86444,30837157,5573483,,59800,23310181,4207519,,26644,7526976,1365964,PDP
BA491,,1999,1988,,86688,31832211,5750782,,59936,23574125,4254620,,26752,8258086,1496162,PDP
BA491,,2000,1988,,84171,32967649,5950301,,60445,24611667,4439745,,23726,8355982,1510556,PDP
BA491,,2001,1988,,71123,32706315,5890752,,60862,26650365,4802920,,10261,6055950,1087832,PDP
BA491,,2002,1988,,71123,36956678,6647044,,61026,28079497,5057378,,10097,8877181,1589666,PDP
BA491,,2003,1988,,71554,40165986,7218527,,61400,29395988,5292003,,10154,10769998,1926524,PDP
BA491,,2004,1988,,70330,38014950,6834556,,61519,30278673,5449183,,8811,7736277,1385373,PDP
BA491,,2005,1988,,74641,37696850,6782266,,64200,31501275,5669409,,10441,6195575,1112857,PDP
BA491,,2006,1988,,85015,41589170,7485223,,66595,33352284,6001165,,18420,8236886,1484058,PDP
BA491,,2007,1988,,85958,47628295,8560744,,67281,34610766,6225780,,18677,13017529,2334964,PDP
BA491,,2008,1988,,86826,49574003,8907823,,68007,36754818,6608010,,18819,12819185,2299813,PDP
BA491,,2009,1988,,73145,54360986,9745920,,68930,39017478,7011542,,4215,15343508,2734376,PDP
BA491,,2010,1988,,73145,54360986,9745920,,69757,41039916,7372234,,3388,13321070,2373685,PDP
BA491,,2011,1988,,73145,54360986,9745920,,70241,42626462,7655022,,2904,11734524,2090897,PDP
BA491,,2012,1988,,73145,54360986,9745920,,71094,45951820,8247576,,2051,8409166,1498344,PDP
BA491,,2013,1988,,73145,54360986,9745920,,71601,46999152,8434441,,1544,7361834,1311479,PDP
BA491,,2014,1988,,74303,54800627,9825306,,71888,48855085,8764965,,2415,5945542,1060339,PDP
BA491,,2015,1988,,74267,55033060,9866628,,72349,50456340,9050348,,1918,4576720,816280,PDP
BA491,,2016,1988,,79740,55834759,10014752,,73729,51925748,9313187,,6011,3909011,701565,PDP
BA491,,2017,1988,,80593,55834759,10015605,,75706,53152292,9533410,,4887,2682467,482194,PDP
BA491,,2017,1988,,80593,55834759,10015605,,75706,53152292,9533410,,4887,2682467,482194,PDP
BA494,,1986,1984,,41628,8825150,1611939,,0,0,0,,41628,8825150,1611939,PDN
BA494,,1987,1984,,41628,8825150,1611939,,0,0,0,,41628,8825150,1611939,PDN
BA494,,1989,1984,,347441,8049525,1779741,,70489,1681023,369603,,276952,6368502,1410138,PDN
BA494,,1990,1984,,819319,20728757,4507710,,188143,4828360,1047282,,631176,15900397,3460428,PDN
BA494,,1991,1984,,819319,20728757,4507710,,266883,7133444,1536179,,552436,13595313,2971531,PDN
BA494,,1992,1984,,349131,11756352,2441009,,289388,8384457,1781284,,59743,3371895,659725,PDN
BA494,,1993,1984,,329413,10648057,2224085,,297578,8745046,1853636,,31835,1903011,370449,PDN
BA494,,1994,1984,,456421,13034030,2775643,,395690,10560843,2274844,,60731,2473187,500799,PDN
BA494,,1995,1984,,1612639,33866133,7638641,,520657,13009158,2835454,,1091982,20856975,4803187,PDN
BA494,,1996,1984,,4975991,128775883,27889849,,576202,14390368,3136766,,4399789,114385515,24753083,PDN
BA494,,1997,1984,,2848616,75599017,16300398,,629149,15870642,3453107,,2219467,59728375,12847291,PDN
BA494,,1998,1984,,2848585,75598266,16300234,,664781,17000418,3689766,,2183804,58597848,12610468,PDN
BA494,,1999,1984,,2472070,66969246,14388306,,696310,17784049,3860732,,1775760,49185197,10527574,PDN
BA494,,2000,1984,,2274116,66546760,14115176,,733717,18610198,4045140,,1540399,47936562,10070036,PDN
BA494,,2001,1984,,2329092,69190649,14640595,,770941,19627664,4263408,,1558151,49562985,10377187,PDN
BA494,,2002,1984,,2329092,69190649,14640595,,822926,21283867,4610091,,1506166,47906782,10030504,PDN
BA494,,2003,1984,,2382664,70916459,15001251,,856912,22293018,4823641,,1525752,48623441,10177610,PDN
BA494,,2004,1984,,857382,22305829,4826391,,857382,22305829,4826391,,0,0,0,PDN
BA494,,2005,1984,,857382,22305829,4826391,,857382,22305829,4826391,,0,0,0,PDN
BA494,,2006,1984,,857382,22305829,4826391,,857382,22305829,4826391,,0,0,0,PDN
BA494,,2007,1984,,857382,22305829,4826391,,857382,22305829,4826391,,0,0,0,PDN
BA494,,2008,1984,,857382,22305829,4826391,,857382,22305829,4826391,,0,0,0,PDN
BA494,,2009,1984,,857382,22640604,4885959,,857382,22640604,4885959,,0,0,0,PDN
BA494,,2010,1984,,857382,22640604,4885959,,857382,22640604,4885959,,0,0,0,PDN
BA494,,2011,1984,,857382,22640604,4885959,,857382,22640604,4885959,,0,0,0,PDN
BA494,,2012,1984,,857382,22640604,4885959,,857382,22640604,4885959,,0,0,0,PDN
BA494,,2013,1984,,857382,22640604,4885959,,857382,22640604,4885959,,0,0,0,PDN
BA494,,2014,1984,,857382,22640604,4885959,,857382,22640604,4885959,,0,0,0,PDN
BA494,,2015,1984,,857382,22640604,4885959,,857382,22640604,4885959,,0,0,0,PDN
BA494,,2016,1984,,857382,22640604,4885959,,857382,22640604,4885959,,0,0,0,PDN
BA494,,2017,1984,,857382,22640604,4885959,,857382,22640604,4885959,,0,0,0,PDN
BA494,,2017,1984,,857382,22640604,4885959,,857382,22640604,4885959,,0,0,0,PDN
BA501,,1982,1979,,315508,72566703,13227733,,27345,6190145,1128794,,288163,66376558,12098939,PDN
BA501,,1983,1979,,315508,72566703,13227733,,65474,17063200,3101631,,250034,55503503,10126102,PDN
BA501,,1984,1979,,183071,55920564,10133349,,83975,23777902,4314918,,99096,32142662,5818431,PDN
BA501,,1985,1979,,162700,55477442,10034131,,90906,26263205,4764074,,71794,29214237,5270057,PDN
BA501,,1986,1979,,162700,55477442,10034131,,93671,27668182,5016835,,69029,27809260,5017296,PDN
BA501,,1987,1979,,162700,55477442,10034131,,96785,28459108,5160683,,65915,27018334,4873448,PDN
BA501,,1988,1979,,162700,55477442,10034131,,99584,29201596,5295598,,63116,26275846,4738533,PDN
BA501,,1989,1979,,156994,54131767,9788981,,101203,29856481,5413744,,55791,24275286,4375237,PDN
BA501,,1990,1979,,162558,54131767,9794545,,103329,30602559,5548624,,59229,23529208,4245921,PDN
BA501,,1991,1979,,162558,54131767,9794545,,104766,31165018,5650143,,57792,22966749,4144402,PDN
BA501,,1992,1979,,162558,54131767,9794545,,106384,31565351,5722994,,56174,22566416,4071551,PDN
BA501,,1993,1979,,127062,37145536,6736588,,106605,31669315,5741714,,20457,5476221,994874,PDN
BA501,,1994,1979,,145678,43249227,7841270,,118107,35136123,6370086,,27571,8113104,1471184,PDN
BA501,,1995,1979,,145675,43248329,7841107,,122690,37120685,6727794,,22985,6127644,1113313,PDN
BA501,,1996,1979,,139722,42225907,7653229,,123208,37394668,6777064,,16514,4831239,876165,PDN
BA501,,1997,1979,,123614,37622323,6817978,,123614,37622323,6817978,,0,0,0,PDN
BA501,,1998,1979,,123614,37622323,6817978,,123614,37622323,6817978,,0,0,0,PDN
BA501,,1999,1979,,123614,37622323,6817978,,123614,37622323,6817978,,0,0,0,PDN
BA501,,2000,1979,,123614,37622323,6817978,,123614,37622323,6817978,,0,0,0,PDN
BA501,,2001,1979,,123614,37622323,6817978,,123614,37622323,6817978,,0,0,0,PDN
BA501,,2002,1979,,123614,37622323,6817978,,123614,37622323,6817978,,0,0,0,PDN
BA501,,2003,1979,,123614,37622323,6817978,,123614,37622323,6817978,,0,0,0,PDN
BA501,,2004,1979,,124292,40985552,7417095,,123966,37913254,6870097,,326,3072298,546998,PDN
BA501,,2005,1979,,125991,42784176,7738834,,125797,39516502,7157203,,194,3267674,581631,PDN
BA501,,2006,1979,,128609,43345574,7841345,,126924,40571031,7345969,,1685,2774543,495376,PDN
BA501,,2007,1979,,128609,43345574,7841345,,127866,41360313,7487352,,743,1985261,353993,PDN
BA501,,2008,1979,,182033,57435225,10401824,,128661,41842749,7573990,,53372,15592476,2827834,PDN
BA501,,2009,1979,,164308,54424900,9848455,,139272,46236295,8366372,,25036,8188605,1482084,PDN
BA501,,2010,1979,,161538,53393708,9662199,,147925,49183705,8899474,,13613,4210003,762724,PDN
BA501,,2011,1979,,153072,51240322,9270568,,151582,50579243,9151449,,1490,661079,119119,PDN
BA501,,2012,1979,,153072,51240322,9270568,,153048,51146265,9253808,,24,94057,16760,PDN
BA501,,2013,1979,,153072,51240322,9270568,,153072,51240322,9270568,,0,0,0,PDN
BA501,,2014,1979,,153072,51240322,9270568,,153072,51240322,9270568,,0,0,0,PDN
BA501,,2015,1979,,153072,51240322,9270568,,153072,51240322,9270568,,0,0,0,PDN
BA501,,2016,1979,,153072,51240322,9270568,,153072,51240322,9270568,,0,0,0,PDN
BA501,,2017,1979,,153072,51240322,9270568,,153072,51240322,9270568,,0,0,0,PDN
BA501,,2017,1979,,153072,51240322,9270568,,153072,51240322,9270568,,0,0,0,PDN
BA506,,2000,1968,,49924,6057471,1127766,,0,0,0,,49924,6057471,1127766,PDN
BA506,,2001,1968,,49995,6063530,1128915,,7999,1549304,283676,,41996,4514226,845239,PDN
BA506,,2002,1968,,80279,13430122,2469980,,13652,3557319,646627,,66627,9872803,1823353,PDN
BA506,,2003,1968,,80197,13421963,2468446,,14916,4054390,736338,,65281,9367573,1732108,PDN
BA506,,2004,1968,,23854,5652897,1029707,,17857,5006299,908658,,5997,646598,121049,PDN
BA506,,2005,1968,,19415,5208978,946279,,19415,5208978,946279,,0,0,0,PDN
BA506,,2006,1968,,19415,5208978,946279,,19415,5208978,946279,,0,0,0,PDN
BA506,,2007,1968,,19415,5208978,946279,,19415,5208978,946279,,0,0,0,PDN
BA506,,2008,1968,,19415,5208978,946279,,19415,5208978,946279,,0,0,0,PDN
BA506,,2009,1968,,19415,5208978,946280,,19415,5208978,946280,,0,0,0,PDN
BA506,,2010,1968,,19415,5208978,946280,,19415,5208978,946280,,0,0,0,PDN
BA506,,2011,1968,,19415,5208978,946280,,19415,5208978,946280,,0,0,0,PDN
BA506,,2012,1968,,19415,5208978,946280,,19415,5208978,946280,,0,0,0,PDN
BA506,,2013,1968,,19415,5208978,946280,,19415,5208978,946280,,0,0,0,PDN
BA506,,2014,1968,,19415,5208978,946280,,19415,5208978,946280,,0,0,0,PDN
BA506,,2015,1968,,19415,5208978,946280,,19415,5208978,946280,,0,0,0,PDN
BA506,,2016,1968,,19415,5208978,946280,,19415,5208978,946280,,0,0,0,PDN
BA506,,2017,1968,,19415,5208978,946280,,19415,5208978,946280,,0,0,0,PDN
BA506,,2017,1968,,19415,5208978,946280,,19415,5208978,946280,,0,0,0,PDN
BA507,,1994,1993,,1439,8593863,1530596,,91,543300,96764,,1348,8050563,1433832,PDN
BA507,,1995,1993,,1523,9138515,1627593,,91,546001,97244,,1432,8592514,1530349,PDN
BA507,,1996,1993,,91,546001,97244,,91,546001,97244,,0,0,0,PDN
BA507,,1997,1993,,91,546001,97244,,91,546001,97244,,0,0,0,PDN
BA507,,1998,1993,,91,546001,97244,,91,546001,97244,,0,0,0,PDN
BA507,,1999,1993,,91,546001,97244,,91,546001,97244,,0,0,0,PDN
BA507,,2000,1993,,91,546001,97244,,91,546001,97244,,0,0,0,PDN
BA507,,2001,1993,,91,546001,97244,,91,546001,97244,,0,0,0,PDN
BA507,,2002,1993,,91,546001,97244,,91,546001,97244,,0,0,0,PDN
BA507,,2003,1993,,91,546001,97244,,91,546001,97244,,0,0,0,PDN
BA507,,2004,1993,,91,546001,97244,,91,546001,97244,,0,0,0,PDN
BA507,,2005,1993,,91,546001,97244,,91,546001,97244,,0,0,0,PDN
BA507,,2006,1993,,91,546001,97244,,91,546001,97244,,0,0,0,PDN
BA507,,2007,1993,,91,546001,97244,,91,546001,97244,,0,0,0,PDN
BA507,,2008,1993,,91,546001,97244,,91,546001,97244,,0,0,0,PDN
BA507,,2009,1993,,91,556936,99190,,91,556936,99190,,0,0,0,PDN
BA507,,2010,1993,,91,556936,99190,,91,556936,99190,,0,0,0,PDN
BA507,,2011,1993,,91,556936,99190,,91,556936,99190,,0,0,0,PDN
BA507,,2012,1993,,91,556936,99190,,91,556936,99190,,0,0,0,PDN
BA507,,2013,1993,,91,556936,99190,,91,556936,99190,,0,0,0,PDN
BA507,,2014,1993,,91,556936,99190,,91,556936,99190,,0,0,0,PDN
BA507,,2015,1993,,91,556936,99190,,91,556936,99190,,0,0,0,PDN
BA507,,2016,1993,,91,556936,99190,,91,556936,99190,,0,0,0,PDN
BA507,,2017,1993,,91,556936,99190,,91,556936,99190,,0,0,0,PDN
BA507,,2017,1993,,91,556936,99190,,91,556936,99190,,0,0,0,PDN
BA515,,1991,1990,,4858,2759481,495869,,0,0,0,,4858,2759481,495869,PDN
BA515,,1992,1990,,4858,2759481,495869,,0,0,0,,4858,2759481,495869,PDN
BA515,,1993,1990,,4858,2759481,495869,,0,0,0,,4858,2759481,495869,PDN
BA515,,1994,1990,,4821,2738304,492064,,0,0,0,,4821,2738304,492064,PDN
BA515,,1995,1990,,4821,2738304,492064,,2052,1305376,234325,,2769,1432928,257739,PDN
BA515,,1996,1990,,5082,2886317,518662,,3993,2320194,416839,,1089,566123,101823,PDN
BA515,,1997,1990,,4369,2711933,486919,,4369,2711933,486919,,0,0,0,PDN
BA515,,1998,1990,,5002,4184148,749512,,4878,3576663,641295,,124,607485,108217,PDN
BA515,,1999,1990,,5002,4184148,749512,,4929,4090086,732702,,73,94062,16810,PDN
BA515,,2000,1990,,4929,4095768,733713,,4929,4095768,733713,,0,0,0,PDN
BA515,,2001,1990,,4929,4095768,733713,,4929,4095768,733713,,0,0,0,PDN
BA515,,2002,1990,,4929,4095768,733713,,4929,4095768,733713,,0,0,0,PDN
BA515,,2003,1990,,4929,4095768,733713,,4929,4095768,733713,,0,0,0,PDN
BA515,,2004,1990,,4929,4095768,733713,,4929,4095768,733713,,0,0,0,PDN
BA515,,2005,1990,,4929,4095768,733713,,4929,4095768,733713,,0,0,0,PDN
BA515,,2006,1990,,4929,4095768,733713,,4929,4095768,733713,,0,0,0,PDN
BA515,,2007,1990,,4929,4095768,733713,,4929,4095768,733713,,0,0,0,PDN
BA515,,2008,1990,,4929,4095768,733713,,4929,4095768,733713,,0,0,0,PDN
BA515,,2009,1990,,4929,4159990,745141,,4929,4159990,745141,,0,0,0,PDN
BA515,,2010,1990,,4929,4159990,745141,,4929,4159990,745141,,0,0,0,PDN
BA515,,2011,1990,,4929,4159990,745141,,4929,4159990,745141,,0,0,0,PDN
BA515,,2012,1990,,4929,4159990,745141,,4929,4159990,745141,,0,0,0,PDN
BA515,,2013,1990,,4929,4159990,745141,,4929,4159990,745141,,0,0,0,PDN
BA515,,2014,1990,,4929,4159990,745141,,4929,4159990,745141,,0,0,0,PDN
BA515,,2015,1990,,4929,4159990,745141,,4929,4159990,745141,,0,0,0,PDN
BA515,,2016,1990,,4929,4159990,745141,,4929,4159990,745141,,0,0,0,PDN
BA515,,2017,1990,,4929,4159990,745141,,4929,4159990,745141,,0,0,0,PDN
BA515,,2017,1990,,4929,4159990,745141,,4929,4159990,745141,,0,0,0,PDN
BA538,,1975,1968,,78766,16446400,3005172,,36171,15567523,2806193,,42595,878877,198979,PDN
BA538,,1976,1968,,78766,16446400,3005172,,38491,13120852,2373162,,40275,3325548,632010,PDN
BA538,,1977,1968,,78766,16446400,3005172,,39973,14264367,2578117,,38793,2182033,427055,PDN
BA538,,1978,1968,,39907,14282400,2581259,,39907,14282400,2581259,,0,0,0,PDN
BA538,,1979,1968,,38541,17381720,3131374,,38541,17381720,3131374,,0,0,0,PDN
BA538,,1980,1968,,38541,17381720,3131374,,38541,17381720,3131374,,0,0,0,PDN
BA538,,1981,1968,,38541,17381720,3131374,,38541,17381720,3131374,,0,0,0,PDN
BA538,,1982,1968,,38541,17381720,3131374,,38541,17381720,3131374,,0,0,0,PDN
BA538,,1983,1968,,38541,17381720,3131374,,38541,17381720,3131374,,0,0,0,PDN
BA538,,1984,1968,,38541,17381720,3131374,,38541,17381720,3131374,,0,0,0,PDN
BA538,,1985,1968,,38541,17381720,3131374,,38541,17381720,3131374,,0,0,0,PDN
BA538,,1986,1968,,38541,17381720,3131374,,38541,17381720,3131374,,0,0,0,PDN
BA538,,1987,1968,,38541,17381720,3131374,,38541,17381720,3131374,,0,0,0,PDN
BA538,,1988,1968,,38541,17381720,3131374,,38541,17381720,3131374,,0,0,0,PDN
BA538,,1989,1968,,38541,17381720,3131374,,38541,17381720,3131374,,0,0,0,PDN
BA538,,1990,1968,,38541,17381720,3131374,,38541,17381720,3131374,,0,0,0,PDN
BA538,,1991,1968,,38541,17381720,3131374,,38541,17381720,3131374,,0,0,0,PDN
BA538,,1992,1968,,38541,17381720,3131374,,38541,17381720,3131374,,0,0,0,PDN
BA538,,1993,1968,,38541,17381720,3131374,,38541,17381720,3131374,,0,0,0,PDN
BA538,,1994,1968,,38541,17381720,3131374,,38541,17381720,3131374,,0,0,0,PDN
BA538,,1995,1968,,38541,17381720,3131374,,38541,17381720,3131374,,0,0,0,PDN
BA538,,1996,1968,,38541,17381720,3131374,,38541,17381720,3131374,,0,0,0,PDN
BA538,,1997,1968,,38541,17381720,3131374,,38541,17381720,3131374,,0,0,0,PDN
BA538,,1998,1968,,38541,17381720,3131374,,38541,17381720,3131374,,0,0,0,PDN
BA538,,1999,1968,,38541,17381720,3131374,,38541,17381720,3131374,,0,0,0,PDN
BA538,,2000,1968,,38541,17381720,3131374,,38541,17381720,3131374,,0,0,0,PDN
BA538,,2001,1968,,38541,17381720,3131374,,38541,17381720,3131374,,0,0,0,PDN
BA538,,2002,1968,,38541,17381720,3131374,,38541,17381720,3131374,,0,0,0,PDN
BA538,,2003,1968,,38541,17381720,3131374,,38541,17381720,3131374,,0,0,0,PDN
BA538,,2004,1968,,38541,17381720,3131374,,38541,17381720,3131374,,0,0,0,PDN
BA538,,2005,1968,,38541,17381720,3131374,,38541,17381720,3131374,,0,0,0,PDN
BA538,,2006,1968,,38541,17381720,3131374,,38541,17381720,3131374,,0,0,0,PDN
BA538,,2007,1968,,38541,17381720,3131374,,38541,17381720,3131374,,0,0,0,PDN
BA538,,2008,1968,,38541,17381720,3131374,,38541,17381720,3131374,,0,0,0,PDN
BA538,,2009,1968,,38541,17729827,3193314,,38541,17729827,3193314,,0,0,0,PDN
BA538,,2010,1968,,38541,17729827,3193314,,38541,17729827,3193314,,0,0,0,PDN
BA538,,2011,1968,,38541,17729827,3193314,,38541,17729827,3193314,,0,0,0,PDN
BA538,,2012,1968,,38541,17729827,3193314,,38541,17729827,3193314,,0,0,0,PDN
BA538,,2013,1968,,38541,17729827,3193314,,38541,17729827,3193314,,0,0,0,PDN
BA538,,2014,1968,,38541,17729827,3193314,,38541,17729827,3193314,,0,0,0,PDN
BA538,,2015,1968,,38541,17729827,3193314,,38541,17729827,3193314,,0,0,0,PDN
BA538,,2016,1968,,38541,17729827,3193314,,38541,17729827,3193314,,0,0,0,PDN
BA538,,2017,1968,,38541,17729827,3193314,,38541,17729827,3193314,,0,0,0,PDN
BA538,,2017,1968,,38541,17729827,3193314,,38541,17729827,3193314,,0,0,0,PDN
BA541,,1975,1969,,154211,45099400,8179015,,10216,6805829,1221218,,143995,38293571,6957797,PDN
BA541,,1976,1969,,154211,45099400,8179015,,14347,6290428,1133640,,139864,38808972,7045375,PDN
BA541,,1977,1969,,154211,45099400,8179015,,14407,6714298,1209122,,139804,38385102,6969893,PDN
BA541,,1978,1969,,14155,6731930,1212007,,14155,6731930,1212007,,0,0,0,PDN
BA541,,1979,1969,,18553,7539715,1360139,,18553,7539715,1360139,,0,0,0,PDN
BA541,,1980,1969,,18553,7539715,1360139,,18553,7539715,1360139,,0,0,0,PDN
BA541,,1981,1969,,18553,7539715,1360139,,18553,7539715,1360139,,0,0,0,PDN
BA541,,1982,1969,,18553,7539715,1360139,,18553,7539715,1360139,,0,0,0,PDN
BA541,,1983,1969,,18553,7539715,1360139,,18553,7539715,1360139,,0,0,0,PDN
BA541,,1984,1969,,18553,7539715,1360139,,18553,7539715,1360139,,0,0,0,PDN
BA541,,1985,1969,,18553,7539715,1360139,,18553,7539715,1360139,,0,0,0,PDN
BA541,,1986,1969,,18553,7539715,1360139,,18553,7539715,1360139,,0,0,0,PDN
BA541,,1987,1969,,18553,7539715,1360139,,18553,7539715,1360139,,0,0,0,PDN
BA541,,1988,1969,,18553,7539715,1360139,,18553,7539715,1360139,,0,0,0,PDN
BA541,,1989,1969,,18553,7539715,1360139,,18553,7539715,1360139,,0,0,0,PDN
BA541,,1990,1969,,18553,7539715,1360139,,18553,7539715,1360139,,0,0,0,PDN
BA541,,1991,1969,,18553,7539715,1360139,,18553,7539715,1360139,,0,0,0,PDN
BA541,,1992,1969,,18553,7539715,1360139,,18553,7539715,1360139,,0,0,0,PDN
BA541,,1993,1969,,18553,7539715,1360139,,18553,7539715,1360139,,0,0,0,PDN
BA541,,1994,1969,,18553,7539715,1360139,,18553,7539715,1360139,,0,0,0,PDN
BA541,,1995,1969,,18553,7539715,1360139,,18553,7539715,1360139,,0,0,0,PDN
BA541,,1996,1969,,18553,7539715,1360139,,18553,7539715,1360139,,0,0,0,PDN
BA541,,1997,1969,,18553,7539715,1360139,,18553,7539715,1360139,,0,0,0,PDN
BA541,,1998,1969,,18553,7539715,1360139,,18553,7539715,1360139,,0,0,0,PDN
BA541,,1999,1969,,18553,7539715,1360139,,18553,7539715,1360139,,0,0,0,PDN
BA541,,2000,1969,,18553,7539715,1360139,,18553,7539715,1360139,,0,0,0,PDN
BA541,,2001,1969,,18553,7539715,1360139,,18553,7539715,1360139,,0,0,0,PDN
BA541,,2002,1969,,18553,7539715,1360139,,18553,7539715,1360139,,0,0,0,PDN
BA541,,2003,1969,,18553,7539715,1360139,,18553,7539715,1360139,,0,0,0,PDN
BA541,,2004,1969,,18553,7539715,1360139,,18553,7539715,1360139,,0,0,0,PDN
BA541,,2005,1969,,18553,7539715,1360139,,18553,7539715,1360139,,0,0,0,PDN
BA541,,2006,1969,,18553,7539715,1360139,,18553,7539715,1360139,,0,0,0,PDN
BA541,,2007,1969,,18553,7539715,1360139,,18553,7539715,1360139,,0,0,0,PDN
BA541,,2008,1969,,18553,7539715,1360139,,18553,7539715,1360139,,0,0,0,PDN
BA541,,2009,1969,,18553,7690713,1387007,,18553,7690713,1387007,,0,0,0,PDN
BA541,,2010,1969,,18553,7690713,1387007,,18553,7690713,1387007,,0,0,0,PDN
BA541,,2011,1969,,18553,7690713,1387007,,18553,7690713,1387007,,0,0,0,PDN
BA541,,2012,1969,,18553,7690713,1387007,,18553,7690713,1387007,,0,0,0,PDN
BA541,,2013,1969,,18553,7690713,1387007,,18553,7690713,1387007,,0,0,0,PDN
BA541,,2014,1969,,18553,7690713,1387007,,18553,7690713,1387007,,0,0,0,PDN
BA541,,2015,1969,,18553,7690713,1387007,,18553,7690713,1387007,,0,0,0,PDN
BA541,,2016,1969,,18553,7690713,1387007,,18553,7690713,1387007,,0,0,0,PDN
BA541,,2017,1969,,18553,7690713,1387007,,18553,7690713,1387007,,0,0,0,PDN
BA541,,2017,1969,,18553,7690713,1387007,,18553,7690713,1387007,,0,0,0,PDN
BA542,,1991,1991,,89221,21499160,3914694,,2713,739033,134214,,86508,20760127,3780480,PDN
BA542,,1992,1991,,144625,32250884,5883216,,23309,5241016,955874,,121316,27009868,4927342,PDN
BA542,,1993,1991,,122635,27257302,4972689,,37078,8312023,1516086,,85557,18945279,3456603,PDN
BA542,,1994,1991,,122635,27257302,4972689,,45720,10133976,1848919,,76915,17123326,3123770,PDN
BA542,,1995,1991,,122789,27288280,4978355,,50005,11249422,2051682,,72784,16038858,2926673,PDN
BA542,,1996,1991,,122756,27281751,4977160,,52578,11981514,2184520,,70178,15300237,2792640,PDN
BA542,,1997,1991,,122756,27281751,4977160,,53293,12550277,2286438,,69463,14731474,2690722,PDN
BA542,,1998,1991,,76596,17544470,3198388,,53464,12914640,2351443,,23132,4629830,846945,PDN
BA542,,1999,1991,,72025,16901473,3079405,,64777,15345972,2795377,,7248,1555501,284028,PDN
BA542,,2000,1991,,139549,23110349,4251711,,69662,16308516,2971533,,69887,6801833,1280178,PDN
BA542,,2001,1991,,73994,17285842,3149767,,70456,16471767,3001375,,3538,814075,148392,PDN
BA542,,2002,1991,,73994,17285842,3149767,,70691,16523057,3010737,,3303,762785,139030,PDN
BA542,,2003,1991,,73994,17285842,3149767,,70831,16546672,3015079,,3163,739170,134688,PDN
BA542,,2004,1991,,73994,17285842,3149767,,71399,16833612,3066704,,2595,452230,83063,PDN
BA542,,2005,1991,,73994,17285842,3149767,,71490,16916043,3081462,,2504,369799,68305,PDN
BA542,,2006,1991,,71701,16982303,3093463,,71701,16982303,3093463,,0,0,0,PDN
BA542,,2007,1991,,71701,16982303,3093463,,71701,16982303,3093463,,0,0,0,PDN
BA542,,2008,1991,,71701,16982303,3093463,,71701,16982303,3093463,,0,0,0,PDN
BA542,,2009,1991,,71701,17239189,3139173,,71701,17239189,3139173,,0,0,0,PDN
BA542,,2010,1991,,71701,17239189,3139173,,71701,17239189,3139173,,0,0,0,PDN
BA542,,2011,1991,,71701,17239189,3139173,,71701,17239189,3139173,,0,0,0,PDN
BA542,,2012,1991,,71701,17239189,3139173,,71701,17239189,3139173,,0,0,0,PDN
BA542,,2013,1991,,71701,17239189,3139173,,71701,17239189,3139173,,0,0,0,PDN
BA542,,2014,1991,,71701,17239189,3139173,,71701,17239189,3139173,,0,0,0,PDN
BA542,,2015,1991,,71701,17239189,3139173,,71701,17239189,3139173,,0,0,0,PDN
BA542,,2016,1991,,71701,17239189,3139173,,71701,17239189,3139173,,0,0,0,PDN
BA542,,2017,1991,,71701,17239189,3139173,,71701,17239189,3139173,,0,0,0,PDN
BA542,,2017,1991,,71701,17239189,3139173,,71701,17239189,3139173,,0,0,0,PDN
BA544,,1994,1972,,47002,28660158,5146674,,495,258042,46410,,46507,28402116,5100264,PDN
BA544,,1995,1972,,34551,28712391,5143517,,3355,2679285,480096,,31196,26033106,4663421,PDN
BA544,,1996,1972,,32582,28458236,5096325,,5423,5539797,991152,,27159,22918439,4105173,PDN
BA544,,1997,1972,,32582,28458236,5096325,,5706,5921608,1059373,,26876,22536628,4036952,PDN
BA544,,1998,1972,,96739,37055273,6690204,,19540,7670867,1384463,,77199,29384406,5305741,PDN
BA544,,1999,1972,,180552,37736790,6895283,,48005,11791986,2146223,,132547,25944804,4749060,PDN
BA544,,2000,1972,,159610,27778162,5102344,,75652,15629509,2856703,,83958,12148653,2245641,PDN
BA544,,2001,1972,,159610,27777989,5102313,,104961,20843429,3813756,,54649,6934560,1288557,PDN
BA544,,2002,1972,,252348,50985533,9324507,,141469,28155944,5151423,,110879,22829589,4173084,PDN
BA544,,2003,1972,,252348,50985533,9324507,,161532,32853156,6007289,,90816,18132377,3317218,PDN
BA544,,2004,1972,,252485,52138808,9529853,,166955,36444777,6651791,,85530,15694031,2878062,PDN
BA544,,2005,1972,,252548,52515388,9596923,,173599,38820074,7081085,,78949,13695314,2515838,PDN
BA544,,2006,1972,,252548,52515561,9596954,,176612,40529020,7388181,,75936,11986541,2208773,PDN
BA544,,2007,1972,,252532,51047778,9335767,,179271,41684151,7596380,,73261,9363627,1739387,PDN
BA544,,2008,1972,,252416,51404582,9399139,,182232,42501279,7744737,,70184,8903303,1654402,PDN
BA544,,2009,1972,,186751,44368243,8081456,,185062,43438333,7914302,,1689,929910,167154,PDN
BA544,,2010,1972,,186751,44368274,8081461,,185896,44090696,8031215,,855,277578,50246,PDN
BA544,,2011,1972,,186751,44368274,8081461,,186751,44368274,8081461,,0,0,0,PDN
BA544,,2012,1972,,186751,44368274,8081461,,186751,44368274,8081461,,0,0,0,PDN
BA544,,2013,1972,,186751,44368274,8081461,,186751,44368274,8081461,,0,0,0,PDN
BA544,,2014,1972,,186751,44368274,8081461,,186751,44368274,8081461,,0,0,0,PDN
BA544,,2015,1972,,186751,44368274,8081461,,186751,44368274,8081461,,0,0,0,PDN
BA544,,2016,1972,,186751,44368274,8081461,,186751,44368274,8081461,,0,0,0,PDN
BA544,,2017,1972,,186751,44368274,8081461,,186751,44368274,8081461,,0,0,0,PDN
BA544,,2017,1972,,186751,44368274,8081461,,186751,44368274,8081461,,0,0,0,PDN
BA550,,1988,1988,,10511,2417454,440663,,0,0,0,,10511,2417454,440663,PDN
BA550,,1989,1988,,8742,7488316,1341183,,227,831854,148244,,8515,6656462,1192939,PDN
BA550,,1990,1988,,4704,19345270,3446923,,1257,5280205,940795,,3447,14065065,2506128,PDN
BA550,,1991,1988,,4783,20139630,3588347,,1630,8552843,1523488,,3153,11586787,2064859,PDN
BA550,,1992,1988,,3859,26521721,4723026,,1807,10907766,1942691,,2052,15613955,2780335,PDN
BA550,,1993,1988,,2988,24630441,4385629,,1914,12864934,2291048,,1074,11765507,2094581,PDN
BA550,,1994,1988,,3016,24888472,4431570,,2063,14491487,2580619,,953,10396985,1850951,PDN
BA550,,1995,1988,,2379,18102773,3223513,,2122,16283696,2899577,,257,1819077,323936,PDN
BA550,,1996,1988,,2232,20579682,3664097,,2154,18634762,3317948,,78,1944920,346149,PDN
BA550,,1997,1988,,2232,20579682,3664097,,2213,19838346,3532168,,19,741336,131929,PDN
BA550,,1998,1988,,2257,22169060,3946930,,2238,20585116,3665070,,19,1583944,281860,PDN
BA550,,1999,1988,,2342,22169060,3947015,,2264,21073367,3751973,,78,1095693,195042,PDN
BA550,,2000,1988,,2783,23373439,4161758,,2401,21664468,3857289,,382,1708971,304469,PDN
BA550,,2001,1988,,2455,22200002,3952633,,2442,22081121,3931467,,13,118881,21166,PDN
BA550,,2002,1988,,2452,22168190,3946970,,2452,22168190,3946970,,0,0,0,PDN
BA550,,2003,1988,,2452,22168190,3946970,,2452,22168190,3946970,,0,0,0,PDN
BA550,,2004,1988,,2452,22168190,3946970,,2452,22168190,3946970,,0,0,0,PDN
BA550,,2005,1988,,2452,22168190,3946970,,2452,22168190,3946970,,0,0,0,PDN
BA550,,2006,1988,,2452,22168190,3946970,,2452,22168190,3946970,,0,0,0,PDN
BA550,,2007,1988,,2452,22168190,3946970,,2452,22168190,3946970,,0,0,0,PDN
BA550,,2008,1988,,2452,22168190,3946970,,2452,22168190,3946970,,0,0,0,PDN
BA550,,2009,1988,,2452,22577225,4019752,,2452,22577225,4019752,,0,0,0,PDN
BA550,,2010,1988,,2452,22577225,4019752,,2452,22577225,4019752,,0,0,0,PDN
BA550,,2011,1988,,2452,22577225,4019752,,2452,22577225,4019752,,0,0,0,PDN
BA550,,2012,1988,,2452,22577225,4019752,,2452,22577225,4019752,,0,0,0,PDN
BA550,,2013,1988,,2452,22577225,4019752,,2452,22577225,4019752,,0,0,0,PDN
BA550,,2014,1988,,2452,22577225,4019752,,2452,22577225,4019752,,0,0,0,PDN
BA550,,2015,1988,,2452,22577225,4019752,,2452,22577225,4019752,,0,0,0,PDN
BA550,,2016,1988,,2452,22577225,4019752,,2452,22577225,4019752,,0,0,0,PDN
BA550,,2017,1988,,2452,22577225,4019752,,2452,22577225,4019752,,0,0,0,PDN
BA550,,2017,1988,,2452,22577225,4019752,,2452,22577225,4019752,,0,0,0,PDN
BA552,,1994,1992,,2644,5748645,1025535,,789,1602989,286018,,1855,4145656,739517,PDN
BA552,,1995,1992,,3770,9000535,1605289,,2591,5514781,983869,,1179,3485754,621420,PDN
BA552,,1996,1992,,4452,12755499,2274114,,3483,8401452,1498403,,969,4354047,775711,PDN
BA552,,1997,1992,,7630,17083640,3047424,,4518,11257323,2007600,,3112,5826317,1039824,PDN
BA552,,1998,1992,,9113,23548921,4199312,,5433,13455247,2399605,,3680,10093674,1799707,PDN
BA552,,1999,1992,,16595,22553905,4029745,,5975,14787801,2637256,,10620,7766104,1392489,PDN
BA552,,2000,1992,,7840,17454028,3113539,,6159,15304971,2729463,,1681,2149057,384076,PDN
BA552,,2001,1992,,6286,16019575,2856744,,6228,15541154,2771558,,58,478421,85186,PDN
BA552,,2002,1992,,6286,16019575,2856744,,6268,15846723,2825970,,18,172852,30774,PDN
BA552,,2003,1992,,6269,15902635,2835919,,6269,15902635,2835919,,0,0,0,PDN
BA552,,2004,1992,,6269,15902635,2835919,,6269,15902635,2835919,,0,0,0,PDN
BA552,,2005,1992,,6269,15902635,2835919,,6269,15902635,2835919,,0,0,0,PDN
BA552,,2006,1992,,6269,15902635,2835919,,6269,15902635,2835919,,0,0,0,PDN
BA552,,2007,1992,,6269,15902635,2835919,,6269,15902635,2835919,,0,0,0,PDN
BA552,,2008,1992,,6269,15902635,2835919,,6269,15902635,2835919,,0,0,0,PDN
BA552,,2009,1992,,6269,16157257,2881225,,6269,16157257,2881225,,0,0,0,PDN
BA552,,2010,1992,,6269,16157257,2881225,,6269,16157257,2881225,,0,0,0,PDN
BA552,,2011,1992,,6269,16157257,2881225,,6269,16157257,2881225,,0,0,0,PDN
BA552,,2012,1992,,6269,16157257,2881225,,6269,16157257,2881225,,0,0,0,PDN
BA552,,2013,1992,,6269,16157257,2881225,,6269,16157257,2881225,,0,0,0,PDN
BA552,,2014,1992,,6269,16157257,2881225,,6269,16157257,2881225,,0,0,0,PDN
BA552,,2015,1992,,6269,16157257,2881225,,6269,16157257,2881225,,0,0,0,PDN
BA552,,2016,1992,,6269,16157257,2881225,,6269,16157257,2881225,,0,0,0,PDN
BA552,,2017,1992,,6269,16157257,2881225,,6269,16157257,2881225,,0,0,0,PDN
BA552,,2017,1992,,6269,16157257,2881225,,6269,16157257,2881225,,0,0,0,PDN
BA578,,1985,1978,,44246,98294871,17534437,,40769,92174005,16441838,,3477,6120866,1092599,PDN
BA578,,1986,1978,,44246,98294871,17534437,,42326,94260848,16814719,,1920,4034023,719718,PDN
BA578,,1987,1978,,44766,99662904,17778379,,42457,94494754,16856470,,2309,5168150,921909,PDN
BA578,,1988,1978,,43260,96281967,17175283,,42509,94662360,16886345,,751,1619607,288938,PDN
BA578,,1989,1978,,43260,96281967,17175283,,42509,94662360,16886345,,751,1619607,288938,PDN
BA578,,1990,1978,,42967,95698473,17071165,,42509,94662360,16886345,,458,1036113,184820,PDN
BA578,,1991,1978,,43100,97027352,17307753,,42509,94663965,16886631,,591,2363387,421122,PDN
BA578,,1992,1978,,43100,95736993,17078152,,42509,94663965,16886631,,591,1073028,191521,PDN
BA578,,1993,1978,,43083,96789874,17265481,,42509,94663965,16886631,,574,2125909,378850,PDN
BA578,,1994,1978,,43083,96789874,17265481,,42509,94663965,16886631,,574,2125909,378850,PDN
BA578,,1995,1978,,43084,96789282,17265376,,42509,94663965,16886631,,575,2125317,378745,PDN
BA578,,1996,1978,,43083,96785916,17264776,,42509,94663965,16886631,,574,2121951,378145,PDN
BA578,,1997,1978,,43083,96785916,17264776,,42509,94663965,16886631,,574,2121951,378145,PDN
BA578,,1998,1978,,43096,96920132,17288671,,42509,94663965,16886631,,587,2256167,402040,PDN
BA578,,1999,1978,,43081,95938938,17114067,,42509,94663965,16886631,,572,1274973,227436,PDN
BA578,,2000,1978,,43546,96976141,17299087,,42509,94663965,16886631,,1037,2312176,412456,PDN
BA578,,2001,1978,,43081,95938938,17114067,,42509,94663965,16886631,,572,1274973,227436,PDN
BA578,,2002,1978,,43081,95938938,17114067,,42509,94663965,16886631,,572,1274973,227436,PDN
BA578,,2003,1978,,42509,94663965,16886631,,42509,94663965,16886631,,0,0,0,PDN
BA578,,2004,1978,,42509,94663965,16886631,,42509,94663965,16886631,,0,0,0,PDN
BA578,,2005,1978,,42512,94672584,16888168,,42512,94672584,16888168,,0,0,0,PDN
BA578,,2006,1978,,42512,94672584,16888168,,42512,94672584,16888168,,0,0,0,PDN
BA578,,2007,1978,,42512,94672584,16888168,,42512,94672584,16888168,,0,0,0,PDN
BA578,,2008,1978,,42512,94672584,16888168,,42512,94672584,16888168,,0,0,0,PDN
BA578,,2009,1978,,42512,96568427,17225506,,42512,96568427,17225506,,0,0,0,PDN
BA578,,2010,1978,,42512,96568427,17225506,,42512,96568427,17225506,,0,0,0,PDN
BA578,,2011,1978,,42512,96568427,17225506,,42512,96568427,17225506,,0,0,0,PDN
BA578,,2012,1978,,42512,96568427,17225506,,42512,96568427,17225506,,0,0,0,PDN
BA578,,2013,1978,,42512,96568427,17225506,,42512,96568427,17225506,,0,0,0,PDN
BA578,,2014,1978,,42512,96568427,17225506,,42512,96568427,17225506,,0,0,0,PDN
BA578,,2015,1978,,42512,96568427,17225506,,42512,96568427,17225506,,0,0,0,PDN
BA578,,2016,1978,,42512,96568427,17225506,,42512,96568427,17225506,,0,0,0,PDN
BA578,,2017,1978,,42512,96568427,17225506,,42512,96568427,17225506,,0,0,0,PDN
BA578,,2017,1978,,42512,96568427,17225506,,42512,96568427,17225506,,0,0,0,PDN
BM002,,1975,1949,,510000000,474810000,594485765,,314870752,259367104,361021482,,195129248,215442896,233464283,PDP
BM002,,1976,1949,,510000000,474810000,594485765,,317582902,275351056,366577752,,192417098,199458944,227908013,PDP
BM002,,1977,1949,,510000000,474810000,594485765,,334269959,290088578,385887144,,175730041,184721422,208598621,PDP
BM002,,1978,1949,,449541360,432721778,526538118,,372563279,319619848,429435138,,76978081,113101930,97102980,PDP
BM002,,1979,1949,,449714700,432973636,526756272,,383461759,329430326,442079255,,66252941,103543310,84677017,PDP
BM002,,1980,1949,,451412586,434104045,528655299,,392900582,337431764,452941821,,58512004,96672281,75713478,PDP
BM002,,1981,1949,,431655622,398421237,502549081,,396862483,348063317,458795458,,34793139,50357920,43753623,PDP
BM002,,1982,1949,,438089129,416057155,512120651,,403416267,355202208,466619507,,34672862,60854947,45501144,PDP
BM002,,1983,1949,,452804566,430290444,529368702,,411375342,363073095,475979096,,41429224,67217349,53389606,PDP
BM002,,1984,1949,,474541975,452507539,555059331,,418506158,371034443,484526522,,56035817,81473096,70532809,PDP
BM002,,1985,1949,,479714428,458707379,561334958,,425070282,376856344,492126571,,54644146,81851035,69208387,PDP
BM002,,1986,1949,,489049132,465142135,571814636,,431542040,383624360,499802602,,57507092,81517775,72012034,PDP
BM002,,1987,1949,,490418329,462080245,572639013,,437608881,390514230,507095399,,52809448,71566015,65543614,PDP
BM002,,1988,1949,,501155065,476044205,585860440,,442788767,397270806,513477523,,58366298,78773399,72382917,PDP
BM002,,1989,1949,,497384680,479289683,582667542,,447759468,404145416,519671464,,49625212,75144267,62996078,PDP
BM002,,1990,1949,,500797486,511096103,591739853,,453967247,413185712,527487836,,46830239,97910391,64252017,PDP
BM002,,1991,1949,,510452366,523321745,603570114,,460768805,421841779,535829620,,49683561,101479966,67740494,PDP
BM002,,1992,1949,,508655812,492955064,596370236,,467291028,432285428,544210143,,41364784,60669636,52160093,PDP
BM002,,1993,1949,,512451885,543043554,609078852,,474719461,451639655,555082389,,37732424,91403899,53996463,PDP
BM002,,1994,1949,,522184958,557823171,621441750,,481703529,468602706,565084793,,40481429,89220465,56356957,PDP
BM002,,1995,1949,,517204522,544368816,614067301,,487996527,481727608,573713183,,29207995,62641208,40354118,PDP
BM002,,1996,1949,,512505157,544394610,609372525,,492876538,490884621,580222556,,19628619,53509989,29149969,PDP
BM002,,1997,1949,,512713464,544736256,609641623,,496464763,497367130,584964252,,16248701,47369126,24677371,PDP
BM002,,1998,1949,,514225568,546960262,611549458,,499069641,501072734,588228490,,15155927,45887528,23320968,PDP
BM002,,1999,1949,,516582455,549876970,614425332,,501902555,505656979,591877106,,14679900,44219991,22548226,PDP
BM002,,2000,1949,,519888961,549001068,617575984,,505118904,511313114,596099885,,14770057,37687954,21476099,PDP
BM002,,2001,1949,,521550219,550533327,619509886,,509364574,519847042,601864048,,12185645,30686285,17645838,PDP
BM002,,2002,1949,,523904364,553714977,622430161,,513197309,525110424,606633328,,10707055,28604553,15796833,PDP
BM002,,2003,1949,,524620496,555699609,623499430,,515930402,527870811,609857593,,8690094,27828798,13641837,PDP
BM002,,2004,1949,,525199408,546536264,622447854,,518710423,532440872,613450792,,6488985,14095392,8997062,PDP
BM002,,2005,1949,,527417947,545454939,624473986,,520643982,534571088,615763393,,6773965,10883851,8710593,PDP
BM002,,2006,1949,,530267401,549870334,628109097,,522519732,536457523,617974807,,7747669,13412811,10134290,PDP
BM002,,2007,1949,,529871124,549882299,627714949,,524926112,540114356,621031869,,4945012,9767943,6683080,PDP
BM002,,2008,1949,,534468765,555505403,633313143,,526733853,542413507,623248712,,7734912,13091896,10064431,PDP
BM002,,2009,1949,,535682174,570289247,637157131,,528458487,555312530,627268546,,7223687,14976717,9888579,PDP
BM002,,2010,1949,,536603553,571212392,638242771,,530864753,559419668,630405618,,5738800,11792724,7837152,PDP
BM002,,2011,1949,,538308875,572197747,640123424,,532731660,562685353,632853609,,5577215,9512394,7269811,PDP
BM002,,2012,1949,,542116536,574755926,644386273,,534252960,565160921,634815405,,7863576,9595005,9570870,PDP
BM002,,2013,1949,,542596320,575095970,644926564,,536438875,567368939,637394199,,6157445,7727031,7532362,PDP
BM002,,2014,1949,,543651381,576642020,646256724,,538850138,569538717,640191546,,4801243,7103303,6065178,PDP
BM002,,2015,1949,,546687912,578923123,649699145,,541125647,572112046,642924940,,5562265,6811077,6774203,PDP
BM002,,2016,1949,,546767588,578298740,649667720,,543009614,573696570,645090850,,3757974,4602170,4576868,PDP
BM002,,2017,1949,,547230829,578539787,650173852,,544240058,574486395,646461836,,2990771,4053392,3712015,PDP
BM002,,2017,1949,,547230829,578539787,650173852,,544240058,574486395,646461836,,2990771,4053392,3712015,PDP
BS025,,2014,2013,,489191,7337862,1794860,,7035,117965,28025,,482156,7219897,1766835,PDP
BS025,,2015,2013,,489191,7337862,1794860,,205580,2655314,678056,,283611,4682548,1116805,PDP
BS025,,2016,2013,,585437,7337862,1891106,,429218,5403605,1390714,,156219,1934257,500393,PDP
BS025,,2017,2013,,1091596,13697342,3528845,,607622,7619682,1963437,,483974,6077660,1565408,PDP
BS025,,2017,2013,,1091596,13697342,3528845,,607622,7619682,1963437,,483974,6077660,1565408,PDP
BS041,,2001,2001,,537,5366911,955503,,0,0,0,,537,5366911,955503,PDN
BS041,,2002,2001,,565,5642544,1004576,,0,2572902,457812,,565,3069642,546764,PDN
BS041,,2003,2001,,972165,34708188,7147999,,16985,5178235,938379,,955180,29529953,6209620,PDN
BS041,,2004,2001,,975025,35272468,7251265,,215222,11099293,2190185,,759803,24173175,5061080,PDN
BS041,,2005,2001,,1240706,45301032,9301388,,464014,19446811,3924301,,776692,25854221,5377087,PDN
BS041,,2006,2001,,1171001,43123540,8844229,,667686,27191429,5506019,,503315,15932111,3338210,PDN
BS041,,2007,2001,,927152,37514044,7602249,,686023,27865538,5644304,,241129,9648506,1957945,PDN
BS041,,2008,2001,,927152,37514044,7602249,,769093,30828886,6254660,,158059,6685158,1347589,PDN
BS041,,2009,2001,,941579,38022532,7707153,,833166,33334062,6764493,,108413,4688470,942660,PDN
BS041,,2010,2001,,937681,38022532,7703255,,851565,34098025,6918828,,86116,3924507,784427,PDN
BS041,,2011,2001,,937681,38022532,7703255,,882276,35264188,7157042,,55405,2758344,546214,PDN
BS041,,2012,2001,,935366,37909155,7680766,,917112,36744299,7455243,,18254,1164856,225524,PDN
BS041,,2013,2001,,935366,37909155,7680766,,924248,37055156,7517691,,11118,853999,163075,PDN
BS041,,2014,2001,,924248,37055156,7517691,,924248,37055156,7517691,,0,0,0,PDN
BS041,,2015,2001,,924248,37055156,7517691,,924248,37055156,7517691,,0,0,0,PDN
BS041,,2016,2001,,924248,37055156,7517691,,924248,37055156,7517691,,0,0,0,PDN
BS041,,2017,2001,,924248,37055156,7517691,,924248,37055156,7517691,,0,0,0,PDN
BS041,,2017,2001,,924248,37055156,7517691,,924248,37055156,7517691,,0,0,0,PDN
BS053,,1978,1976,,6795000,7406550,8112891,,572910,611243,681672,,6222090,6795307,7431219,PDN
BS053,,1979,1976,,6795000,7406550,8112891,,1473532,1454020,1732254,,5321468,5952530,6380637,PDN
BS053,,1980,1976,,6795000,7406550,8112891,,2071475,2048479,2435973,,4723525,5358071,5676918,PDN
BS053,,1981,1976,,6795000,7447320,8120146,,2635141,2659279,3108322,,4159859,4788041,5011824,PDN
BS053,,1982,1976,,6795000,7447320,8120146,,3108324,3320255,3699117,,3686676,4127065,4421029,PDN
BS053,,1983,1976,,6795000,7447320,8120146,,3445586,3813020,4124059,,3349414,3634300,3996087,PDN
BS053,,1984,1976,,6795000,7447320,8120146,,3673362,4014064,4387608,,3121638,3433256,3732538,PDN
BS053,,1985,1976,,6795000,7447320,8120146,,3814576,4213656,4564337,,2980424,3233664,3555809,PDN
BS053,,1986,1976,,6795000,7447320,8120146,,3934822,4341503,4707331,,2860178,3105817,3412815,PDN
BS053,,1987,1976,,6795000,7447320,8120146,,4098033,4497909,4898373,,2696967,2949411,3221773,PDN
BS053,,1988,1976,,6795000,7447320,8120146,,4224636,4616404,5046060,,2570364,2830916,3074086,PDN
BS053,,1989,1976,,6795000,7447320,8120146,,4308549,4745507,5152945,,2486451,2701813,2967201,PDN
BS053,,1990,1976,,6795000,7447320,8120146,,4372341,4847387,5234865,,2422659,2599933,2885281,PDN
BS053,,1991,1976,,4515311,5011995,5407125,,4411827,4887211,5281437,,103484,124784,125688,PDN
BS053,,1992,1976,,5418375,6014395,6488552,,4464440,5021869,5358011,,953935,992526,1130541,PDN
BS053,,1993,1976,,5418375,6014395,6488552,,4488823,5076749,5392159,,929552,937646,1096393,PDN
BS053,,1994,1976,,5418374,6014395,6488551,,4527569,5122723,5439086,,890805,891672,1049465,PDN
BS053,,1995,1976,,4540933,5150383,5457371,,4540933,5150383,5457371,,0,0,0,PDN
BS053,,1996,1976,,4540933,5150383,5457371,,4540933,5150383,5457371,,0,0,0,PDN
BS053,,1997,1976,,4540933,5150383,5457371,,4540933,5150383,5457371,,0,0,0,PDN
BS053,,1998,1976,,4540933,5150383,5457371,,4540933,5150383,5457371,,0,0,0,PDN
BS053,,1999,1976,,4542102,14738802,7164665,,4541223,5952992,5600474,,879,8785810,1564191,PDN
BS053,,2000,1976,,4567070,16969842,7586615,,4544297,8943813,6135723,,22773,8026029,1450892,PDN
BS053,,2001,1976,,4567070,16969842,7586615,,4549827,11567921,6608176,,17243,5401921,978439,PDN
BS053,,2002,1976,,4567070,16969842,7586615,,4552906,12772480,6825589,,14164,4197362,761026,PDN
BS053,,2003,1976,,4567070,16969842,7586615,,4553805,12976470,6862785,,13265,3993372,723830,PDN
BS053,,2004,1976,,4559779,14082632,7065585,,4554618,13127014,6890386,,5161,955618,175199,PDN
BS053,,2005,1976,,4565136,14082632,7070942,,4556686,13314906,6925886,,8450,767726,145056,PDN
BS053,,2006,1976,,4565136,14082632,7070942,,4557186,13398241,6941215,,7950,684391,129727,PDN
BS053,,2007,1976,,4557186,13398596,6941278,,4557186,13398596,6941278,,0,0,0,PDN
BS053,,2008,1976,,4557186,13398596,6941278,,4557186,13398596,6941278,,0,0,0,PDN
BS053,,2009,1976,,4557186,13501744,6959631,,4557186,13501744,6959631,,0,0,0,PDN
BS053,,2010,1976,,4557186,13501744,6959631,,4557186,13501744,6959631,,0,0,0,PDN
BS053,,2011,1976,,4557186,13501744,6959631,,4557186,13501744,6959631,,0,0,0,PDN
BS053,,2012,1976,,4557186,13501744,6959631,,4557186,13501744,6959631,,0,0,0,PDN
BS053,,2013,1976,,4557186,13501744,6959631,,4557186,13501744,6959631,,0,0,0,PDN
BS053,,2014,1976,,4557186,13501744,6959631,,4557186,13501744,6959631,,0,0,0,PDN
BS053,,2015,1976,,4557186,13501744,6959631,,4557186,13501744,6959631,,0,0,0,PDN
BS053,,2016,1976,,4557186,13501744,6959631,,4557186,13501744,6959631,,0,0,0,PDN
BS053,,2017,1976,,4557186,13501744,6959631,,4557186,13501744,6959631,,0,0,0,PDN
BS053,,2017,1976,,4557186,13501744,6959631,,4557186,13501744,6959631,,0,0,0,PDN
CA003,,2004,2004,,390,3904242,695095,,0,0,0,,390,3904242,695095,PDN
CA003,,2005,2004,,390,3904242,695095,,0,1002314,178348,,390,2901928,516747,PDN
CA003,,2006,2004,,390,3903115,694894,,0,1583293,281725,,390,2319822,413169,PDN
CA003,,2007,2004,,116,2916632,519090,,0,1721894,306387,,116,1194738,212703,PDN
CA003,,2008,2004,,116,2917759,519290,,0,1754915,312262,,116,1162844,207028,PDN
CA003,,2009,2004,,142,3171871,564532,,0,2012412,358080,,142,1159459,206452,PDN
CA003,,2010,2004,,0,3155272,561436,,0,2467110,438987,,0,688162,122449,PDN
CA003,,2011,2004,,0,3155272,561436,,0,2849588,507044,,0,305684,54393,PDN
CA003,,2012,2004,,0,3154772,561347,,0,3139662,558658,,0,15110,2689,PDN
CA003,,2013,2004,,0,3139662,558658,,0,3139662,558658,,0,0,0,PDN
CA003,,2014,2004,,0,3139662,558658,,0,3139662,558658,,0,0,0,PDN
CA003,,2015,2004,,0,3139662,558658,,0,3139662,558658,,0,0,0,PDN
CA003,,2016,2004,,0,3139662,558658,,0,3139662,558658,,0,0,0,PDN
CA003,,2017,2004,,0,3139662,558658,,0,3139662,558658,,0,0,0,PDN
CA003,,2017,2004,,0,3139662,558658,,0,3139662,558658,,0,0,0,PDN
CA014,,1984,1983,,0,8894906,1582723,,0,622791,110817,,0,8272115,1471906,PDN
CA014,,1985,1983,,332,8894906,1583055,,45,2355944,419252,,287,6538962,1163803,PDN
CA014,,1986,1983,,332,8894906,1583055,,95,3693376,657279,,237,5201530,925776,PDN
CA014,,1987,1983,,332,8894906,1583055,,95,4743668,844164,,237,4151238,738891,PDN
CA014,,1988,1983,,332,8894906,1583055,,0,5129453,912714,,332,3765453,670341,PDN
CA014,,1989,1983,,332,8894906,1583055,,0,5209002,926869,,332,3685904,656186,PDN
CA014,,1990,1983,,332,8894906,1583055,,0,5340461,950260,,332,3554445,632795,PDN
CA014,,1991,1983,,0,7522980,1338609,,0,6164286,1096848,,0,1358694,241761,PDN
CA014,,1992,1983,,0,7522980,1338609,,0,6555363,1166435,,0,967617,172174,PDN
CA014,,1993,1983,,0,7522980,1338609,,0,6966618,1239612,,0,556362,98997,PDN
CA014,,1994,1983,,0,7522980,1338609,,0,7255861,1291078,,0,267119,47531,PDN
CA014,,1995,1983,,0,7522980,1338609,,0,7485684,1331972,,0,37296,6637,PDN
CA014,,1996,1983,,0,8047250,1431895,,0,7703009,1370642,,0,344241,61253,PDN
CA014,,1997,1983,,0,7752505,1379449,,0,7752505,1379449,,0,0,0,PDN
CA014,,1998,1983,,0,7752505,1379449,,0,7752505,1379449,,0,0,0,PDN
CA014,,1999,1983,,0,7752505,1379449,,0,7752505,1379449,,0,0,0,PDN
CA014,,2000,1983,,0,7752505,1379449,,0,7752505,1379449,,0,0,0,PDN
CA014,,2001,1983,,0,7752505,1379449,,0,7752505,1379449,,0,0,0,PDN
CA014,,2002,1983,,0,7752505,1379449,,0,7752505,1379449,,0,0,0,PDN
CA014,,2003,1983,,0,7752505,1379449,,0,7752505,1379449,,0,0,0,PDN
CA014,,2004,1983,,0,7752505,1379449,,0,7752505,1379449,,0,0,0,PDN
CA014,,2005,1983,,0,7752505,1379449,,0,7752505,1379449,,0,0,0,PDN
CA014,,2006,1983,,0,7752505,1379449,,0,7752505,1379449,,0,0,0,PDN
CA014,,2007,1983,,0,7752505,1379449,,0,7752505,1379449,,0,0,0,PDN
CA014,,2008,1983,,0,7752505,1379449,,0,7752505,1379449,,0,0,0,PDN
CA014,,2009,1983,,0,7907763,1407076,,0,7907763,1407076,,0,0,0,PDN
CA014,,2010,1983,,0,7907763,1407076,,0,7907763,1407076,,0,0,0,PDN
CA014,,2011,1983,,0,7907763,1407076,,0,7907763,1407076,,0,0,0,PDN
CA014,,2012,1983,,0,7907763,1407076,,0,7907763,1407076,,0,0,0,PDN
CA014,,2013,1983,,0,7907763,1407076,,0,7907763,1407076,,0,0,0,PDN
CA014,,2014,1983,,0,7907763,1407076,,0,7907763,1407076,,0,0,0,PDN
CA014,,2015,1983,,0,7907763,1407076,,0,7907763,1407076,,0,0,0,PDN
CA014,,2016,1983,,0,7907763,1407076,,0,7907763,1407076,,0,0,0,PDN
CA014,,2017,1983,,0,7907763,1407076,,0,7907763,1407076,,0,0,0,PDN
CA014,,2017,1983,,0,7907763,1407076,,0,7907763,1407076,,0,0,0,PDN
CA021,,1996,1984,,39290,22128254,3976702,,0,50927,9062,,39290,22077327,3967640,PDN
CA021,,1997,1984,,261,22128254,3937673,,0,573095,101974,,261,21555159,3835699,PDN
CA021,,1998,1984,,261,24085488,4285935,,0,756789,134660,,261,23328699,4151275,PDN
CA021,,1999,1984,,380,12494644,2223626,,0,847366,150777,,380,11647278,2072849,PDN
CA021,,2000,1984,,0,847366,150777,,0,847366,150777,,0,0,0,PDN
CA021,,2001,1984,,380,4641332,826240,,0,847366,150777,,380,3793966,675463,PDN
CA021,,2002,1984,,0,847366,150777,,0,847366,150777,,0,0,0,PDN
CA021,,2003,1984,,0,847366,150777,,0,847366,150777,,0,0,0,PDN
CA021,,2004,1984,,0,847366,150777,,0,847366,150777,,0,0,0,PDN
CA021,,2005,1984,,0,847366,150777,,0,847366,150777,,0,0,0,PDN
CA021,,2006,1984,,0,847366,150777,,0,847366,150777,,0,0,0,PDN
CA021,,2007,1984,,0,847366,150777,,0,847366,150777,,0,0,0,PDN
CA021,,2008,1984,,0,847366,150777,,0,847366,150777,,0,0,0,PDN
CA021,,2009,1984,,0,861597,153309,,0,861597,153309,,0,0,0,PDN
CA021,,2010,1984,,0,861597,153309,,0,861597,153309,,0,0,0,PDN
CA021,,2011,1984,,0,861597,153309,,0,861597,153309,,0,0,0,PDN
CA021,,2012,1984,,0,861597,153309,,0,861597,153309,,0,0,0,PDN
CA021,,2013,1984,,0,861597,153309,,0,861597,153309,,0,0,0,PDN
CA021,,2014,1984,,0,861597,153309,,0,861597,153309,,0,0,0,PDN
CA021,,2015,1984,,0,861597,153309,,0,861597,153309,,0,0,0,PDN
CA021,,2016,1984,,0,861597,153309,,0,861597,153309,,0,0,0,PDN
CA021,,2017,1984,,0,861597,153309,,0,861597,153309,,0,0,0,PDN
CA021,,2017,1984,,0,861597,153309,,0,861597,153309,,0,0,0,PDN
CA024,,1987,1985,,436,1862983,331928,,0,0,0,,436,1862983,331928,PDN
CA024,,1988,1985,,1909,8171932,1455989,,0,0,0,,1909,8171932,1455989,PDN
CA024,,1989,1985,,1909,8171932,1455989,,428,863474,154071,,1481,7308458,1301918,PDN
CA024,,1990,1985,,1909,8171932,1455989,,1192,3053562,544530,,717,5118370,911459,PDN
CA024,,1991,1985,,3180,8171932,1457260,,1886,4636105,826816,,1294,3535827,630444,PDN
CA024,,1992,1985,,5599,13242656,2361943,,2350,5639150,1005757,,3249,7603506,1356186,PDN
CA024,,1993,1985,,5490,13242656,2361834,,2381,5761042,1027477,,3109,7481614,1334357,PDN
CA024,,1994,1985,,2381,5764032,1028009,,2381,5764032,1028009,,0,0,0,PDN
CA024,,1995,1985,,2381,5764032,1028009,,2381,5764032,1028009,,0,0,0,PDN
CA024,,1996,1985,,2381,5764032,1028009,,2381,5764032,1028009,,0,0,0,PDN
CA024,,1997,1985,,2381,5764032,1028009,,2381,5764032,1028009,,0,0,0,PDN
CA024,,1998,1985,,2381,5764032,1028009,,2381,5764032,1028009,,0,0,0,PDN
CA024,,1999,1985,,2381,5764032,1028009,,2381,5764032,1028009,,0,0,0,PDN
CA024,,2000,1985,,2381,5764032,1028009,,2381,5764032,1028009,,0,0,0,PDN
CA024,,2001,1985,,2381,5764032,1028009,,2381,5764032,1028009,,0,0,0,PDN
CA024,,2002,1985,,2381,5764032,1028009,,2381,5764032,1028009,,0,0,0,PDN
CA024,,2003,1985,,2381,5764032,1028009,,2381,5764032,1028009,,0,0,0,PDN
CA024,,2004,1985,,2381,5764032,1028009,,2381,5764032,1028009,,0,0,0,PDN
CA024,,2005,1985,,2381,5764032,1028009,,2381,5764032,1028009,,0,0,0,PDN
CA024,,2006,1985,,2381,5764032,1028009,,2381,5764032,1028009,,0,0,0,PDN
CA024,,2007,1985,,2381,5764032,1028009,,2381,5764032,1028009,,0,0,0,PDN
CA024,,2008,1985,,2381,5764032,1028009,,2381,5764032,1028009,,0,0,0,PDN
CA024,,2009,1985,,2381,5879465,1048549,,2381,5879465,1048549,,0,0,0,PDN
CA024,,2010,1985,,2381,5879465,1048549,,2381,5879465,1048549,,0,0,0,PDN
CA024,,2011,1985,,2381,5879465,1048549,,2381,5879465,1048549,,0,0,0,PDN
CA024,,2012,1985,,2381,5879465,1048549,,2381,5879465,1048549,,0,0,0,PDN
CA024,,2013,1985,,2381,5879465,1048549,,2381,5879465,1048549,,0,0,0,PDN
CA024,,2014,1985,,2381,5879465,1048549,,2381,5879465,1048549,,0,0,0,PDN
CA024,,2015,1985,,2381,5879465,1048549,,2381,5879465,1048549,,0,0,0,PDN
CA024,,2016,1985,,2381,5879465,1048549,,2381,5879465,1048549,,0,0,0,PDN
CA024,,2017,1985,,2381,5879465,1048549,,2381,5879465,1048549,,0,0,0,PDN
CA024,,2017,1985,,2381,5879465,1048549,,2381,5879465,1048549,,0,0,0,PDN
CA025,,1983,1982,,35324,152067040,27093516,,2392,8985853,1601298,,32932,143081187,25492218,PDN
CA025,,1984,1982,,37004,159063703,28340154,,7597,29657254,5284688,,29407,129406449,23055466,PDN
CA025,,1985,1982,,21885,85606880,15254426,,11155,48316989,8608484,,10730,37289891,6645942,PDN
CA025,,1986,1982,,21885,85606880,15254426,,13157,62857680,11197798,,8728,22749200,4056628,PDN
CA025,,1987,1982,,21885,85606880,15254426,,14566,72102102,12844122,,7319,13504778,2410304,PDN
CA025,,1988,1982,,21885,85606880,15254426,,15250,78297792,13947241,,6635,7309088,1307185,PDN
CA025,,1989,1982,,21885,85606880,15254426,,15743,82893032,14765393,,6142,2713848,489033,PDN
CA025,,1990,1982,,24156,95162238,16956939,,16406,88002432,15675202,,7750,7159806,1281737,PDN
CA025,,1991,1982,,18075,96824470,17246628,,16986,90356521,16094659,,1089,6467949,1151969,PDN
CA025,,1992,1982,,18075,96824470,17246628,,17496,92169860,16417827,,579,4654610,828801,PDN
CA025,,1993,1982,,18075,96824470,17246628,,17737,93647353,16680967,,338,3177117,565661,PDN
CA025,,1994,1982,,19508,104438297,18602835,,18021,94926469,16908852,,1487,9511828,1693983,PDN
CA025,,1995,1982,,19508,104438297,18602835,,18225,96033564,17106048,,1283,8404733,1496787,PDN
CA025,,1996,1982,,19336,103813642,18491514,,18363,97016469,17281080,,973,6797173,1210434,PDN
CA025,,1997,1982,,19336,103813642,18491514,,18575,98203034,17492424,,761,5610608,999090,PDN
CA025,,1998,1982,,19336,103813642,18491514,,18683,99263313,17681194,,653,4550329,810320,PDN
CA025,,1999,1982,,19336,103813642,18491514,,18769,100402641,17884008,,567,3411001,607506,PDN
CA025,,2000,1982,,19336,103813642,18491514,,18769,101490263,18077535,,567,2323379,413979,PDN
CA025,,2001,1982,,21669,103813303,18493787,,19212,102465945,18251587,,2457,1347358,242200,PDN
CA025,,2002,1982,,21669,103813303,18493787,,19870,102914237,18332012,,1799,899066,161775,PDN
CA025,,2003,1982,,21652,103735548,18479935,,19951,103290689,18399077,,1701,444859,80858,PDN
CA025,,2004,1982,,20554,108619570,19347880,,20067,103611431,18456265,,487,5008139,891615,PDN
CA025,,2005,1982,,20554,108619570,19347880,,20067,103952784,18517004,,487,4666786,830876,PDN
CA025,,2006,1982,,20263,105753180,18837555,,20067,104130859,18548690,,196,1622321,288865,PDN
CA025,,2007,1982,,20227,105730883,18833552,,20067,104130859,18548690,,160,1600024,284862,PDN
CA025,,2008,1982,,20227,105686932,18825731,,20067,104086908,18540869,,160,1600024,284862,PDN
CA025,,2009,1982,,20066,106068247,18893419,,20066,106068247,18893419,,0,0,0,PDN
CA025,,2010,1982,,20066,106068247,18893419,,20066,106068247,18893419,,0,0,0,PDN
CA025,,2011,1982,,20066,106068247,18893419,,20066,106068247,18893419,,0,0,0,PDN
CA025,,2012,1982,,20066,106068247,18893419,,20066,106068247,18893419,,0,0,0,PDN
CA025,,2013,1982,,20066,106068247,18893419,,20066,106068247,18893419,,0,0,0,PDN
CA025,,2014,1982,,20066,106068247,18893419,,20066,106068247,18893419,,0,0,0,PDN
CA025,,2015,1982,,20066,106068247,18893419,,20066,106068247,18893419,,0,0,0,PDN
CA025,,2016,1982,,20066,106068247,18893419,,20066,106068247,18893419,,0,0,0,PDN
CA025,,2017,1982,,20066,106068247,18893419,,20066,106068247,18893419,,0,0,0,PDN
CA025,,2017,1982,,20066,106068247,18893419,,20066,106068247,18893419,,0,0,0,PDN
CA027,,2003,2003,,644,6443628,1147197,,0,0,0,,644,6443628,1147197,PDN
CA027,,2004,2003,,0,5774871,1027557,,0,1465315,260732,,0,4309556,766825,PDN
CA027,,2005,2003,,0,5774871,1027557,,0,0,0,,0,5774871,1027557,PDN
CA027,,2006,2003,,0,5774871,1027557,,0,4085520,726961,,0,1689351,300596,PDN
CA027,,2008,2003,,0,4080578,726081,,0,4080578,726081,,0,0,0,PDN
CA027,,2009,2003,,0,4080578,726081,,0,4080578,726081,,0,0,0,PDN
CA027,,2010,2003,,0,4080578,726081,,0,4080578,726081,,0,0,0,PDN
CA027,,2011,2003,,0,4080578,726081,,0,4080578,726081,,0,0,0,PDN
CA027,,2012,2003,,0,4080578,726081,,0,4080578,726081,,0,0,0,PDN
CA027,,2013,2003,,0,4080578,726081,,0,4080578,726081,,0,0,0,PDN
CA027,,2014,2003,,0,4080578,726081,,0,4080578,726081,,0,0,0,PDN
CA027,,2015,2003,,0,4080578,726081,,0,4080578,726081,,0,0,0,PDN
CA027,,2016,2003,,0,4080578,726081,,0,4080578,726081,,0,0,0,PDN
CA027,,2017,2003,,0,4080578,726081,,0,4080578,726081,,0,0,0,PDN
CA027,,2017,2003,,0,4080578,726081,,0,4080578,726081,,0,0,0,PDN
CA029,,1984,1983,,3087,30870112,5495989,,0,2685109,477777,,3087,28185003,5018212,PDN
CA029,,1985,1983,,7749,30870112,5500651,,4340,16295607,2903914,,3409,14574505,2596737,PDN
CA029,,1986,1983,,16952,60926851,10858029,,12680,43701782,7788798,,4272,17225069,3069231,PDN
CA029,,1987,1983,,29472,105000000,18712746,,16757,61094464,10887658,,12715,43905536,7825088,PDN
CA029,,1988,1983,,29472,105000000,18712746,,18501,72521229,12922634,,10971,32478771,5790112,PDN
CA029,,1989,1983,,29472,105000000,18712746,,19830,81530586,14527052,,9642,23469414,4185694,PDN
CA029,,1990,1983,,29472,105000000,18712746,,20964,93625718,16680344,,8508,11374282,2032402,PDN
CA029,,1991,1983,,28224,130000000,23159897,,21552,102211901,18208723,,6672,27788099,4951174,PDN
CA029,,1992,1983,,28224,130000000,23159897,,22000,109253162,19462064,,6224,20746838,3697833,PDN
CA029,,1993,1983,,28224,130000000,23159897,,22275,113845659,20279510,,5949,16154341,2880387,PDN
CA029,,1994,1983,,28224,130000000,23159897,,22316,114469264,20390512,,5908,15530736,2769385,PDN
CA029,,1995,1983,,28224,130000000,23159897,,22553,118928374,21184185,,5671,11071626,1975712,PDN
CA029,,1996,1983,,28224,130000000,23159897,,23041,125526378,22358695,,5183,4473622,801202,PDN
CA029,,1997,1983,,24445,136979802,24398075,,23338,129939729,23144286,,1107,7040073,1253789,PDN
CA029,,1998,1983,,24445,136979802,24398075,,23558,132376654,23578123,,887,4603148,819952,PDN
CA029,,1999,1983,,24445,136979802,24398075,,23638,133860686,23842265,,807,3119116,555810,PDN
CA029,,2000,1983,,24445,136979802,24398075,,23899,135071267,24057932,,546,1908535,340143,PDN
CA029,,2001,1983,,24445,136979802,24398075,,23993,136186551,24256475,,452,793251,141600,PDN
CA029,,2002,1983,,24456,138075499,24593050,,24134,137252903,24446359,,322,822596,146691,PDN
CA029,,2003,1983,,24733,139499926,24846784,,24428,137940575,24569014,,305,1559351,277770,PDN
CA029,,2004,1983,,24983,139677973,24878715,,24773,138452646,24660475,,210,1225327,218240,PDN
CA029,,2005,1983,,24983,139677973,24878715,,24773,139021408,24761678,,210,656565,117037,PDN
CA029,,2006,1983,,24983,139677973,24878715,,24773,139514849,24849479,,210,163124,29236,PDN
CA029,,2007,1983,,24773,140600270,25042615,,24773,139907831,24919405,,0,692439,123210,PDN
CA029,,2008,1983,,25060,140107629,24955243,,25060,140107629,24955243,,0,0,0,PDN
CA029,,2009,1983,,25060,143052001,25479153,,25060,143034057,25475960,,0,17944,3193,PDN
CA029,,2010,1983,,25060,143052001,25479153,,25060,143052001,25479153,,0,0,0,PDN
CA029,,2011,1983,,25060,143052001,25479153,,25060,143052001,25479153,,0,0,0,PDN
CA029,,2012,1983,,25060,143052001,25479153,,25060,143052001,25479153,,0,0,0,PDN
CA029,,2013,1983,,25060,143052001,25479153,,25060,143052001,25479153,,0,0,0,PDN
CA029,,2014,1983,,25060,143052001,25479153,,25060,143052001,25479153,,0,0,0,PDN
CA029,,2015,1983,,25060,143052001,25479153,,25060,143052001,25479153,,0,0,0,PDN
CA029,,2016,1983,,25060,143052001,25479153,,25060,143052001,25479153,,0,0,0,PDN
CA029,,2017,1983,,25060,143052001,25479153,,25060,143052001,25479153,,0,0,0,PDN
CA029,,2017,1983,,25060,143052001,25479153,,25060,143052001,25479153,,0,0,0,PDN
CA031,,1987,1987,,311,3108679,553457,,31,751992,133837,,280,2356687,419620,PDN
CA031,,1988,1987,,311,3108679,553457,,82,1339247,238382,,229,1769432,315075,PDN
CA031,,1989,1987,,584,8747529,1557084,,127,1718955,305991,,457,7028574,1251093,PDN
CA031,,1990,1987,,584,8747529,1557084,,193,2195525,390856,,391,6552004,1166228,PDN
CA031,,1991,1987,,584,8747529,1557084,,208,2523287,449191,,376,6224242,1107893,PDN
CA031,,1992,1987,,584,8747529,1557084,,220,2804301,499206,,364,5943228,1057878,PDN
CA031,,1993,1987,,584,8747529,1557084,,229,3044323,541923,,355,5703206,1015161,PDN
CA031,,1994,1987,,355,3584200,638113,,314,3233715,575708,,41,350485,62405,PDN
CA031,,1995,1987,,355,3584200,638113,,314,3347410,595939,,41,236790,42174,PDN
CA031,,1996,1987,,314,3383664,602389,,314,3383664,602389,,0,0,0,PDN
CA031,,1997,1987,,314,3383664,602389,,314,3383664,602389,,0,0,0,PDN
CA031,,1998,1987,,314,3383664,602389,,314,3383664,602389,,0,0,0,PDN
CA031,,1999,1987,,314,3383664,602389,,314,3383664,602389,,0,0,0,PDN
CA031,,2000,1987,,314,3383664,602389,,314,3383664,602389,,0,0,0,PDN
CA031,,2001,1987,,314,3383664,602389,,314,3383664,602389,,0,0,0,PDN
CA031,,2002,1987,,314,3383664,602389,,314,3383664,602389,,0,0,0,PDN
CA031,,2003,1987,,314,3383664,602389,,314,3383664,602389,,0,0,0,PDN
CA031,,2004,1987,,314,3383664,602389,,314,3383664,602389,,0,0,0,PDN
CA031,,2005,1987,,314,3383664,602389,,314,3383664,602389,,0,0,0,PDN
CA031,,2006,1987,,1557,13043244,2322419,,314,3383664,602389,,1243,9659580,1720030,PDN
CA031,,2007,1987,,971,9754770,1736695,,456,5028202,895154,,515,4726568,841541,PDN
CA031,,2008,1987,,961,9754770,1736685,,480,7768395,1382757,,481,1986375,353928,PDN
CA031,,2009,1987,,490,11706687,2083531,,480,9346604,1663577,,10,2360083,419953,PDN
CA031,,2010,1987,,490,11145046,1983595,,480,10117718,1800786,,10,1027328,182808,PDN
CA031,,2011,1987,,490,11145046,1983595,,480,10589651,1884760,,10,555395,98835,PDN
CA031,,2012,1987,,486,11081067,1972206,,486,10937176,1946603,,0,143891,25603,PDN
CA031,,2013,1987,,486,11081067,1972206,,486,11081067,1972206,,0,0,0,PDN
CA031,,2014,1987,,486,11081067,1972206,,486,11081067,1972206,,0,0,0,PDN
CA031,,2015,1987,,486,11081067,1972206,,486,11081067,1972206,,0,0,0,PDN
CA031,,2016,1987,,486,11081067,1972206,,486,11081067,1972206,,0,0,0,PDN
CA031,,2017,1987,,486,11081067,1972206,,486,11081067,1972206,,0,0,0,PDN
CA031,,2017,1987,,486,11081067,1972206,,486,11081067,1972206,,0,0,0,PDN
CA032,,2007,2006,,1553,8758044,1559924,,179,1514003,269575,,1374,7244041,1290349,PDN
CA032,,2008,2006,,1553,8759399,1560165,,712,4088274,728163,,841,4671125,832002,PDN
CA032,,2009,2006,,1504,6737026,1200263,,1272,5778303,1029440,,232,958723,170823,PDN
CA032,,2010,2006,,1479,6609209,1177495,,1444,6342178,1129946,,35,267031,47549,PDN
CA032,,2011,2006,,1536,6807909,1212907,,1486,6588210,1173766,,50,219699,39143,PDN
CA032,,2012,2006,,1536,6686216,1191254,,1536,6678243,1189835,,0,7973,1419,PDN
CA032,,2013,2006,,1536,6686216,1191254,,1536,6686216,1191254,,0,0,0,PDN
CA032,,2014,2006,,1536,6686216,1191254,,1536,6686216,1191254,,0,0,0,PDN
CA032,,2015,2006,,1536,6686216,1191254,,1536,6686216,1191254,,0,0,0,PDN
CA032,,2016,2006,,1536,6686216,1191254,,1536,6686216,1191254,,0,0,0,PDN
CA032,,2017,2006,,1536,6686216,1191254,,1536,6686216,1191254,,0,0,0,PDN
CA032,,2017,2006,,1536,6686216,1191254,,1536,6686216,1191254,,0,0,0,PDN
CA037,,1994,1987,,1545,15450298,2750708,,0,912499,162366,,1545,14537799,2588342,PDN
CA037,,1995,1987,,1545,15450298,2750708,,0,1936292,344536,,1545,13514006,2406172,PDN
CA037,,1996,1987,,1545,15450298,2750708,,0,2326002,413879,,1545,13124296,2336829,PDN
CA037,,1997,1987,,0,15450298,2749163,,0,2526533,449561,,0,12923765,2299602,PDN
CA037,,1998,1987,,0,15450298,2749163,,0,2681028,477051,,0,12769270,2272112,PDN
CA037,,1999,1987,,0,2852363,507538,,0,2798495,497953,,0,53868,9585,PDN
CA037,,2000,1987,,0,3038288,540621,,0,2834578,504373,,0,203710,36248,PDN
CA037,,2001,1987,,222,5259072,936000,,0,2885839,513494,,222,2373233,422506,PDN
CA037,,2002,1987,,222,5495801,978122,,0,3038121,540591,,222,2457680,437531,PDN
CA037,,2003,1987,,222,5495801,978122,,0,3038121,540591,,222,2457680,437531,PDN
CA037,,2004,1987,,222,6425793,1143601,,0,4023995,716013,,222,2401798,427588,PDN
CA037,,2005,1987,,222,6511579,1158866,,0,4216186,750211,,222,2295393,408655,PDN
CA037,,2006,1987,,222,6605108,1175508,,0,4379513,779273,,222,2225595,396235,PDN
CA037,,2007,1987,,222,6605108,1175508,,0,4379513,779273,,222,2225595,396235,PDN
CA037,,2008,1987,,222,6605108,1175508,,0,4379513,779273,,222,2225595,396235,PDN
CA037,,2009,1987,,227,6703493,1193019,,0,4432215,788650,,227,2271278,404369,PDN
CA037,,2010,1987,,0,4432215,788650,,0,4432215,788650,,0,0,0,PDN
CA037,,2011,1987,,0,4432215,788650,,0,4432215,788650,,0,0,0,PDN
CA037,,2012,1987,,0,4432215,788650,,0,4432215,788650,,0,0,0,PDN
CA037,,2013,1987,,0,4432215,788650,,0,4432215,788650,,0,0,0,PDN
CA037,,2014,1987,,0,4432215,788650,,0,4432215,788650,,0,0,0,PDN
CA037,,2015,1987,,0,4432215,788650,,0,4432215,788650,,0,0,0,PDN
CA037,,2016,1987,,0,4432215,788650,,0,4432215,788650,,0,0,0,PDN
CA037,,2017,1987,,0,4432215,788650,,0,4432215,788650,,0,0,0,PDN
CA037,,2017,1987,,0,4432215,788650,,0,4432215,788650,,0,0,0,PDN
CA038,,1988,1988,,6304,27802048,4953288,,0,0,0,,6304,27802048,4953288,PDN
CA038,,1989,1988,,6304,27802048,4953288,,0,0,0,,6304,27802048,4953288,PDN
CA038,,1990,1988,,6304,27802048,4953288,,0,0,0,,6304,27802048,4953288,PDN
CA038,,1991,1988,,6304,27802048,4953288,,0,605925,107816,,6304,27196123,4845472,PDN
CA038,,1992,1988,,1177,11766495,2094859,,0,1841317,327636,,1177,9925178,1767223,PDN
CA038,,1993,1988,,1177,11766495,2094859,,0,3111630,553671,,1177,8654865,1541188,PDN
CA038,,1994,1988,,1170,11698806,2082808,,0,4060992,722596,,1170,7637814,1360212,PDN
CA038,,1995,1988,,1170,11698806,2082808,,0,4779502,850445,,1170,6919304,1232363,PDN
CA038,,1996,1988,,1146,11461897,2040629,,0,5312293,945248,,1146,6149604,1095381,PDN
CA038,,1997,1988,,0,11461897,2039483,,0,5706401,1015374,,0,5755496,1024109,PDN
CA038,,1998,1988,,0,11461897,2039483,,0,6058785,1078076,,0,5403112,961407,PDN
CA038,,1999,1988,,0,6898967,1227574,,0,6358478,1131402,,0,540489,96172,PDN
CA038,,2000,1988,,0,6840855,1217234,,0,6582313,1171230,,0,258542,46004,PDN
CA038,,2001,1988,,0,7327899,1303897,,0,6764229,1203599,,0,563670,100298,PDN
CA038,,2002,1988,,0,7327899,1303897,,0,6919668,1231258,,0,408231,72639,PDN
CA038,,2003,1988,,0,7327899,1303897,,0,7052540,1254900,,0,275359,48997,PDN
CA038,,2004,1988,,0,7327899,1303897,,0,7152481,1272683,,0,175418,31214,PDN
CA038,,2005,1988,,0,7327899,1303897,,0,7249770,1289995,,0,78129,13902,PDN
CA038,,2006,1988,,0,7327899,1303897,,0,7325814,1303526,,0,2085,371,PDN
CA038,,2007,1988,,0,7356700,1309021,,0,7356700,1309021,,0,0,0,PDN
CA038,,2008,1988,,0,7356700,1309021,,0,7356700,1309021,,0,0,0,PDN
CA038,,2009,1988,,0,7475727,1330201,,0,7475727,1330201,,0,0,0,PDN
CA038,,2010,1988,,0,7475727,1330201,,0,7475727,1330201,,0,0,0,PDN
CA038,,2011,1988,,0,7475727,1330201,,0,7475727,1330201,,0,0,0,PDN
CA038,,2012,1988,,0,7475727,1330201,,0,7475727,1330201,,0,0,0,PDN
CA038,,2013,1988,,0,7475727,1330201,,0,7475727,1330201,,0,0,0,PDN
CA038,,2014,1988,,0,7475727,1330201,,0,7475727,1330201,,0,0,0,PDN
CA038,,2015,1988,,0,7475727,1330201,,0,7475727,1330201,,0,0,0,PDN
CA038,,2016,1988,,0,7475727,1330201,,0,7475727,1330201,,0,0,0,PDN
CA038,,2017,1988,,0,7475727,1330201,,0,7475727,1330201,,0,0,0,PDN
CA038,,2017,1988,,0,7475727,1330201,,0,7475727,1330201,,0,0,0,PDN
CA040,,1986,1984,,31425,6567742,1200062,,0,0,0,,31425,6567742,1200062,PDN
CA040,,1987,1984,,31425,6567742,1200062,,0,0,0,,31425,6567742,1200062,PDN
CA040,,1988,1984,,1007472,210561325,38473900,,0,0,0,,1007472,210561325,38473900,PDN
CA040,,1989,1984,,1007472,210561325,38473900,,41,4439874,790054,,1007431,206121451,37683846,PDN
CA040,,1990,1984,,945471,198283584,36227248,,214,7944333,1413796,,945257,190339251,34813452,PDN
CA040,,1991,1984,,945471,198283584,36227248,,303,12408310,2208187,,945168,185875274,34019061,PDN
CA040,,1992,1984,,4895,79487614,14148599,,406,17806720,3168862,,4489,61680894,10979737,PDN
CA040,,1993,1984,,4895,78776009,14021978,,481,23277335,4142356,,4414,55498674,9879622,PDN
CA040,,1994,1984,,4891,78740028,14015572,,520,28739877,5114377,,4371,50000151,8901195,PDN
CA040,,1995,1984,,4881,78609022,13992251,,593,33976706,6046270,,4288,44632316,7945981,PDN
CA040,,1996,1984,,3751,75320793,13406027,,740,37792752,6725429,,3011,37528041,6680598,PDN
CA040,,1997,1984,,2258,71947029,12804220,,807,47374503,8430434,,1451,24572526,4373786,PDN
CA040,,1998,1984,,2258,71947029,12804220,,799,53676622,9551799,,1459,18270407,3252421,PDN
CA040,,1999,1984,,961,64152487,11415994,,799,56621784,10075850,,162,7530703,1340144,PDN
CA040,,2000,1984,,961,64152487,11415994,,799,58432720,10398080,,162,5719767,1017914,PDN
CA040,,2001,1984,,904,65507605,11657061,,799,60680894,10798111,,105,4826711,858950,PDN
CA040,,2002,1984,,904,68149236,12127103,,799,62204844,11069277,,105,5944392,1057826,PDN
CA040,,2003,1984,,867,66313014,11800336,,799,62865767,11186879,,68,3447247,613457,PDN
CA040,,2004,1984,,205054,73946215,13362744,,799,62865767,11186879,,204255,11080448,2175865,PDN
CA040,,2005,1984,,205054,73946215,13362744,,101218,66890535,12003448,,103836,7055680,1359296,PDN
CA040,,2006,1984,,205054,73946215,13362744,,161793,70366457,12682515,,43261,3579758,680229,PDN
CA040,,2007,1984,,169715,73436038,13236626,,169669,70852099,12776804,,46,2583939,459822,PDN
CA040,,2008,1984,,170294,73436038,13237205,,170248,70852099,12777383,,46,2583939,459822,PDN
CA040,,2009,1984,,170295,74530215,13431898,,170248,71894367,12962839,,47,2635848,469059,PDN
CA040,,2010,1984,,170295,72365097,13046646,,170248,71894367,12962839,,47,470730,83807,PDN
CA040,,2011,1984,,170248,71894367,12962839,,170248,71894367,12962839,,0,0,0,PDN
CA040,,2012,1984,,170248,71894367,12962839,,170248,71894367,12962839,,0,0,0,PDN
CA040,,2013,1984,,170248,71894367,12962839,,170248,71894367,12962839,,0,0,0,PDN
CA040,,2014,1984,,170248,71894367,12962839,,170248,71894367,12962839,,0,0,0,PDN
CA040,,2015,1984,,170248,71894367,12962840,,170248,71894367,12962840,,0,0,0,PDN
CA040,,2016,1984,,170248,71894367,12962840,,170248,71894367,12962840,,0,0,0,PDN
CA040,,2017,1984,,170248,71894367,12962840,,170248,71894367,12962840,,0,0,0,PDN
CA040,,2017,1984,,170248,71894367,12962840,,170248,71894367,12962840,,0,0,0,PDN
CA041,,1989,1987,,3440,34397872,6124058,,0,0,0,,3440,34397872,6124058,PDN
CA041,,1990,1987,,3440,34397872,6124058,,6,1332142,237042,,3434,33065730,5887016,PDN
CA041,,1991,1987,,3440,34397872,6124058,,30,2072044,368721,,3410,32325828,5755337,PDN
CA041,,1992,1987,,3440,34397872,6124058,,30,2734999,486685,,3410,31662873,5637373,PDN
CA041,,1993,1987,,3440,34397872,6124058,,30,3126000,556258,,3410,31271872,5567800,PDN
CA041,,1994,1987,,3423,34223736,6093056,,30,3549888,631683,,3393,30673848,5461373,PDN
CA041,,1995,1987,,95514,14040507,2593825,,30,3884817,691279,,95484,10155690,1902546,PDN
CA041,,1996,1987,,95514,14040507,2593825,,30,4075930,725284,,95484,9964577,1868541,PDN
CA041,,1997,1987,,150,14040507,2498461,,33,4463278,794211,,117,9577229,1704250,PDN
CA041,,1998,1987,,150,14040507,2498461,,33,4832942,859987,,117,9207565,1638474,PDN
CA041,,1999,1987,,150,6581488,1171233,,33,5179417,921637,,117,1402071,249596,PDN
CA041,,2000,1987,,150,6581488,1171233,,33,5594586,995511,,117,986902,175722,PDN
CA041,,2001,1987,,150,7459019,1327378,,33,6166314,1097242,,117,1292705,230136,PDN
CA041,,2002,1987,,150,7459019,1327378,,33,6531122,1162154,,117,927897,165224,PDN
CA041,,2003,1987,,150,7459019,1327378,,33,6762273,1203284,,117,696746,124094,PDN
CA041,,2004,1987,,33,6846155,1218210,,33,6846155,1218210,,0,0,0,PDN
CA041,,2005,1987,,33,6846155,1218210,,33,6846155,1218210,,0,0,0,PDN
CA041,,2006,1987,,33,6846155,1218210,,33,6846155,1218210,,0,0,0,PDN
CA041,,2007,1987,,33,6846155,1218210,,33,6846155,1218210,,0,0,0,PDN
CA041,,2008,1987,,33,6846155,1218210,,33,6846155,1218210,,0,0,0,PDN
CA041,,2009,1987,,33,6941731,1235216,,33,6941731,1235216,,0,0,0,PDN
CA041,,2010,1987,,33,6941731,1235216,,33,6941731,1235216,,0,0,0,PDN
CA041,,2011,1987,,33,6941731,1235216,,33,6941731,1235216,,0,0,0,PDN
CA041,,2012,1987,,33,6941731,1235216,,33,6941731,1235216,,0,0,0,PDN
CA041,,2013,1987,,33,6941731,1235216,,33,6941731,1235216,,0,0,0,PDN
CA041,,2014,1987,,33,6941731,1235216,,33,6941731,1235216,,0,0,0,PDN
CA041,,2015,1987,,33,6941731,1235216,,33,6941731,1235216,,0,0,0,PDN
CA041,,2016,1987,,33,6941731,1235216,,33,6941731,1235216,,0,0,0,PDN
CA041,,2017,1987,,33,6941731,1235216,,33,6941731,1235216,,0,0,0,PDN
CA041,,2017,1987,,33,6941731,1235216,,33,6941731,1235216,,0,0,0,PDN
CA043,,2008,2009,,1171,11712258,2085203,,0,0,0,,1171,11712258,2085203,PDP
CA043,,2009,2009,,1196,11951130,2127731,,0,0,0,,1196,11951130,2127731,PDP
CA043,,2010,2009,,4836,4365434,781603,,96,143800,25683,,4740,4221634,755921,PDP
CA043,,2011,2009,,4836,4365434,781603,,899,678239,121583,,3937,3687195,660021,PDP
CA043,,2012,2009,,4836,4365434,781603,,2120,1581816,283582,,2716,2783618,498022,PDP
CA043,,2013,2009,,5272,4531412,811572,,2999,2411252,432048,,2273,2120160,379526,PDP
CA043,,2014,2009,,4385,3956631,708411,,3610,3175058,568566,,775,781573,139845,PDP
CA043,,2015,2009,,4337,3977267,712035,,3994,3813619,682574,,343,163648,29462,PDP
CA043,,2016,2009,,5354,5456211,976210,,4506,4438742,794318,,848,1017469,181892,PDP
CA043,,2017,2009,,5354,5456273,976221,,5220,5041723,902323,,134,414550,73897,PDP
CA043,,2017,2009,,5354,5456273,976221,,5220,5041723,902323,,134,414550,73897,PDP
CP000,,1975,1966,,17000170,401000000,88352483,,7087582,202004569,43031455,,9912588,198995431,45321028,PDN
CP000,,1976,1966,,17000170,401000000,88352483,,7487604,218169913,46307873,,9512566,182830087,42044610,PDN
CP000,,1977,1966,,8822320,254205520,54054619,,7178856,198096552,42427353,,1643464,56108968,11627266,PDN
CP000,,1978,1966,,12152266,276745520,61395241,,10983810,246661489,54873755,,1168456,30084031,6521486,PDN
CP000,,1979,1966,,8511767,300288250,61943840,,7186933,261428750,53704504,,1324834,38859500,8239336,PDN
CP000,,1980,1966,,8838293,317015677,65246776,,6183854,271027704,54409424,,2654439,45987973,10837352,PDN
CP000,,1981,1966,,8997104,322081776,66307029,,6353839,279925495,56162646,,2643265,42156281,10144383,PDN
CP000,,1982,1966,,8997104,329584137,67641968,,6562439,290880553,58320545,,2434665,38703584,9321423,PDN
CP000,,1983,1966,,10220235,380248468,77880105,,6741851,300617734,60232551,,3478384,79630734,17647554,PDN
CP000,,1984,1966,,10252691,391524607,79918991,,6895558,310085679,62070946,,3357133,81438928,17848045,PDN
CP000,,1985,1966,,10310823,391946549,80052202,,6995089,317315516,63456925,,3315734,74631033,16595277,PDN
CP000,,1986,1966,,10361173,396698764,80948142,,7057776,321904899,64336228,,3303397,74793865,16611914,PDN
CP000,,1987,1966,,10359154,401423667,81786853,,7098257,324219637,64788584,,3260897,77204030,16998269,PDN
CP000,,1988,1966,,8725428,402534057,80350705,,7134723,326321689,65199080,,1590705,76212368,15151625,PDN
CP000,,1989,1966,,8840625,411112803,81992369,,7166772,327416007,65425848,,1673853,83696796,16566521,PDN
CP000,,1990,1966,,9184045,420828956,84064642,,7238152,329683522,65900700,,1945893,91145434,18163942,PDN
CP000,,1991,1966,,7760595,356564624,71206258,,7317046,333707593,66695621,,443549,22857031,4510637,PDN
CP000,,1992,1966,,7829708,363475916,72505138,,7335974,334734375,66897251,,493734,28741541,5607887,PDN
CP000,,1993,1966,,7764701,360086534,71837038,,7345397,335154725,66981469,,419304,24931809,4855569,PDN
CP000,,1994,1966,,7764701,360086534,71837038,,7358225,335786096,67106641,,406476,24300438,4730397,PDN
CP000,,1995,1966,,7571756,345276132,69008790,,7402605,337781705,67506111,,169151,7494427,1502679,PDN
CP000,,1996,1966,,7659842,349774133,69897232,,7479028,341002193,68155575,,180814,8771940,1741657,PDN
CP000,,1997,1966,,7757320,353107435,70587824,,7553752,343881670,68742661,,203568,9225765,1845163,PDN
CP000,,1998,1966,,7771248,353620272,70693005,,7588113,345406166,69048285,,183135,8214106,1644720,PDN
CP000,,1999,1966,,7771085,353620272,70692842,,7606840,346325864,69230659,,164245,7294408,1462183,PDN
CP000,,2000,1966,,7771085,353620272,70692842,,7617877,346880892,69340456,,153208,6739380,1352386,PDN
CP000,,2001,1966,,7793389,353986373,70780288,,7623855,347182769,69400148,,169534,6803604,1380140,PDN
CP000,,2002,1966,,7793389,353986373,70780288,,7628516,347415620,69446242,,164873,6570753,1334046,PDN
CP000,,2003,1966,,7877022,355938035,71211192,,7653085,347865439,69550850,,223937,8072596,1660342,PDN
CP000,,2004,1966,,7735619,349790728,69975962,,7692304,348771222,69751240,,43315,1019506,224722,PDN
CP000,,2005,1966,,7750707,352273283,70432786,,7743915,349970865,70016311,,6792,2302418,416475,PDN
CP000,,2006,1966,,7823205,354665942,70931024,,7755373,350365012,70097902,,67832,4300930,833122,PDN
CP000,,2007,1966,,7823668,354665942,70931487,,7780833,352192436,70448526,,42835,2473506,482961,PDN
CP000,,2008,1966,,7824423,355038077,70998458,,7792898,352907761,70587873,,31525,2130316,410585,PDN
CP000,,2009,1966,,7897175,362126142,72332432,,7811644,361175954,72077828,,85531,950188,254604,PDN
CP000,,2010,1966,,7867116,364012545,72638031,,7852345,363187616,72476476,,14771,824929,161555,PDN
CP000,,2011,1966,,7867116,364012545,72638031,,7864824,363891353,72614175,,2292,121192,23856,PDN
CP000,,2012,1966,,7867297,364012545,72638212,,7867297,364012545,72638212,,0,0,0,PDN
CP000,,2013,1966,,7867297,364012545,72638212,,7867297,364012545,72638212,,0,0,0,PDN
CP000,,2014,1966,,7867297,364012545,72638212,,7867297,364012545,72638212,,0,0,0,PDN
CP000,,2015,1966,,7867297,364012545,72638212,,7867297,364012545,72638212,,0,0,0,PDN
CP000,,2016,1966,,7867297,364012545,72638212,,7867297,364012545,72638212,,0,0,0,PDN
CP000,,2017,1966,,7867297,364012545,72638212,,7867297,364012545,72638212,,0,0,0,PDN
CP000,,2017,1966,,7867297,364012545,72638212,,7867297,364012545,72638212,,0,0,0,PDN
DC004,,2012,2010,,21575895,17260716,24647197,,0,0,0,,21575895,17260716,24647197,PDP
DC004,,2013,2010,,21575895,17260716,24647197,,0,0,0,,21575895,17260716,24647197,PDP
DC004,,2014,2010,,21575895,17260716,24647197,,1666569,1535800,1939843,,19909326,15724916,22707354,PDP
DC004,,2015,2010,,9181232,9548481,10880250,,3468377,3604390,4109728,,5712855,5944091,6770522,PDP
DC004,,2016,2010,,5049677,5029478,5944602,,4467608,4479708,5264709,,582069,549770,679893,PDP
DC004,,2017,2010,,6426862,6401155,7565858,,5172482,5178642,6093949,,1254380,1222513,1471909,PDP
DC004,,2017,2010,,6426862,6401155,7565858,,5172482,5178642,6093949,,1254380,1222513,1471909,PDP
DC048,,2007,2008,,130852,53067002,9573379,,0,0,0,,130852,53067002,9573379,PDN
DC048,,2008,2008,,130852,53067002,9573379,,0,0,0,,130852,53067002,9573379,PDN
DC048,,2009,2008,,133471,54129006,9764967,,0,0,0,,133471,54129006,9764967,PDN
DC048,,2010,2008,,133471,54129006,9764967,,0,0,0,,133471,54129006,9764967,PDN
DC048,,2011,2008,,133471,54129006,9764967,,0,0,0,,133471,54129006,9764967,PDN
DC048,,2012,2008,,133471,54129006,9764967,,0,0,0,,133471,54129006,9764967,PDN
DC048,,2013,2008,,133471,54129006,9764967,,0,0,0,,133471,54129006,9764967,PDN
DC048,,2014,2008,,133471,54129006,9764967,,2479,12162116,2166557,,130992,41966890,7598410,PDN
DC048,,2015,2008,,133471,54129006,9764967,,8762,28341649,5051760,,124709,25787357,4713207,PDN
DC048,,2016,2008,,16655,32477403,5795552,,11555,29988402,5347570,,5100,2489001,447983,PDN
DC048,,2017,2008,,11560,29988403,5347575,,11560,29988403,5347575,,0,0,0,PDN
DC048,,2017,2008,,11560,29988403,5347575,,11560,29988403,5347575,,0,0,0,PDN
DC133,,1994,1993,,7819,78193632,13921277,,0,0,0,,7819,78193632,13921277,PDN
DC133,,1995,1993,,7819,78193632,13921277,,0,0,0,,7819,78193632,13921277,PDN
DC133,,1996,1993,,8018,80183925,14275620,,0,0,0,,8018,80183925,14275620,PDN
DC133,,1997,1993,,8018,80183925,14275620,,0,0,0,,8018,80183925,14275620,PDN
DC133,,1998,1993,,10122,101220836,18020947,,0,0,0,,10122,101220836,18020947,PDN
DC133,,1999,1993,,5841,58403426,10397910,,0,0,0,,5841,58403426,10397910,PDN
DC133,,2000,1993,,14534,145318197,25871864,,0,0,0,,14534,145318197,25871864,PDN
DC133,,2001,1993,,65884,139804064,24942052,,0,0,0,,65884,139804064,24942052,PDN
DC133,,2002,1993,,121106,151231914,27030700,,2540,6103551,1088581,,118566,145128363,25942119,PDN
DC133,,2003,1993,,120605,146215716,26137636,,49893,45655683,8173680,,70712,100560033,17963956,PDN
DC133,,2004,1993,,120653,138788803,24816170,,88213,70503433,12633308,,32440,68285370,12182862,PDN
DC133,,2005,1993,,120653,138788803,24816170,,103972,82408486,14767404,,16681,56380317,10048766,PDN
DC133,,2006,1993,,108026,109161577,19531794,,105881,87724003,15715134,,2145,21437574,3816660,PDN
DC133,,2007,1993,,108090,109230279,19544083,,105945,87792705,15727423,,2145,21437574,3816660,PDN
DC133,,2008,1993,,110754,126816314,22675935,,106646,88034557,15771158,,4108,38781757,6904777,PDN
DC133,,2009,1993,,108770,109248690,19548039,,106646,88034557,15771158,,2124,21214133,3776881,PDN
DC133,,2010,1993,,109451,117034544,20934103,,108250,99824636,17870641,,1201,17209908,3063462,PDN
DC133,,2011,1993,,109451,117055234,20937785,,108887,111464535,19942434,,564,5590699,995350,PDN
DC133,,2012,1993,,109451,117055234,20937785,,109331,115850456,20723291,,120,1204778,214493,PDN
DC133,,2013,1993,,109451,117055234,20937785,,109331,115856668,20724397,,120,1198566,213388,PDN
DC133,,2014,1993,,109331,115856668,20724397,,109331,115856668,20724397,,0,0,0,PDN
DC133,,2015,1993,,109331,115856668,20724397,,109331,115856668,20724397,,0,0,0,PDN
DC133,,2016,1993,,109331,115856668,20724397,,109331,115856668,20724397,,0,0,0,PDN
DC133,,2017,1993,,109331,115856668,20724397,,109331,115856668,20724397,,0,0,0,PDN
DC133,,2017,1993,,109331,115856668,20724397,,109331,115856668,20724397,,0,0,0,PDN
DC134,,2014,2012,,4274935,4869120,5141327,,0,0,0,,4274935,4869120,5141327,PDP
DC134,,2015,2012,,4274935,4869120,5141327,,0,0,0,,4274935,4869120,5141327,PDP
DC134,,2016,2012,,7813458,7087774,9074628,,577840,374124,644410,,7235618,6713650,8430218,PDP
DC134,,2017,2012,,7813458,7087774,9074628,,1240618,790925,1381352,,6572840,6296849,7693276,PDP
DC134,,2017,2012,,7813458,7087774,9074628,,1240618,790925,1381352,,6572840,6296849,7693276,PDP
DC618,,2004,2004,,158146,79072671,14228017,,0,0,0,,158146,79072671,14228017,PDN
DC618,,2005,2004,,158146,79072671,14228017,,0,0,0,,158146,79072671,14228017,PDN
DC618,,2006,2004,,158146,79072671,14228017,,0,0,0,,158146,79072671,14228017,PDN
DC618,,2007,2004,,27428,127609297,22733709,,1844,10381687,1849119,,25584,117227610,20884590,PDN
DC618,,2008,2004,,28598,110418189,19675963,,10879,41171293,7336732,,17719,69246896,12339231,PDN
DC618,,2009,2004,,33949,119169573,21238499,,22362,76022844,13549558,,11587,43146729,7688941,PDN
DC618,,2010,2004,,39125,127934444,22803261,,27538,84787715,15114320,,11587,43146729,7688941,PDN
DC618,,2011,2004,,39328,127934444,22803464,,27741,84787715,15114523,,11587,43146729,7688941,PDN
DC618,,2012,2004,,39328,127934444,22803464,,27741,84787715,15114523,,11587,43146729,7688941,PDN
DC618,,2013,2004,,27741,84787715,15114523,,27741,84787715,15114523,,0,0,0,PDN
DC618,,2014,2004,,27741,84787715,15114523,,27741,84787715,15114523,,0,0,0,PDN
DC618,,2015,2004,,27741,84787715,15114523,,27741,84787715,15114523,,0,0,0,PDN
DC618,,2016,2004,,27741,84787715,15114523,,27741,84787715,15114523,,0,0,0,PDN
DC618,,2017,2004,,27741,84787715,15114523,,27741,84787715,15114523,,0,0,0,PDN
DC618,,2017,2004,,27741,84787715,15114523,,27741,84787715,15114523,,0,0,0,PDN
DC621,,2003,2003,,408672,204335778,36767351,,0,0,0,,408672,204335778,36767351,PDN
DC621,,2004,2003,,526742,263371056,47389919,,0,0,0,,526742,263371056,47389919,PDN
DC621,,2005,2003,,607964,303981976,54697284,,0,0,0,,607964,303981976,54697284,PDN
DC621,,2006,2003,,607964,303981976,54697284,,0,0,0,,607964,303981976,54697284,PDN
DC621,,2007,2003,,218597,209696291,37531104,,2641,12366013,2202999,,215956,197330278,35328105,PDN
DC621,,2008,2003,,66590,209696301,37379099,,19458,59029312,10522894,,47132,150666989,26856205,PDN
DC621,,2009,2003,,51665,149932107,26729976,,39909,120480749,21477765,,11756,29451358,5252212,PDN
DC621,,2010,2003,,74043,280002309,49896518,,53799,164209660,29272600,,20244,115792649,20623918,PDN
DC621,,2011,2003,,71146,270792128,48254799,,62507,209078659,37265116,,8639,61713469,10989683,PDN
DC621,,2012,2003,,71148,272074995,48483069,,69784,257098808,45816903,,1364,14976187,2666166,PDN
DC621,,2013,2003,,71148,272074995,48483069,,71148,272074995,48483069,,0,0,0,PDN
DC621,,2014,2003,,71148,272074995,48483069,,71148,272074995,48483069,,0,0,0,PDN
DC621,,2015,2003,,71148,272074995,48483069,,71148,272074995,48483069,,0,0,0,PDN
DC621,,2016,2003,,71148,272074995,48483069,,71148,272074995,48483069,,0,0,0,PDN
DC621,,2017,2003,,71148,272074995,48483069,,71148,272074995,48483069,,0,0,0,PDN
DC621,,2017,2003,,71148,272074995,48483069,,71148,272074995,48483069,,0,0,0,PDN
EB109,,1977,1976,,5155300,160300000,33678432,,0,0,0,,5155300,160300000,33678432,PDN
EB109,,1978,1976,,149156,149156000,26689370,,0,0,0,,149156,149156000,26689370,PDN
EB109,,1979,1976,,149156,149156000,26689370,,0,0,0,,149156,149156000,26689370,PDN
EB109,,1980,1976,,149156,149156000,26689370,,0,0,0,,149156,149156000,26689370,PDN
EB109,,1981,1976,,149156,149156000,26689370,,0,0,0,,149156,149156000,26689370,PDN
EB109,,1982,1976,,149156,149156000,26689370,,0,0,0,,149156,149156000,26689370,PDN
EB109,,1983,1976,,149156,149156000,26689370,,0,0,0,,149156,149156000,26689370,PDN
EB109,,1984,1976,,149156,149156000,26689370,,0,0,0,,149156,149156000,26689370,PDN
EB109,,1985,1976,,487520,167998834,30380551,,127,8114,1571,,487393,167990720,30378980,PDN
EB109,,1986,1976,,487520,167998834,30380551,,127,8114,1571,,487393,167990720,30378980,PDN
EB109,,1987,1976,,487520,167998834,30380551,,16967,4310525,783964,,470553,163688309,29596587,PDN
EB109,,1988,1976,,756120,198626127,36098847,,131386,22338779,4106258,,624734,176287348,31992589,PDN
EB109,,1989,1976,,461011,198626127,35803738,,191126,36015622,6599600,,269885,162610505,29204138,PDN
EB109,,1990,1976,,433323,99271190,18097236,,224361,46918653,8572876,,208962,52352537,9524360,PDN
EB109,,1991,1976,,435520,99284516,18101804,,235832,52381504,9556384,,199688,46903012,8545420,PDN
EB109,,1992,1976,,453983,100860880,18400759,,280611,63950527,11659708,,173372,36910353,6741051,PDN
EB109,,1993,1976,,454759,104109188,18979526,,290801,68321910,12447724,,163958,35787278,6531802,PDN
EB109,,1994,1976,,454758,104109188,18979525,,297948,70639189,12867199,,156810,33469999,6112326,PDN
EB109,,1995,1976,,338263,91617977,16640394,,303861,74077961,13484993,,34402,17540016,3155401,PDN
EB109,,1996,1976,,338655,91587438,16635352,,308877,77095232,14026890,,29778,14492206,2608462,PDN
EB109,,1997,1976,,338655,91587438,16635352,,312945,79030530,14375317,,25710,12556908,2260035,PDN
EB109,,1998,1976,,328996,82934678,15086056,,315652,80142762,14575930,,13344,2791916,510126,PDN
EB109,,1999,1976,,328492,83038848,15104088,,320390,81001499,14733468,,8102,2037349,370620,PDN
EB109,,2000,1976,,387739,89427847,16300167,,327909,82176306,14950028,,59830,7251541,1350139,PDN
EB109,,2001,1976,,393854,91113645,16606246,,363408,86229666,15706765,,30446,4883979,899481,PDN
EB109,,2002,1976,,384887,92475726,16839643,,371554,87618996,15962123,,13333,4856730,877520,PDN
EB109,,2003,1976,,397466,94516762,17215395,,372091,88024937,16034891,,25375,6491825,1180504,PDN
EB109,,2004,1976,,396786,93057284,16955022,,371791,88522298,16123090,,24995,4534986,831932,PDN
EB109,,2005,1976,,371806,89566412,16308890,,371806,88812642,16174767,,0,753770,134123,PDN
EB109,,2006,1976,,371806,89566412,16308890,,371806,89074251,16221317,,0,492161,87573,PDN
EB109,,2007,1976,,371806,89566412,16308890,,371806,89167726,16237949,,0,398686,70941,PDN
EB109,,2008,1976,,371806,89175181,16239276,,371806,89175181,16239276,,0,0,0,PDN
EB109,,2009,1976,,371806,90775393,16524011,,371806,90775393,16524011,,0,0,0,PDN
EB109,,2010,1976,,371806,90775393,16524011,,371806,90775393,16524011,,0,0,0,PDN
EB109,,2011,1976,,371806,90775393,16524011,,371806,90775393,16524011,,0,0,0,PDN
EB109,,2012,1976,,371806,90775393,16524011,,371806,90775393,16524011,,0,0,0,PDN
EB109,,2013,1976,,371806,90775393,16524011,,371806,90775393,16524011,,0,0,0,PDN
EB109,,2014,1976,,371806,90775393,16524011,,371806,90775393,16524011,,0,0,0,PDN
EB109,,2015,1976,,371806,90775393,16524011,,371806,90775393,16524011,,0,0,0,PDN
EB109,,2016,1976,,371806,90775393,16524011,,371806,90775393,16524011,,0,0,0,PDN
EB109,,2017,1976,,371806,90775393,16524011,,371806,90775393,16524011,,0,0,0,PDN
EB109,,2017,1976,,371806,90775393,16524011,,371806,90775393,16524011,,0,0,0,PDN
EB112,,1993,1975,,514760,23141036,4632382,,0,0,0,,514760,23141036,4632382,PDN
EB112,,1994,1975,,513579,23087929,4621751,,0,0,0,,513579,23087929,4621751,PDN
EB112,,1995,1975,,513579,23087929,4621751,,0,0,0,,513579,23087929,4621751,PDN
EB112,,1996,1975,,3818277,14911905,6471641,,112628,484024,198753,,3705649,14427881,6272888,PDN
EB112,,1997,1975,,11166244,12841181,13451152,,652876,1037389,837465,,10513368,11803792,12613687,PDN
EB112,,1998,1975,,6012309,6823970,7226539,,1180978,1602119,1466053,,4831331,5221851,5760486,PDN
EB112,,1999,1975,,6012309,6823970,7226539,,1657247,2130497,2036339,,4355062,4693473,5190200,PDN
EB112,,2000,1975,,14515494,16602657,17469704,,2055686,2574669,2513812,,12459808,14027988,14955892,PDN
EB112,,2001,1975,,12012299,12676291,14267867,,2301316,2922816,2821390,,9710983,9753475,11446477,PDN
EB112,,2002,1975,,12012299,12676291,14267867,,2451164,3234581,3026712,,9561135,9441710,11241155,PDN
EB112,,2003,1975,,12012299,12676291,14267867,,2568945,3538056,3198492,,9443354,9138235,11069375,PDN
EB112,,2004,1975,,11581888,11521304,13631942,,2665464,3771702,3336585,,8916424,7749602,10295357,PDN
EB112,,2005,1975,,11581888,11521304,13631942,,2733977,3880154,3424396,,8847911,7641150,10207546,PDN
EB112,,2006,1975,,11581888,11553518,13637674,,2792474,3979566,3500582,,8789414,7573952,10137092,PDN
EB112,,2007,1975,,11581888,11553518,13637674,,2808261,3983545,3517077,,8773627,7569973,10120597,PDN
EB112,,2008,1975,,2928540,4211241,3677871,,2855358,4026858,3571881,,73182,184383,105990,PDN
EB112,,2009,1975,,2870243,4063369,3593262,,2870243,4063369,3593262,,0,0,0,PDN
EB112,,2010,1975,,2870243,4063369,3593262,,2870243,4063369,3593262,,0,0,0,PDN
EB112,,2011,1975,,2870243,4063369,3593262,,2870243,4063369,3593262,,0,0,0,PDN
EB112,,2012,1975,,2870243,4063369,3593262,,2870243,4063369,3593262,,0,0,0,PDN
EB112,,2013,1975,,2870243,4063369,3593262,,2870243,4063369,3593262,,0,0,0,PDN
EB112,,2014,1975,,2870243,4063369,3593262,,2870243,4063369,3593262,,0,0,0,PDN
EB112,,2015,1975,,2870243,4063369,3593262,,2870243,4063369,3593262,,0,0,0,PDN
EB112,,2016,1975,,2870243,4063369,3593262,,2870243,4063369,3593262,,0,0,0,PDN
EB112,,2017,1975,,2870243,4063369,3593262,,2870243,4063369,3593262,,0,0,0,PDN
EB112,,2017,1975,,2870243,4063369,3593262,,2870243,4063369,3593262,,0,0,0,PDN
EB157,,1993,1976,,1035737,46561524,9320706,,0,0,0,,1035737,46561524,9320706,PDP
EB157,,1994,1976,,1028094,46217940,9251927,,0,0,0,,1028094,46217940,9251927,PDP
EB157,,1995,1976,,1028094,46217940,9251927,,0,0,0,,1028094,46217940,9251927,PDP
EB157,,1996,1976,,766118,58254009,11131600,,7683,2339635,423988,,758435,55914374,10707612,PDP
EB157,,1997,1976,,364110,123797280,22392096,,22626,7369303,1333890,,341484,116427977,21058206,PDP
EB157,,1998,1976,,360308,123588276,22351105,,37339,12502589,2261999,,322969,111085687,20089106,PDP
EB157,,1999,1976,,360308,123588276,22351105,,51456,17715729,3203721,,308852,105872547,19147384,PDP
EB157,,2000,1976,,390768,134328724,24292676,,65674,22837661,4129315,,325094,111491063,20163361,PDP
EB157,,2001,1976,,396051,137611217,24882032,,78292,27378226,4949862,,317759,110232991,19932170,PDP
EB157,,2002,1976,,396051,137611217,24882032,,89237,31193005,5639594,,306814,106418212,19242438,PDP
EB157,,2003,1976,,406613,142432349,25750447,,96024,34364764,6210751,,310589,108067585,19539696,PDP
EB157,,2004,1976,,386043,145284756,26237423,,102361,37278293,6735509,,283682,108006463,19501914,PDP
EB157,,2005,1976,,295793,115385329,20826990,,109019,39875868,7204369,,186774,75509461,13622621,PDP
EB157,,2006,1976,,295793,115385329,20826990,,121001,45466407,8211109,,174792,69918922,12615881,PDP
EB157,,2007,1976,,266970,101356810,18301989,,122592,45884010,8287007,,144378,55472800,10014982,PDP
EB157,,2008,1976,,936445,49911440,9817484,,122683,46272469,8356218,,813762,3638971,1461266,PDP
EB157,,2009,1976,,932261,47889197,9453470,,341994,46897043,8686664,,590267,992154,766807,PDP
EB157,,2010,1976,,932261,47889197,9453470,,571299,47145163,8960118,,360962,744034,493352,PDP
EB157,,2011,1976,,932261,47889197,9453470,,645561,47198430,9043858,,286700,690767,409612,PDP
EB157,,2012,1976,,932261,47889197,9453470,,732027,47256212,9140606,,200234,632985,312865,PDP
EB157,,2013,1976,,932261,47889197,9453470,,776318,47312917,9194987,,155943,576280,258484,PDP
EB157,,2014,1976,,932261,47889197,9453470,,819790,47356495,9246213,,112471,532702,207258,PDP
EB157,,2015,1976,,932261,47481979,9381012,,851743,47392145,9284509,,80518,89834,96503,PDP
EB157,,2016,1976,,932261,47481979,9381012,,873430,47443459,9315327,,58831,38520,65685,PDP
EB157,,2017,1976,,932261,47537031,9390807,,889641,47472573,9336718,,42620,64458,54089,PDP
EB157,,2017,1976,,932261,47537031,9390807,,889641,47472573,9336718,,42620,64458,54089,PDP
EB158,,1981,1976,,3000,3000000,536808,,0,0,0,,3000,3000000,536808,PDP
EB158,,1982,1976,,3000,36743920,6541064,,0,0,0,,3000,36743920,6541064,PDP
EB158,,1983,1976,,964186,38635260,7838787,,0,0,0,,964186,38635260,7838787,PDP
EB158,,1984,1976,,964186,38635260,7838787,,0,0,0,,964186,38635260,7838787,PDP
EB158,,1985,1976,,4877596,52666970,14248943,,0,0,0,,4877596,52666970,14248943,PDP
EB158,,1986,1976,,4877596,52666970,14248943,,282526,593844,388192,,4595070,52073126,13860751,PDP
EB158,,1987,1976,,4875859,54659189,14601693,,775221,3417997,1383406,,4100638,51241192,13218287,PDP
EB158,,1988,1976,,4875859,54659189,14601693,,1393498,7503124,2728573,,3482361,47156065,11873120,PDP
EB158,,1989,1976,,7280877,67222343,19242148,,2281174,12817037,4561786,,4999703,54405306,14680362,PDP
EB158,,1990,1976,,7280461,67637581,19315618,,3171332,17466639,6279275,,4109129,50170942,13036343,PDP
EB158,,1991,1976,,8355277,67637581,20390434,,4187341,21371835,7990159,,4167936,46265746,12400275,PDP
EB158,,1992,1976,,9327971,58222341,19687818,,4909289,24075269,9193145,,4418682,34147072,10494673,PDP
EB158,,1993,1976,,9327971,58222341,19687818,,5363468,26455111,10070783,,3964503,31767230,9617035,PDP
EB158,,1994,1976,,9598973,63234354,20850637,,5750466,29453831,10991361,,3848507,33780523,9859276,PDP
EB158,,1995,1976,,9675413,63616553,20995084,,6065240,31740676,11713047,,3610173,31875877,9282037,PDP
EB158,,1996,1976,,11076397,75507591,24511911,,7310461,37371256,13960151,,3765936,38136335,10551760,PDP
EB158,,1997,1976,,12989125,85017234,28116747,,7706803,39393307,14716288,,5282322,45623927,13400459,PDP
EB158,,1998,1976,,13459845,89904940,29457165,,8225059,49931850,17109730,,5234786,39973090,12347435,PDP
EB158,,1999,1976,,14537217,136297560,38789452,,8884228,67882766,20963012,,5652989,68414794,17826440,PDP
EB158,,2000,1976,,14475368,171900086,45062572,,10057900,86242777,25403590,,4417468,85657309,19658982,PDP
EB158,,2001,1976,,12609957,131588305,36024246,,10977268,97950377,28406161,,1632689,33637928,7618085,PDP
EB158,,2002,1976,,13725412,176411856,45115422,,11696413,113756581,31937798,,2028999,62655275,13177624,PDP
EB158,,2003,1976,,14361568,192487385,48611992,,12275737,129459189,35311180,,2085831,63028196,13300812,PDP
EB158,,2004,1976,,14429285,194872309,49104073,,12781216,142271814,38096485,,1648069,52600495,11007588,PDP
EB158,,2005,1976,,14910981,181834411,47265858,,13188837,151246072,40100949,,1722144,30588339,7164909,PDP
EB158,,2006,1976,,14950119,185854335,48020285,,13472274,157416191,41482272,,1477845,28438144,6538013,PDP
EB158,,2007,1976,,15645178,185459916,48645163,,13639382,161488213,42373939,,2005796,23971703,6271224,PDP
EB158,,2008,1976,,15463388,190770815,49408373,,13730847,164209631,42949643,,1732541,26561184,6458730,PDP
EB158,,2009,1976,,15005060,185542573,48019753,,13938094,169966002,44181156,,1066966,15576571,3838598,PDP
EB158,,2010,1976,,15005060,185542573,48019753,,14085040,173598021,44974368,,920020,11944552,3045385,PDP
EB158,,2011,1976,,15005060,185542573,48019753,,14131437,175316684,45326577,,873623,10225889,2693175,PDP
EB158,,2012,1976,,15005060,185542573,48019753,,14230567,177108991,45744623,,774493,8433582,2275132,PDP
EB158,,2013,1976,,15005060,185542573,48019753,,14262676,177953397,45926983,,742384,7589176,2092771,PDP
EB158,,2014,1976,,14894162,182302081,47332256,,14320871,178599656,46100170,,573291,3702425,1232085,PDP
EB158,,2015,1976,,14923112,182859687,47460425,,14373946,179288758,46275863,,549166,3570929,1184564,PDP
EB158,,2016,1976,,14919441,183733808,47612291,,14442439,180472883,46555053,,477002,3260925,1057237,PDP
EB158,,2017,1976,,14664379,184591193,47509788,,14491978,181290445,46750064,,172401,3300748,759724,PDP
EB158,,2017,1976,,14664379,184591193,47509788,,14491978,181290445,46750064,,172401,3300748,759724,PDP
EB160,,1976,1976,,1699999,804200000,144796084,,0,0,0,,1699999,804200000,144796084,PDP
EB160,,1977,1976,,17865390,160300440,46388600,,0,0,0,,17865390,160300440,46388600,PDP
EB160,,1978,1976,,17865390,160300440,46388600,,0,0,0,,17865390,160300440,46388600,PDP
EB160,,1979,1976,,17865390,160300440,46388600,,0,0,0,,17865390,160300440,46388600,PDP
EB160,,1980,1976,,17865390,160300440,46388600,,0,0,0,,17865390,160300440,46388600,PDP
EB160,,1981,1976,,17865390,160300440,46388600,,0,0,0,,17865390,160300440,46388600,PDP
EB160,,1982,1976,,17361266,125899980,39763398,,0,0,0,,17361266,125899980,39763398,PDP
EB160,,1983,1976,,23263433,141287017,48403472,,0,0,0,,23263433,141287017,48403472,PDP
EB160,,1984,1976,,23263433,141287017,48403472,,0,0,0,,23263433,141287017,48403472,PDP
EB160,,1985,1976,,27578119,152364018,54689154,,0,0,0,,27578119,152364018,54689154,PDP
EB160,,1986,1976,,27294741,165068643,56666386,,0,0,0,,27294741,165068643,56666386,PDP
EB160,,1987,1976,,27812620,165068643,57184265,,1186945,3177637,1752361,,26625675,161891006,55431904,PDP
EB160,,1988,1976,,13296049,83275737,28113796,,2639468,13665965,5071134,,10656581,69609772,23042662,PDP
EB160,,1989,1976,,11683944,90299689,27751504,,3853187,23727235,8075115,,7830757,66572454,19676389,PDP
EB160,,1990,1976,,11710119,91718635,28030161,,4800223,30046478,10146571,,6909896,61672157,17883590,PDP
EB160,,1991,1976,,12539229,79814154,26741036,,5693056,34102348,11761089,,6846173,45711806,14979947,PDP
EB160,,1992,1976,,10082180,59295567,20632993,,6374798,38073447,13149433,,3707382,21222120,7483560,PDP
EB160,,1993,1976,,10368888,60043110,21052715,,7061661,40459104,14260790,,3307227,19584006,6791925,PDP
EB160,,1994,1976,,10431567,60531097,21202225,,7708587,42681336,15303131,,2722980,17849761,5899094,PDP
EB160,,1995,1976,,10778777,62179048,21842665,,8302239,45268223,16357083,,2476538,16910825,5485582,PDP
EB160,,1996,1976,,12108099,85803509,27375627,,7988038,46091957,16189454,,4120061,39711552,11186173,PDP
EB160,,1997,1976,,13007691,90843795,29172067,,8539991,53654466,18087049,,4467700,37189329,11085018,PDP
EB160,,1998,1976,,13129733,91026190,29326564,,8997817,58738275,19449467,,4131916,32287915,9877097,PDP
EB160,,1999,1976,,12723667,88026365,28386721,,9358341,62369018,20456031,,3365326,25657347,7930690,PDP
EB160,,2000,1976,,11814108,94715097,28667328,,9892927,69054558,22180215,,1921181,25660539,6487113,PDP
EB160,,2001,1976,,11561814,93822772,28256257,,10282119,72455001,23174468,,1279695,21367771,5081789,PDP
EB160,,2002,1976,,11606226,93774254,28292036,,10648006,75811392,24137578,,958220,17962862,4154458,PDP
EB160,,2003,1976,,11735271,92582225,28208977,,10934906,78299574,24867215,,800365,14282651,3341762,PDP
EB160,,2004,1976,,12458303,92839465,28977781,,11170226,82422210,25836100,,1288077,10417255,3141681,PDP
EB160,,2005,1976,,16313925,104206087,34855933,,11736239,87641490,27330810,,4577686,16564597,7525123,PDP
EB160,,2006,1976,,16873279,104981395,35553243,,12524859,90048999,28547813,,4348420,14932396,7005430,PDP
EB160,,2007,1976,,17011588,108486915,36315310,,13129114,91293222,29373460,,3882474,17193693,6941850,PDP
EB160,,2008,1976,,16866998,109947901,36430681,,13415275,91833213,29755704,,3451723,18114688,6674977,PDP
EB160,,2009,1976,,15116837,98142830,32579975,,13768467,93976165,30490205,,1348370,4166665,2089770,PDP
EB160,,2010,1976,,15116837,98142830,32579975,,14011757,94710676,30864191,,1105080,3432154,1715784,PDP
EB160,,2011,1976,,15116837,98142830,32579975,,14203616,95258983,31153615,,913221,2883847,1426359,PDP
EB160,,2012,1976,,15116837,98142830,32579975,,14355706,95694665,31383228,,761131,2448165,1196747,PDP
EB160,,2013,1976,,15129491,98142830,32592629,,14467238,95970668,31543871,,662253,2172162,1048759,PDP
EB160,,2014,1976,,15168696,98238835,32648917,,14561477,96174590,31674395,,607219,2064245,974522,PDP
EB160,,2015,1976,,15074947,98121875,32534357,,14634456,96308439,31771190,,440491,1813436,763168,PDP
EB160,,2016,1976,,14995435,97737254,32386407,,14722221,96479838,31889453,,273214,1257416,496954,PDP
EB160,,2017,1976,,14996570,97725921,32385525,,14791239,96691704,31996169,,205331,1034217,389356,PDP
EB160,,2017,1976,,14996570,97725921,32385525,,14791239,96691704,31996169,,205331,1034217,389356,PDP
EB165,,1986,1984,,13521122,38648736,20398121,,0,0,0,,13521122,38648736,20398121,PDP
EB165,,1987,1984,,16536616,40302376,23707857,,2511523,3444564,3124435,,14025093,36857812,20583422,PDP
EB165,,1988,1984,,18778914,51518926,27945983,,8023346,13204136,10372836,,10755568,38314790,17573147,PDP
EB165,,1989,1984,,32703479,76837935,46375709,,12996328,27111199,17820385,,19707151,49726736,28555324,PDP
EB165,,1990,1984,,30633611,94485850,47446040,,17217853,39538026,24253089,,13415758,54947824,23192951,PDP
EB165,,1991,1984,,30905251,103883581,49389874,,19960270,52342434,29273870,,10944981,51541147,20116004,PDP
EB165,,1992,1984,,30932253,104709007,49563749,,21809708,59654965,32424470,,9122545,45054042,17139279,PDP
EB165,,1993,1984,,31684596,110789755,51398076,,23354950,67009180,35278292,,8329646,43780575,16119784,PDP
EB165,,1994,1984,,33041227,116712952,53808656,,24586957,71724814,37349379,,8454270,44988138,16459277,PDP
EB165,,1995,1984,,32089475,109122171,51506231,,25566199,74143587,38759008,,6523276,34978584,12747223,PDP
EB165,,1996,1984,,31333137,106581800,50297870,,26390027,76476393,39997926,,4943110,30105407,10299944,PDP
EB165,,1997,1984,,31803918,107034451,50849194,,27217263,78200173,41131885,,4586655,28834278,9717309,PDP
EB165,,1998,1984,,31886123,109452592,51361673,,27945229,79399920,42073329,,3940894,30052672,9288344,PDP
EB165,,1999,1984,,33606793,118178294,54634959,,28799624,81963827,43383935,,4807169,36214467,11251024,PDP
EB165,,2000,1984,,34580273,118912111,55739011,,29414856,83627306,44295160,,5165417,35284805,11443851,PDP
EB165,,2001,1984,,35545326,129631064,58611352,,29853384,85377712,45045148,,5691942,44253352,13566204,PDP
EB165,,2002,1984,,34666225,123824932,56699131,,30225172,87842126,45855444,,4441053,35982806,10843687,PDP
EB165,,2003,1984,,35246895,124062000,57321984,,30566749,88490898,46312460,,4680146,35571102,11009524,PDP
EB165,,2004,1984,,35319300,108718190,54664173,,30875407,89009974,46713481,,4443893,19708216,7950692,PDP
EB165,,2005,1984,,35317992,108703262,54660209,,31083270,89283641,46970039,,4234722,19419621,7690170,PDP
EB165,,2006,1984,,35323465,108986290,54716043,,31417049,89853779,47405266,,3906416,19132511,7310777,PDP
EB165,,2007,1984,,35821219,109770147,55353273,,31637397,90335745,47711373,,4183822,19434402,7641900,PDP
EB165,,2008,1984,,34618503,99637931,52347672,,31874288,90632950,48001147,,2744215,9004981,4346525,PDP
EB165,,2009,1984,,34625470,100624165,52530126,,32186126,93930178,48899682,,2439344,6693987,3630446,PDP
EB165,,2010,1984,,34779917,102218533,52968270,,32435332,95238723,49381722,,2344585,6979810,3586543,PDP
EB165,,2011,1984,,34787840,102279695,52987074,,32617445,96013615,49701717,,2170395,6266080,3285356,PDP
EB165,,2012,1984,,34787840,102279695,52987074,,32741977,96568175,49924924,,2045863,5711520,3062149,PDP
EB165,,2013,1984,,34784142,101546245,52852869,,32872662,97029114,50137628,,1911480,4517131,2715241,PDP
EB165,,2014,1984,,34784142,101546245,52852869,,32968727,97228900,50269241,,1815415,4317345,2583625,PDP
EB165,,2015,1984,,34659238,101427696,52706870,,33041219,97322730,50358429,,1618019,4104966,2348441,PDP
EB165,,2016,1984,,34874009,101448642,52925368,,33131109,97471597,50474807,,1742900,3977045,2450560,PDP
EB165,,2017,1984,,34847626,101488854,52906140,,33208743,97604094,50576017,,1638883,3884760,2330121,PDP
EB165,,2017,1984,,34847626,101488854,52906140,,33208743,97604094,50576017,,1638883,3884760,2330121,PDP
EB168,,1997,1997,,245,7779546,1384506,,0,0,0,,245,7779546,1384506,PDN
EB168,,1998,1997,,20,7779546,1384281,,8,3337795,593922,,12,4441751,790359,PDN
EB168,,1999,1997,,32,20931123,3724431,,8,6945116,1235794,,24,13986007,2488637,PDN
EB168,,2000,1997,,32,20931123,3724431,,8,10095444,1796350,,24,10835679,1928081,PDN
EB168,,2001,1997,,116,18441643,3281547,,8,11343682,2018457,,108,7097961,1263090,PDN
EB168,,2002,1997,,108,18834784,3351493,,8,11677712,2077893,,100,7157072,1273600,PDN
EB168,,2003,1997,,108,18834784,3351493,,8,13738780,2444631,,100,5096004,906862,PDN
EB168,,2004,1997,,8,19431207,3457518,,8,15687201,2791325,,0,3744006,666193,PDN
EB168,,2005,1997,,8,19431207,3457518,,8,16805027,2990226,,0,2626180,467292,PDN
EB168,,2006,1997,,8,19431207,3457518,,8,17870662,3179841,,0,1560545,277677,PDN
EB168,,2007,1997,,8,18684261,3324610,,8,18684261,3324610,,0,0,0,PDN
EB168,,2008,1997,,8,18684261,3324610,,8,18684261,3324610,,0,0,0,PDN
EB168,,2009,1997,,8,18727448,3332294,,8,18727448,3332294,,0,0,0,PDN
EB168,,2010,1997,,8,18727448,3332294,,8,18727448,3332294,,0,0,0,PDN
EB168,,2011,1997,,8,18727448,3332294,,8,18727448,3332294,,0,0,0,PDN
EB168,,2012,1997,,8,18727448,3332294,,8,18727448,3332294,,0,0,0,PDN
EB168,,2013,1997,,8,18727448,3332294,,8,18727448,3332294,,0,0,0,PDN
EB168,,2014,1997,,8,18727448,3332294,,8,18727448,3332294,,0,0,0,PDN
EB168,,2015,1997,,8,18727448,3332294,,8,18727448,3332294,,0,0,0,PDN
EB168,,2016,1997,,8,18727448,3332294,,8,18727448,3332294,,0,0,0,PDN
EB168,,2017,1997,,8,18727448,3332294,,8,18727448,3332294,,0,0,0,PDN
EB168,,2017,1997,,8,18727448,3332294,,8,18727448,3332294,,0,0,0,PDN
EB205,,2001,2001,,1645091,9084156,3261489,,57251,563246,157473,,1587840,8520910,3104016,PDN
EB205,,2002,2001,,1645280,9090757,3262852,,648492,5622854,1649000,,996788,3467903,1613852,PDN
EB205,,2003,2001,,1645280,9090757,3262852,,905719,6883500,2130541,,739561,2207257,1132311,PDN
EB205,,2004,2001,,2793567,10265635,4620192,,1249056,7686590,2616777,,1544511,2579045,2003415,PDN
EB205,,2005,2001,,2027021,8935077,3616892,,1486716,8094459,2927011,,540305,840618,689881,PDN
EB205,,2006,2001,,2027021,8959786,3621289,,1649015,8346456,3134150,,378006,613330,487139,PDN
EB205,,2007,2001,,1991577,8787637,3555213,,1672278,8422866,3171009,,319299,364771,384204,PDN
EB205,,2008,2001,,1991577,8787637,3555213,,1758166,8492351,3269260,,233411,295286,285953,PDN
EB205,,2009,2001,,1991340,8743129,3547057,,1837496,8598117,3367410,,153844,145012,179647,PDN
EB205,,2010,2001,,1991340,8743129,3547057,,1837496,8602768,3368238,,153844,140361,178819,PDN
EB205,,2011,2001,,1991340,8743129,3547057,,1844310,8609485,3376247,,147030,133644,170810,PDN
EB205,,2012,2001,,1991340,8743129,3547057,,1844354,8610251,3376427,,146986,132878,170630,PDN
EB205,,2013,2001,,1991340,8743129,3547057,,1844354,8610251,3376427,,146986,132878,170630,PDN
EB205,,2014,2001,,1991340,8743129,3547057,,1844354,8610251,3376427,,146986,132878,170630,PDN
EB205,,2015,2001,,1844354,8610251,3376427,,1844354,8610251,3376427,,0,0,0,PDN
EB205,,2016,2001,,1844354,8610251,3376427,,1844354,8610251,3376427,,0,0,0,PDN
EB205,,2017,2001,,1844354,8610251,3376427,,1844354,8610251,3376427,,0,0,0,PDN
EB205,,2017,2001,,1844354,8610251,3376427,,1844354,8610251,3376427,,0,0,0,PDN
EB421,,2001,2001,,60486,49822597,8925717,,0,0,0,,60486,49822597,8925717,PDN
EB421,,2002,2001,,51043,49766928,8906368,,7866,6396760,1146080,,43177,43370168,7760288,PDN
EB421,,2003,2001,,51043,49766928,8906368,,20133,17597150,3151298,,30910,32169778,5755070,PDN
EB421,,2004,2001,,37138,50109178,8953362,,24848,25450841,4553467,,12290,24658337,4399895,PDN
EB421,,2005,2001,,42221,50664273,9057216,,25965,29852565,5337809,,16256,20811708,3719407,PDN
EB421,,2006,2001,,42199,50637887,9052499,,28424,33575872,6002778,,13775,17062015,3049721,PDN
EB421,,2007,2001,,39480,47011930,8404592,,30868,35544528,6355517,,8612,11467402,2049075,PDN
EB421,,2008,2001,,47858,40198624,7200638,,46186,39795383,7127215,,1672,403241,73423,PDN
EB421,,2009,2001,,47858,40198624,7200638,,47858,40198624,7200638,,0,0,0,PDN
EB421,,2010,2001,,47858,40198624,7200638,,47858,40198624,7200638,,0,0,0,PDN
EB421,,2011,2001,,47858,40198624,7200638,,47858,40198624,7200638,,0,0,0,PDN
EB421,,2012,2001,,47858,40198624,7200638,,47858,40198624,7200638,,0,0,0,PDN
EB421,,2013,2001,,47858,40198624,7200638,,47858,40198624,7200638,,0,0,0,PDN
EB421,,2014,2001,,47858,40198624,7200638,,47858,40198624,7200638,,0,0,0,PDN
EB421,,2015,2001,,47858,40198624,7200638,,47858,40198624,7200638,,0,0,0,PDN
EB421,,2016,2001,,47858,40198624,7200638,,47858,40198624,7200638,,0,0,0,PDN
EB421,,2017,2001,,47858,40198624,7200638,,47858,40198624,7200638,,0,0,0,PDN
EB421,,2017,2001,,47858,40198624,7200638,,47858,40198624,7200638,,0,0,0,PDN
EB430,,1999,2000,,248592,24859225,4671942,,0,0,0,,248592,24859225,4671942,PDP
EB430,,2000,2000,,248592,24859225,4671942,,0,0,0,,248592,24859225,4671942,PDP
EB430,,2001,2000,,99160,9915941,1863562,,0,0,0,,99160,9915941,1863562,PDP
EB430,,2002,2000,,99160,9915941,1863562,,0,0,0,,99160,9915941,1863562,PDP
EB430,,2003,2000,,99160,9915941,1863562,,0,0,0,,99160,9915941,1863562,PDP
EB430,,2004,2000,,2017051,4659370,2846120,,0,0,0,,2017051,4659370,2846120,PDP
EB430,,2005,2000,,2345681,7983008,3766145,,0,0,0,,2345681,7983008,3766145,PDP
EB430,,2006,2000,,2345681,8245868,3812917,,426711,787648,566862,,1918970,7458220,3246055,PDP
EB430,,2007,2000,,2345681,8245868,3812917,,1235052,1830394,1560745,,1110629,6415474,2252172,PDP
EB430,,2008,2000,,3463638,7279604,4758941,,1698704,2351235,2117073,,1764934,4928369,2641868,PDP
EB430,,2009,2000,,4656453,8998912,6257683,,2000853,2522733,2449738,,2655600,6476179,3807945,PDP
EB430,,2010,2000,,4656453,8998912,6257683,,2365304,2731316,2851303,,2291149,6267596,3406379,PDP
EB430,,2011,2000,,4656453,8998912,6257683,,2828115,3157564,3389959,,1828338,5841348,2867723,PDP
EB430,,2012,2000,,4656453,8998912,6257683,,3411358,3702148,4070103,,1245095,5296764,2187579,PDP
EB430,,2013,2000,,4656453,8998912,6257683,,4008938,4199384,4756159,,647515,4799528,1501523,PDP
EB430,,2014,2000,,5430046,9426297,7107323,,4469076,4584915,5284897,,960970,4841382,1822426,PDP
EB430,,2015,2000,,5430046,9426297,7107323,,4723764,4824244,5582170,,706282,4602053,1525152,PDP
EB430,,2016,2000,,6259166,9921262,8024515,,5046330,5158760,5964259,,1212836,4762502,2060256,PDP
EB430,,2017,2000,,6259166,9921262,8024515,,5622828,5832609,6660659,,636338,4088653,1363856,PDP
EB430,,2017,2000,,6259166,9921262,8024515,,5622828,5832609,6660659,,636338,4088653,1363856,PDP
EB579,,2001,2001,,980847,259523464,47159399,,0,0,0,,980847,259523464,47159399,PDN
EB579,,2002,2001,,886242,241501001,43857950,,0,0,0,,886242,241501001,43857950,PDN
EB579,,2003,2001,,720087,223444929,40478971,,202119,52288402,9506105,,517968,171156527,30972866,PDN
EB579,,2004,2001,,581512,236303038,42628316,,365331,106721515,19354924,,216181,129581523,23273392,PDN
EB579,,2005,2001,,589185,265093878,47758914,,450446,150197168,27175921,,138739,114896710,20582993,PDN
EB579,,2006,2001,,589185,265093878,47758914,,505887,192269394,34717523,,83298,72824484,13041391,PDN
EB579,,2007,2001,,589185,265093878,47758914,,535499,218618048,39435508,,53686,46475830,8323406,PDN
EB579,,2008,2001,,589185,265093878,47758914,,553005,234045791,42198164,,36180,31048087,5560750,PDN
EB579,,2009,2001,,581761,268045472,48276685,,558076,238839429,43056194,,23685,29206043,5220489,PDN
EB579,,2010,2001,,581761,268045472,48276685,,562879,243431055,43878013,,18882,24614417,4398672,PDN
EB579,,2011,2001,,581761,268045472,48276685,,565708,246577175,44440650,,16053,21468297,3836035,PDN
EB579,,2012,2001,,581761,268045472,48276685,,568681,250629572,45164690,,13080,17415900,3111994,PDN
EB579,,2013,2001,,581761,268045472,48276685,,568694,250686089,45174759,,13067,17359383,3101925,PDN
EB579,,2014,2001,,581761,268045472,48276685,,571522,254304809,45821488,,10239,13740663,2455197,PDN
EB579,,2015,2001,,581761,268045472,48276685,,572895,257964946,46474130,,8866,10080526,1802554,PDN
EB579,,2016,2001,,573241,258596603,46586871,,573241,258596603,46586871,,0,0,0,PDN
EB579,,2017,2001,,573251,258596605,46586882,,573251,258596605,46586882,,0,0,0,PDN
EB579,,2017,2001,,573251,258596605,46586882,,573251,258596605,46586882,,0,0,0,PDN
EB597,,2001,2001,,3586430,7401055,4903344,,0,0,0,,3586430,7401055,4903344,PDP
EB597,,2002,2001,,3586430,7401055,4903344,,0,0,0,,3586430,7401055,4903344,PDP
EB597,,2003,2001,,3586430,7401055,4903344,,0,0,0,,3586430,7401055,4903344,PDP
EB597,,2004,2001,,3586430,7401055,4903344,,0,0,0,,3586430,7401055,4903344,PDP
EB597,,2005,2001,,3586430,7401055,4903344,,0,0,0,,3586430,7401055,4903344,PDP
EB597,,2006,2001,,3586430,7401055,4903344,,0,0,0,,3586430,7401055,4903344,PDP
EB597,,2007,2001,,3586430,7401055,4903344,,0,0,0,,3586430,7401055,4903344,PDP
EB597,,2008,2001,,3508231,6426679,4651768,,0,0,0,,3508231,6426679,4651768,PDP
EB597,,2009,2001,,4493539,6207357,5598051,,0,0,0,,4493539,6207357,5598051,PDP
EB597,,2010,2001,,4493539,6207357,5598051,,1566,48726,10236,,4491973,6158631,5587815,PDP
EB597,,2011,2001,,4493539,6207357,5598051,,614932,2664182,1088986,,3878607,3543175,4509065,PDP
EB597,,2012,2001,,4493539,6207357,5598051,,1467845,3380698,2069393,,3025694,2826659,3528658,PDP
EB597,,2013,2001,,4493539,6207357,5598051,,2330456,4092541,3058666,,2163083,2114816,2539385,PDP
EB597,,2014,2001,,4493539,6207357,5598051,,3058817,4700720,3895244,,1434722,1506637,1702807,PDP
EB597,,2015,2001,,4493539,6207357,5598051,,3664721,5336769,4614324,,828818,870588,983727,PDP
EB597,,2016,2001,,5184530,7030051,6435429,,4185858,5960631,5246468,,998672,1069420,1188960,PDP
EB597,,2017,2001,,5184530,7030051,6435429,,4561617,6382527,5697298,,622913,647524,738131,PDP
EB597,,2017,2001,,5184530,7030051,6435429,,4561617,6382527,5697298,,622913,647524,738131,PDP
EB602,,1999,1999,,39465574,417934406,113831127,,0,0,0,,39465574,417934406,113831127,PDP
EB602,,2000,1999,,58364534,567765457,159390416,,0,0,0,,58364534,567765457,159390416,PDP
EB602,,2001,1999,,70708563,674534629,190732518,,14199,0,14199,,70694364,674534629,190718319,PDP
EB602,,2002,1999,,64531309,683874617,186217184,,5880714,34166243,11960117,,58650595,649708374,174257067,PDP
EB602,,2003,1999,,69991970,713282283,196910526,,16644953,102061451,34805354,,53347017,611220832,162105172,PDP
EB602,,2004,1999,,70013668,692761906,193280911,,28450522,159887127,56900189,,41563146,532874779,136380722,PDP
EB602,,2005,1999,,81987584,742411483,214089271,,37514904,227182730,77938877,,44472680,515228753,136150394,PDP
EB602,,2006,1999,,83814942,739710758,215436073,,45156097,288819977,96547552,,38658845,450890781,118888521,PDP
EB602,,2007,1999,,79208404,534857695,174378812,,50409097,320977616,107522552,,28799307,213880079,66856260,PDP
EB602,,2008,1999,,90959218,628985895,202878416,,56387906,372320400,122637087,,34571312,256665495,80241329,PDP
EB602,,2009,1999,,91394990,683044815,212933211,,60458438,407276372,132927544,,30936552,275768443,80005671,PDP
EB602,,2010,1999,,91394990,683044815,212933211,,63229113,433035943,140281771,,28165877,250008872,72651441,PDP
EB602,,2011,1999,,90852121,671920183,210410870,,65737292,453096185,146359388,,25114829,218823998,64051481,PDP
EB602,,2012,1999,,90296482,661886569,208069890,,68628090,484938900,154916150,,21668392,176947669,53153743,PDP
EB602,,2013,1999,,89036795,625443875,200325739,,70545210,510575702,161394978,,18491585,114868173,38930763,PDP
EB602,,2014,1999,,78268137,589080584,183086745,,71839612,526453696,165514646,,6428525,62626888,17572097,PDP
EB602,,2015,1999,,78372100,589377803,183243594,,73051407,538338199,168841120,,5320693,51039604,14402473,PDP
EB602,,2016,1999,,77420741,586973905,181864494,,73979108,547922571,171474225,,3441633,39051334,10390268,PDP
EB602,,2017,1999,,77412819,586820600,181829294,,74533807,555228641,173328937,,2879012,31591959,8500355,PDP
EB602,,2017,1999,,77412819,586820600,181829294,,74533807,555228641,173328937,,2879012,31591959,8500355,PDP
EB642,,1999,1999,,39606,3960638,744346,,0,0,0,,39606,3960638,744346,PDP
EB642,,2000,1999,,56316,5631622,1058384,,0,0,0,,56316,5631622,1058384,PDP
EB642,,2001,1999,,56514,5651433,1062107,,368,0,368,,56146,5651433,1061739,PDP
EB642,,2002,1999,,1252676,40998778,8547832,,174000,5366327,1128862,,1078676,35632451,7418970,PDP
EB642,,2003,1999,,1744617,68420663,13919112,,388714,14315517,2935959,,1355903,54105146,10983153,PDP
EB642,,2004,1999,,1486809,68420663,13661304,,519683,22307577,4489003,,967126,46113086,9172301,PDP
EB642,,2005,1999,,829716,58576359,11252556,,565508,27414131,5443467,,264208,31162228,5809089,PDP
EB642,,2006,1999,,829716,58576359,11252556,,592928,30637881,6044508,,236788,27938478,5208048,PDP
EB642,,2007,1999,,622730,34716122,6799976,,608888,32882689,6459900,,13842,1833433,340076,PDP
EB642,,2008,1999,,697660,44844138,8677044,,631630,35903062,7020075,,66030,8941076,1656969,PDP
EB642,,2009,1999,,710237,45726230,8846577,,639607,37791992,7364161,,70630,7934238,1482416,PDP
EB642,,2010,1999,,710237,45726230,8846577,,639982,38489524,7488652,,70255,7236706,1357925,PDP
EB642,,2011,1999,,710237,45726230,8846577,,641108,40034761,7764731,,69129,5691469,1081846,PDP
EB642,,2012,1999,,710237,45726230,8846577,,641108,40509227,7849156,,69129,5217003,997421,PDP
EB642,,2013,1999,,710237,45726230,8846577,,641108,41650576,8052243,,69129,4075654,794335,PDP
EB642,,2014,1999,,710237,45726230,8846577,,641108,42138527,8139067,,69129,3587703,707510,PDP
EB642,,2015,1999,,645666,42518218,8211185,,641108,42193895,8148919,,4558,324323,62267,PDP
EB642,,2016,1999,,645666,42518218,8211185,,641115,42141072,8139527,,4551,377146,71658,PDP
EB642,,2017,1999,,645666,42518218,8211185,,641115,42231008,8155529,,4551,287210,55656,PDP
EB642,,2017,1999,,645666,42518218,8211185,,641115,42231008,8155529,,4551,287210,55656,PDP
EB643,,1998,1997,,34886645,69773290,47301821,,0,0,0,,34886645,69773290,47301821,PDP
EB643,,1999,1997,,7445516,67681584,19488502,,0,0,0,,7445516,67681584,19488502,PDP
EB643,,2000,1997,,12085015,49232088,20845173,,0,0,0,,12085015,49232088,20845173,PDP
EB643,,2001,1997,,35117515,75404221,48534636,,0,0,0,,35117515,75404221,48534636,PDP
EB643,,2002,1997,,35113326,75359676,48522521,,2134233,2236678,2532218,,32979093,73122998,45990303,PDP
EB643,,2003,1997,,35113326,75359676,48522521,,13925603,18857664,17281059,,21187723,56502012,31241462,PDP
EB643,,2004,1997,,53324926,87789538,68945840,,24826743,34531321,30971106,,28498183,53258217,37974734,PDP
EB643,,2005,1997,,53324926,87789538,68945840,,35963636,47997805,44504171,,17361290,39791733,24441669,PDP
EB643,,2006,1997,,55875209,89147694,71737788,,43167004,55522080,53046378,,12708205,33625614,18691410,PDP
EB643,,2007,1997,,73924656,106428153,92862050,,51543205,63992216,62929720,,22381451,42435937,29932330,PDP
EB643,,2008,1997,,83633544,113992587,103916922,,59079572,71350547,71775399,,24553972,42642040,32141523,PDP
EB643,,2009,1997,,91706057,121953430,113405955,,66098298,78401142,80048682,,25607759,43552288,33357276,PDP
EB643,,2010,1997,,91706057,121953430,113405955,,70582331,82944107,85341069,,21123726,39009323,28064888,PDP
EB643,,2011,1997,,91266462,121383951,112865030,,74269817,87191098,89784247,,16996645,34192853,23080782,PDP
EB643,,2012,1997,,85562356,113919796,105832783,,76579469,89541008,92512033,,8982887,24378788,13320750,PDP
EB643,,2013,1997,,85562356,113919796,105832783,,78522062,91902817,94874874,,7040294,22016979,10957905,PDP
EB643,,2014,1997,,85928458,114218896,106252106,,80181240,94482196,96993019,,5747218,19736700,9259086,PDP
EB643,,2015,1997,,85928458,114141531,106238340,,81523600,96571670,98707172,,4404858,17569861,7531167,PDP
EB643,,2016,1997,,85533163,115139137,106020553,,82546073,98007329,99985099,,2987090,17131808,6035453,PDP
EB643,,2017,1997,,86383688,118487410,107466856,,83367001,99088652,100998432,,3016687,19398758,6468424,PDP
EB643,,2017,1997,,86383688,118487410,107466856,,83367001,99088652,100998432,,3016687,19398758,6468424,PDP
EB668,,2003,2003,,68900,20125144,3649886,,0,0,0,,68900,20125144,3649886,PDN
EB668,,2004,2003,,47017,13768325,2496897,,29254,8827935,1600061,,17763,4940390,896836,PDN
EB668,,2005,2003,,44852,13134416,2381937,,44852,13134416,2381937,,0,0,0,PDN
EB668,,2006,2003,,44852,13134416,2381937,,44852,13134416,2381937,,0,0,0,PDN
EB668,,2007,2003,,44852,13134416,2381937,,44852,13134416,2381937,,0,0,0,PDN
EB668,,2008,2003,,44852,13134416,2381937,,44852,13134416,2381937,,0,0,0,PDN
EB668,,2009,2003,,44852,13134416,2381937,,44852,13134416,2381937,,0,0,0,PDN
EB668,,2010,2003,,44852,13134416,2381937,,44852,13134416,2381937,,0,0,0,PDN
EB668,,2011,2003,,44852,13134416,2381937,,44852,13134416,2381937,,0,0,0,PDN
EB668,,2012,2003,,44852,13134416,2381937,,44852,13134416,2381937,,0,0,0,PDN
EB668,,2013,2003,,44852,13134416,2381937,,44852,13134416,2381937,,0,0,0,PDN
EB668,,2014,2003,,44852,13134416,2381937,,44852,13134416,2381937,,0,0,0,PDN
EB668,,2015,2003,,44852,13134416,2381937,,44852,13134416,2381937,,0,0,0,PDN
EB668,,2016,2003,,44852,13134416,2381937,,44852,13134416,2381937,,0,0,0,PDN
EB668,,2017,2003,,44852,13134416,2381937,,44852,13134416,2381937,,0,0,0,PDN
EB668,,2017,2003,,44852,13134416,2381937,,44852,13134416,2381937,,0,0,0,PDN
EB688,,1993,1988,,1987547,99377337,19670347,,0,0,0,,1987547,99377337,19670347,PDN
EB688,,1994,1988,,1987547,99377337,19670347,,0,0,0,,1987547,99377337,19670347,PDN
EB688,,1995,1988,,1987547,99377337,19670347,,0,0,0,,1987547,99377337,19670347,PDN
EB688,,1996,1988,,1984616,99230775,19641338,,0,0,0,,1984616,99230775,19641338,PDN
EB688,,1997,1988,,2579883,92455261,19030997,,0,0,0,,2579883,92455261,19030997,PDN
EB688,,1998,1988,,2579883,92455261,19030997,,0,0,0,,2579883,92455261,19030997,PDN
EB688,,1999,1988,,2579883,92455261,19030997,,0,0,0,,2579883,92455261,19030997,PDN
EB688,,2000,1988,,2579883,92455261,19030998,,0,0,0,,2579883,92455261,19030998,PDN
EB688,,2001,1988,,2746477,100784966,20679745,,0,0,0,,2746477,100784966,20679745,PDN
EB688,,2002,1988,,2415932,226641676,42743633,,30109,19856068,3563217,,2385823,206785608,39180416,PDN
EB688,,2003,1988,,1428953,141291298,26569753,,77988,52883379,9487842,,1350965,88407919,17081911,PDN
EB688,,2004,1988,,738910,124606664,22910914,,259163,77172527,13990929,,479747,47434137,8919985,PDN
EB688,,2005,1988,,1509102,130466222,24723732,,405796,95552379,17407999,,1103306,34913843,7315733,PDN
EB688,,2006,1988,,969261,135317390,25047088,,526021,105213721,19247324,,443240,30103669,5799764,PDN
EB688,,2007,1988,,956242,125084363,23213246,,540252,105625780,19334875,,415990,19458583,3878371,PDN
EB688,,2008,1988,,583868,109816874,20124237,,583252,109370428,20044182,,616,446446,80055,PDN
EB688,,2009,1988,,583868,109816874,20124236,,583868,109816874,20124236,,0,0,0,PDN
EB688,,2010,1988,,583868,109816874,20124236,,583868,109816874,20124236,,0,0,0,PDN
EB688,,2011,1988,,583868,109816874,20124236,,583868,109816874,20124236,,0,0,0,PDN
EB688,,2012,1988,,583868,109816874,20124236,,583868,109816874,20124236,,0,0,0,PDN
EB688,,2013,1988,,583868,109816874,20124236,,583868,109816874,20124236,,0,0,0,PDN
EB688,,2014,1988,,583868,109816874,20124236,,583868,109816874,20124236,,0,0,0,PDN
EB688,,2015,1988,,583868,109816874,20124236,,583868,109816874,20124236,,0,0,0,PDN
EB688,,2016,1988,,583868,109816874,20124236,,583868,109816874,20124236,,0,0,0,PDN
EB688,,2017,1988,,583868,109816874,20124236,,583868,109816874,20124236,,0,0,0,PDN
EB688,,2017,1988,,583868,109816874,20124236,,583868,109816874,20124236,,0,0,0,PDN
EB759,,2003,2003,,335344,118571882,21433544,,0,0,0,,335344,118571882,21433544,PDN
EB759,,2004,2003,,189410,74979278,13530919,,80328,28402304,5134119,,109082,46576974,8396800,PDN
EB759,,2005,2003,,126952,50254400,9069016,,126952,50254400,9069016,,0,0,0,PDN
EB759,,2006,2003,,126952,50254400,9069016,,126952,50254400,9069016,,0,0,0,PDN
EB759,,2007,2003,,126952,50254400,9069016,,126952,50254400,9069016,,0,0,0,PDN
EB759,,2008,2003,,126952,50254400,9069016,,126952,50254400,9069016,,0,0,0,PDN
EB759,,2009,2003,,126951,50254399,9069015,,126951,50254399,9069015,,0,0,0,PDN
EB759,,2010,2003,,126951,50254399,9069015,,126951,50254399,9069015,,0,0,0,PDN
EB759,,2011,2003,,126951,50254399,9069015,,126951,50254399,9069015,,0,0,0,PDN
EB759,,2012,2003,,126951,50254399,9069015,,126951,50254399,9069015,,0,0,0,PDN
EB759,,2013,2003,,126951,50254399,9069015,,126951,50254399,9069015,,0,0,0,PDN
EB759,,2014,2003,,126951,50254399,9069015,,126951,50254399,9069015,,0,0,0,PDN
EB759,,2015,2003,,126951,50254399,9069015,,126951,50254399,9069015,,0,0,0,PDN
EB759,,2016,2003,,126951,50254399,9069015,,126951,50254399,9069015,,0,0,0,PDN
EB759,,2017,2003,,126951,50254399,9069015,,126951,50254399,9069015,,0,0,0,PDN
EB759,,2017,2003,,126951,50254399,9069015,,126951,50254399,9069015,,0,0,0,PDN
EB945,,1993,1990,,78701227,297072256,131561059,,0,0,0,,78701227,297072256,131561059,PDN
EB945,,1994,1990,,78724123,297095152,131588029,,0,0,0,,78724123,297095152,131588029,PDN
EB945,,1995,1990,,78724123,297095152,131588029,,0,0,0,,78724123,297095152,131588029,PDN
EB945,,1996,1990,,88450252,219698080,127542437,,0,0,0,,88450252,219698080,127542437,PDN
EB945,,1997,1990,,110783406,172389525,141457699,,0,0,0,,110783406,172389525,141457699,PDN
EB945,,1998,1990,,86935110,152271170,114029625,,6722,3262,7302,,86928388,152267908,114022323,PDN
EB945,,1999,1990,,86935110,152271170,114029625,,6722,3262,7302,,86928388,152267908,114022323,PDN
EB945,,2000,1990,,37564933,220794483,76852208,,2774391,37104429,9376603,,34790542,183690054,67475605,PDN
EB945,,2001,1990,,37644523,237739697,79946960,,7876182,105086574,26574861,,29768341,132653123,53372099,PDN
EB945,,2002,1990,,25056207,280210410,74915710,,11305404,149559468,37917409,,13750803,130650942,36998301,PDN
EB945,,2003,1990,,24948605,332584064,84127264,,13889088,199579677,49401486,,11059517,133004387,34725778,PDN
EB945,,2004,1990,,25310627,396036762,95779801,,15029764,257105526,60778078,,10280863,138931236,35001723,PDN
EB945,,2005,1990,,16463141,378745221,83855529,,15673201,298309558,68753194,,789940,80435663,15102335,PDN
EB945,,2006,1990,,16463141,378745221,83855529,,15961663,326741196,74100666,,501478,52004025,9754863,PDN
EB945,,2007,1990,,16463141,378745221,83855529,,16077435,341001525,76753863,,385706,37743696,7101666,PDN
EB945,,2008,1990,,16463141,378745221,83855529,,16095298,346209798,77698465,,367843,32535423,6157064,PDN
EB945,,2009,1990,,16127966,366806681,81396059,,16107855,350569474,78486765,,20111,16237207,2909294,PDN
EB945,,2010,1990,,16127966,366806681,81396059,,16114349,354547489,79201091,,13617,12259192,2194968,PDN
EB945,,2011,1990,,16127966,366806681,81396059,,16116235,356839983,79610894,,11731,9966698,1785165,PDN
EB945,,2012,1990,,16118343,362843312,80681210,,16116272,358850537,79968681,,2071,3992775,712529,PDN
EB945,,2013,1990,,16118343,362843312,80681210,,16116636,359924214,80160090,,1707,2919098,521119,PDN
EB945,,2014,1990,,16116636,359999597,80173504,,16116636,359999597,80173504,,0,0,0,PDN
EB945,,2015,1990,,16116635,360000287,80173626,,16116635,360000287,80173626,,0,0,0,PDN
EB945,,2016,1990,,16116631,359953236,80165250,,16116631,359953236,80165250,,0,0,0,PDN
EB945,,2017,1990,,16116631,359953236,80165250,,16116631,359953236,80165250,,0,0,0,PDN
EB945,,2017,1990,,16116631,359953236,80165250,,16116631,359953236,80165250,,0,0,0,PDN
EB949,,1998,1998,,5943249,5051762,6842139,,0,0,0,,5943249,5051762,6842139,PDP
EB949,,1999,1998,,7189997,7908996,8597292,,0,0,0,,7189997,7908996,8597292,PDP
EB949,,2000,1998,,16329935,19595922,19816754,,0,0,0,,16329935,19595922,19816754,PDP
EB949,,2001,1998,,4555658,3690083,5212256,,610987,553624,709497,,3944671,3136459,4502759,PDP
EB949,,2002,1998,,4915315,4020728,5630747,,2496920,2078593,2866776,,2418395,1942135,2763971,PDP
EB949,,2003,1998,,4915315,4020728,5630747,,3388408,2782346,3883487,,1526907,1238382,1747260,PDP
EB949,,2004,1998,,5874401,4934497,6752425,,4294177,3541430,4924325,,1580224,1393067,1828100,PDP
EB949,,2005,1998,,6114173,5093106,7020420,,4881431,4060284,5603901,,1232742,1032822,1416519,PDP
EB949,,2006,1998,,6953373,5799113,7985244,,5576356,4645474,6402953,,1377017,1153639,1582291,PDP
EB949,,2007,1998,,6953373,5799113,7985244,,6110120,5109451,7019275,,843253,689662,965969,PDP
EB949,,2008,1998,,8471990,7396047,9788013,,6632585,5514072,7613737,,1839405,1881975,2174276,PDP
EB949,,2009,1998,,9415027,9678648,11137206,,7088808,5963848,8149991,,2326219,3714800,2987215,PDP
EB949,,2010,1998,,9415027,9678648,11137206,,7366950,6284461,8485181,,2048077,3394187,2652025,PDP
EB949,,2011,1998,,9415027,9678648,11137206,,7702055,6952422,8939141,,1712972,2726226,2198066,PDP
EB949,,2012,1998,,9415027,9678648,11137206,,8037459,7436844,9360741,,1377568,2241804,1776466,PDP
EB949,,2013,1998,,9415027,9678648,11137206,,8364307,7897216,9769506,,1050720,1781432,1367701,PDP
EB949,,2014,1998,,9415027,9678648,11137206,,8667277,8393867,10160848,,747750,1284781,976359,PDP
EB949,,2015,1998,,9415027,9678648,11137206,,8964720,8735622,10519101,,450307,943026,618105,PDP
EB949,,2016,1998,,9415027,9678648,11137206,,9231511,8994498,10831955,,183516,684150,305251,PDP
EB949,,2017,1998,,9976134,9676850,11697993,,9547860,9309582,11204369,,428274,367268,493624,PDP
EB949,,2017,1998,,9976134,9676850,11697993,,9547860,9309582,11204369,,428274,367268,493624,PDP
EB992,,2009,1995,,231459,98514024,17760644,,25846,11297368,2036054,,205613,87216656,15724591,PDN
EB992,,2010,1995,,170743,66631303,12026847,,112758,42062028,7597104,,57985,24569275,4429742,PDN
EB992,,2011,1995,,170743,66631303,12026847,,152878,61741733,11138952,,17865,4889570,887896,PDN
EB992,,2012,1995,,170327,66631257,12026423,,170327,66631257,12026423,,0,0,0,PDN
EB992,,2013,1995,,170327,66631257,12026423,,170327,66631257,12026423,,0,0,0,PDN
EB992,,2014,1995,,170327,66631257,12026423,,170327,66631257,12026423,,0,0,0,PDN
EB992,,2015,1995,,170494,66631147,12026570,,170494,66631147,12026570,,0,0,0,PDN
EB992,,2016,1995,,170494,66646610,12029322,,170494,66646610,12029322,,0,0,0,PDN
EB992,,2017,1995,,170494,66646610,12029322,,170494,66646610,12029322,,0,0,0,PDN
EB992,,2017,1995,,170494,66646610,12029322,,170494,66646610,12029322,,0,0,0,PDN
EC002,,1990,1982,,3580959,3986431,4290288,,39816,326655,97940,,3541143,3659776,4192348,PDN
EC002,,1991,1982,,1609342,6576114,2779469,,90592,508644,181098,,1518750,6067470,2598371,PDN
EC002,,1992,1982,,1609342,6576114,2779469,,144916,694399,268475,,1464426,5881715,2510994,PDN
EC002,,1993,1982,,1609342,6576114,2779469,,160040,747576,293061,,1449302,5828538,2486408,PDN
EC002,,1994,1982,,1452418,16303439,4353386,,162162,793860,303418,,1290256,15509579,4049968,PDN
EC002,,1995,1982,,880990,12350049,3078508,,252966,2280213,658698,,628024,10069836,2419810,PDN
EC002,,1996,1982,,817578,14895218,3467973,,297947,3121817,853430,,519631,11773401,2614543,PDN
EC002,,1997,1982,,817578,14895218,3467973,,317447,4673779,1149080,,500131,10221439,2318893,PDN
EC002,,1998,1982,,924236,17175095,3980303,,328869,6190164,1430322,,595367,10984931,2549981,PDN
EC002,,1999,1982,,397255,9264800,2045796,,330477,6875051,1553796,,66778,2389749,492000,PDN
EC002,,2000,1982,,399000,12291126,2586033,,331802,6973218,1572588,,67198,5317908,1013445,PDN
EC002,,2001,1982,,426569,13283888,2790250,,334570,7177628,1611728,,91999,6106260,1178522,PDN
EC002,,2002,1982,,426569,13283888,2790250,,335580,7269792,1629137,,90989,6014096,1161113,PDN
EC002,,2003,1982,,352162,7961333,1768769,,335925,7322359,1638836,,16237,638974,129933,PDN
EC002,,2004,1982,,336373,7404465,1653893,,336369,7404229,1653847,,4,236,46,PDN
EC002,,2005,1982,,336373,7404465,1653893,,336373,7404465,1653893,,0,0,0,PDN
EC002,,2006,1982,,336373,7404465,1653893,,336373,7404465,1653893,,0,0,0,PDN
EC002,,2007,1982,,336373,7404465,1653893,,336373,7404465,1653893,,0,0,0,PDN
EC002,,2008,1982,,336373,7404465,1653893,,336373,7404465,1653893,,0,0,0,PDN
EC002,,2009,1982,,336373,7519394,1674345,,336373,7519394,1674345,,0,0,0,PDN
EC002,,2010,1982,,336373,7519394,1674345,,336373,7519394,1674345,,0,0,0,PDN
EC002,,2011,1982,,336373,7519394,1674345,,336373,7519394,1674345,,0,0,0,PDN
EC002,,2012,1982,,336373,7519394,1674345,,336373,7519394,1674345,,0,0,0,PDN
EC002,,2013,1982,,336373,7519394,1674345,,336373,7519394,1674345,,0,0,0,PDN
EC002,,2014,1982,,336373,7519394,1674345,,336373,7519394,1674345,,0,0,0,PDN
EC002,,2015,1982,,336373,7519394,1674345,,336373,7519394,1674345,,0,0,0,PDN
EC002,,2016,1982,,336373,7519394,1674345,,336373,7519394,1674345,,0,0,0,PDN
EC002,,2017,1982,,336373,7519394,1674345,,336373,7519394,1674345,,0,0,0,PDN
EC002,,2017,1982,,336373,7519394,1674345,,336373,7519394,1674345,,0,0,0,PDN
EC014,,1975,1968,,9480309,280797950,59444357,,7102464,176538135,38514944,,2377845,104259815,20929413,PDP
EC014,,1976,1968,,9480309,280797950,59444357,,5997574,168798324,36032863,,3482735,111999626,23411494,PDP
EC014,,1977,1968,,10760926,298586940,63890275,,7127689,173925342,38075259,,3633237,124661598,25815016,PDP
EC014,,1978,1968,,9658886,245628530,53365030,,7303580,178880765,39132898,,2355306,66747765,14232132,PDP
EC014,,1979,1968,,8967567,251523824,53722696,,6033510,184028595,38778812,,2934057,67495229,14943884,PDP
EC014,,1980,1968,,9776213,256523824,55421022,,6227529,189206239,39894120,,3548684,67317585,15526902,PDP
EC014,,1981,1968,,9876213,257523824,55698957,,6389788,193011774,40733520,,3486425,64512050,14965437,PDP
EC014,,1982,1968,,10405606,268723824,58221233,,6491659,195793604,41330379,,3913947,72930220,16890854,PDP
EC014,,1983,1968,,10298652,264025563,57278290,,6571495,197507663,41715207,,3727157,66517900,15563083,PDP
EC014,,1984,1968,,10341377,265807198,57638031,,6605048,198546094,41933534,,3736329,67261104,15704497,PDP
EC014,,1985,1968,,10334062,265807198,57630716,,6642999,201062332,42419215,,3691063,64744866,15211501,PDP
EC014,,1986,1968,,10346355,266377322,57744455,,6663272,202392327,42676142,,3683083,63984995,15068313,PDP
EC014,,1987,1968,,9690465,243646274,53043895,,6727009,205244896,43247453,,2963456,38401378,9796442,PDP
EC014,,1988,1968,,8353256,235925939,50332960,,6624831,201382389,42457996,,1728425,34543550,7874964,PDP
EC014,,1989,1968,,8359519,238810469,50852485,,6628485,201800254,42536004,,1731034,37010215,8316481,PDP
EC014,,1990,1968,,8606354,246931354,52544317,,6638767,202161898,42610635,,1967587,44769456,9933682,PDP
EC014,,1991,1968,,6754682,204505303,43143526,,6663970,202439542,42685241,,90712,2065761,458285,PDP
EC014,,1992,1968,,7510897,208351878,44584185,,6713369,202872215,42811628,,797528,5479663,1772557,PDP
EC014,,1993,1968,,7457702,207909784,44452325,,6770423,203555998,42990351,,687279,4353786,1461974,PDP
EC014,,1994,1968,,7457750,207909833,44452382,,6832429,204303702,43185401,,625321,3606131,1266981,PDP
EC014,,1995,1968,,7456000,208615406,44576179,,6887074,204796791,43327784,,568926,3818615,1248395,PDP
EC014,,1996,1968,,7175656,215297834,45484879,,6953655,206643576,43722975,,222001,8654258,1761904,PDP
EC014,,1997,1968,,7083468,212461442,44887995,,6999107,208497032,44098223,,84361,3964410,789772,PDP
EC014,,1998,1968,,7098288,214044883,45184566,,7021161,208844697,44182139,,77127,5200186,1002427,PDP
EC014,,1999,1968,,7184250,215639620,45554289,,7069161,210190691,44469640,,115089,5448929,1084649,PDP
EC014,,2000,1968,,7481403,232574174,48864708,,7202013,214134735,45304279,,279390,18439439,3560429,PDP
EC014,,2001,1968,,7583311,232949408,49033383,,7250718,216760099,45820131,,332593,16189309,3213252,PDP
EC014,,2002,1968,,7581583,232949408,49031655,,7294061,218922469,46248237,,287522,14026939,2783418,PDP
EC014,,2003,1968,,7633680,233143866,49118353,,7410250,219888561,46536328,,223430,13255305,2582025,PDP
EC014,,2004,1968,,7746639,229537778,48589660,,7540582,220346385,46748124,,206057,9191393,1841536,PDP
EC014,,2005,1968,,8009323,232232519,49331835,,7613582,220463964,46842045,,395741,11768555,2489790,PDP
EC014,,2006,1968,,7696806,232052713,48987325,,7614275,220463964,46842738,,82531,11588749,2144587,PDP
EC014,,2007,1968,,7796774,232217649,49116641,,7695254,220541240,46937468,,101520,11676409,2179173,PDP
EC014,,2008,1968,,8407714,251686337,53191759,,7707205,220570547,46954633,,700509,31115790,6237126,PDP
EC014,,2009,1968,,8043976,234735841,49811920,,7791418,226165012,48034302,,252558,8570829,1777616,PDP
EC014,,2010,1968,,8043976,234735841,49811920,,7855381,227395883,48317281,,188595,7339958,1494637,PDP
EC014,,2011,1968,,8043976,234735841,49811920,,7882261,227699022,48398100,,161715,7036819,1413818,PDP
EC014,,2012,1968,,8150557,237142996,50346820,,7947536,228857384,48669490,,203021,8285612,1677329,PDP
EC014,,2013,1968,,8150557,237142996,50346820,,8005450,230307155,48985370,,145107,6835841,1361449,PDP
EC014,,2014,1968,,8150557,237142996,50346820,,8039820,231711655,49269652,,110737,5431341,1077168,PDP
EC014,,2015,1968,,8288028,241382479,51238647,,8056804,232747145,49470887,,231224,8635334,1767761,PDP
EC014,,2016,1968,,8135001,239749851,50795117,,8072448,233693599,49654939,,62553,6056252,1140178,PDP
EC014,,2017,1968,,8135001,239749851,50795117,,8083939,234750407,49854474,,51062,4999444,940643,PDP
EC014,,2017,1968,,8135001,239749851,50795117,,8083939,234750407,49854474,,51062,4999444,940643,PDP
EC026,,1988,1978,,163534,7732181,1539367,,149192,7196596,1429725,,14342,535585,109642,PDN
EC026,,1989,1978,,178228,9915829,1942610,,160274,8887973,1741764,,17954,1027856,200846,PDN
EC026,,1990,1978,,161917,9017465,1766448,,161917,9017465,1766448,,0,0,0,PDN
EC026,,1991,1978,,161917,9017465,1766448,,161917,9017465,1766448,,0,0,0,PDN
EC026,,1992,1978,,161917,9017465,1766448,,161917,9017465,1766448,,0,0,0,PDN
EC026,,1993,1978,,161917,9017465,1766448,,161917,9017465,1766448,,0,0,0,PDN
EC026,,1994,1978,,161917,9017465,1766448,,161917,9017465,1766448,,0,0,0,PDN
EC026,,1995,1978,,161917,9017465,1766448,,161917,9017465,1766448,,0,0,0,PDN
EC026,,1996,1978,,161917,9017465,1766448,,161917,9017465,1766448,,0,0,0,PDN
EC026,,1997,1978,,161917,9017465,1766448,,161917,9017465,1766448,,0,0,0,PDN
EC026,,1998,1978,,161917,9017465,1766448,,161917,9017465,1766448,,0,0,0,PDN
EC026,,1999,1978,,161917,9017465,1766448,,161917,9017465,1766448,,0,0,0,PDN
EC026,,2000,1978,,161917,9017465,1766448,,161917,9017465,1766448,,0,0,0,PDN
EC026,,2001,1978,,161917,9017465,1766448,,161917,9017465,1766448,,0,0,0,PDN
EC026,,2002,1978,,161917,9017465,1766448,,161917,9017465,1766448,,0,0,0,PDN
EC026,,2003,1978,,161917,9017465,1766448,,161917,9017465,1766448,,0,0,0,PDN
EC026,,2004,1978,,161917,9017465,1766448,,161917,9017465,1766448,,0,0,0,PDN
EC026,,2005,1978,,161917,9017465,1766448,,161917,9017465,1766448,,0,0,0,PDN
EC026,,2006,1978,,161917,9017465,1766448,,161917,9017465,1766448,,0,0,0,PDN
EC026,,2007,1978,,161917,9017465,1766448,,161917,9017465,1766448,,0,0,0,PDN
EC026,,2008,1978,,161917,9017465,1766448,,161917,9017465,1766448,,0,0,0,PDN
EC026,,2009,1978,,161917,9198056,1798581,,161917,9198056,1798581,,0,0,0,PDN
EC026,,2010,1978,,161917,9198056,1798581,,161917,9198056,1798581,,0,0,0,PDN
EC026,,2011,1978,,161917,9198056,1798581,,161917,9198056,1798581,,0,0,0,PDN
EC026,,2012,1978,,161917,9198056,1798581,,161917,9198056,1798581,,0,0,0,PDN
EC026,,2013,1978,,161917,9198056,1798581,,161917,9198056,1798581,,0,0,0,PDN
EC026,,2014,1978,,161917,9198056,1798581,,161917,9198056,1798581,,0,0,0,PDN
EC026,,2015,1978,,161917,9198056,1798581,,161917,9198056,1798581,,0,0,0,PDN
EC026,,2016,1978,,161917,9198056,1798581,,161917,9198056,1798581,,0,0,0,PDN
EC026,,2017,1978,,161917,9198056,1798581,,161917,9198056,1798581,,0,0,0,PDN
EC026,,2017,1978,,161917,9198056,1798581,,161917,9198056,1798581,,0,0,0,PDN
EC033,,1975,1960,,15182571,295500000,67762642,,1443004,114214799,21765922,,13739567,181285201,45996720,PDN
EC033,,1976,1960,,5000301,354338560,68049867,,1190668,162463761,30098811,,3809633,191874799,37951056,PDN
EC033,,1977,1960,,5552364,388604570,74699085,,1869881,194589219,36494297,,3682483,194015351,38204788,PDN
EC033,,1978,1960,,5552364,388604570,74699085,,2060718,230423553,43061350,,3491646,158181017,31637735,PDN
EC033,,1979,1960,,3017286,399358783,74077568,,1996041,276165971,51135893,,1021245,123192812,22941675,PDN
EC033,,1980,1960,,3700376,480887712,89267585,,2199839,308713542,57131074,,1500537,172174170,32136511,PDN
EC033,,1981,1960,,3700376,486437712,90255129,,2340484,334538106,61866837,,1359892,151899606,28388292,PDN
EC033,,1982,1960,,4297631,525966533,97885982,,2460020,356137331,65829652,,1837611,169829202,32056330,PDN
EC033,,1983,1960,,3973141,524485382,97297942,,2528431,370305646,68419115,,1444710,154179736,28878827,PDN
EC033,,1984,1960,,4159902,552325398,102438443,,2654448,389707281,71997381,,1505454,162618117,30441062,PDN
EC033,,1985,1960,,4246505,569204394,105528426,,2811421,406724161,75182268,,1435084,162480233,30346158,PDN
EC033,,1986,1960,,4415450,576851120,107057998,,2944298,425776725,78705281,,1471152,151074395,28352717,PDN
EC033,,1987,1960,,4331600,574767651,106603424,,3042802,440719291,81462605,,1288798,134048360,25140819,PDN
EC033,,1988,1960,,4218213,577391791,106956966,,3120544,452977231,83721475,,1097669,124414560,23235491,PDN
EC033,,1989,1960,,4219230,580952494,107591560,,3210118,470367734,86905444,,1009112,110584760,20686116,PDN
EC033,,1990,1960,,4798390,633393433,117501848,,3282886,485088930,89597642,,1515504,148304503,27904206,PDN
EC033,,1991,1960,,4138059,583844032,108024897,,3392380,497046688,91834851,,745679,86797344,16190046,PDN
EC033,,1992,1960,,4217160,592281691,109605361,,3437919,505285809,93346426,,779241,86995882,16258935,PDN
EC033,,1993,1960,,3990024,584933282,108070679,,3465363,511905653,94551778,,524661,73027629,13518901,PDN
EC033,,1994,1960,,4058495,592191003,109430560,,3497281,518083408,95682941,,561214,74107595,13747619,PDN
EC033,,1995,1960,,3625714,537157130,99205274,,3506837,519860091,96008633,,118877,17297039,3196641,PDN
EC033,,1996,1960,,3689979,553524818,102181939,,3548770,526894814,97302296,,141209,26630004,4879643,PDN
EC033,,1997,1960,,3857197,572726512,105765829,,3603324,536563734,99077298,,253873,36162778,6688531,PDN
EC033,,1998,1960,,4009002,599975753,110766253,,3672819,548527588,101275593,,336183,51448165,9490660,PDN
EC033,,1999,1960,,4044421,588376719,108737788,,3749045,560683770,103514840,,295376,27692949,5222948,PDN
EC033,,2000,1960,,4879368,680140929,125900885,,3846490,576207124,106374448,,1032878,103933805,19526437,PDN
EC033,,2001,1960,,4267350,637014313,117615093,,4005997,597585273,110337896,,261353,39429040,7277197,PDN
EC033,,2002,1960,,4290485,642407219,118597820,,4087039,611763690,112941788,,203446,30643529,5656032,PDN
EC033,,2003,1960,,4300427,648718996,119730854,,4133748,620273892,114502768,,166679,28445104,5228086,PDN
EC033,,2004,1960,,4296986,653352897,120551950,,4187896,628810173,116075827,,109090,24542724,4476123,PDN
EC033,,2005,1960,,4682349,690652334,127574224,,4238121,637557309,117682482,,444228,53095025,9891742,PDN
EC033,,2006,1960,,4539761,668103486,123419385,,4305229,644481813,118981708,,234532,23621673,4437677,PDN
EC033,,2007,1960,,4546298,671483987,124027434,,4346099,649357822,119890195,,200199,22126165,4137239,PDN
EC033,,2008,1960,,4572008,671017968,123970223,,4361335,652738884,120507044,,210673,18279084,3463179,PDN
EC033,,2009,1960,,4455923,682908638,125969918,,4373332,666354237,122941703,,82591,16554401,3028217,PDN
EC033,,2010,1960,,4717699,693528341,128121320,,4383130,668712412,123371105,,334569,24815929,4750215,PDN
EC033,,2011,1960,,4457851,681973083,125805376,,4410730,671810253,123949924,,47121,10162830,1855453,PDN
EC033,,2012,1960,,4457851,681973083,125805376,,4423189,674370377,124417920,,34662,7602706,1387456,PDN
EC033,,2013,1960,,4457851,681973083,125805376,,4427692,675423290,124609774,,30159,6549793,1195603,PDN
EC033,,2014,1960,,4454975,681152650,125656516,,4432337,676488163,124803898,,22638,4664487,852618,PDN
EC033,,2015,1960,,4454975,681152650,125656516,,4433275,676894984,124877224,,21700,4257666,779291,PDN
EC033,,2016,1960,,4432941,676894984,124876890,,4432941,676894984,124876890,,0,0,0,PDN
EC033,,2017,1960,,4432941,676893830,124876685,,4432941,676893830,124876685,,0,0,0,PDN
EC033,,2017,1960,,4432941,676893830,124876685,,4432941,676893830,124876685,,0,0,0,PDN
EC038,,1978,1975,,15000,15000000,2684039,,0,0,0,,15000,15000000,2684039,PDN
EC038,,1979,1975,,15000,15000000,2684039,,0,0,0,,15000,15000000,2684039,PDN
EC038,,1980,1975,,20000,15000000,2689039,,1952,1467197,263019,,18048,13532803,2426020,PDN
EC038,,1981,1975,,36585,15000000,2705624,,9692,3104940,562172,,26893,11895060,2143452,PDN
EC038,,1982,1975,,58949,19494204,3527669,,17802,4811614,873961,,41147,14682590,2653708,PDN
EC038,,1983,1975,,69248,15384743,2806747,,25754,6288610,1144724,,43494,9096133,1662023,PDN
EC038,,1984,1975,,69248,15384743,2806747,,34369,6955638,1272027,,34879,8429105,1534720,PDN
EC038,,1985,1975,,69248,15384743,2806747,,41724,8389019,1534432,,27524,6995724,1272315,PDN
EC038,,1986,1975,,69248,15384743,2806747,,43908,8835114,1615992,,25340,6549629,1190755,PDN
EC038,,1987,1975,,69248,15384743,2806747,,45437,9118260,1667903,,23811,6266483,1138844,PDN
EC038,,1988,1975,,69248,15384743,2806747,,51901,10373880,1897787,,17347,5010863,908960,PDN
EC038,,1989,1975,,73713,15384743,2811212,,55893,11151453,2040137,,17820,4233290,771075,PDN
EC038,,1990,1975,,91557,18778743,3432970,,66960,13569436,2481450,,24597,5209307,951520,PDN
EC038,,1991,1975,,97806,20538393,3752324,,70608,14580492,2665002,,27198,5957901,1087322,PDN
EC038,,1992,1975,,92994,18775871,3433896,,76096,15550477,2843085,,16898,3225394,590811,PDN
EC038,,1993,1975,,120589,24165488,4420498,,82566,16900573,3089785,,38023,7264915,1330713,PDN
EC038,,1994,1975,,157558,27862421,5115284,,86515,17562905,3211587,,71043,10299516,1903697,PDN
EC038,,1995,1975,,157558,27862421,5115284,,89705,19436088,3548084,,67853,8426333,1567200,PDN
EC038,,1996,1975,,106478,23159711,4227423,,92340,20049950,3659947,,14138,3109761,567476,PDN
EC038,,1997,1975,,92953,20159570,3680065,,92953,20155827,3679399,,0,3743,666,PDN
EC038,,1998,1975,,110344,23461250,4284944,,95067,20560028,3753435,,15277,2901222,531509,PDN
EC038,,1999,1975,,115044,24356794,4448993,,96390,20900738,3815383,,18654,3456056,633610,PDN
EC038,,2000,1975,,187066,32416536,5955133,,133219,22590331,4152851,,53847,9826205,1802282,PDN
EC038,,2001,1975,,209362,29426072,5445318,,188574,25309293,4692007,,20788,4116779,753311,PDN
EC038,,2002,1975,,209362,29426072,5445318,,208089,28408829,5263041,,1273,1017243,182277,PDN
EC038,,2003,1975,,209742,29462610,5452199,,209458,29142341,5394928,,284,320269,57271,PDN
EC038,,2004,1975,,209688,29152558,5396976,,209688,29152558,5396976,,0,0,0,PDN
EC038,,2005,1975,,209688,29152558,5396976,,209688,29152558,5396976,,0,0,0,PDN
EC038,,2006,1975,,209688,29152558,5396976,,209688,29152558,5396976,,0,0,0,PDN
EC038,,2007,1975,,209688,29152558,5396976,,209688,29152558,5396976,,0,0,0,PDN
EC038,,2008,1975,,265413,34648141,6430563,,209688,29152558,5396976,,55725,5495583,1033587,PDN
EC038,,2009,1975,,250814,39820034,7336228,,209688,29560910,5469636,,41126,10259124,1866592,PDN
EC038,,2010,1975,,250814,39820034,7336228,,224906,31364250,5805733,,25908,8455784,1530496,PDN
EC038,,2011,1975,,250814,39820034,7336228,,235253,33050939,6116203,,15561,6769095,1220026,PDN
EC038,,2012,1975,,250814,39820034,7336228,,241094,34760912,6426309,,9720,5059122,909920,PDN
EC038,,2013,1975,,251118,43742395,8034461,,244360,38856477,7158323,,6758,4885918,876138,PDN
EC038,,2014,1975,,266649,42355595,7803231,,246619,39521315,7278881,,20030,2834280,524350,PDN
EC038,,2015,1975,,246619,39521631,7278937,,246619,39521631,7278937,,0,0,0,PDN
EC038,,2016,1975,,246619,39521631,7278937,,246619,39521631,7278937,,0,0,0,PDN
EC038,,2017,1975,,246619,39521631,7278937,,246619,39521631,7278937,,0,0,0,PDN
EC038,,2017,1975,,246619,39521631,7278937,,246619,39521631,7278937,,0,0,0,PDN
EC046,,1977,1978,,0,15000000,2669039,,0,0,0,,0,15000000,2669039,PDN
EC046,,1978,1978,,0,15000000,2669039,,0,0,0,,0,15000000,2669039,PDN
EC046,,1979,1978,,0,40000000,7117438,,0,0,0,,0,40000000,7117438,PDN
EC046,,1980,1978,,1184497,131852880,24645864,,18331,2273889,422938,,1166166,129578991,24222926,PDN
EC046,,1981,1978,,4007278,123760080,26028645,,158480,9670589,1879225,,3848798,114089491,24149420,PDN
EC046,,1982,1978,,5374377,131299965,28737360,,1212799,26897847,5998893,,4161578,104402118,22738467,PDN
EC046,,1983,1978,,4854054,138845848,29559721,,2798325,39454639,9818723,,2055729,99391209,19740998,PDN
EC046,,1984,1978,,7693269,148127618,34050496,,4047533,57605909,14297695,,3645736,90521709,19752801,PDN
EC046,,1985,1978,,10819198,97558938,28178440,,5378447,62436043,16488063,,5440751,35122895,11690377,PDN
EC046,,1986,1978,,10819198,97558938,28178440,,7176127,66349809,18982143,,3643071,31209129,9196297,PDN
EC046,,1987,1978,,10914165,102034926,29069846,,8279240,69519137,20649193,,2634925,32515789,8420653,PDN
EC046,,1988,1978,,14980482,113153156,35114496,,9148919,77882660,23007044,,5831563,35270496,12107452,PDN
EC046,,1989,1978,,14986351,114009325,35272708,,9851293,87785707,25471526,,5135058,26223618,9801182,PDN
EC046,,1990,1978,,15002329,114532089,35381704,,10421293,94670012,27266491,,4581036,19862077,8115213,PDN
EC046,,1991,1978,,15006871,114532089,35386246,,10916717,99254769,28577708,,4090154,15277320,6808538,PDN
EC046,,1992,1978,,15036341,118125346,36055086,,11358770,102113134,29528367,,3677571,16012212,6526719,PDN
EC046,,1993,1978,,14302022,117005500,35121506,,11735387,104152130,30267794,,2566635,12853370,4853712,PDN
EC046,,1994,1978,,14448160,125474099,36774512,,12112132,109378417,31574484,,2336028,16095682,5200028,PDN
EC046,,1995,1978,,14455984,129385906,37478387,,12311707,111982247,32237374,,2144277,17403659,5241013,PDN
EC046,,1996,1978,,14333816,127500379,37020716,,12515396,114995056,32977150,,1818420,12505323,4043566,PDN
EC046,,1997,1978,,14333816,127500379,37020716,,12714745,118618722,33821279,,1619071,8881657,3199437,PDN
EC046,,1998,1978,,13907712,130878704,37195738,,12878612,120434332,34308208,,1029100,10444372,2887530,PDN
EC046,,1999,1978,,14395924,127298817,37046959,,13010975,121432476,34618177,,1384949,5866341,2428782,PDN
EC046,,2000,1978,,14392236,127036364,36996571,,13106172,122093290,34830957,,1286064,4943074,2165614,PDN
EC046,,2001,1978,,14194624,124894838,36417905,,13185747,122479441,34979242,,1008877,2415397,1438663,PDN
EC046,,2002,1978,,14197670,125370091,36505515,,13244535,122756414,35087313,,953135,2613677,1418202,PDN
EC046,,2003,1978,,14198263,126375590,36685023,,13272602,123259017,35204811,,925661,3116573,1480212,PDN
EC046,,2004,1978,,14197361,126377514,36684463,,13288533,123773920,35312362,,908828,2603594,1372101,PDN
EC046,,2005,1978,,14162677,127812810,36905170,,13299754,124060811,35374631,,862923,3751999,1530539,PDN
EC046,,2006,1978,,14228025,142764778,39631011,,13304014,126418489,35798407,,924011,16346289,3832604,PDN
EC046,,2007,1978,,14213202,142596745,39586288,,13319127,129977893,36446866,,894075,12618852,3139422,PDN
EC046,,2008,1978,,14213202,142596745,39586288,,13337080,132848074,36975527,,876122,9748671,2610761,PDN
EC046,,2009,1978,,14244145,144079100,39880996,,13348183,137214983,37763661,,895962,6864117,2117336,PDN
EC046,,2010,1978,,14244145,144079100,39880996,,13354266,138071972,37922233,,889879,6007128,1958764,PDN
EC046,,2011,1978,,14247157,141507571,39426441,,13361286,138664139,38034620,,885871,2843432,1391821,PDN
EC046,,2012,1978,,14247157,141507571,39426441,,13372666,139236526,38147849,,874491,2271045,1278592,PDN
EC046,,2013,1978,,14247157,141507571,39426441,,13384300,139585112,38221508,,862857,1922459,1204932,PDN
EC046,,2014,1978,,13416748,140438835,38405865,,13390624,139873021,38279062,,26124,565814,126803,PDN
EC046,,2015,1978,,13392805,139885037,38283381,,13392805,139885037,38283381,,0,0,0,PDN
EC046,,2016,1978,,13392805,139885037,38283381,,13392805,139885037,38283381,,0,0,0,PDN
EC046,,2017,1978,,13392805,139885037,38283381,,13392805,139885037,38283381,,0,0,0,PDN
EC046,,2017,1978,,13392805,139885037,38283381,,13392805,139885037,38283381,,0,0,0,PDN
EC049,,1975,1955,,2099872,82000000,16690619,,636567,46682737,8943104,,1463305,35317263,7747515,PDN
EC049,,1976,1955,,1813307,91278000,18054944,,1154164,48960457,9865989,,659143,42317543,8188955,PDN
EC049,,1977,1955,,1813307,91278000,18054944,,1154164,50041948,10058425,,659143,41236052,7996519,PDN
EC049,,1978,1955,,1813307,91278000,18054944,,1154164,50903567,10211738,,659143,40374433,7843206,PDN
EC049,,1979,1955,,1112010,91328251,17362588,,521815,51812909,9741194,,590195,39515342,7621394,PDN
EC049,,1980,1955,,546598,56165039,10540377,,521815,52473033,9858654,,24783,3692006,681723,PDN
EC049,,1981,1955,,546598,56165039,10540377,,521815,53121759,9974085,,24783,3043280,566292,PDN
EC049,,1982,1955,,546598,56165039,10540377,,521815,53399394,10023487,,24783,2765645,516890,PDN
EC049,,1983,1955,,554345,61607972,11516618,,521815,53836369,10101240,,32530,7771603,1415378,PDN
EC049,,1984,1955,,554345,61607972,11516618,,521815,54187952,10163799,,32530,7420020,1352819,PDN
EC049,,1985,1955,,554345,61607972,11516618,,521815,54559840,10229972,,32530,7048132,1286646,PDN
EC049,,1986,1955,,554345,61607972,11516618,,521815,54875012,10286052,,32530,6732960,1230566,PDN
EC049,,1987,1955,,582349,64856471,12122646,,522092,57951691,10833781,,60257,6904780,1288865,PDN
EC049,,1988,1955,,524819,85591302,15754588,,522563,69436735,12877854,,2256,16154567,2876734,PDN
EC049,,1989,1955,,525011,93260182,17119349,,523179,77141419,14249410,,1832,16118763,2869939,PDN
EC049,,1990,1955,,525373,99576244,18243566,,523524,80067619,14770431,,1849,19508625,3473135,PDN
EC049,,1991,1955,,525373,99576244,18243566,,523571,82169711,15144516,,1802,17406533,3099050,PDN
EC049,,1992,1955,,524080,87644848,16119249,,523571,83450952,15372495,,509,4193896,746754,PDN
EC049,,1993,1955,,524480,91118404,16737719,,523571,84098506,15487718,,909,7019898,1250001,PDN
EC049,,1994,1955,,536801,94884895,17420234,,523691,84617191,15580131,,13110,10267704,1840103,PDN
EC049,,1995,1955,,536801,94884895,17420234,,523693,84803185,15613228,,13108,10081710,1807006,PDN
EC049,,1996,1955,,621679,93668192,17288617,,528774,85217380,15692009,,92905,8450812,1596608,PDN
EC049,,1997,1955,,622643,95574484,17628779,,611354,90101680,16643681,,11289,5472804,985098,PDN
EC049,,1998,1955,,733681,109358090,20192416,,621422,92348366,17053516,,112259,17009724,3138900,PDN
EC049,,1999,1955,,642903,95070836,17559422,,624479,93479061,17257764,,18424,1591775,301658,PDN
EC049,,2000,1955,,642463,95007661,17547741,,624499,94005577,17351470,,17964,1002084,196271,PDN
EC049,,2001,1955,,625998,94670388,17471263,,624797,94015958,17353615,,1201,654430,117648,PDN
EC049,,2002,1955,,632658,96696896,17838511,,624797,93985278,17348156,,7861,2711618,490355,PDN
EC049,,2003,1955,,632787,96954841,17884538,,626385,94387209,17421262,,6402,2567632,463276,PDN
EC049,,2004,1955,,662931,97397066,17993370,,634752,95308235,17593513,,28179,2088831,399857,PDN
EC049,,2005,1955,,660222,99682944,18397401,,645605,96662597,17845355,,14617,3020347,552046,PDN
EC049,,2006,1955,,754812,103414073,19155893,,646707,96873497,17883984,,108105,6540576,1271909,PDN
EC049,,2007,1955,,681786,99106718,18316433,,653662,97613261,18022570,,28124,1493457,293863,PDN
EC049,,2008,1955,,681786,99116321,18318142,,666031,98268528,18151534,,15755,847793,166608,PDN
EC049,,2009,1955,,687512,100731527,18611271,,668713,100377128,18529412,,18799,354399,81859,PDN
EC049,,2010,1955,,687512,100731527,18611271,,672071,100687995,18588084,,15441,43532,23187,PDN
EC049,,2011,1955,,672071,100687995,18588084,,672071,100687995,18588084,,0,0,0,PDN
EC049,,2012,1955,,672071,100687995,18588084,,672071,100687995,18588084,,0,0,0,PDN
EC049,,2013,1955,,672071,100687995,18588084,,672071,100687995,18588084,,0,0,0,PDN
EC049,,2014,1955,,672071,100687995,18588084,,672071,100687995,18588084,,0,0,0,PDN
EC049,,2015,1955,,672071,100687995,18588084,,672071,100687995,18588084,,0,0,0,PDN
EC049,,2016,1955,,672071,100687995,18588084,,672071,100687995,18588084,,0,0,0,PDN
EC049,,2017,1955,,672071,100687995,18588084,,672071,100687995,18588084,,0,0,0,PDN
EC049,,2017,1955,,672071,100687995,18588084,,672071,100687995,18588084,,0,0,0,PDN
EC051,,1975,1962,,0,2780000,494662,,0,2780000,494662,,0,0,0,PDN
EC051,,1976,1962,,0,2780000,494662,,0,2780000,494662,,0,0,0,PDN
EC051,,1977,1962,,0,2780000,494662,,0,2780000,494662,,0,0,0,PDN
EC051,,1978,1962,,0,2780000,494662,,0,2780000,494662,,0,0,0,PDN
EC051,,1979,1962,,8,2844362,506122,,8,2844362,506122,,0,0,0,PDN
EC051,,1980,1962,,8,2844362,506122,,8,2844362,506122,,0,0,0,PDN
EC051,,1981,1962,,8,2844362,506122,,8,2844362,506122,,0,0,0,PDN
EC051,,1982,1962,,8,2844362,506122,,8,2844362,506122,,0,0,0,PDN
EC051,,1983,1962,,8,2844362,506122,,8,2844362,506122,,0,0,0,PDN
EC051,,1984,1962,,8,2844362,506122,,8,2844362,506122,,0,0,0,PDN
EC051,,1985,1962,,8,2844362,506122,,8,2844362,506122,,0,0,0,PDN
EC051,,1986,1962,,8,2844362,506122,,8,2844362,506122,,0,0,0,PDN
EC051,,1987,1962,,8,2844362,506122,,8,2844362,506122,,0,0,0,PDN
EC051,,1988,1962,,8,2844362,506122,,8,2844362,506122,,0,0,0,PDN
EC051,,1989,1962,,8,2844362,506122,,8,2844362,506122,,0,0,0,PDN
EC051,,1990,1962,,8,2844362,506122,,8,2844362,506122,,0,0,0,PDN
EC051,,1991,1962,,8,2844362,506122,,8,2844362,506122,,0,0,0,PDN
EC051,,1992,1962,,8,2844362,506122,,8,2844362,506122,,0,0,0,PDN
EC051,,1993,1962,,8,2844362,506122,,8,2844362,506122,,0,0,0,PDN
EC051,,1994,1962,,8,2844362,506122,,8,2844362,506122,,0,0,0,PDN
EC051,,1995,1962,,8,2844362,506122,,8,2844362,506122,,0,0,0,PDN
EC051,,1996,1962,,8,2844362,506122,,8,2844362,506122,,0,0,0,PDN
EC051,,1997,1962,,8,2844362,506122,,8,2844362,506122,,0,0,0,PDN
EC051,,1998,1962,,8,2844362,506122,,8,2844362,506122,,0,0,0,PDN
EC051,,1999,1962,,8,2844362,506122,,8,2844362,506122,,0,0,0,PDN
EC051,,2000,1962,,8,2844362,506122,,8,2844362,506122,,0,0,0,PDN
EC051,,2001,1962,,8,2844362,506122,,8,2844362,506122,,0,0,0,PDN
EC051,,2002,1962,,8,2844362,506122,,8,2844362,506122,,0,0,0,PDN
EC051,,2003,1962,,8,2844362,506122,,8,2844362,506122,,0,0,0,PDN
EC051,,2004,1962,,8,2844362,506122,,8,2844362,506122,,0,0,0,PDN
EC051,,2005,1962,,8,2844362,506122,,8,2844362,506122,,0,0,0,PDN
EC051,,2006,1962,,8,2844362,506122,,8,2844362,506122,,0,0,0,PDN
EC051,,2007,1962,,8,2844362,506122,,8,2844362,506122,,0,0,0,PDN
EC051,,2008,1962,,8,2844362,506122,,8,2844362,506122,,0,0,0,PDN
EC051,,2009,1962,,8,2901324,516258,,8,2901324,516258,,0,0,0,PDN
EC051,,2010,1962,,8,2901324,516258,,8,2901324,516258,,0,0,0,PDN
EC051,,2011,1962,,8,2901324,516258,,8,2901324,516258,,0,0,0,PDN
EC051,,2012,1962,,8,2901324,516258,,8,2901324,516258,,0,0,0,PDN
EC051,,2013,1962,,8,2901324,516258,,8,2901324,516258,,0,0,0,PDN
EC051,,2014,1962,,8,2901324,516258,,8,2901324,516258,,0,0,0,PDN
EC051,,2015,1962,,8,2901324,516258,,8,2901324,516258,,0,0,0,PDN
EC051,,2016,1962,,8,2901324,516258,,8,2901324,516258,,0,0,0,PDN
EC051,,2017,1962,,8,2901324,516258,,8,2901324,516258,,0,0,0,PDN
EC051,,2017,1962,,8,2901324,516258,,8,2901324,516258,,0,0,0,PDN
EC060,,1989,1988,,4126656,70128637,16605061,,86718,2070525,455139,,4039938,68058112,16149922,PDN
EC060,,1990,1988,,4207743,77270812,17956998,,806997,19172802,4218528,,3400746,58098010,13738470,PDN
EC060,,1991,1988,,4207743,77270812,17956998,,1550787,31783895,7206284,,2656956,45486917,10750714,PDN
EC060,,1992,1988,,4207743,77270812,17956998,,1801338,35370798,8095074,,2406405,41900014,9861924,PDN
EC060,,1993,1988,,2320433,56351892,12347460,,1908212,39380507,8915420,,412221,16971385,3432040,PDN
EC060,,1994,1988,,3480791,70673112,16056078,,1957745,40990142,9251365,,1523046,29682970,6804713,PDN
EC060,,1995,1988,,3480791,70673112,16056078,,2103607,43491673,9842339,,1377184,27181439,6213739,PDN
EC060,,1996,1988,,3246972,59774287,13882966,,2426807,47633906,10902591,,820165,12140381,2980375,PDN
EC060,,1997,1988,,3246972,59774287,13882966,,2691253,51006072,11767067,,555719,8768215,2115899,PDN
EC060,,1998,1988,,3160025,56276034,13173554,,2770270,52227293,12063383,,389755,4048741,1110171,PDN
EC060,,1999,1988,,2824439,53391280,12324667,,2806457,52851854,12210701,,17982,539426,113966,PDN
EC060,,2000,1988,,3247481,64698681,14759702,,2889003,56893575,13012415,,358478,7805106,1747287,PDN
EC060,,2001,1988,,2954075,61279837,13857961,,2902125,57519985,13136998,,51950,3759852,720963,PDN
EC060,,2002,1988,,2930003,58095479,13267277,,2902173,57520570,13137150,,27830,574909,130127,PDN
EC060,,2003,1988,,2902173,57520570,13137150,,2902173,57520570,13137150,,0,0,0,PDN
EC060,,2004,1988,,2902173,57520570,13137150,,2902173,57520570,13137150,,0,0,0,PDN
EC060,,2005,1988,,2902173,57520570,13137150,,2902173,57520570,13137150,,0,0,0,PDN
EC060,,2006,1988,,2902173,57520570,13137150,,2902173,57520570,13137150,,0,0,0,PDN
EC060,,2007,1988,,2902173,57520570,13137150,,2902173,57520570,13137150,,0,0,0,PDN
EC060,,2008,1988,,2902173,57520570,13137150,,2902173,57520570,13137150,,0,0,0,PDN
EC060,,2009,1988,,2902173,58561101,13322297,,2902173,58561101,13322297,,0,0,0,PDN
EC060,,2010,1988,,2902173,58561101,13322297,,2902173,58561101,13322297,,0,0,0,PDN
EC060,,2011,1988,,2902173,58561101,13322297,,2902173,58561101,13322297,,0,0,0,PDN
EC060,,2012,1988,,2902173,58561101,13322297,,2902173,58561101,13322297,,0,0,0,PDN
EC060,,2013,1988,,2902173,58561101,13322297,,2902173,58561101,13322297,,0,0,0,PDN
EC060,,2014,1988,,2902173,58561101,13322297,,2902173,58561101,13322297,,0,0,0,PDN
EC060,,2015,1988,,2902173,58561101,13322297,,2902173,58561101,13322297,,0,0,0,PDN
EC060,,2016,1988,,2902173,58561101,13322297,,2902173,58561101,13322297,,0,0,0,PDN
EC060,,2017,1988,,2902173,58561101,13322297,,2902173,58561101,13322297,,0,0,0,PDN
EC060,,2017,1988,,2902173,58561101,13322297,,2902173,58561101,13322297,,0,0,0,PDN
EC062,,1975,1955,,4400004,400000000,75574381,,3565887,252851289,48557220,,834117,147148711,27017161,PDN
EC062,,1976,1955,,7286957,331579030,66286784,,6142695,285790063,56995019,,1144262,45788967,9291765,PDN
EC062,,1977,1955,,7291157,335779030,67038315,,6566533,296322011,59292869,,724624,39457019,7745446,PDN
EC062,,1978,1955,,7286957,334982880,66892452,,6609660,303671783,60643785,,677297,31311097,6248667,PDN
EC062,,1979,1955,,3357455,335165061,62995366,,2841568,307889684,57626209,,515887,27275377,5369157,PDN
EC062,,1980,1955,,3169276,331707311,62191929,,2848977,311315928,58243270,,320299,20391383,3948659,PDN
EC062,,1981,1955,,2978307,326293695,61037683,,2861925,316168030,59119582,,116382,10125665,1918101,PDN
EC062,,1982,1955,,3062307,332437695,62214922,,2878431,318390158,59531484,,183876,14047537,2683438,PDN
EC062,,1983,1955,,3062307,332437695,62214922,,2891918,320398772,59902376,,170389,12038923,2312546,PDN
EC062,,1984,1955,,2994847,337436181,63036872,,2901447,324272053,60601101,,93400,13164128,2435771,PDN
EC062,,1985,1955,,3873288,422734373,79092927,,2915554,328212676,61316386,,957734,94521697,17776541,PDN
EC062,,1986,1955,,4044761,422734373,79264400,,3124537,340799119,63764950,,920224,81935254,15499450,PDN
EC062,,1987,1955,,5550591,546596320,102809723,,3286862,351110552,65762049,,2263729,195485768,37047674,PDN
EC062,,1988,1955,,4755807,478799278,89951408,,3166256,347114394,64930383,,1589551,131684884,25021025,PDN
EC062,,1989,1955,,4743985,478571555,89899066,,3248897,353926383,66225122,,1495088,124645172,23673944,PDN
EC062,,1990,1955,,3852458,389750343,73203053,,3340788,358484966,67128148,,511670,31265377,6074905,PDN
EC062,,1991,1955,,3856364,389750343,73206959,,3450464,362742553,67995402,,405900,27007790,5211557,PDN
EC062,,1992,1955,,4085360,399814287,75226692,,3532033,366027258,68661438,,553327,33787029,6565254,PDN
EC062,,1993,1955,,4775837,428263576,80979320,,3708434,372744976,70033163,,1067403,55518600,10946157,PDN
EC062,,1994,1955,,4775837,428263576,80979320,,3877900,379206674,71352397,,897937,49056902,9626923,PDN
EC062,,1995,1955,,4833275,412874830,78298547,,3987543,384019533,72318421,,845732,28855297,5980126,PDN
EC062,,1996,1955,,4569498,413820648,78203065,,4051513,386833849,72883159,,517985,26986799,5319906,PDN
EC062,,1997,1955,,4651030,417833354,78998602,,4100484,388988015,73315433,,550546,28845339,5683169,PDN
EC062,,1998,1955,,5495713,466552434,88512160,,4216636,395009793,74503076,,1279077,71542641,14009084,PDN
EC062,,1999,1955,,4679066,431158835,81397720,,4272573,401701826,75749766,,406493,29457009,5647954,PDN
EC062,,2000,1955,,4568995,431284624,81310032,,4313827,404540903,76296194,,255168,26743721,5013838,PDN
EC062,,2001,1955,,4538969,428517687,80787668,,4337274,406004737,76580110,,201695,22512950,4207558,PDN
EC062,,2002,1955,,4549505,428517687,80798204,,4357385,407087163,76792823,,192120,21430524,4005381,PDN
EC062,,2003,1955,,4855771,442665996,83621963,,4362429,407398065,76853188,,493342,35267931,6768775,PDN
EC062,,2004,1955,,4714175,435034811,82122505,,4397454,408858221,77148027,,316721,26176590,4974478,PDN
EC062,,2005,1955,,4561655,429777446,81034510,,4439872,410979639,77567922,,121783,18797807,3466588,PDN
EC062,,2006,1955,,4657850,438831280,82741708,,4444967,411226994,77617030,,212883,27604286,5124678,PDN
EC062,,2007,1955,,4657850,438831280,82741708,,4478089,413349261,78027780,,179761,25482019,4713928,PDN
EC062,,2008,1955,,4657850,438831280,82741708,,4486724,414274970,78201131,,171126,24556310,4540577,PDN
EC062,,2009,1955,,4599321,433632030,81758044,,4486819,422327777,79634109,,112502,11304253,2123935,PDN
EC062,,2010,1955,,4599321,433632030,81758044,,4489226,422570480,79679702,,110095,11061550,2078343,PDN
EC062,,2011,1955,,4599321,433632030,81758044,,4491122,422775652,79718105,,108199,10856378,2039939,PDN
EC062,,2012,1955,,4599321,433632030,81758044,,4491600,422908260,79742179,,107721,10723770,2015866,PDN
EC062,,2013,1955,,4599321,433632030,81758044,,4492151,423025110,79763522,,107170,10606920,1994523,PDN
EC062,,2014,1955,,4597435,433553520,81742189,,4492151,423025110,79763522,,105284,10528410,1978667,PDN
EC062,,2015,1955,,4492151,423025110,79763522,,4492151,423025110,79763522,,0,0,0,PDN
EC062,,2016,1955,,4492151,423025007,79763503,,4492151,423025007,79763503,,0,0,0,PDN
EC062,,2017,1955,,4492151,423025007,79763503,,4492151,423025007,79763503,,0,0,0,PDN
EC062,,2017,1955,,4492151,423025007,79763503,,4492151,423025007,79763503,,0,0,0,PDN
EC064,,1975,1957,,25000000,1400000000,274110320,,14190977,941741569,181760651,,10809023,458258431,92349669,PDP
EC064,,1976,1957,,18200118,1320000000,253075563,,14660477,980420437,189112512,,3539641,339579563,63963051,PDP
EC064,,1977,1957,,22910227,1248625054,245085504,,20989215,1082118784,213537041,,1921012,166506270,31548463,PDP
EC064,,1978,1957,,23374526,1278363533,250841347,,21455240,1121936870,221088135,,1919286,156426663,29753212,PDP
EC064,,1979,1957,,18004915,1278363533,245471736,,16479903,1166128513,223976080,,1525012,112235020,21495656,PDP
EC064,,1980,1957,,20965760,1335390286,258579690,,16971918,1168436722,224878808,,3993842,166953564,33700882,PDP
EC064,,1981,1957,,20966341,1338641516,259158782,,17185427,1193453569,229543713,,3780914,145187947,29615069,PDP
EC064,,1982,1957,,20973915,1361151431,263171679,,17333646,1214586322,233452209,,3640269,146565109,29719470,PDP
EC064,,1983,1957,,21056972,1437645904,276865852,,17471752,1233231179,236907905,,3585220,204414725,39957947,PDP
EC064,,1984,1957,,21014785,1442768001,277735070,,17572817,1242192491,238603509,,3441968,200575510,39131561,PDP
EC064,,1985,1957,,21026742,1446674785,278442184,,17776505,1251238289,240416770,,3250237,195436496,38025414,PDP
EC064,,1986,1957,,21036510,1447427592,278585904,,18008102,1258005998,241852586,,3028408,189421594,36733318,PDP
EC064,,1987,1957,,20687911,1404191591,270544066,,18259526,1266436114,243604030,,2428385,137755477,26940036,PDP
EC064,,1988,1957,,22673547,1541196418,296907785,,19015361,1308216658,251794126,,3658186,232979760,45113659,PDP
EC064,,1989,1957,,22603153,1570955641,302132626,,19317474,1333012717,256508349,,3285679,237942924,45624277,PDP
EC064,,1990,1957,,22528310,1551611071,298615689,,19558890,1351292781,260002445,,2969420,200318290,38613244,PDP
EC064,,1991,1957,,22375192,1478213439,285402494,,19906200,1364265868,262658134,,2468992,113947571,22744360,PDP
EC064,,1992,1957,,24504232,1446998088,281977201,,21096665,1377116519,266135192,,3407567,69881569,15842009,PDP
EC064,,1993,1957,,27913674,1495835108,294076505,,22414722,1403352101,272121502,,5498952,92483007,21955003,PDP
EC064,,1994,1957,,29400028,1546258277,304534953,,23953061,1444400629,280963849,,5446967,101857648,23571104,PDP
EC064,,1995,1957,,27986254,1553912800,304483194,,24671551,1467091893,285719931,,3314703,86820907,18763263,PDP
EC064,,1996,1957,,27280361,1543475124,301920063,,25046091,1476283360,287729963,,2234270,67191764,14190100,PDP
EC064,,1997,1957,,27023651,1545149337,301961255,,25297502,1485471252,289616230,,1726149,59678085,12345025,PDP
EC064,,1998,1957,,34093961,1920125848,375753365,,25484086,1494854157,291472370,,8609875,425271691,84280995,PDP
EC064,,1999,1957,,26404195,1538556370,300168674,,25559298,1500770782,292600362,,844897,37785588,7568312,PDP
EC064,,2000,1957,,27216983,1557289114,304314690,,25847195,1512220994,294925664,,1369788,45068120,9389026,PDP
EC064,,2001,1957,,26983833,1552385007,303208923,,25839609,1511708647,294826913,,1144224,40676360,8382010,PDP
EC064,,2002,1957,,27158736,1549051784,302790726,,26055155,1519211684,296377519,,1103581,29840100,6413207,PDP
EC064,,2003,1957,,27157820,1548224967,302642689,,26214769,1524896608,297548685,,943051,23328359,5094004,PDP
EC064,,2004,1957,,27371104,1548447381,302895549,,26428818,1531391862,298918473,,942286,17055519,3977076,PDP
EC064,,2005,1957,,27619116,1553130705,303976893,,26581050,1535346129,299774311,,1038066,17784576,4202582,PDP
EC064,,2006,1957,,27790970,1586458259,310078916,,26630182,1537869046,300272361,,1160788,48589213,9806555,PDP
EC064,,2007,1957,,27624805,1575578859,307976915,,26738148,1547043784,302012843,,886657,28535075,5964072,PDP
EC064,,2008,1957,,27823841,1588674104,310506066,,26823920,1553455405,303239472,,999921,35218699,7266594,PDP
EC064,,2009,1957,,27365237,1617085528,315102872,,26894276,1586626489,309212154,,470961,30459039,5890719,PDP
EC064,,2010,1957,,27374538,1617723458,315225683,,26981029,1591145573,310103014,,393509,26577885,5122671,PDP
EC064,,2011,1957,,27370603,1617261422,315139536,,27034543,1594849170,310815532,,336060,22412252,4324004,PDP
EC064,,2012,1957,,27370603,1617261422,315139536,,27074406,1598223405,311455793,,296197,19038017,3683744,PDP
EC064,,2013,1957,,27322223,1618654453,315339027,,27093671,1600593813,311896837,,228552,18060640,3442189,PDP
EC064,,2014,1957,,29062462,1613491391,316160572,,27233774,1603070376,312477610,,1828688,10421015,3682960,PDP
EC064,,2015,1957,,29062462,1613491391,316160572,,27372157,1604960326,312952284,,1690305,8531065,3208287,PDP
EC064,,2016,1957,,29062462,1613491391,316160572,,27375145,1605723759,313091114,,1687317,7767632,3069456,PDP
EC064,,2017,1957,,28674889,1609000186,314973853,,27377595,1606373421,313209162,,1297294,2626765,1764689,PDP
EC064,,2017,1957,,28674889,1609000186,314973853,,27377595,1606373421,313209162,,1297294,2626765,1764689,PDP
EC071,,1975,1954,,2099405,229482322,42932558,,1691752,162211278,30554969,,407653,67271044,12377589,PDN
EC071,,1976,1954,,2099405,229482322,42932558,,1721472,171168773,32178549,,377933,58313549,10754009,PDN
EC071,,1977,1954,,2362611,495417362,90515167,,1753670,178928117,33591413,,608941,316489245,56923754,PDN
EC071,,1978,1954,,2517496,479071340,87761507,,1783549,185809861,34845802,,733947,293261479,52915705,PDN
EC071,,1979,1954,,2611026,496690232,90990071,,1860507,194418956,36454627,,750519,302271276,54535444,PDN
EC071,,1980,1954,,7567918,496690232,95946963,,2623639,234711109,44387182,,4944279,261979123,51559781,PDN
EC071,,1981,1954,,7697212,510320232,98501524,,3407776,286608817,54405786,,4289436,223711415,44095738,PDN
EC071,,1982,1954,,8046720,548244136,105599057,,3888416,336543875,63771668,,4158304,211700261,41827389,PDN
EC071,,1983,1954,,8000920,575311739,110369557,,4179696,381640313,72087225,,3821224,193671426,38282332,PDN
EC071,,1984,1954,,8057171,576228049,110588852,,4339078,417008817,78539935,,3718093,159219232,32048917,PDN
EC071,,1985,1954,,8091638,582946692,111818807,,4428649,444457998,83513702,,3662989,138488694,28305105,PDN
EC071,,1986,1954,,8165818,586358960,112500153,,4527477,464410324,87162766,,3638341,121948636,25337387,PDN
EC071,,1987,1954,,8059883,584263721,112021399,,4574379,477283027,89500185,,3485504,106980694,22521214,PDN
EC071,,1988,1954,,5161041,570746165,106717298,,4606111,488247496,91482890,,554930,82498669,15234408,PDN
EC071,,1989,1954,,4994335,559761585,104596041,,4653951,498355837,93329367,,340384,61405748,11266674,PDN
EC071,,1990,1954,,4962497,568060736,106040920,,4686224,508177172,95109208,,276273,59883564,10931712,PDN
EC071,,1991,1954,,4793198,542346670,101296164,,4691505,512291707,95846613,,101693,30054963,5449551,PDN
EC071,,1992,1954,,5232766,549819325,103065386,,4845723,517058352,96848988,,387043,32760973,6216398,PDN
EC071,,1993,1954,,5487828,552196043,103743352,,4995006,521550252,97797542,,492822,30645791,5945810,PDN
EC071,,1994,1954,,5521986,556658883,104571609,,5112510,527804095,99027829,,409476,28854788,5543780,PDN
EC071,,1995,1954,,5777242,576315997,108324572,,5186367,533257382,100072022,,590875,43058615,8252550,PDN
EC071,,1996,1954,,6704258,582720830,110391238,,5439696,540212784,101562967,,1264562,42508046,8828271,PDN
EC071,,1997,1954,,6962260,612178874,115890885,,5604184,548745304,103245697,,1358076,63433570,12645188,PDN
EC071,,1998,1954,,7633943,656692048,124483062,,5663121,556015050,104598183,,1970822,100676998,19884879,PDN
EC071,,1999,1954,,5756339,589325002,110618439,,5682154,561307376,105558911,,74185,28017626,5059528,PDN
EC071,,2000,1954,,5901442,594143280,111620886,,5739700,567028666,106634480,,161742,27114614,4986406,PDN
EC071,,2001,1954,,5925376,598559413,112430609,,5758822,569658142,107121481,,166554,28901271,5309128,PDN
EC071,,2002,1954,,5925377,598561884,112431050,,5767876,571456363,107450503,,157501,27105521,4980547,PDN
EC071,,2003,1954,,6511022,626509161,117989520,,5794203,574386109,107998137,,716819,52123052,9991383,PDN
EC071,,2004,1954,,6452796,620675194,116893222,,6104172,586553830,110473181,,348624,34121364,6420041,PDN
EC071,,2005,1954,,6707665,648533105,122105015,,6261436,595244757,112176873,,446229,53288348,9928142,PDN
EC071,,2006,1954,,7305853,655191656,123887998,,6352695,600862053,113267651,,953158,54329603,10620347,PDN
EC071,,2007,1954,,6818083,643016353,121233804,,6512189,607004501,114520107,,305894,36011852,6713697,PDN
EC071,,2008,1954,,6818046,642640115,121166821,,6566362,610521375,115200059,,251684,32118740,5966762,PDN
EC071,,2009,1954,,6677250,641484972,120820481,,6575104,623155913,117456939,,102146,18329059,3363543,PDN
EC071,,2010,1954,,6677250,641484972,120820481,,6590104,624659222,117739432,,87146,16825750,3081050,PDN
EC071,,2011,1954,,6676791,641381349,120801584,,6597166,625764640,117943188,,79625,15616709,2858398,PDN
EC071,,2012,1954,,6680605,641364519,120802403,,6606270,626581308,118097607,,74335,14783211,2704799,PDN
EC071,,2013,1954,,6683788,642553548,121017157,,6613073,627311378,118234316,,70715,15242170,2782844,PDN
EC071,,2014,1954,,6683862,642580196,121021972,,6617367,627723149,118311878,,66495,14857047,2710097,PDN
EC071,,2015,1954,,6650709,635836931,119788950,,6617367,627723149,118311878,,33342,8113782,1477075,PDN
EC071,,2016,1954,,6650709,635836931,119788950,,6617367,627723149,118311878,,33342,8113782,1477075,PDN
EC071,,2017,1954,,6656579,641706709,120839264,,6617367,627723149,118311878,,39212,13983560,2527389,PDN
EC071,,2017,1954,,6656579,641706709,120839264,,6617367,627723149,118311878,,39212,13983560,2527389,PDN
EC089,,1975,1963,,523001,228203560,41128617,,403168,140480214,25399647,,119833,87723346,15728970,PDN
EC089,,1976,1963,,523001,228203560,41128617,,423819,156650827,28297632,,99182,71552733,12830985,PDN
EC089,,1977,1963,,588669,245697560,44307096,,451781,172639292,31170516,,136888,73058268,13136580,PDN
EC089,,1978,1963,,690033,275128920,49645357,,473566,186170040,33599908,,216467,88958880,16045449,PDN
EC089,,1979,1963,,702928,273247234,49323432,,492908,198963829,35895725,,210020,74283405,13427707,PDN
EC089,,1980,1963,,740106,282037234,50924667,,500497,207724167,37462093,,239609,74313067,13462574,PDN
EC089,,1981,1963,,613225,249346274,44980889,,506849,216270165,38989085,,106376,33076109,5991804,PDN
EC089,,1982,1963,,647700,267167967,48186484,,516671,222725971,40147627,,131029,44441996,8038857,PDN
EC089,,1983,1963,,617799,267167967,48156583,,521816,225839123,40706713,,95983,41328844,7449870,PDN
EC089,,1984,1963,,619188,265946037,47940547,,528972,229472635,41360402,,90216,36473402,6580145,PDN
EC089,,1985,1963,,635635,266435551,48044096,,533560,231284248,41687341,,102075,35151303,6356755,PDN
EC089,,1986,1963,,648119,271967290,49040875,,536126,235571793,42452815,,111993,36395497,6588060,PDN
EC089,,1987,1963,,629650,275577668,49664822,,545750,240777393,43388702,,83900,34800275,6276120,PDN
EC089,,1988,1963,,652656,273626815,49340701,,551722,243668430,43909094,,100934,29958385,5431607,PDN
EC089,,1989,1963,,644970,272980601,49218031,,563674,246073075,44348919,,81296,26907526,4869112,PDN
EC089,,1990,1963,,726837,289313084,52206033,,619531,249071370,44938280,,107306,40241714,7267753,PDN
EC089,,1991,1963,,810936,288778416,52194996,,667264,251229403,45370005,,143672,37549013,6824991,PDN
EC089,,1992,1963,,929746,270604369,49079990,,704290,252142567,45569515,,225456,18461802,3510475,PDN
EC089,,1993,1963,,707697,270093695,48767073,,704834,252922709,45708875,,2863,17170986,3058198,PDN
EC089,,1994,1963,,717435,256521258,46361787,,704863,253236706,45764775,,12572,3284552,597012,PDN
EC089,,1995,1963,,717435,256521258,46361787,,704883,253276951,45771956,,12552,3244307,589831,PDN
EC089,,1996,1963,,706791,256405094,46330473,,705107,253897659,45882626,,1684,2507435,447847,PDN
EC089,,1997,1963,,721225,259942546,46974347,,705207,254525955,45994523,,16018,5416591,979824,PDN
EC089,,1998,1963,,840624,258403114,46819826,,709318,255798254,46225022,,131306,2604860,594804,PDN
EC089,,1999,1963,,725875,260678953,47110030,,716577,256242990,46311415,,9298,4435963,798615,PDN
EC089,,2000,1963,,771040,277496684,50147674,,727628,260481045,47076568,,43412,17015639,3071106,PDN
EC089,,2001,1963,,1654773,284443817,52267552,,821317,265147206,48000535,,833456,19296611,4267017,PDN
EC089,,2002,1963,,2160180,287480152,53313232,,996046,268927955,48847995,,1164134,18552197,4465237,PDN
EC089,,2003,1963,,1986209,288494325,53319719,,1343430,274431566,50174670,,642779,14062759,3145049,PDN
EC089,,2004,1963,,1751257,281506174,51841324,,1551963,279531319,51290632,,199294,1974855,550692,PDN
EC089,,2005,1963,,3586634,302341737,57384096,,1635880,280973763,51631211,,1950754,21367974,5752885,PDN
EC089,,2006,1963,,2411571,302463281,56230660,,1814059,284166761,52377540,,597512,18296520,3853120,PDN
EC089,,2007,1963,,2258396,299671542,55580734,,1976481,286726698,52995466,,281915,12944844,2585268,PDN
EC089,,2008,1963,,2258396,299671542,55580734,,2018169,289187939,53475098,,240227,10483603,2105636,PDN
EC089,,2009,1963,,2043066,294919003,54519757,,2042896,294919003,54519587,,170,0,170,PDN
EC089,,2010,1963,,2043066,294919003,54519757,,2043066,294919003,54519757,,0,0,0,PDN
EC089,,2011,1963,,2043066,294919003,54519757,,2043066,294919003,54519757,,0,0,0,PDN
EC089,,2012,1963,,2043066,294919003,54519757,,2043066,294919003,54519757,,0,0,0,PDN
EC089,,2013,1963,,2043066,294919003,54519757,,2043066,294919003,54519757,,0,0,0,PDN
EC089,,2014,1963,,2043066,294919003,54519757,,2043066,294919003,54519757,,0,0,0,PDN
EC089,,2015,1963,,2043066,294919003,54519757,,2043066,294919003,54519757,,0,0,0,PDN
EC089,,2016,1963,,2043066,294919003,54519757,,2043066,294919003,54519757,,0,0,0,PDN
EC089,,2017,1963,,2043066,294919003,54519757,,2043066,294919003,54519757,,0,0,0,PDN
EC089,,2017,1963,,2043066,294919003,54519757,,2043066,294919003,54519757,,0,0,0,PDN
EC096,,1977,1976,,0,10000000,1779359,,0,0,0,,0,10000000,1779359,PDN
EC096,,1978,1976,,52166,52166000,9334372,,0,0,0,,52166,52166000,9334372,PDN
EC096,,1979,1976,,119000,52166000,9401206,,13421,5837329,1052092,,105579,46328671,8349114,PDN
EC096,,1980,1976,,142000,94333000,16927231,,28932,22142695,3968913,,113068,72190305,12958318,PDN
EC096,,1981,1976,,527600,82042888,15125979,,47526,39881004,7143790,,480074,42161884,7982189,PDN
EC096,,1982,1976,,527600,86717611,15957780,,60322,51179669,9167025,,467278,35537942,6790755,PDN
EC096,,1983,1976,,527600,91802471,16862559,,63919,58414003,10457870,,463681,33388468,6404689,PDN
EC096,,1984,1976,,527600,91802471,16862559,,69293,62907574,11262812,,458307,28894897,5599747,PDN
EC096,,1985,1976,,527600,91802471,16862559,,75979,68721788,12304055,,451621,23080683,4558504,PDN
EC096,,1986,1976,,513074,104741802,19150405,,81888,74000009,13249149,,431186,30741793,5901256,PDN
EC096,,1987,1976,,513074,104741802,19150405,,85964,78270094,14013027,,427110,26471708,5137378,PDN
EC096,,1988,1976,,518441,109625410,20024742,,87731,82124018,14700546,,430710,27501392,5324196,PDN
EC096,,1989,1976,,524471,109726126,20048693,,94730,84843082,15191364,,429741,24883044,4857329,PDN
EC096,,1990,1976,,478146,90878566,16648709,,95094,85366620,15284884,,383052,5511946,1363825,PDN
EC096,,1991,1976,,95102,85439427,15297847,,95102,85439427,15297847,,0,0,0,PDN
EC096,,1992,1976,,95102,85439427,15297847,,95102,85439427,15297847,,0,0,0,PDN
EC096,,1993,1976,,95102,85439427,15297847,,95102,85439427,15297847,,0,0,0,PDN
EC096,,1994,1976,,95102,85439427,15297847,,95102,85439427,15297847,,0,0,0,PDN
EC096,,1995,1976,,95102,85439427,15297847,,95102,85439427,15297847,,0,0,0,PDN
EC096,,1996,1976,,95102,85439427,15297847,,95102,85439427,15297847,,0,0,0,PDN
EC096,,1997,1976,,95102,85439427,15297847,,95102,85439427,15297847,,0,0,0,PDN
EC096,,1998,1976,,95102,85439427,15297847,,95102,85439427,15297847,,0,0,0,PDN
EC096,,1999,1976,,95102,85439427,15297847,,95102,85439427,15297847,,0,0,0,PDN
EC096,,2000,1976,,95102,85439427,15297847,,95102,85439427,15297847,,0,0,0,PDN
EC096,,2001,1976,,100046,90226519,16154587,,95931,87129060,15599322,,4115,3097459,555265,PDN
EC096,,2002,1976,,98859,90149684,16139728,,98110,89319477,15991255,,749,830207,148473,PDN
EC096,,2003,1976,,98859,90149684,16139728,,98120,89766844,16070868,,739,382840,68860,PDN
EC096,,2004,1976,,98120,89766844,16070868,,98120,89766844,16070868,,0,0,0,PDN
EC096,,2005,1976,,98120,89766844,16070868,,98120,89766844,16070868,,0,0,0,PDN
EC096,,2006,1976,,98120,89766844,16070868,,98120,89766844,16070868,,0,0,0,PDN
EC096,,2007,1976,,98120,89766844,16070868,,98120,89766844,16070868,,0,0,0,PDN
EC096,,2008,1976,,96701,87700798,15701825,,96701,87700798,15701825,,0,0,0,PDN
EC096,,2009,1976,,96701,89411900,16006293,,96701,89411900,16006293,,0,0,0,PDN
EC096,,2010,1976,,96701,89411900,16006293,,96701,89411900,16006293,,0,0,0,PDN
EC096,,2011,1976,,96701,89411900,16006293,,96701,89411900,16006293,,0,0,0,PDN
EC096,,2012,1976,,96701,89411900,16006293,,96701,89411900,16006293,,0,0,0,PDN
EC096,,2013,1976,,96701,89411900,16006293,,96701,89411900,16006293,,0,0,0,PDN
EC096,,2014,1976,,96701,89411900,16006293,,96701,89411900,16006293,,0,0,0,PDN
EC096,,2015,1976,,96701,89411900,16006293,,96701,89411900,16006293,,0,0,0,PDN
EC096,,2016,1976,,96701,89411900,16006293,,96701,89411900,16006293,,0,0,0,PDN
EC096,,2017,1976,,96701,89411900,16006293,,96701,89411900,16006293,,0,0,0,PDN
EC096,,2017,1976,,96701,89411900,16006293,,96701,89411900,16006293,,0,0,0,PDN
EC106,,1988,1988,,1795235,10398986,3645588,,0,0,0,,1795235,10398986,3645588,PDN
EC106,,1989,1988,,1795235,10398986,3645588,,0,0,0,,1795235,10398986,3645588,PDN
EC106,,1990,1988,,2154982,13939766,4635367,,149736,5219298,1078437,,2005246,8720468,3556930,PDN
EC106,,1991,1988,,2154982,13939766,4635367,,179054,5833481,1217040,,1975928,8106285,3418327,PDN
EC106,,1992,1988,,179054,5833481,1217040,,179054,5833481,1217040,,0,0,0,PDN
EC106,,1993,1988,,179054,5833481,1217040,,179054,5833481,1217040,,0,0,0,PDN
EC106,,1994,1988,,179054,5833481,1217040,,179054,5833481,1217040,,0,0,0,PDN
EC106,,1995,1988,,179054,5833481,1217040,,179054,5833481,1217040,,0,0,0,PDN
EC106,,1996,1988,,179054,5833481,1217040,,179054,5833481,1217040,,0,0,0,PDN
EC106,,1997,1988,,179054,5833481,1217040,,179054,5833481,1217040,,0,0,0,PDN
EC106,,1998,1988,,179054,5833481,1217040,,179054,5833481,1217040,,0,0,0,PDN
EC106,,1999,1988,,179054,5833481,1217040,,179054,5833481,1217040,,0,0,0,PDN
EC106,,2000,1988,,179054,5833481,1217040,,179054,5833481,1217040,,0,0,0,PDN
EC106,,2001,1988,,179054,5833481,1217040,,179054,5833481,1217040,,0,0,0,PDN
EC106,,2002,1988,,179054,5833481,1217040,,179054,5833481,1217040,,0,0,0,PDN
EC106,,2003,1988,,179054,5833481,1217040,,179054,5833481,1217040,,0,0,0,PDN
EC106,,2004,1988,,179054,5833481,1217040,,179054,5833481,1217040,,0,0,0,PDN
EC106,,2005,1988,,179054,5833481,1217040,,179054,5833481,1217040,,0,0,0,PDN
EC106,,2006,1988,,179054,5833481,1217040,,179054,5833481,1217040,,0,0,0,PDN
EC106,,2007,1988,,179054,5833481,1217040,,179054,5833481,1217040,,0,0,0,PDN
EC106,,2008,1988,,179054,5833481,1217040,,179054,5833481,1217040,,0,0,0,PDN
EC106,,2009,1988,,179054,5950307,1237827,,179054,5950307,1237827,,0,0,0,PDN
EC106,,2010,1988,,179054,5950307,1237827,,179054,5950307,1237827,,0,0,0,PDN
EC106,,2011,1988,,179054,5950307,1237827,,179054,5950307,1237827,,0,0,0,PDN
EC106,,2012,1988,,179054,5950307,1237827,,179054,5950307,1237827,,0,0,0,PDN
EC106,,2013,1988,,179054,5950307,1237827,,179054,5950307,1237827,,0,0,0,PDN
EC106,,2014,1988,,179054,5950307,1237827,,179054,5950307,1237827,,0,0,0,PDN
EC106,,2015,1988,,179054,5950307,1237827,,179054,5950307,1237827,,0,0,0,PDN
EC106,,2016,1988,,179054,5950307,1237827,,179054,5950307,1237827,,0,0,0,PDN
EC106,,2017,1988,,179054,5950307,1237827,,179054,5950307,1237827,,0,0,0,PDN
EC106,,2017,1988,,179054,5950307,1237827,,179054,5950307,1237827,,0,0,0,PDN
EC115,,2008,1957,,1419,2066046,369043,,1419,2066046,369043,,0,0,0,PDN
EC115,,2009,1957,,1419,2066046,369043,,1419,2066046,369043,,0,0,0,PDN
EC115,,2010,1957,,1419,2066046,369043,,1419,2066046,369043,,0,0,0,PDN
EC115,,2011,1957,,1419,2066046,369043,,1419,2066046,369043,,0,0,0,PDN
EC115,,2012,1957,,1419,2066046,369043,,1419,2066046,369043,,0,0,0,PDN
EC115,,2013,1957,,1419,2066046,369043,,1419,2066046,369043,,0,0,0,PDN
EC115,,2014,1957,,1419,2066046,369043,,1419,2066046,369043,,0,0,0,PDN
EC115,,2015,1957,,1419,2066046,369043,,1419,2066046,369043,,0,0,0,PDN
EC115,,2016,1957,,1419,2066046,369043,,1419,2066046,369043,,0,0,0,PDN
EC115,,2017,1957,,1419,2066046,369043,,1419,2066046,369043,,0,0,0,PDN
EC115,,2017,1957,,1419,2066046,369043,,1419,2066046,369043,,0,0,0,PDN
EC117,,1988,1988,,77128,8946820,1669089,,0,72044,12819,,77128,8874776,1656270,PDN
EC117,,1989,1988,,77128,8946820,1669089,,213,1515734,269917,,76915,7431086,1399172,PDN
EC117,,1990,1988,,29544,8946820,1621505,,768,3068292,546727,,28776,5878528,1074778,PDN
EC117,,1991,1988,,30412,8946820,1622373,,1375,4124304,735237,,29037,4822516,887136,PDN
EC117,,1992,1988,,2328,6434469,1147251,,1687,4918701,876901,,641,1515768,270350,PDN
EC117,,1993,1988,,2328,7294649,1300308,,1888,5873501,1046995,,440,1421148,253313,PDN
EC117,,1994,1988,,5016,11800781,2104799,,3992,8370188,1493349,,1024,3430593,611450,PDN
EC117,,1995,1988,,3994,8445726,1506792,,3994,8445726,1506792,,0,0,0,PDN
EC117,,1996,1988,,3994,8445726,1506792,,3994,8445726,1506792,,0,0,0,PDN
EC117,,1997,1988,,3994,8445726,1506792,,3994,8445726,1506792,,0,0,0,PDN
EC117,,1998,1988,,3994,8445726,1506792,,3994,8445726,1506792,,0,0,0,PDN
EC117,,1999,1988,,3994,8445726,1506792,,3994,8445726,1506792,,0,0,0,PDN
EC117,,2000,1988,,3994,8445726,1506792,,3994,8445726,1506792,,0,0,0,PDN
EC117,,2001,1988,,3994,8445726,1506792,,3994,8445726,1506792,,0,0,0,PDN
EC117,,2002,1988,,3994,8445726,1506792,,3994,8445726,1506792,,0,0,0,PDN
EC117,,2003,1988,,3994,8445726,1506792,,3994,8445726,1506792,,0,0,0,PDN
EC117,,2004,1988,,3994,8445726,1506792,,3994,8445726,1506792,,0,0,0,PDN
EC117,,2005,1988,,3994,8445726,1506792,,3994,8445726,1506792,,0,0,0,PDN
EC117,,2006,1988,,3994,8445726,1506792,,3994,8445726,1506792,,0,0,0,PDN
EC117,,2007,1988,,3994,8445726,1506792,,3994,8445726,1506792,,0,0,0,PDN
EC117,,2008,1988,,3994,8445726,1506792,,3994,8445726,1506792,,0,0,0,PDN
EC117,,2009,1988,,3994,8614868,1536889,,3994,8614868,1536889,,0,0,0,PDN
EC117,,2010,1988,,3994,8614868,1536889,,3994,8614868,1536889,,0,0,0,PDN
EC117,,2011,1988,,3994,8614868,1536889,,3994,8614868,1536889,,0,0,0,PDN
EC117,,2012,1988,,3994,8614868,1536889,,3994,8614868,1536889,,0,0,0,PDN
EC117,,2013,1988,,3994,8614868,1536889,,3994,8614868,1536889,,0,0,0,PDN
EC117,,2014,1988,,3994,8614868,1536889,,3994,8614868,1536889,,0,0,0,PDN
EC117,,2015,1988,,3994,8614868,1536889,,3994,8614868,1536889,,0,0,0,PDN
EC117,,2016,1988,,3994,8614868,1536889,,3994,8614868,1536889,,0,0,0,PDN
EC117,,2017,1988,,3994,8614868,1536889,,3994,8614868,1536889,,0,0,0,PDN
EC117,,2017,1988,,3994,8614868,1536889,,3994,8614868,1536889,,0,0,0,PDN
EC118,,1975,1966,,16724,14256000,2553379,,424,1085729,193614,,16300,13170271,2359765,PDN
EC118,,1976,1966,,16724,14256000,2553379,,4041,2724647,488854,,12683,11531353,2064525,PDN
EC118,,1977,1966,,21839,13260000,2381270,,6938,4688716,841229,,14901,8571284,1540041,PDN
EC118,,1978,1966,,33071,22443030,4026493,,8911,8026546,1437122,,24160,14416484,2589371,PDN
EC118,,1979,1966,,33071,23443030,4204429,,12940,11831920,2118264,,20131,11611110,2086165,PDN
EC118,,1980,1966,,38462,30305010,5430813,,15514,15084446,2699579,,22948,15220564,2731234,PDN
EC118,,1981,1966,,38462,30305010,5430813,,16877,17043979,3049613,,21585,13261031,2381200,PDN
EC118,,1982,1966,,38399,35217802,6304912,,17318,17792186,3183187,,21081,17425616,3121725,PDN
EC118,,1983,1966,,18269,25066813,4478556,,17352,18304337,3274351,,917,6762476,1204205,PDN
EC118,,1984,1966,,18269,25066813,4478556,,17355,18859159,3373077,,914,6207654,1105479,PDN
EC118,,1985,1966,,20768,26799600,4789380,,17379,19036917,3404731,,3389,7762683,1384649,PDN
EC118,,1986,1966,,28920,28308163,5065960,,17423,19151239,3425117,,11497,9156924,1640843,PDN
EC118,,1987,1966,,17423,19151239,3425117,,17423,19151239,3425117,,0,0,0,PDN
EC118,,1988,1966,,17423,19151239,3425117,,17423,19151239,3425117,,0,0,0,PDN
EC118,,1989,1966,,17423,19151239,3425117,,17423,19151239,3425117,,0,0,0,PDN
EC118,,1990,1966,,17423,19151239,3425117,,17423,19151239,3425117,,0,0,0,PDN
EC118,,1991,1966,,17423,19151239,3425117,,17423,19151239,3425117,,0,0,0,PDN
EC118,,1992,1966,,17423,19151239,3425117,,17423,19151239,3425117,,0,0,0,PDN
EC118,,1993,1966,,17423,19151239,3425117,,17423,19151239,3425117,,0,0,0,PDN
EC118,,1994,1966,,17423,19151239,3425117,,17423,19151239,3425117,,0,0,0,PDN
EC118,,1995,1966,,17423,19151239,3425117,,17423,19151239,3425117,,0,0,0,PDN
EC118,,1996,1966,,17423,19151239,3425117,,17423,19151239,3425117,,0,0,0,PDN
EC118,,1997,1966,,68063,31881376,5740906,,17682,19667394,3517218,,50381,12213982,2223688,PDN
EC118,,1998,1966,,67287,31097943,5600729,,22482,22528427,4031099,,44805,8569516,1569630,PDN
EC118,,1999,1966,,49380,28563080,5131779,,23908,23345272,4177871,,25472,5217808,953908,PDN
EC118,,2000,1966,,75967,30965781,5585893,,24952,24013085,4297743,,51015,6952696,1288150,PDN
EC118,,2001,1966,,24952,24015906,4298245,,24952,24015906,4298245,,0,0,0,PDN
EC118,,2002,1966,,24952,24015906,4298245,,24952,24015906,4298245,,0,0,0,PDN
EC118,,2003,1966,,24952,24015906,4298245,,24952,24015906,4298245,,0,0,0,PDN
EC118,,2004,1966,,24952,24015906,4298245,,24952,24015906,4298245,,0,0,0,PDN
EC118,,2005,1966,,24952,24015906,4298245,,24952,24015906,4298245,,0,0,0,PDN
EC118,,2006,1966,,24952,24015906,4298245,,24952,24015906,4298245,,0,0,0,PDN
EC118,,2007,1966,,24952,24015906,4298245,,24952,24015906,4298245,,0,0,0,PDN
EC118,,2008,1966,,24952,24015906,4298245,,24952,24015906,4298245,,0,0,0,PDN
EC118,,2009,1966,,24952,24435916,4372980,,24952,24435916,4372980,,0,0,0,PDN
EC118,,2010,1966,,24952,24435916,4372980,,24952,24435916,4372980,,0,0,0,PDN
EC118,,2011,1966,,24952,24435916,4372980,,24952,24435916,4372980,,0,0,0,PDN
EC118,,2012,1966,,24952,24435916,4372980,,24952,24435916,4372980,,0,0,0,PDN
EC118,,2013,1966,,24952,24435916,4372980,,24952,24435916,4372980,,0,0,0,PDN
EC118,,2014,1966,,24952,24435916,4372980,,24952,24435916,4372980,,0,0,0,PDN
EC118,,2015,1966,,24952,24435916,4372980,,24952,24435916,4372980,,0,0,0,PDN
EC118,,2016,1966,,24952,24435916,4372980,,24952,24435916,4372980,,0,0,0,PDN
EC118,,2017,1966,,24952,24435916,4372980,,24952,24435916,4372980,,0,0,0,PDN
EC118,,2017,1966,,24952,24435916,4372980,,24952,24435916,4372980,,0,0,0,PDN
EC121,,1987,1986,,221208,13826299,2681404,,51907,3744488,718186,,169301,10081811,1963218,PDN
EC121,,1988,1986,,886637,59776804,11523079,,144116,10637121,2036842,,742521,49139683,9486237,PDN
EC121,,1989,1986,,903763,59776804,11540205,,289696,17061584,3325565,,614067,42715220,8214640,PDN
EC121,,1990,1986,,903763,59776804,11540205,,379240,19825625,3906931,,524523,39951179,7633274,PDN
EC121,,1991,1986,,414834,20102285,3991753,,414834,20102285,3991753,,0,0,0,PDN
EC121,,1992,1986,,414834,20102285,3991753,,414834,20102285,3991753,,0,0,0,PDN
EC121,,1993,1986,,414834,20102285,3991753,,414834,20102285,3991753,,0,0,0,PDN
EC121,,1994,1986,,414834,20102285,3991753,,414834,20102285,3991753,,0,0,0,PDN
EC121,,1995,1986,,414834,20102285,3991753,,414834,20102285,3991753,,0,0,0,PDN
EC121,,1996,1986,,414834,20102285,3991753,,414834,20102285,3991753,,0,0,0,PDN
EC121,,1997,1986,,414834,20102285,3991753,,414834,20102285,3991753,,0,0,0,PDN
EC121,,1998,1986,,414834,20102285,3991753,,414834,20102285,3991753,,0,0,0,PDN
EC121,,1999,1986,,414834,20102285,3991753,,414834,20102285,3991753,,0,0,0,PDN
EC121,,2000,1986,,414834,20102285,3991753,,414834,20102285,3991753,,0,0,0,PDN
EC121,,2001,1986,,414834,20102285,3991753,,414834,20102285,3991753,,0,0,0,PDN
EC121,,2002,1986,,414834,20102285,3991753,,414834,20102285,3991753,,0,0,0,PDN
EC121,,2003,1986,,414834,20102285,3991753,,414834,20102285,3991753,,0,0,0,PDN
EC121,,2004,1986,,414834,20102285,3991753,,414834,20102285,3991753,,0,0,0,PDN
EC121,,2005,1986,,665791,32067072,6371676,,414834,20102285,3991753,,250957,11964787,2379923,PDN
EC121,,2006,1986,,946267,43717050,8725101,,468837,22170988,4413853,,477430,21546062,4311248,PDN
EC121,,2007,1986,,946268,43717316,8725150,,595103,26746116,5354198,,351165,16971200,3370952,PDN
EC121,,2008,1986,,978856,37362900,7627059,,659706,31486542,6262294,,319150,5876358,1364765,PDN
EC121,,2009,1986,,977521,37566118,7661883,,672233,33129971,6567245,,305288,4436147,1094638,PDN
EC121,,2010,1986,,977521,37566118,7661883,,714393,33974209,6759625,,263128,3591909,902258,PDN
EC121,,2011,1986,,890420,37188135,7507525,,848916,34279031,6948387,,41504,2909104,559138,PDN
EC121,,2012,1986,,890420,37188135,7507525,,863306,34297348,6966036,,27114,2890787,541489,PDN
EC121,,2013,1986,,863306,34297348,6966036,,863306,34297348,6966036,,0,0,0,PDN
EC121,,2014,1986,,863306,34297348,6966036,,863306,34297348,6966036,,0,0,0,PDN
EC121,,2015,1986,,863306,34297348,6966036,,863306,34297348,6966036,,0,0,0,PDN
EC121,,2016,1986,,863306,34297348,6966036,,863306,34297348,6966036,,0,0,0,PDN
EC121,,2017,1986,,863306,34297348,6966036,,863306,34297348,6966036,,0,0,0,PDN
EC121,,2017,1986,,863306,34297348,6966036,,863306,34297348,6966036,,0,0,0,PDN
EC136,,1995,1995,,1072,14859377,2645089,,50,1248652,222230,,1022,13610725,2422859,PDN
EC136,,1996,1995,,1072,14859377,2645089,,191,4095345,728900,,881,10764032,1916189,PDN
EC136,,1997,1995,,1072,14859377,2645089,,505,6211177,1105697,,567,8648200,1539392,PDN
EC136,,1998,1995,,1072,14859377,2645089,,603,8053878,1433677,,469,6805499,1211412,PDN
EC136,,1999,1995,,603,8138044,1448654,,603,8138044,1448654,,0,0,0,PDN
EC136,,2000,1995,,1189,11887501,2116403,,606,8164874,1453431,,583,3722627,662972,PDN
EC136,,2001,1995,,785,8205476,1460834,,785,8205476,1460834,,0,0,0,PDN
EC136,,2002,1995,,792,8207492,1461200,,792,8207492,1461200,,0,0,0,PDN
EC136,,2003,1995,,792,8207492,1461200,,792,8207492,1461200,,0,0,0,PDN
EC136,,2004,1995,,792,8207492,1461200,,792,8207492,1461200,,0,0,0,PDN
EC136,,2005,1995,,792,8207492,1461200,,792,8207492,1461200,,0,0,0,PDN
EC136,,2006,1995,,792,8207492,1461200,,792,8207492,1461200,,0,0,0,PDN
EC136,,2007,1995,,792,8207492,1461200,,792,8207492,1461200,,0,0,0,PDN
EC136,,2008,1995,,792,8207492,1461200,,792,8207492,1461200,,0,0,0,PDN
EC136,,2009,1995,,792,8365614,1489335,,792,8365614,1489335,,0,0,0,PDN
EC136,,2010,1995,,792,8365614,1489335,,792,8365614,1489335,,0,0,0,PDN
EC136,,2011,1995,,792,8365614,1489335,,792,8365614,1489335,,0,0,0,PDN
EC136,,2012,1995,,792,8365614,1489335,,792,8365614,1489335,,0,0,0,PDN
EC136,,2013,1995,,792,8365614,1489335,,792,8365614,1489335,,0,0,0,PDN
EC136,,2014,1995,,792,8365614,1489335,,792,8365614,1489335,,0,0,0,PDN
EC136,,2015,1995,,792,8365614,1489335,,792,8365614,1489335,,0,0,0,PDN
EC136,,2016,1995,,792,8365614,1489335,,792,8365614,1489335,,0,0,0,PDN
EC136,,2017,1995,,792,8365614,1489335,,792,8365614,1489335,,0,0,0,PDN
EC136,,2017,1995,,792,8365614,1489335,,792,8365614,1489335,,0,0,0,PDN
EC138,,1994,1962,,7438,743794,139786,,0,0,0,,7438,743794,139786,PDN
EC138,,1995,1962,,39975,22705833,4080159,,664,2832111,504598,,39311,19873722,3575561,PDN
EC138,,1996,1962,,34794,10240696,1856982,,1180,6228668,1109484,,33614,4012028,747498,PDN
EC138,,1997,1962,,25741,10569278,1906395,,1359,7223248,1286634,,24382,3346030,619761,PDN
EC138,,1998,1962,,25741,10569278,1906395,,1359,7223248,1286634,,24382,3346030,619761,PDN
EC138,,1999,1962,,568830,19120018,3970969,,261173,10717310,2168168,,307657,8402708,1802801,PDN
EC138,,2000,1962,,703672,23367484,4861588,,402799,13570629,2817502,,300873,9796855,2044086,PDN
EC138,,2001,1962,,453896,18982024,3831481,,425663,15301995,3148438,,28233,3680029,683043,PDN
EC138,,2002,1962,,453900,19102670,3852952,,426147,15448643,3175016,,27753,3654027,677936,PDN
EC138,,2003,1962,,453900,19102670,3852952,,426147,15448643,3175016,,27753,3654027,677936,PDN
EC138,,2004,1962,,453900,19102670,3852952,,426147,15448643,3175016,,27753,3654027,677936,PDN
EC138,,2005,1962,,457784,19613958,3947812,,426147,15448643,3175016,,31637,4165315,772796,PDN
EC138,,2006,1962,,457784,19613958,3947812,,426147,15448643,3175016,,31637,4165315,772796,PDN
EC138,,2007,1962,,457784,19613958,3947812,,426147,15448643,3175016,,31637,4165315,772796,PDN
EC138,,2008,1962,,426147,15448643,3175016,,426147,15448643,3175016,,0,0,0,PDN
EC138,,2009,1962,,426147,15593303,3200756,,426147,15593303,3200756,,0,0,0,PDN
EC138,,2010,1962,,426147,15593303,3200756,,426147,15593303,3200756,,0,0,0,PDN
EC138,,2011,1962,,426147,15593303,3200756,,426147,15593303,3200756,,0,0,0,PDN
EC138,,2012,1962,,426147,15593303,3200756,,426147,15593303,3200756,,0,0,0,PDN
EC138,,2013,1962,,426147,15593303,3200756,,426147,15593303,3200756,,0,0,0,PDN
EC138,,2014,1962,,426147,15593303,3200756,,426147,15593303,3200756,,0,0,0,PDN
EC138,,2015,1962,,426147,15593303,3200756,,426147,15593303,3200756,,0,0,0,PDN
EC138,,2016,1962,,426147,15593303,3200756,,426147,15593303,3200756,,0,0,0,PDN
EC138,,2017,1962,,426147,15593303,3200756,,426147,15593303,3200756,,0,0,0,PDN
EC138,,2017,1962,,426147,15593303,3200756,,426147,15593303,3200756,,0,0,0,PDN
EC142,,1984,1982,,208562,20856189,3919628,,0,2780249,494706,,208562,18075940,3424922,PDN
EC142,,1985,1982,,378878,42351774,7914781,,0,8023815,1427725,,378878,34327959,6487056,PDN
EC142,,1986,1982,,378878,42351774,7914781,,0,10147634,1805629,,378878,32204140,6109152,PDN
EC142,,1987,1982,,378878,42351774,7914781,,0,10822023,1925627,,378878,31529751,5989154,PDN
EC142,,1988,1982,,373100,42351774,7909003,,0,11283169,2007681,,373100,31068605,5901322,PDN
EC142,,1989,1982,,0,11337014,2017262,,0,11337014,2017262,,0,0,0,PDN
EC142,,1990,1982,,0,11337014,2017262,,0,11337014,2017262,,0,0,0,PDN
EC142,,1991,1982,,0,11337014,2017262,,0,11337014,2017262,,0,0,0,PDN
EC142,,1992,1982,,0,11337014,2017262,,0,11337014,2017262,,0,0,0,PDN
EC142,,1993,1982,,0,11337014,2017262,,0,11337014,2017262,,0,0,0,PDN
EC142,,1994,1982,,0,11337014,2017262,,0,11337014,2017262,,0,0,0,PDN
EC142,,1995,1982,,0,11337014,2017262,,0,11337014,2017262,,0,0,0,PDN
EC142,,1996,1982,,0,11337014,2017262,,0,11337014,2017262,,0,0,0,PDN
EC142,,1997,1982,,0,11337014,2017262,,0,11337014,2017262,,0,0,0,PDN
EC142,,1998,1982,,0,11337014,2017262,,0,11337014,2017262,,0,0,0,PDN
EC142,,1999,1982,,0,11337014,2017262,,0,11337014,2017262,,0,0,0,PDN
EC142,,2000,1982,,0,11337014,2017262,,0,11337014,2017262,,0,0,0,PDN
EC142,,2001,1982,,1873,19808396,3526499,,155,13202386,2349334,,1718,6606010,1177165,PDN
EC142,,2002,1982,,2572,19808396,3527198,,514,14448645,2571447,,2058,5359751,955751,PDN
EC142,,2003,1982,,6019,18067661,3220905,,1314,15416287,2744426,,4705,2651374,476479,PDN
EC142,,2004,1982,,216960,23359089,4373382,,3694,16609103,2959050,,213266,6749986,1414332,PDN
EC142,,2005,1982,,235999,20714235,3921806,,67103,18392323,3339758,,168896,2321912,582048,PDN
EC142,,2006,1982,,147833,19467786,3611852,,95016,18868295,3452364,,52817,599491,159488,PDN
EC142,,2007,1982,,111479,19054485,3501957,,111361,19053866,3501729,,118,619,228,PDN
EC142,,2008,1982,,111479,19076645,3505900,,111479,19076645,3505900,,0,0,0,PDN
EC142,,2009,1982,,111479,19303697,3546300,,111479,19303697,3546300,,0,0,0,PDN
EC142,,2010,1982,,111479,19303697,3546300,,111479,19303697,3546300,,0,0,0,PDN
EC142,,2011,1982,,111479,19303697,3546300,,111479,19303697,3546300,,0,0,0,PDN
EC142,,2012,1982,,111479,19303697,3546300,,111479,19303697,3546300,,0,0,0,PDN
EC142,,2013,1982,,111479,19303697,3546300,,111479,19303697,3546300,,0,0,0,PDN
EC142,,2014,1982,,111479,19303697,3546300,,111479,19303697,3546300,,0,0,0,PDN
EC142,,2015,1982,,111479,19303697,3546300,,111479,19303697,3546300,,0,0,0,PDN
EC142,,2016,1982,,111479,19303697,3546300,,111479,19303697,3546300,,0,0,0,PDN
EC142,,2017,1982,,111479,19303697,3546300,,111479,19303697,3546300,,0,0,0,PDN
EC142,,2017,1982,,111479,19303697,3546300,,111479,19303697,3546300,,0,0,0,PDN
EC144,,2000,2000,,222650,11132481,2203519,,11628,142996,37072,,211022,10989485,2166447,PDN
EC144,,2001,2000,,531409,11132481,2512278,,187986,3255644,767282,,343423,7876837,1744996,PDN
EC144,,2002,2000,,401529,10708789,2307007,,280315,5610337,1278596,,121214,5098452,1028411,PDN
EC144,,2003,2000,,401529,10708789,2307007,,322179,7298800,1620898,,79350,3409989,686109,PDN
EC144,,2004,2000,,450476,11361000,2472006,,344644,8453180,1848769,,105832,2907820,623237,PDN
EC144,,2005,2000,,424129,12068600,2571567,,359896,9165197,1990714,,64233,2903403,580853,PDN
EC144,,2006,2000,,390011,10635600,2282467,,374359,9816175,2121009,,15652,819425,161458,PDN
EC144,,2007,2000,,390011,10635600,2282467,,381702,10184012,2193804,,8309,451588,88663,PDN
EC144,,2008,2000,,390011,10635600,2282467,,383512,10330540,2221686,,6499,305060,60781,PDN
EC144,,2009,2000,,390011,10635600,2282467,,386076,10486257,2251958,,3935,149343,30508,PDN
EC144,,2010,2000,,399026,11126439,2378819,,389593,10660111,2286410,,9433,466328,92410,PDN
EC144,,2011,2000,,399026,11126439,2378819,,392205,10800954,2314083,,6821,325485,64736,PDN
EC144,,2012,2000,,399026,11126439,2378819,,393450,10860465,2325917,,5576,265974,52902,PDN
EC144,,2013,2000,,393510,10863532,2326523,,393510,10863532,2326523,,0,0,0,PDN
EC144,,2014,2000,,393510,10863532,2326523,,393510,10863532,2326523,,0,0,0,PDN
EC144,,2015,2000,,393510,10863532,2326523,,393510,10863532,2326523,,0,0,0,PDN
EC144,,2016,2000,,393510,10863532,2326523,,393510,10863532,2326523,,0,0,0,PDN
EC144,,2017,2000,,393510,10863532,2326523,,393510,10863532,2326523,,0,0,0,PDN
EC144,,2017,2000,,393510,10863532,2326523,,393510,10863532,2326523,,0,0,0,PDN
EC148,,1991,1988,,266178,18106576,3487989,,70308,5465326,1042786,,195870,12641250,2445203,PDN
EC148,,1992,1988,,378564,30217002,5755255,,185033,14794487,2817504,,193531,15422515,2937751,PDN
EC148,,1993,1988,,603328,45516962,8702432,,259514,21148469,4022587,,343814,24368493,4679845,PDN
EC148,,1994,1988,,614691,46977158,8973616,,312186,26796037,5080164,,302505,20181121,3893452,PDN
EC148,,1995,1988,,593390,68182382,12725486,,368149,32433037,6139152,,225241,35749345,6586334,PDN
EC148,,1996,1988,,540114,27790628,5485066,,297424,18513507,3591642,,242690,9277121,1893424,PDN
EC148,,1997,1988,,540114,27790628,5485066,,376443,22200052,4326630,,163671,5590576,1158436,PDN
EC148,,1998,1988,,540114,27790628,5485066,,415496,24369708,4751743,,124618,3420920,733323,PDN
EC148,,1999,1988,,540114,27790628,5485066,,432888,25406829,4953676,,107226,2383799,531390,PDN
EC148,,2000,1988,,585707,31190740,6135661,,465173,27867871,5423869,,120534,3322869,711792,PDN
EC148,,2001,1988,,520614,31280114,6086471,,479101,28554812,5560028,,41513,2725302,526443,PDN
EC148,,2002,1988,,520614,31280114,6086471,,482653,28829580,5612472,,37961,2450534,473999,PDN
EC148,,2003,1988,,549953,33180308,6453922,,492029,29439620,5730396,,57924,3740688,723526,PDN
EC148,,2004,1988,,534395,31755545,6184848,,508530,30490220,5933836,,25865,1265325,251012,PDN
EC148,,2005,1988,,521482,31496588,6125857,,520729,31433219,6113828,,753,63369,12029,PDN
EC148,,2006,1988,,521482,31496588,6125857,,521482,31496588,6125857,,0,0,0,PDN
EC148,,2007,1988,,521482,31496588,6125857,,521482,31496588,6125857,,0,0,0,PDN
EC148,,2008,1988,,521482,31496588,6125857,,521482,31496588,6125857,,0,0,0,PDN
EC148,,2009,1988,,521482,31976584,6211267,,521482,31976584,6211267,,0,0,0,PDN
EC148,,2010,1988,,521482,31976584,6211267,,521482,31976584,6211267,,0,0,0,PDN
EC148,,2011,1988,,521482,31976584,6211267,,521482,31976584,6211267,,0,0,0,PDN
EC148,,2012,1988,,521482,31976584,6211267,,521482,31976584,6211267,,0,0,0,PDN
EC148,,2013,1988,,521482,31976584,6211267,,521482,31976584,6211267,,0,0,0,PDN
EC148,,2014,1988,,521482,31976584,6211267,,521482,31976584,6211267,,0,0,0,PDN
EC148,,2015,1988,,521482,31976584,6211267,,521482,31976584,6211267,,0,0,0,PDN
EC148,,2016,1988,,521482,31976584,6211267,,521482,31976584,6211267,,0,0,0,PDN
EC148,,2017,1988,,521482,31976584,6211267,,521482,31976584,6211267,,0,0,0,PDN
EC148,,2017,1988,,521482,31976584,6211267,,521482,31976584,6211267,,0,0,0,PDN
EC151,,1988,1987,,81276,14865839,2726443,,0,0,0,,81276,14865839,2726443,PDN
EC151,,1989,1987,,103145,21209025,3876993,,12429,6566671,1180876,,90716,14642354,2696117,PDN
EC151,,1990,1987,,120698,38538879,6978150,,18248,13658288,2448548,,102450,24880591,4529602,PDN
EC151,,1991,1987,,120608,42463446,7676381,,22302,20409649,3653912,,98306,22053797,4022469,PDN
EC151,,1992,1987,,47124,44479707,7961663,,24196,24188806,4328254,,22928,20290901,3633409,PDN
EC151,,1993,1987,,47026,43313924,7754130,,24837,25750797,4606829,,22189,17563127,3147301,PDN
EC151,,1994,1987,,46993,43283839,7748744,,28387,29634582,5301444,,18606,13649257,2447300,PDN
EC151,,1995,1987,,434819,71087364,13083816,,285375,42946629,7927124,,149444,28140735,5156692,PDN
EC151,,1996,1987,,1624838,94473390,18435050,,593070,56877355,10713596,,1031768,37596035,7721454,PDN
EC151,,1997,1987,,1518729,86673740,16941103,,996389,76644369,14634177,,522340,10029371,2306926,PDN
EC151,,1998,1987,,1668105,114736005,22083764,,1174180,88350118,16894842,,493925,26385887,5188922,PDN
EC151,,1999,1987,,1511045,114647670,21910986,,1267196,98910974,18867013,,243849,15736696,3043973,PDN
EC151,,2000,1987,,1573023,124987222,23812742,,1314467,105558771,20097166,,258556,19428451,3715576,PDN
EC151,,2001,1987,,1428190,124611257,23601012,,1347152,110025027,20924559,,81038,14586230,2676453,PDN
EC151,,2002,1987,,1391489,118845916,22538449,,1357683,111656514,21225390,,33806,7189402,1313059,PDN
EC151,,2003,1987,,1371213,118162027,22396485,,1361307,114417004,21720205,,9906,3745023,676280,PDN
EC151,,2004,1987,,1382072,120057677,22744648,,1370940,116935835,22178028,,11132,3121842,566620,PDN
EC151,,2005,1987,,1392530,122328037,23159085,,1387432,120212263,22777514,,5098,2115774,381571,PDN
EC151,,2006,1987,,1432595,124557067,23595774,,1387912,120594439,22845997,,44683,3962628,749777,PDN
EC151,,2007,1987,,1432592,124523205,23589746,,1397844,121537189,23023678,,34748,2986016,566068,PDN
EC151,,2008,1987,,1432594,124526032,23590251,,1406171,122244071,23157785,,26423,2281961,432466,PDN
EC151,,2009,1987,,1438721,126282057,23908837,,1409267,124119451,23494577,,29454,2162606,414259,PDN
EC151,,2010,1987,,1438721,126282057,23908837,,1414858,124260041,23525185,,23863,2022016,383652,PDN
EC151,,2011,1987,,1427718,124991970,23668281,,1419752,124327702,23542118,,7966,664268,126163,PDN
EC151,,2012,1987,,1427718,124991970,23668281,,1423792,124416980,23562044,,3926,574990,106237,PDN
EC151,,2013,1987,,1427718,124991970,23668281,,1424309,124445677,23567667,,3409,546293,100614,PDN
EC151,,2014,1987,,1427718,124991970,23668281,,1424431,124471000,23572295,,3287,520970,95986,PDN
EC151,,2015,1987,,1424825,124471000,23572689,,1424825,124471000,23572689,,0,0,0,PDN
EC151,,2016,1987,,1424825,124471000,23572689,,1424825,124471000,23572689,,0,0,0,PDN
EC151,,2017,1987,,1424825,124471576,23572791,,1424825,124471576,23572791,,0,0,0,PDN
EC151,,2017,1987,,1424825,124471576,23572791,,1424825,124471576,23572791,,0,0,0,PDN
EC160,,1975,1956,,1500000,30000000,6838078,,341397,11840862,2448312,,1158603,18159138,4389766,PDN
EC160,,1976,1956,,1359680,53135400,10814378,,375665,14456248,2947951,,984015,38679152,7866427,PDN
EC160,,1977,1956,,1365943,54234400,11016192,,396949,15824676,3212728,,968994,38409724,7803464,PDN
EC160,,1978,1956,,1365943,54234400,11016192,,423506,17437805,3526318,,942437,36796595,7489874,PDN
EC160,,1979,1956,,1371792,55454400,11239123,,443221,18975310,3819611,,928571,36479090,7419512,PDN
EC160,,1980,1956,,1442760,59014400,11943543,,458798,20261064,4063970,,983962,38753336,7879573,PDN
EC160,,1981,1956,,562746,32910461,6418700,,466010,20961692,4195848,,96736,11948769,2222852,PDN
EC160,,1982,1956,,473371,23235635,4607826,,467106,21084781,4218846,,6265,2150854,388980,PDN
EC160,,1983,1956,,494534,24981909,4939714,,468390,21249099,4249368,,26144,3732810,690346,PDN
EC160,,1984,1956,,684265,25278768,5182266,,487344,21408818,4296742,,196921,3869950,885524,PDN
EC160,,1985,1956,,737868,30639115,6189668,,497185,21830999,4381704,,240683,8808116,1807964,PDN
EC160,,1986,1956,,2346745,32569768,8142077,,525458,23061156,4628867,,1821287,9508612,3513210,PDN
EC160,,1987,1956,,805322,35772799,7170589,,560497,25190137,5042728,,244825,10582662,2127861,PDN
EC160,,1988,1956,,833183,35772799,7198450,,584556,27426112,5464647,,248627,8346687,1733803,PDN
EC160,,1989,1956,,874987,41127545,8193056,,615747,30891288,6112417,,259240,10236257,2080639,PDN
EC160,,1990,1956,,874987,41127545,8193056,,625756,32403187,6391448,,249231,8724358,1801608,PDN
EC160,,1991,1956,,1122778,47728708,9615431,,790718,38065332,7563909,,332060,9663376,2051522,PDN
EC160,,1992,1956,,1265930,61506558,12210157,,925909,46888394,9269040,,340021,14618164,2941117,PDN
EC160,,1993,1956,,1250453,72790793,14202551,,947022,51648572,10137159,,303431,21142221,4065392,PDN
EC160,,1994,1956,,1389117,86657216,16808550,,966263,54741150,10706681,,422854,31916066,6101869,PDN
EC160,,1995,1956,,1236695,85657346,16478216,,1041066,65172245,12637551,,195629,20485101,3840665,PDN
EC160,,1996,1956,,1549355,147680331,27826994,,1252341,96090145,18350232,,297014,51590186,9476762,PDN
EC160,,1997,1956,,1452486,128216851,24266872,,1270427,103829956,19745508,,182059,24386895,4521364,PDN
EC160,,1998,1956,,1412240,125975946,23827889,,1290850,107804211,20473094,,121390,18171735,3354795,PDN
EC160,,1999,1956,,1435763,128115731,24232156,,1315202,110678717,21008924,,120561,17437014,3223232,PDN
EC160,,2000,1956,,1560922,136357256,25823779,,1391669,118540198,22484231,,169253,17817058,3339548,PDN
EC160,,2001,1956,,1555027,143207687,27036822,,1463809,127292814,24113776,,91218,15914873,2923046,PDN
EC160,,2002,1956,,1566047,146133058,27568370,,1501499,132838717,25138281,,64548,13294341,2430089,PDN
EC160,,2003,1956,,1585774,148416720,27994443,,1521663,138463399,26159278,,64111,9953321,1835165,PDN
EC160,,2004,1956,,1581060,152060555,28638098,,1543818,143485883,27075114,,37242,8574672,1562984,PDN
EC160,,2005,1956,,1604004,157144329,29565628,,1552034,146551414,27628798,,51970,10592915,1936830,PDN
EC160,,2006,1956,,1634194,169453223,31786013,,1568639,147977362,27899130,,65555,21475861,3886883,PDN
EC160,,2007,1956,,1636797,162784479,30602007,,1580394,149217892,28131620,,56403,13566587,2470387,PDN
EC160,,2008,1956,,1686500,169206527,31794423,,1591286,150718352,28409498,,95214,18488175,3384925,PDN
EC160,,2009,1956,,1600497,158206418,29751104,,1593116,154025306,28999754,,7381,4181112,751351,PDN
EC160,,2010,1956,,1600497,158225749,29754543,,1593605,154669338,29114839,,6892,3556411,639707,PDN
EC160,,2011,1956,,1705364,169106166,31795428,,1594279,155119009,29195526,,111085,13987157,2599902,PDN
EC160,,2012,1956,,1705364,169106166,31795428,,1622746,157551999,29656910,,82618,11554167,2138518,PDN
EC160,,2013,1956,,1705364,169106166,31795428,,1641197,159693341,30056382,,64167,9412825,1739046,PDN
EC160,,2014,1956,,1702469,167114506,31438145,,1643336,159922381,30099276,,59133,7192125,1338869,PDN
EC160,,2015,1956,,1728774,169745031,31932515,,1647889,160007586,30118990,,80885,9737445,1813525,PDN
EC160,,2016,1956,,1648112,160007586,30119213,,1648112,160007586,30119213,,0,0,0,PDN
EC160,,2017,1956,,1648112,160007586,30119213,,1648112,160007586,30119213,,0,0,0,PDN
EC160,,2017,1956,,1648112,160007586,30119213,,1648112,160007586,30119213,,0,0,0,PDN
EC171,,1996,1996,,121252,6015940,1191704,,6548,332624,65734,,114704,5683316,1125970,PDN
EC171,,1997,1996,,641528,24394649,4982213,,104948,6161768,1201348,,536580,18232881,3780865,PDN
EC171,,1998,1996,,807538,30449810,6225654,,205085,16385961,3120736,,602453,14063849,3104918,PDN
EC171,,1999,1996,,537753,37473375,7205613,,346462,27204099,5187049,,191291,10269276,2018564,PDN
EC171,,2000,1996,,645423,43431413,8373432,,443758,34372629,6559884,,201665,9058784,1813548,PDN
EC171,,2001,1996,,1033326,70428567,13565099,,511406,39027072,7455725,,521920,31401495,6109374,PDN
EC171,,2002,1996,,870954,70437031,13404234,,632346,47841987,9145155,,238608,22595044,4259079,PDN
EC171,,2003,1996,,860271,69384472,13206262,,699060,56405696,10735661,,161211,12978776,2470601,PDN
EC171,,2004,1996,,858576,71132750,13515649,,739510,62069606,11783924,,119066,9063144,1731725,PDN
EC171,,2005,1996,,828828,75000976,14174197,,752648,64584806,12244606,,76180,10416170,1929591,PDN
EC171,,2006,1996,,814450,72234776,13667613,,763063,66253511,12551944,,51387,5981265,1115669,PDN
EC171,,2007,1996,,814450,72234776,13667613,,774040,67548765,12793393,,40410,4686011,874220,PDN
EC171,,2008,1996,,814450,72234776,13667613,,780505,68443898,12959135,,33945,3790878,708478,PDN
EC171,,2009,1996,,810003,72465366,13704196,,785020,69433818,13139792,,24983,3031548,564404,PDN
EC171,,2010,1996,,810003,72465366,13704196,,789699,69978433,13241377,,20304,2486933,462819,PDN
EC171,,2011,1996,,810003,72465366,13704196,,793100,70405527,13320774,,16903,2059839,383422,PDN
EC171,,2012,1996,,810003,72465366,13704196,,796691,70750967,13385831,,13312,1714399,318365,PDN
EC171,,2013,1996,,810003,72465366,13704196,,802201,71036993,13442235,,7802,1428373,261961,PDN
EC171,,2014,1996,,810003,72465366,13704196,,804186,71195756,13472470,,5817,1269610,231726,PDN
EC171,,2015,1996,,810003,72465366,13704196,,805171,71226037,13478843,,4832,1239329,225353,PDN
EC171,,2016,1996,,805173,71226037,13478845,,805173,71226037,13478845,,0,0,0,PDN
EC171,,2017,1996,,805234,71226037,13478906,,805234,71226037,13478906,,0,0,0,PDN
EC171,,2017,1996,,805234,71226037,13478906,,805234,71226037,13478906,,0,0,0,PDN
EC185,,1987,1971,,208029,24963597,4649950,,0,0,0,,208029,24963597,4649950,PDN
EC185,,1988,1971,,519242,24581221,4893125,,99926,3765373,769921,,419316,20815848,4123204,PDN
EC185,,1989,1971,,513599,30370677,5917634,,296104,15111096,2984911,,217495,15259581,2932723,PDN
EC185,,1990,1971,,1369014,59318118,11923839,,531539,20568439,4191404,,837475,38749679,7732435,PDN
EC185,,1991,1971,,951300,31424294,6542811,,575903,21745827,4445267,,375397,9678467,2097544,PDN
EC185,,1992,1971,,645516,25508990,5184482,,587918,22815178,4647558,,57598,2693812,536924,PDN
EC185,,1993,1971,,807618,33614091,6788773,,601084,23547413,4791015,,206534,10066678,1997758,PDN
EC185,,1994,1971,,807618,33614091,6788773,,624886,24970906,5068108,,182732,8643185,1720665,PDN
EC185,,1995,1971,,727742,29870051,6042698,,636476,25848066,5235776,,91266,4021985,806922,PDN
EC185,,1996,1971,,934133,36098990,7357441,,651072,26617584,5387297,,283061,9481406,1970144,PDN
EC185,,1997,1971,,939906,34544126,7086548,,685896,27670838,5609533,,254010,6873288,1477015,PDN
EC185,,1998,1971,,1004033,36398215,7480584,,725382,28679186,5828440,,278651,7719029,1652144,PDN
EC185,,1999,1971,,792036,31386793,6376875,,741581,29111970,5921647,,50455,2274823,455228,PDN
EC185,,2000,1971,,743852,29177825,5935636,,743852,29177825,5935636,,0,0,0,PDN
EC185,,2001,1971,,743852,29177825,5935636,,743852,29177825,5935636,,0,0,0,PDN
EC185,,2002,1971,,911244,34869141,7115717,,850263,32906036,6705430,,60981,1963105,410287,PDN
EC185,,2003,1971,,1265300,44467660,9177695,,938078,35917180,7329035,,327222,8550480,1848660,PDN
EC185,,2004,1971,,1227699,43471680,8962874,,988722,37040331,7579528,,238977,6431349,1383346,PDN
EC185,,2005,1971,,1598567,58455389,11999882,,1038544,38951162,7969356,,560023,19504227,4030526,PDN
EC185,,2006,1971,,1653481,62167874,12715381,,1124949,41718290,8548132,,528532,20449584,4167249,PDN
EC185,,2007,1971,,1518628,56947269,11651594,,1222173,45016717,9232265,,296455,11930552,2419329,PDN
EC185,,2008,1971,,1529968,57419698,11746996,,1255440,46370631,9506442,,274528,11049067,2240554,PDN
EC185,,2009,1971,,1281226,47909658,9806076,,1275044,47613621,9747219,,6182,296037,58858,PDN
EC185,,2010,1971,,1281226,47909658,9806076,,1280247,47864676,9797093,,979,44982,8982,PDN
EC185,,2011,1971,,1280857,47894401,9802993,,1280857,47894386,9802990,,0,15,3,PDN
EC185,,2012,1971,,1280857,47894401,9802993,,1280857,47894401,9802993,,0,0,0,PDN
EC185,,2013,1971,,1280857,47894401,9802993,,1280857,47894401,9802993,,0,0,0,PDN
EC185,,2014,1971,,1280857,47894401,9802993,,1280857,47894401,9802993,,0,0,0,PDN
EC185,,2015,1971,,1280857,47894401,9802993,,1280857,47894401,9802993,,0,0,0,PDN
EC185,,2016,1971,,1280857,47894401,9802993,,1280857,47894401,9802993,,0,0,0,PDN
EC185,,2017,1971,,1280857,47894401,9802993,,1280857,47894401,9802993,,0,0,0,PDN
EC185,,2017,1971,,1280857,47894401,9802993,,1280857,47894401,9802993,,0,0,0,PDN
EC193,,1991,1963,,402182,49448888,9200917,,38,12994,2350,,402144,49435894,9198567,PDN
EC193,,1992,1963,,403688,49448888,9202423,,52997,5739180,1074203,,350691,43709708,8128220,PDN
EC193,,1993,1963,,402441,49273212,9169916,,65709,9038284,1673945,,336732,40234928,7495971,PDN
EC193,,1994,1963,,686529,60971915,11535624,,99853,13174986,2444157,,586676,47796929,9091467,PDN
EC193,,1995,1963,,340144,41288858,7686916,,110278,14937273,2768156,,229866,26351585,4918760,PDN
EC193,,1996,1963,,348607,48343283,8950615,,143312,21321101,3937102,,205295,27022182,5013513,PDN
EC193,,1997,1963,,469456,61564937,11424071,,169066,26779086,4934028,,300390,34785851,6490043,PDN
EC193,,1998,1963,,427336,64299271,11868487,,215775,37098016,6816845,,211561,27201255,5051642,PDN
EC193,,1999,1963,,398696,59987570,11072641,,223933,39431583,7240229,,174763,20555987,3832412,PDN
EC193,,2000,1963,,311520,52164155,9593398,,226519,40011842,7346064,,85001,12152313,2247334,PDN
EC193,,2001,1963,,306742,52177277,9590955,,228661,43298013,7932934,,78081,8879264,1658021,PDN
EC193,,2002,1963,,300409,51787989,9515354,,228669,43341274,7940639,,71740,8446715,1574715,PDN
EC193,,2003,1963,,300409,51787504,9515267,,228691,43375208,7946700,,71718,8412296,1568567,PDN
EC193,,2004,1963,,299946,51305673,9429069,,228779,43393318,7950010,,71167,7912355,1479059,PDN
EC193,,2005,1963,,303939,51780615,9517571,,228779,43393318,7950010,,75160,8387297,1567561,PDN
EC193,,2006,1963,,352270,60555757,11127316,,235066,44044606,8072185,,117204,16511151,3055131,PDN
EC193,,2007,1963,,364416,57737758,10638038,,250922,45936889,8424746,,113494,11800869,2213292,PDN
EC193,,2008,1963,,334691,56885596,10456683,,255304,47380536,8686004,,79387,9505060,1770679,PDN
EC193,,2009,1963,,340121,57871229,10637495,,258933,48449807,8879898,,81188,9421422,1757597,PDN
EC193,,2010,1963,,340121,57871229,10637495,,261058,48856376,8954367,,79063,9014853,1683128,PDN
EC193,,2011,1963,,337809,57485227,10566499,,262529,49180196,9013457,,75280,8305031,1553043,PDN
EC193,,2012,1963,,337809,57485227,10566499,,264126,49310980,9038325,,73683,8174247,1528174,PDN
EC193,,2013,1963,,264126,49310980,9038325,,264126,49310980,9038325,,0,0,0,PDN
EC193,,2014,1963,,264126,49310980,9038325,,264126,49310980,9038325,,0,0,0,PDN
EC193,,2015,1963,,264126,49310980,9038325,,264126,49310980,9038325,,0,0,0,PDN
EC193,,2016,1963,,264126,49310980,9038325,,264126,49310980,9038325,,0,0,0,PDN
EC193,,2017,1963,,264126,49310980,9038325,,264126,49310980,9038325,,0,0,0,PDN
EC193,,2017,1963,,264126,49310980,9038325,,264126,49310980,9038325,,0,0,0,PDN
EC195,,1975,1966,,1367131,105848400,20201366,,866397,26070562,5505287,,500734,79777838,14696079,PDN
EC195,,1976,1966,,1367131,105848400,20201366,,1152688,34478920,7287727,,214443,71369480,12913639,PDN
EC195,,1977,1966,,2133930,111475900,21969499,,2055904,44196598,9920067,,78026,67279302,12049432,PDN
EC195,,1978,1966,,2966478,134613420,26919044,,2264898,50682236,11283089,,701580,83931184,15635955,PDN
EC195,,1979,1966,,2483956,129713420,25564636,,1662233,49540728,10477309,,821723,80172692,15087327,PDN
EC195,,1980,1966,,2483956,129713420,25564636,,1741607,52562718,11094404,,742349,77150702,14470232,PDN
EC195,,1981,1966,,2483956,129713420,25564636,,1860123,57368648,12068067,,623833,72344772,13496569,PDN
EC195,,1982,1966,,2640246,134817716,26629163,,1940913,61000017,12795009,,699333,73817699,13834154,PDN
EC195,,1983,1966,,2788212,138775400,27481344,,2053296,64965912,13613067,,734916,73809488,13868277,PDN
EC195,,1984,1966,,4467554,144709475,30216571,,2216961,70055786,14682403,,2250593,74653689,15534168,PDN
EC195,,1985,1966,,4467554,144709475,30216571,,2291556,73064492,15292355,,2175998,71644983,14924216,PDN
EC195,,1986,1966,,4467554,144709475,30216571,,2299847,73318292,15345806,,2167707,71391183,14870765,PDN
EC195,,1987,1966,,4465282,144311454,30143477,,2331351,74479785,15583982,,2133931,69831669,14559495,PDN
EC195,,1988,1966,,4465282,144311454,30143477,,2385202,76737483,16039558,,2080080,67573971,14103919,PDN
EC195,,1989,1966,,4465363,144638404,30201734,,2400502,77806319,16245043,,2064861,66832085,13956691,PDN
EC195,,1990,1966,,2875330,95731875,19909471,,2412302,78688110,16413745,,463028,17043765,3495726,PDN
EC195,,1991,1966,,2875330,95731875,19909471,,2422480,79360778,16543615,,452850,16371097,3365856,PDN
EC195,,1992,1966,,2875330,95731875,19909471,,2429459,79854074,16638369,,445871,15877801,3271102,PDN
EC195,,1993,1966,,2875330,95731875,19909471,,2434713,80218144,16708404,,440617,15513731,3201067,PDN
EC195,,1994,1966,,2875330,95731875,19909471,,2446096,81299027,16912115,,429234,14432848,2997356,PDN
EC195,,1995,1966,,2691812,92454041,19142709,,2452102,81943033,17032713,,239710,10511008,2109996,PDN
EC195,,1996,1966,,2690031,92384018,19128468,,2459203,82775727,17187980,,230828,9608291,1940488,PDN
EC195,,1997,1966,,2690031,92384018,19128468,,2470872,83722691,17368148,,219159,8661327,1760320,PDN
EC195,,1998,1966,,2690031,92384018,19128468,,2477554,84466269,17507139,,212477,7917749,1621329,PDN
EC195,,1999,1966,,2745324,93969283,19465837,,2480813,84939069,17594526,,264511,9030214,1871311,PDN
EC195,,2000,1966,,2921353,103440269,21327095,,2484189,85325603,17666681,,437164,18114666,3660414,PDN
EC195,,2001,1966,,2889267,103440269,21295009,,2487574,85590280,17717161,,401693,17849989,3577848,PDN
EC195,,2002,1966,,2889267,103440269,21295009,,2489668,85863338,17767842,,399599,17576931,3527167,PDN
EC195,,2003,1966,,2790908,99570158,20508018,,2492258,86114978,17815208,,298650,13455180,2692810,PDN
EC195,,2004,1966,,2998209,100165611,20821272,,2602342,86390080,17974242,,395867,13775531,2847030,PDN
EC195,,2005,1966,,3025669,103275690,21402127,,2699150,86674401,18121641,,326519,16601289,3280486,PDN
EC195,,2006,1966,,3021304,102613528,21279939,,2701889,86888567,18162488,,319415,15724961,3117451,PDN
EC195,,2007,1966,,2844751,96742437,20058708,,2701889,86888567,18162488,,142862,9853870,1896220,PDN
EC195,,2008,1966,,2701889,86888567,18162488,,2701889,86888567,18162488,,0,0,0,PDN
EC195,,2009,1966,,2701888,88575468,18462647,,2701888,88575468,18462647,,0,0,0,PDN
EC195,,2010,1966,,2701888,88575468,18462647,,2701888,88575468,18462647,,0,0,0,PDN
EC195,,2011,1966,,2701888,88575468,18462647,,2701888,88575468,18462647,,0,0,0,PDN
EC195,,2012,1966,,2701888,88575468,18462647,,2701888,88575468,18462647,,0,0,0,PDN
EC195,,2013,1966,,2701888,88575468,18462647,,2701888,88575468,18462647,,0,0,0,PDN
EC195,,2014,1966,,2701888,88575468,18462647,,2701888,88575468,18462647,,0,0,0,PDN
EC195,,2015,1966,,2701888,88575468,18462647,,2701888,88575468,18462647,,0,0,0,PDN
EC195,,2016,1966,,2701888,88575468,18462647,,2701888,88575468,18462647,,0,0,0,PDN
EC195,,2017,1966,,2701888,88575468,18462647,,2701888,88575468,18462647,,0,0,0,PDN
EC195,,2017,1966,,2701888,88575468,18462647,,2701888,88575468,18462647,,0,0,0,PDN
EC196,,2000,1988,,78329,9686742,1801949,,0,0,0,,78329,9686742,1801949,PDN
EC196,,2001,1988,,60185,7442895,1384544,,0,130808,23275,,60185,7312087,1361269,PDN
EC196,,2002,1988,,856,8563869,1524676,,0,1988381,353804,,856,6575488,1170872,PDN
EC196,,2003,1988,,856,8563869,1524676,,0,2840718,505466,,856,5723151,1019210,PDN
EC196,,2004,1988,,492,8349838,1486228,,0,3253917,578989,,492,5095921,907239,PDN
EC196,,2005,1988,,493,8354964,1487141,,0,3788337,674081,,493,4566627,813060,PDN
EC196,,2006,1988,,167,5095224,906790,,0,4589018,816551,,167,506206,90239,PDN
EC196,,2007,1988,,0,4804606,854912,,0,4803278,854676,,0,1328,236,PDN
EC196,,2008,1988,,0,4804606,854912,,0,4804606,854912,,0,0,0,PDN
EC196,,2009,1988,,0,4804606,854913,,0,4804606,854913,,0,0,0,PDN
EC196,,2010,1988,,0,4804606,854913,,0,4804606,854913,,0,0,0,PDN
EC196,,2011,1988,,0,4804606,854913,,0,4804606,854913,,0,0,0,PDN
EC196,,2012,1988,,0,4804606,854913,,0,4804606,854913,,0,0,0,PDN
EC196,,2013,1988,,0,4804606,854913,,0,4804606,854913,,0,0,0,PDN
EC196,,2014,1988,,0,4804606,854913,,0,4804606,854913,,0,0,0,PDN
EC196,,2015,1988,,0,4804606,854913,,0,4804606,854913,,0,0,0,PDN
EC196,,2016,1988,,0,4804606,854913,,0,4804606,854913,,0,0,0,PDN
EC196,,2017,1988,,0,4804606,854913,,0,4804606,854913,,0,0,0,PDN
EC196,,2017,1988,,0,4804606,854913,,0,4804606,854913,,0,0,0,PDN
EC213,,1987,1982,,84749,9830966,1834031,,0,0,0,,84749,9830966,1834031,PDN
EC213,,1988,1982,,84749,9830966,1834031,,0,0,0,,84749,9830966,1834031,PDN
EC213,,1989,1982,,84749,9830966,1834031,,3589,1359994,245581,,81160,8470972,1588450,PDN
EC213,,1990,1982,,45797,9830966,1795079,,9703,2824594,512300,,36094,7006372,1282779,PDN
EC213,,1991,1982,,45797,9830966,1795079,,11345,3221847,584627,,34452,6609119,1210452,PDN
EC213,,1992,1982,,83169,20634711,3754826,,16148,4899436,887934,,67021,15735275,2866892,PDN
EC213,,1993,1982,,1401315,42537737,8970307,,99197,10576637,1981161,,1302118,31961100,6989146,PDN
EC213,,1994,1982,,1354337,41322965,8707178,,131362,16694261,3101871,,1222975,24628704,5605307,PDN
EC213,,1995,1982,,1332595,35376521,7627350,,135191,19244020,3559394,,1197404,16132501,4067956,PDN
EC213,,1996,1982,,192152,31563215,5808382,,136313,20608236,3803259,,55839,10954979,2005123,PDN
EC213,,1997,1982,,192750,32128559,5909575,,136985,22261169,4098047,,55765,9867390,1811528,PDN
EC213,,1998,1982,,192750,32128559,5909575,,137063,22491256,4139066,,55687,9637303,1770509,PDN
EC213,,1999,1982,,137079,22547156,4149028,,137079,22534166,4146717,,0,12990,2311,PDN
EC213,,2000,1982,,137079,22547156,4149028,,137079,22547156,4149028,,0,0,0,PDN
EC213,,2001,1982,,137079,22547156,4149028,,137079,22547156,4149028,,0,0,0,PDN
EC213,,2002,1982,,137079,22547156,4149028,,137079,22547156,4149028,,0,0,0,PDN
EC213,,2003,1982,,137079,22547156,4149028,,137079,22547156,4149028,,0,0,0,PDN
EC213,,2004,1982,,137079,22547156,4149028,,137079,22547156,4149028,,0,0,0,PDN
EC213,,2005,1982,,137079,22547156,4149028,,137079,22547156,4149028,,0,0,0,PDN
EC213,,2006,1982,,137210,25419922,4660328,,137079,23500929,4318739,,131,1918993,341589,PDN
EC213,,2007,1982,,137210,25419922,4660328,,137079,24102638,4425805,,131,1317284,234523,PDN
EC213,,2008,1982,,137211,25421159,4660549,,137079,24281760,4457677,,132,1139399,202872,PDN
EC213,,2009,1982,,137100,25508247,4675934,,137079,24981079,4582111,,21,527168,93823,PDN
EC213,,2010,1982,,137100,25508247,4675934,,137079,25313208,4641209,,21,195039,34725,PDN
EC213,,2011,1982,,137100,25505794,4675497,,137079,25387350,4654401,,21,118444,21096,PDN
EC213,,2012,1982,,137167,26183463,4796146,,137079,25554357,4684117,,88,629106,112029,PDN
EC213,,2013,1982,,137167,26183463,4796146,,137079,25776298,4723609,,88,407165,72537,PDN
EC213,,2014,1982,,137167,26183463,4796146,,137079,25902679,4746096,,88,280784,50050,PDN
EC213,,2015,1982,,137167,26183463,4796146,,137079,25995896,4762683,,88,187567,33463,PDN
EC213,,2016,1982,,137079,25995896,4762683,,137079,25995896,4762683,,0,0,0,PDN
EC213,,2017,1982,,137079,25995896,4762683,,137079,25995896,4762683,,0,0,0,PDN
EC213,,2017,1982,,137079,25995896,4762683,,137079,25995896,4762683,,0,0,0,PDN
EC215,,1980,1967,,16700,16700000,2988230,,21,1315000,234007,,16679,15385000,2754223,PDN
EC215,,1981,1967,,426000,26220000,5091480,,21,1315000,234007,,425979,24905000,4857473,PDN
EC215,,1982,1967,,426000,26220000,5091480,,0,0,0,,426000,26220000,5091480,PDN
EC215,,1983,1967,,864951,43352266,8578877,,22566,1695859,324320,,842385,41656407,8254557,PDN
EC215,,1984,1967,,1129879,151892649,28157041,,124393,17076806,3162971,,1005486,134815843,24994070,PDN
EC215,,1985,1967,,1128849,151892649,28156011,,189389,41865635,7638790,,939460,110027014,20517221,PDN
EC215,,1986,1967,,2222338,180606899,34358797,,245926,63723073,11584551,,1976412,116883826,22774246,PDN
EC215,,1987,1967,,1270471,209690249,38581903,,318845,86477121,15706233,,951626,123213128,22875670,PDN
EC215,,1988,1967,,1361030,215860394,39770353,,417025,105919277,19263871,,944005,109941117,20506482,PDN
EC215,,1989,1967,,984979,219001138,39953153,,475749,123113434,22382054,,509230,95887704,17571099,PDN
EC215,,1990,1967,,939394,214450991,39097933,,510769,129415517,23538441,,428625,85035474,15559492,PDN
EC215,,1991,1967,,942275,177796982,32578749,,539731,132271126,24075519,,402544,45525856,8503230,PDN
EC215,,1992,1967,,956075,169421746,31102293,,554251,134328772,24456168,,401824,35092974,6646125,PDN
EC215,,1993,1967,,749851,145249521,26594961,,588274,136559699,24887153,,161577,8689822,1707808,PDN
EC215,,1994,1967,,756850,145969754,26730116,,606391,138547083,25258897,,150459,7422671,1471219,PDN
EC215,,1995,1967,,899237,150285611,27640449,,627313,139859630,25513368,,271924,10425981,2127081,PDN
EC215,,1996,1967,,738762,151626089,27718493,,659834,141570450,25850306,,78928,10055639,1868187,PDN
EC215,,1997,1967,,799722,159158067,29119663,,667316,144757184,26424822,,132406,14400883,2694841,PDN
EC215,,1998,1967,,825216,160338070,29355122,,668156,147573684,26926819,,157060,12764386,2428303,PDN
EC215,,1999,1967,,858488,167842574,30723715,,671673,150441619,27440644,,186815,17400955,3283071,PDN
EC215,,2000,1967,,926883,179265073,32824583,,697520,155167844,28307457,,229363,24097229,4517126,PDN
EC215,,2001,1967,,926877,179282062,32827600,,701805,156996258,28637082,,225072,22285804,4190518,PDN
EC215,,2002,1967,,953562,181636170,33273165,,703144,157622650,28749879,,250418,24013520,4523286,PDN
EC215,,2003,1967,,1030615,189474654,34744966,,734622,160888002,29362380,,295993,28586652,5382586,PDN
EC215,,2004,1967,,964095,184872958,33859639,,789612,166102579,30345231,,174483,18770379,3514408,PDN
EC215,,2005,1967,,978672,188165956,34460159,,806787,168001508,30700294,,171885,20164448,3759865,PDN
EC215,,2006,1967,,970533,188165956,34452020,,817034,168735865,30841209,,153499,19430091,3610811,PDN
EC215,,2007,1967,,970533,188165956,34452020,,823126,169208171,30931341,,147407,18957785,3520679,PDN
EC215,,2008,1967,,865345,172203758,31506583,,823637,169739099,31026324,,41708,2464659,480259,PDN
EC215,,2009,1967,,823637,172679894,31549597,,823637,172679894,31549597,,0,0,0,PDN
EC215,,2010,1967,,823637,172679894,31549597,,823637,172679894,31549597,,0,0,0,PDN
EC215,,2011,1967,,823637,172679894,31549597,,823637,172679894,31549597,,0,0,0,PDN
EC215,,2012,1967,,823637,172679894,31549597,,823637,172679894,31549597,,0,0,0,PDN
EC215,,2013,1967,,823637,172679894,31549597,,823637,172679894,31549597,,0,0,0,PDN
EC215,,2014,1967,,823637,172679894,31549597,,823637,172679894,31549597,,0,0,0,PDN
EC215,,2015,1967,,823637,172679894,31549597,,823637,172679894,31549597,,0,0,0,PDN
EC215,,2016,1967,,823637,172679894,31549597,,823637,172679894,31549597,,0,0,0,PDN
EC215,,2017,1967,,823637,172679894,31549597,,823637,172679894,31549597,,0,0,0,PDN
EC215,,2017,1967,,823637,172679894,31549597,,823637,172679894,31549597,,0,0,0,PDN
EC222,,1975,1971,,394682,62886144,11584387,,6000,2501080,451032,,388682,60385064,11133355,PDN
EC222,,1976,1971,,394682,62886144,11584387,,32414,6655609,1216686,,362268,56230535,10367701,PDN
EC222,,1977,1971,,432441,68486144,12618588,,56730,10552861,1934463,,375711,57933283,10684125,PDN
EC222,,1978,1971,,432441,68486144,12618588,,72063,12976688,2381082,,360378,55509456,10237506,PDN
EC222,,1979,1971,,432441,68486144,12618588,,105194,16765705,3088416,,327247,51720439,9530172,PDN
EC222,,1980,1971,,432441,68486144,12618588,,112950,18226413,3356084,,319491,50259731,9262504,PDN
EC222,,1981,1971,,432441,68486144,12618588,,113326,18792186,3457131,,319115,49693958,9161457,PDN
EC222,,1982,1971,,439795,70408650,12968025,,128701,22095988,4060371,,311094,48312662,8907654,PDN
EC222,,1983,1971,,322454,50615196,9328717,,168427,28010241,5152456,,154027,22604955,4176261,PDN
EC222,,1984,1971,,489594,68963551,12760688,,191871,31317562,5764391,,297723,37645989,6996297,PDN
EC222,,1985,1971,,502406,70941313,13125415,,236326,35213120,6502006,,266080,35728193,6623409,PDN
EC222,,1986,1971,,535321,77432719,14313385,,292974,43247309,7988225,,242347,34185410,6325160,PDN
EC222,,1987,1971,,567396,84491068,15601394,,369250,51172104,9474607,,198146,33318964,6126787,PDN
EC222,,1988,1971,,723508,98349808,18223474,,430315,57536777,10668176,,293193,40813031,7555298,PDN
EC222,,1989,1971,,731015,98811488,18313130,,457689,61102796,11330073,,273326,37708692,6983057,PDN
EC222,,1990,1971,,731015,98811488,18313130,,474146,62991415,11682583,,256869,35820073,6630547,PDN
EC222,,1991,1971,,514693,67682732,12557884,,486100,64348612,11936031,,28593,3334120,621853,PDN
EC222,,1992,1971,,514693,67682732,12557884,,495542,64979394,12057712,,19151,2703338,500172,PDN
EC222,,1993,1971,,640697,78916042,14682697,,513707,68852536,12765048,,126990,10063506,1917649,PDN
EC222,,1994,1971,,582031,86131180,15907864,,528373,78362295,14471842,,53658,7768885,1436022,PDN
EC222,,1995,1971,,780165,93966233,17500135,,638688,83672983,15527119,,141477,10293250,1973016,PDN
EC222,,1996,1971,,1597082,128146598,24398968,,1050036,99397258,18736381,,547046,28749340,5662587,PDN
EC222,,1997,1971,,1707406,144619601,27440431,,1399649,118516760,22488040,,307757,26102841,4952391,PDN
EC222,,1998,1971,,1784525,145278109,27634722,,1483630,127516089,24173326,,300895,17762020,3461396,PDN
EC222,,1999,1971,,1766473,136181651,25998083,,1516937,131440713,24904964,,249536,4740938,1093119,PDN
EC222,,2000,1971,,1696241,135193376,25752002,,1530566,133327080,25254246,,165675,1866296,497756,PDN
EC222,,2001,1971,,1580492,142761776,26982944,,1541608,134744419,25517483,,38884,8017357,1465461,PDN
EC222,,2002,1971,,1578526,142760603,26980769,,1551550,136286005,25801729,,26976,6474598,1179040,PDN
EC222,,2003,1971,,1580161,145237511,27423135,,1562986,138724181,26247004,,17175,6513330,1176131,PDN
EC222,,2004,1971,,1611051,143696530,27179829,,1572233,140100266,26501106,,38818,3596264,678723,PDN
EC222,,2005,1971,,1616023,144957772,27409221,,1581135,141345396,26731561,,34888,3612376,677660,PDN
EC222,,2006,1971,,1596950,144317446,27276211,,1584202,141834706,26821694,,12748,2482740,454517,PDN
EC222,,2007,1971,,1596950,144317446,27276211,,1584202,141834706,26821694,,12748,2482740,454517,PDN
EC222,,2008,1971,,1598006,146322890,27634107,,1583939,141742235,26804977,,14067,4580655,829130,PDN
EC222,,2009,1971,,1601590,148656050,28052843,,1583968,144373448,27273192,,17622,4282602,779651,PDN
EC222,,2010,1971,,1585966,147098399,27760057,,1584319,144998026,27384678,,1647,2100373,375379,PDN
EC222,,2011,1971,,1585649,146030215,27569671,,1585397,145715884,27513489,,252,314331,56183,PDN
EC222,,2012,1971,,1585649,146030215,27569671,,1585637,145908980,27548087,,12,121235,21584,PDN
EC222,,2013,1971,,1585649,146030215,27569671,,1585638,145975015,27559838,,11,55200,9833,PDN
EC222,,2014,1971,,1588598,146295417,27619809,,1586625,146067416,27577266,,1973,228001,42543,PDN
EC222,,2015,1971,,1586625,146067416,27577266,,1586625,146067416,27577266,,0,0,0,PDN
EC222,,2016,1971,,1586625,146067416,27577266,,1586625,146067416,27577266,,0,0,0,PDN
EC222,,2017,1971,,1586625,146067416,27577266,,1586625,146067416,27577266,,0,0,0,PDN
EC222,,2017,1971,,1586625,146067416,27577266,,1586625,146067416,27577266,,0,0,0,PDN
EC224,,1975,1966,,0,15700000,2793594,,0,2633662,468623,,0,13066338,2324971,PDN
EC224,,1976,1966,,0,3666500,652402,,0,2816986,501243,,0,849514,151159,PDN
EC224,,1977,1966,,0,3666500,652402,,0,3065103,545392,,0,601397,107010,PDN
EC224,,1978,1966,,0,3666500,652402,,0,3239762,576470,,0,426738,75932,PDN
EC224,,1979,1966,,200,4016000,714791,,123,3465052,616680,,77,550948,98111,PDN
EC224,,1980,1966,,200,4916000,874933,,123,3679844,654900,,77,1236156,220033,PDN
EC224,,1981,1966,,200,5716000,1017282,,123,4014024,714362,,77,1701976,302920,PDN
EC224,,1982,1966,,200,8216000,1462122,,123,4814150,856733,,77,3401850,605389,PDN
EC224,,1983,1966,,150,6615919,1177360,,123,5199883,925369,,27,1416036,251991,PDN
EC224,,1984,1966,,150,6615919,1177360,,123,5503938,979471,,27,1111981,197889,PDN
EC224,,1985,1966,,150,6615919,1177360,,123,5734920,1020571,,27,880999,156789,PDN
EC224,,1986,1966,,150,6615919,1177360,,123,5754264,1024013,,27,861655,153347,PDN
EC224,,1987,1966,,150,6615919,1177360,,123,5804760,1032998,,27,811159,144362,PDN
EC224,,1988,1966,,150,68864588,12253635,,123,31525619,5609664,,27,37338969,6643971,PDN
EC224,,1989,1966,,150,68953074,12269380,,123,6092673,1084229,,27,62860401,11185151,PDN
EC224,,1990,1966,,150,8566427,1524425,,123,6240846,1110594,,27,2325581,413831,PDN
EC224,,1991,1966,,150,8566427,1524425,,123,6439100,1145870,,27,2127327,378555,PDN
EC224,,1992,1966,,150,7984448,1420870,,123,6777035,1206001,,27,1207413,214869,PDN
EC224,,1993,1966,,150,8005679,1424648,,123,7046448,1253939,,27,959231,170709,PDN
EC224,,1994,1966,,150,7999161,1423488,,123,7262023,1292298,,27,737138,131190,PDN
EC224,,1995,1966,,150,7999161,1423488,,123,7379753,1313246,,27,619408,110242,PDN
EC224,,1996,1966,,150,8154023,1451044,,123,7414891,1319499,,27,739132,131545,PDN
EC224,,1997,1966,,150,8154023,1451044,,123,7611553,1354492,,27,542470,96552,PDN
EC224,,1998,1966,,150,8154023,1451044,,123,7929258,1411023,,27,224765,40021,PDN
EC224,,1999,1966,,150,8578309,1526540,,123,8207954,1460613,,27,370355,65927,PDN
EC224,,2000,1966,,2085,9214837,1641736,,123,8437056,1501379,,1962,777781,140357,PDN
EC224,,2001,1966,,2085,9214836,1641736,,123,8663363,1541647,,1962,551473,100089,PDN
EC224,,2002,1966,,2085,9214836,1641736,,123,8827899,1570924,,1962,386937,70812,PDN
EC224,,2003,1966,,1170,9483947,1688705,,123,8980704,1598113,,1047,503243,90592,PDN
EC224,,2004,1966,,1176,9469080,1686066,,123,9071951,1614349,,1053,397129,71717,PDN
EC224,,2005,1966,,1168,10932330,1946422,,123,9264788,1648662,,1045,1667542,297760,PDN
EC224,,2006,1966,,1168,10932330,1946422,,123,9264788,1648662,,1045,1667542,297760,PDN
EC224,,2007,1966,,1141,9390666,1672078,,123,9264788,1648662,,1018,125878,23416,PDN
EC224,,2008,1966,,123,9264788,1648662,,123,9264788,1648662,,0,0,0,PDN
EC224,,2009,1966,,123,9421253,1676503,,123,9421253,1676503,,0,0,0,PDN
EC224,,2010,1966,,123,9421253,1676503,,123,9421253,1676503,,0,0,0,PDN
EC224,,2011,1966,,123,9421253,1676503,,123,9421253,1676503,,0,0,0,PDN
EC224,,2012,1966,,123,9421253,1676503,,123,9421253,1676503,,0,0,0,PDN
EC224,,2013,1966,,123,9421253,1676503,,123,9421253,1676503,,0,0,0,PDN
EC224,,2014,1966,,123,9421253,1676503,,123,9421253,1676503,,0,0,0,PDN
EC224,,2015,1966,,123,9421253,1676503,,123,9421253,1676503,,0,0,0,PDN
EC224,,2016,1966,,123,9421253,1676503,,123,9421253,1676503,,0,0,0,PDN
EC224,,2017,1966,,123,9421253,1676503,,123,9421253,1676503,,0,0,0,PDN
EC224,,2017,1966,,123,9421253,1676503,,123,9421253,1676503,,0,0,0,PDN
EC231,,1975,1971,,1394326,142650810,26777032,,0,0,0,,1394326,142650810,26777032,PDN
EC231,,1976,1971,,1394326,142650810,26777032,,0,0,0,,1394326,142650810,26777032,PDN
EC231,,1977,1971,,2060745,185848810,35129928,,161046,13655734,2590892,,1899699,172193076,32539036,PDN
EC231,,1978,1971,,2716633,201493950,38569649,,529862,43212256,8218876,,2186771,158281694,30350773,PDN
EC231,,1979,1971,,2797048,202419950,38814833,,832958,70653688,13404789,,1964090,131766262,25410044,PDN
EC231,,1980,1971,,3105169,229201840,43888415,,1030115,96576655,18214573,,2075054,132625185,25673842,PDN
EC231,,1981,1971,,3680010,269557840,51644038,,1531573,140602879,26549879,,2148437,128954961,25094159,PDN
EC231,,1982,1971,,6713647,517355630,98769809,,2197465,211586882,39846376,,4516182,305768748,58923433,PDN
EC231,,1983,1971,,7527518,540480347,103698398,,2765390,264277621,49789878,,4762128,276202726,53908520,PDN
EC231,,1984,1971,,9782327,537017490,105337041,,3387063,310764646,58683263,,6395264,226252844,46653778,PDN
EC231,,1985,1971,,9819634,547698193,107274828,,3807679,340231278,64347052,,6011955,207466915,42927776,PDN
EC231,,1986,1971,,10166059,556866689,109252658,,4064030,355016311,67234192,,6102029,201850378,42018466,PDN
EC231,,1987,1971,,9976274,561617302,109908178,,4323358,369630118,70093842,,5652916,191987184,39814336,PDN
EC231,,1988,1971,,9878914,524398427,103188243,,4589636,386490562,73360199,,5289278,137907865,29828044,PDN
EC231,,1989,1971,,9647941,531799911,104274260,,4965196,415908559,78970278,,4682745,115891352,25303982,PDN
EC231,,1990,1971,,7820516,566642120,108646516,,5227252,441458444,83778577,,2593264,125183676,24867939,PDN
EC231,,1991,1971,,7775445,569456346,109102197,,5393107,457299361,86763100,,2382338,112156985,22339097,PDN
EC231,,1992,1971,,7830395,587011732,112280881,,5520798,471243435,89371943,,2309597,115768297,22908938,PDN
EC231,,1993,1971,,6768679,548068573,104289777,,5628435,484374666,91816098,,1140244,63693907,12473679,PDN
EC231,,1994,1971,,6796169,552757095,105151524,,5699667,496152722,93983069,,1096502,56604373,11168455,PDN
EC231,,1995,1971,,6531023,559349210,106059352,,5786003,503200505,95323459,,745020,56148705,10735893,PDN
EC231,,1996,1971,,6563688,566080509,107289757,,5837669,506724195,96002117,,726019,59356314,11287640,PDN
EC231,,1997,1971,,7057525,569899357,108463105,,5876092,508294139,96319889,,1181433,61605218,12143216,PDN
EC231,,1998,1971,,7018476,561985901,107015967,,5911412,510395168,96729058,,1107064,51590733,10286909,PDN
EC231,,1999,1971,,9044057,536191977,104451882,,5940074,512295253,97095813,,3103983,23896724,7356069,PDN
EC231,,2000,1971,,10002824,545502372,107067303,,6073477,513861280,97507868,,3929347,31641092,9559435,PDN
EC231,,2001,1971,,9587750,539111310,105515029,,6208532,514801540,97810230,,3379218,24309770,7704799,PDN
EC231,,2002,1971,,8925659,540177772,105042700,,6275164,518029077,98451156,,2650495,22148695,6591544,PDN
EC231,,2003,1971,,8925676,540185363,105044068,,6280977,519412701,98703166,,2644699,20772662,6340902,PDN
EC231,,2004,1971,,7326989,535127688,102545439,,6283441,520092916,98826664,,1043548,15034772,3718775,PDN
EC231,,2005,1971,,7146010,531509314,101720621,,6283967,520167209,98840410,,862043,11342105,2880211,PDN
EC231,,2006,1971,,7146010,531509314,101720621,,6283967,520167209,98840410,,862043,11342105,2880211,PDN
EC231,,2007,1971,,6970327,536383926,102412307,,6102631,513039161,97390738,,867696,23344765,5021569,PDN
EC231,,2008,1971,,6910095,527093479,100698970,,6102631,513042696,97391367,,807464,14050783,3307603,PDN
EC231,,2009,1971,,6307658,533930723,101313120,,6283966,530376913,100657077,,23692,3553810,656043,PDN
EC231,,2010,1971,,6381252,535492909,101664683,,6290953,530723714,100725772,,90299,4769195,938911,PDN
EC231,,2011,1971,,6381252,535492909,101664683,,6324140,533386315,101232732,,57112,2106594,431951,PDN
EC231,,2012,1971,,6381252,535492909,101664683,,6337359,534328418,101413585,,43893,1164491,251098,PDN
EC231,,2013,1971,,6381252,535492909,101664683,,6345211,534414865,101436820,,36041,1078044,227863,PDN
EC231,,2014,1971,,6381252,535492909,101664683,,6346650,534417910,101438800,,34602,1074999,225883,PDN
EC231,,2015,1971,,6346831,534418286,101439048,,6346831,534418286,101439048,,0,0,0,PDN
EC231,,2016,1971,,6346831,534418286,101439048,,6346831,534418286,101439048,,0,0,0,PDN
EC231,,2017,1971,,6346831,534418286,101439048,,6346831,534418286,101439048,,0,0,0,PDN
EC231,,2017,1971,,6346831,534418286,101439048,,6346831,534418286,101439048,,0,0,0,PDN
EC233,,1989,1988,,3739,3215393,575873,,1284,1067175,191173,,2455,2148218,384700,PDN
EC233,,1990,1988,,4563,3215393,576697,,2558,1829459,328085,,2005,1385934,248612,PDN
EC233,,1991,1988,,4563,3215393,576697,,2805,1918878,344242,,1758,1296515,232455,PDN
EC233,,1992,1988,,4563,3215393,576697,,2805,1919688,344386,,1758,1295705,232311,PDN
EC233,,1993,1988,,2805,1929883,346201,,2805,1929883,346201,,0,0,0,PDN
EC233,,1994,1988,,2805,1929883,346201,,2805,1929883,346201,,0,0,0,PDN
EC233,,1995,1988,,2805,1929883,346201,,2805,1929883,346201,,0,0,0,PDN
EC233,,1996,1988,,2805,1929883,346201,,2805,1929883,346201,,0,0,0,PDN
EC233,,1997,1988,,2805,1929883,346201,,2805,1929883,346201,,0,0,0,PDN
EC233,,1998,1988,,2805,1929883,346201,,2805,1929883,346201,,0,0,0,PDN
EC233,,1999,1988,,2805,1929883,346201,,2805,1929883,346201,,0,0,0,PDN
EC233,,2000,1988,,2805,1929883,346201,,2805,1929883,346201,,0,0,0,PDN
EC233,,2001,1988,,2805,1929883,346201,,2805,1929883,346201,,0,0,0,PDN
EC233,,2002,1988,,2805,1929883,346201,,2805,1929883,346201,,0,0,0,PDN
EC233,,2003,1988,,2805,1929883,346201,,2805,1929883,346201,,0,0,0,PDN
EC233,,2004,1988,,2805,1929883,346201,,2805,1929883,346201,,0,0,0,PDN
EC233,,2005,1988,,2805,1929883,346201,,2805,1929883,346201,,0,0,0,PDN
EC233,,2006,1988,,2805,1929883,346201,,2805,1929883,346201,,0,0,0,PDN
EC233,,2007,1988,,2805,1929883,346201,,2805,1929883,346201,,0,0,0,PDN
EC233,,2008,1988,,2805,1929883,346201,,2805,1929883,346201,,0,0,0,PDN
EC233,,2009,1988,,2805,1968533,353078,,2805,1968533,353078,,0,0,0,PDN
EC233,,2010,1988,,2805,1968533,353078,,2805,1968533,353078,,0,0,0,PDN
EC233,,2011,1988,,2805,1968533,353078,,2805,1968533,353078,,0,0,0,PDN
EC233,,2012,1988,,2805,1968533,353078,,2805,1968533,353078,,0,0,0,PDN
EC233,,2013,1988,,2805,1968533,353078,,2805,1968533,353078,,0,0,0,PDN
EC233,,2014,1988,,2805,1968533,353078,,2805,1968533,353078,,0,0,0,PDN
EC233,,2015,1988,,2805,1968533,353078,,2805,1968533,353078,,0,0,0,PDN
EC233,,2016,1988,,2805,1968533,353078,,2805,1968533,353078,,0,0,0,PDN
EC233,,2017,1988,,2805,1968533,353078,,2805,1968533,353078,,0,0,0,PDN
EC233,,2017,1988,,2805,1968533,353078,,2805,1968533,353078,,0,0,0,PDN
EC237,,1977,1975,,11460412,135196284,35516690,,0,0,0,,11460412,135196284,35516690,PDN
EC237,,1978,1975,,84680,84680000,15152296,,0,0,0,,84680,84680000,15152296,PDN
EC237,,1979,1975,,250000,84680000,15317616,,97421,33220436,6008531,,152579,51459564,9309085,PDN
EC237,,1980,1975,,790000,173000000,31572918,,169333,61402580,11095059,,620667,111597420,20477859,PDN
EC237,,1981,1975,,1494000,185800000,34554498,,236986,87802919,15860281,,1257014,97997081,18694217,PDN
EC237,,1982,1975,,1965000,191360001,36014822,,492707,93391340,17110383,,1472293,97968661,18904439,PDN
EC237,,1983,1975,,1965000,191360001,36014822,,683604,96932290,17931342,,1281396,94427711,18083480,PDN
EC237,,1984,1975,,2530870,198693433,37885573,,889472,101212866,18898879,,1641398,97480567,18986694,PDN
EC237,,1985,1975,,2530870,198693433,37885573,,975048,103500145,19391444,,1555822,95193288,18494129,PDN
EC237,,1986,1975,,1905291,121988110,23611360,,1017193,104535875,19617883,,888098,17452235,3993477,PDN
EC237,,1987,1975,,2043427,170147694,32318817,,1154715,113800991,21404002,,888712,56346703,10914815,PDN
EC237,,1988,1975,,2044414,172201635,32685274,,1179299,118285483,22226538,,865115,53916152,10458736,PDN
EC237,,1989,1975,,1577597,125871042,23974580,,1348593,120543201,22797561,,229004,5327841,1177019,PDN
EC237,,1990,1975,,1577597,125871042,23974580,,1467463,120682371,22941194,,110134,5188671,1033386,PDN
EC237,,1991,1975,,1618011,125995862,24037204,,1534390,121029346,23069861,,83621,4966516,967343,PDN
EC237,,1992,1975,,1585276,128400437,24432329,,1580947,123603990,23574540,,4329,4796447,857789,PDN
EC237,,1993,1975,,1625443,129772899,24716706,,1587352,123990773,23649767,,38091,5782126,1066939,PDN
EC237,,1994,1975,,1625274,129772900,24716537,,1587788,124121787,23673515,,37486,5651113,1043022,PDN
EC237,,1995,1975,,1858134,142704876,27250461,,1592111,124401348,23727582,,266023,18303528,3522879,PDN
EC237,,1996,1975,,1814112,138443720,26448226,,1628212,126896714,24207698,,185900,11547006,2240528,PDN
EC237,,1997,1975,,1814112,138443720,26448226,,1656686,129206511,24647168,,157426,9237209,1801058,PDN
EC237,,1998,1975,,1812886,138256059,26413608,,1684553,131639682,25107984,,128333,6616377,1305624,PDN
EC237,,1999,1975,,1693581,132595008,25286999,,1693581,132595008,25286999,,0,0,0,PDN
EC237,,2000,1975,,1693581,132595008,25286999,,1693581,132595008,25286999,,0,0,0,PDN
EC237,,2001,1975,,1693581,132595008,25286999,,1693581,132595008,25286999,,0,0,0,PDN
EC237,,2002,1975,,1693581,132595008,25286999,,1693581,132595008,25286999,,0,0,0,PDN
EC237,,2003,1975,,1693581,132595008,25286999,,1693581,132595008,25286999,,0,0,0,PDN
EC237,,2004,1975,,1752326,134099200,25613394,,1741936,133939566,25574599,,10390,159634,38795,PDN
EC237,,2005,1975,,1829723,148814013,28309085,,1793179,138172120,26378965,,36544,10641893,1930120,PDN
EC237,,2006,1975,,1809756,142895292,27235965,,1804363,140782253,26854586,,5393,2113039,381379,PDN
EC237,,2007,1975,,1809756,142895292,27235965,,1806632,141415020,26969447,,3124,1480272,266518,PDN
EC237,,2008,1975,,1809265,142668566,27195131,,1807071,141638609,27009670,,2194,1029957,185461,PDN
EC237,,2009,1975,,1809228,145195758,27644772,,1807289,144352102,27492717,,1939,843656,152056,PDN
EC237,,2010,1975,,1809228,145195758,27644772,,1808829,144958464,27602150,,399,237294,42622,PDN
EC237,,2011,1975,,1809228,145195758,27644772,,1809228,145195756,27644772,,0,2,0,PDN
EC237,,2012,1975,,1809228,145195758,27644772,,1809228,145195758,27644772,,0,0,0,PDN
EC237,,2013,1975,,1809228,145195758,27644772,,1809228,145195758,27644772,,0,0,0,PDN
EC237,,2014,1975,,1809228,145195758,27644772,,1809228,145195758,27644772,,0,0,0,PDN
EC237,,2015,1975,,1809228,145195758,27644772,,1809228,145195758,27644772,,0,0,0,PDN
EC237,,2016,1975,,1809228,145195758,27644772,,1809228,145195758,27644772,,0,0,0,PDN
EC237,,2017,1975,,1809228,145195758,27644772,,1809228,145195758,27644772,,0,0,0,PDN
EC237,,2017,1975,,1809228,145195758,27644772,,1809228,145195758,27644772,,0,0,0,PDN
EC245,,1975,1963,,0,144330400,25681566,,0,37100147,6601450,,0,107230253,19080116,PDN
EC245,,1976,1963,,0,144330400,25681566,,0,50562915,8996960,,0,93767485,16684606,PDN
EC245,,1977,1963,,0,144330400,25681566,,0,63317505,11266460,,0,81012895,14415106,PDN
EC245,,1978,1963,,0,144330400,25681566,,0,75290027,13396802,,0,69040373,12284764,PDN
EC245,,1979,1963,,0,144330400,25681566,,0,87262450,15527126,,0,57067950,10154440,PDN
EC245,,1980,1963,,0,144330400,25681566,,0,100958401,17964128,,0,43371999,7717438,PDN
EC245,,1981,1963,,0,192910000,34325623,,0,113939127,20273866,,0,78970873,14051757,PDN
EC245,,1982,1963,,0,192887377,34321597,,0,124646084,22179019,,0,68241293,12142578,PDN
EC245,,1983,1963,,0,202467377,36026224,,0,134710722,23969879,,0,67756655,12056345,PDN
EC245,,1984,1963,,0,202467377,36026224,,0,144119602,25644057,,0,58347775,10382167,PDN
EC245,,1985,1963,,0,202467377,36026224,,0,151285491,26919127,,0,51181886,9107097,PDN
EC245,,1986,1963,,0,202467377,36026224,,0,158230673,28154924,,0,44236704,7871300,PDN
EC245,,1987,1963,,0,197728495,35183006,,0,165101625,29377513,,0,32626870,5805493,PDN
EC245,,1988,1963,,0,197507297,35143647,,0,172530356,30699352,,0,24976941,4444295,PDN
EC245,,1989,1963,,0,197507297,35143647,,0,177346300,31556281,,0,20160997,3587366,PDN
EC245,,1990,1963,,0,197507297,35143647,,0,185719786,33046225,,0,11787511,2097422,PDN
EC245,,1991,1963,,0,197507297,35143647,,0,190081108,33822261,,0,7426189,1321386,PDN
EC245,,1992,1963,,3812,209780277,37331263,,1008,197682890,35175899,,2804,12097387,2155364,PDN
EC245,,1993,1963,,5695,222300277,39560904,,1509,203091186,36138731,,4186,19209091,3422173,PDN
EC245,,1994,1963,,39327,225663474,40192970,,1710,206954268,36826313,,37617,18709206,3366657,PDN
EC245,,1995,1963,,88088,242050242,43157526,,1932,212944882,37892480,,86156,29105360,5265046,PDN
EC245,,1996,1963,,6132,242640189,43180543,,2083,220878867,39304373,,4049,21761322,3876170,PDN
EC245,,1997,1963,,6252,243840114,43394173,,2116,224236386,39901829,,4136,19603728,3492344,PDN
EC245,,1998,1963,,6351,244834337,43571180,,2116,226221157,40254991,,4235,18613180,3316189,PDN
EC245,,1999,1963,,3536,231165434,41136176,,2116,227461937,40475770,,1420,3703497,660406,PDN
EC245,,2000,1963,,3214,229563589,40850828,,2116,228139818,40596390,,1098,1423771,254438,PDN
EC245,,2001,1963,,2225,228906655,40732947,,2116,228303094,40625442,,109,603561,107505,PDN
EC245,,2002,1963,,2225,228906655,40732947,,2116,228518579,40663785,,109,388076,69162,PDN
EC245,,2003,1963,,2225,228931655,40737395,,2116,228661193,40689161,,109,270462,48234,PDN
EC245,,2004,1963,,2232,229497123,40838019,,2116,228810617,40715749,,116,686506,122270,PDN
EC245,,2005,1963,,2160,229762250,40885123,,2116,229280964,40799441,,44,481286,85682,PDN
EC245,,2006,1963,,2116,229430150,40825986,,2116,229353377,40812325,,0,76773,13661,PDN
EC245,,2007,1963,,2116,229383302,40817650,,2116,229383302,40817650,,0,0,0,PDN
EC245,,2008,1963,,2116,229383302,40817650,,2116,229383302,40817650,,0,0,0,PDN
EC245,,2009,1963,,2116,233904448,41622124,,2116,233904448,41622124,,0,0,0,PDN
EC245,,2010,1963,,2116,233904448,41622124,,2116,233904448,41622124,,0,0,0,PDN
EC245,,2011,1963,,2116,233904448,41622124,,2116,233904448,41622124,,0,0,0,PDN
EC245,,2012,1963,,2116,233904448,41622124,,2116,233904448,41622124,,0,0,0,PDN
EC245,,2013,1963,,2116,233904448,41622124,,2116,233904448,41622124,,0,0,0,PDN
EC245,,2014,1963,,2116,233904448,41622124,,2116,233904448,41622124,,0,0,0,PDN
EC245,,2015,1963,,2116,233904448,41622124,,2116,233904448,41622124,,0,0,0,PDN
EC245,,2016,1963,,2116,233904448,41622124,,2116,233904448,41622124,,0,0,0,PDN
EC245,,2017,1963,,2116,233904448,41622124,,2116,233904448,41622124,,0,0,0,PDN
EC245,,2017,1963,,2116,233904448,41622124,,2116,233904448,41622124,,0,0,0,PDN
EC246,,1991,1990,,15958,8852764,1591183,,3810,2354594,422777,,12148,6498170,1168406,PDN
EC246,,1992,1990,,4354,3168868,568210,,4354,3168868,568210,,0,0,0,PDN
EC246,,1993,1990,,4354,3168868,568210,,4354,3168868,568210,,0,0,0,PDN
EC246,,1994,1990,,4354,3168868,568210,,4354,3168868,568210,,0,0,0,PDN
EC246,,1995,1990,,4354,3168868,568210,,4354,3168868,568210,,0,0,0,PDN
EC246,,1996,1990,,4354,3168868,568210,,4354,3168868,568210,,0,0,0,PDN
EC246,,1997,1990,,4354,3168868,568210,,4354,3168868,568210,,0,0,0,PDN
EC246,,1998,1990,,4354,3168868,568210,,4354,3168868,568210,,0,0,0,PDN
EC246,,1999,1990,,4354,3168868,568210,,4354,3168868,568210,,0,0,0,PDN
EC246,,2000,1990,,4354,3168868,568210,,4354,3168868,568210,,0,0,0,PDN
EC246,,2001,1990,,4354,3168868,568210,,4354,3168868,568210,,0,0,0,PDN
EC246,,2002,1990,,4354,3168868,568210,,4354,3168868,568210,,0,0,0,PDN
EC246,,2003,1990,,4354,3168868,568210,,4354,3168868,568210,,0,0,0,PDN
EC246,,2004,1990,,4354,3168868,568210,,4354,3168868,568210,,0,0,0,PDN
EC246,,2005,1990,,4354,3168868,568210,,4354,3168868,568210,,0,0,0,PDN
EC246,,2006,1990,,4354,3168868,568210,,4354,3168868,568210,,0,0,0,PDN
EC246,,2007,1990,,4354,3168868,568210,,4354,3168868,568210,,0,0,0,PDN
EC246,,2008,1990,,4354,3168868,568210,,4354,3168868,568210,,0,0,0,PDN
EC246,,2009,1990,,4354,3232330,579502,,4354,3232330,579502,,0,0,0,PDN
EC246,,2010,1990,,4354,3232330,579502,,4354,3232330,579502,,0,0,0,PDN
EC246,,2011,1990,,4354,3232330,579502,,4354,3232330,579502,,0,0,0,PDN
EC246,,2012,1990,,4354,3232330,579502,,4354,3232330,579502,,0,0,0,PDN
EC246,,2013,1990,,4354,3232330,579502,,4354,3232330,579502,,0,0,0,PDN
EC246,,2014,1990,,4354,3232330,579502,,4354,3232330,579502,,0,0,0,PDN
EC246,,2015,1990,,4354,3232330,579502,,4354,3232330,579502,,0,0,0,PDN
EC246,,2016,1990,,4354,3232330,579502,,4354,3232330,579502,,0,0,0,PDN
EC246,,2017,1990,,4354,3232330,579502,,4354,3232330,579502,,0,0,0,PDN
EC246,,2017,1990,,4354,3232330,579502,,4354,3232330,579502,,0,0,0,PDN
EC257,,1975,1971,,19824,49331300,8797635,,7851,19513834,3480063,,11973,29817466,5317572,PDP
EC257,,1976,1971,,19824,49331300,8797635,,7856,21579421,3847611,,11968,27751879,4950024,PDP
EC257,,1977,1971,,47218,50091800,8960350,,7856,22273104,3971042,,39362,27818696,4989308,PDP
EC257,,1978,1971,,49651,52525400,9395808,,7856,22886650,4080214,,41795,29638750,5315594,PDP
EC257,,1979,1971,,56651,52525400,9402808,,8707,24499174,4367991,,47944,28026226,5034817,PDP
EC257,,1980,1971,,56651,52525400,9402808,,8707,24763980,4415109,,47944,27761420,4987699,PDP
EC257,,1981,1971,,8707,28430405,5067498,,8707,24816847,4424516,,0,3613558,642982,PDP
EC257,,1982,1971,,8707,46122734,8215599,,8707,25238123,4499476,,0,20884611,3716123,PDP
EC257,,1983,1971,,8707,46122734,8215599,,8707,25426674,4533026,,0,20696060,3682573,PDP
EC257,,1984,1971,,8707,25426674,4533026,,8707,25426674,4533026,,0,0,0,PDP
EC257,,1985,1971,,8707,25426674,4533026,,8707,25426674,4533026,,0,0,0,PDP
EC257,,1986,1971,,8707,25426674,4533026,,8707,25426674,4533026,,0,0,0,PDP
EC257,,1987,1971,,8707,25426674,4533026,,8707,25426674,4533026,,0,0,0,PDP
EC257,,1988,1971,,8707,25426674,4533026,,8707,25426674,4533026,,0,0,0,PDP
EC257,,1989,1971,,8707,25426674,4533026,,8707,25426674,4533026,,0,0,0,PDP
EC257,,1990,1971,,8707,25426674,4533026,,8707,25426674,4533026,,0,0,0,PDP
EC257,,1991,1971,,8707,25426674,4533026,,8707,25426674,4533026,,0,0,0,PDP
EC257,,1992,1971,,8707,25426674,4533026,,8707,25426674,4533026,,0,0,0,PDP
EC257,,1993,1971,,8707,25426674,4533026,,8707,25426674,4533026,,0,0,0,PDP
EC257,,1994,1971,,8707,25426674,4533026,,8707,25426674,4533026,,0,0,0,PDP
EC257,,1995,1971,,8707,25426674,4533026,,8707,25426674,4533026,,0,0,0,PDP
EC257,,1996,1971,,8707,25426674,4533026,,8707,25426674,4533026,,0,0,0,PDP
EC257,,1997,1971,,8707,25426674,4533026,,8707,25426674,4533026,,0,0,0,PDP
EC257,,1998,1971,,8707,25426674,4533026,,8707,25426674,4533026,,0,0,0,PDP
EC257,,1999,1971,,8707,25426674,4533026,,8707,25426674,4533026,,0,0,0,PDP
EC257,,2000,1971,,8707,25426674,4533026,,8707,25426674,4533026,,0,0,0,PDP
EC257,,2001,1971,,8707,25426674,4533026,,8707,25426674,4533026,,0,0,0,PDP
EC257,,2002,1971,,8707,25426674,4533026,,8707,25426674,4533026,,0,0,0,PDP
EC257,,2003,1971,,8707,25426674,4533026,,8707,25426674,4533026,,0,0,0,PDP
EC257,,2004,1971,,8707,25426674,4533026,,8707,25426674,4533026,,0,0,0,PDP
EC257,,2005,1971,,8707,25426674,4533026,,8707,25426674,4533026,,0,0,0,PDP
EC257,,2006,1971,,47979,41811150,7487685,,11518,26332974,4697101,,36461,15478176,2790584,PDP
EC257,,2007,1971,,47979,41811150,7487685,,24526,29831806,5332677,,23453,11979344,2155008,PDP
EC257,,2008,1971,,47979,41811150,7487685,,27380,31545678,5640490,,20599,10265472,1847195,PDP
EC257,,2009,1971,,29814,39219492,7008372,,28158,33812010,6044530,,1656,5407482,963842,PDP
EC257,,2010,1971,,29814,39219492,7008372,,29124,35513536,6348258,,690,3705956,660112,PDP
EC257,,2011,1971,,29814,39219492,7008372,,29356,36838762,6584296,,458,2380730,424076,PDP
EC257,,2012,1971,,29814,39219492,7008372,,29356,36842938,6585040,,458,2376554,423332,PDP
EC257,,2013,1971,,33114,42499192,7595248,,30022,37736034,6744620,,3092,4763158,850630,PDP
EC257,,2014,1971,,33114,42499192,7595248,,30588,38752374,6926028,,2526,3746818,669220,PDP
EC257,,2015,1971,,33114,42499192,7595248,,30642,38869852,6946986,,2472,3629340,648262,PDP
EC257,,2016,1971,,33114,42499192,7595248,,30718,39072276,6983080,,2396,3426916,612168,PDP
EC257,,2017,1971,,30770,39149812,6996930,,30770,39149812,6996930,,0,0,0,PDP
EC257,,2017,1971,,30770,39149812,6996930,,30770,39149812,6996930,,0,0,0,PDP
EC261,,1975,1966,,197340,110847976,19921179,,162346,86812449,15609401,,34994,24035527,4311778,PDN
EC261,,1976,1966,,278772,153718018,27630732,,178155,100831309,18119669,,100617,52886709,9511063,PDN
EC261,,1977,1966,,279188,153759401,27638512,,193387,113317885,20356712,,85801,40441516,7281800,PDN
EC261,,1978,1966,,294244,168815251,30332545,,202338,121844225,21882805,,91906,46971026,8449740,PDN
EC261,,1979,1966,,294244,168815251,30332545,,211673,128920277,23151224,,82571,39894974,7181321,PDN
EC261,,1980,1966,,294244,170740396,30675097,,217898,135295148,24291768,,76346,35445248,6383329,PDN
EC261,,1981,1966,,255217,178681987,32049165,,235310,140553776,25244879,,19907,38128211,6804286,PDN
EC261,,1982,1966,,271160,177357732,31829475,,223558,141071536,25325255,,47602,36286196,6504220,PDN
EC261,,1983,1966,,263140,179957153,32283986,,224513,142318710,25548127,,38627,37638443,6735859,PDN
EC261,,1984,1966,,263140,179957153,32283986,,226038,146072448,26217577,,37102,33884705,6066409,PDN
EC261,,1985,1966,,277819,181597928,32590618,,230607,150844868,27071331,,47212,30753060,5519287,PDN
EC261,,1986,1966,,277819,181597928,32590618,,232420,152545553,27375757,,45399,29052375,5214861,PDN
EC261,,1987,1966,,277819,181597928,32590618,,235949,154493959,27725977,,41870,27103969,4864641,PDN
EC261,,1988,1966,,277819,182898440,32822025,,237849,156133462,28019604,,39970,26764978,4802421,PDN
EC261,,1989,1966,,298428,188838490,33899583,,245738,160773285,28853084,,52690,28065205,5046499,PDN
EC261,,1990,1966,,323032,205688623,36922431,,260996,171451538,30768387,,62036,34237085,6154044,PDN
EC261,,1991,1966,,350534,216940382,38952025,,280762,180535979,32404602,,69772,36404403,6547423,PDN
EC261,,1992,1966,,350534,216940382,38952025,,276302,184711905,33143189,,74232,32228477,5808836,PDN
EC261,,1993,1966,,327336,215863797,38737264,,295521,190777722,34241735,,31815,25086075,4495529,PDN
EC261,,1994,1966,,327336,215863797,38737264,,299384,193825380,34787886,,27952,22038417,3949378,PDN
EC261,,1995,1966,,369446,220200083,39550955,,300260,199548130,35807045,,69186,20651953,3743910,PDN
EC261,,1996,1966,,346263,233122063,41827057,,303045,203315876,36480247,,43218,29806187,5346810,PDN
EC261,,1997,1966,,346263,233122063,41827057,,304111,205694950,36904636,,42152,27427113,4922421,PDN
EC261,,1998,1966,,333153,230235564,41300335,,305293,208200617,37351666,,27860,22034947,3948669,PDN
EC261,,1999,1966,,307716,219297113,39328555,,306784,210329509,37731964,,932,8967604,1596591,PDN
EC261,,2000,1966,,330429,230977172,41429570,,314781,215246483,38614867,,15648,15730689,2814703,PDN
EC261,,2001,1966,,339514,230801111,41407327,,320417,218218500,39149332,,19097,12582611,2257995,PDN
EC261,,2002,1966,,343130,230846621,41419041,,324102,220500851,39559129,,19028,10345770,1859912,PDN
EC261,,2003,1966,,334443,225695385,40493764,,325775,221350766,39712032,,8668,4344619,781732,PDN
EC261,,2004,1966,,328839,223320886,40065651,,326807,221906579,39811963,,2032,1414307,253688,PDN
EC261,,2005,1966,,391354,251860600,45206407,,328491,223509021,40098779,,62863,28351579,5107628,PDN
EC261,,2006,1966,,355093,241223067,43277347,,339085,227773418,40868163,,16008,13449649,2409184,PDN
EC261,,2007,1966,,355093,241223067,43277347,,343638,231186962,41480108,,11455,10036105,1797239,PDN
EC261,,2008,1966,,355093,241224440,43277591,,345301,232419236,41701037,,9792,8805204,1576554,PDN
EC261,,2009,1966,,374343,248559634,44602034,,345301,236570669,42439725,,29042,11988965,2162309,PDN
EC261,,2010,1966,,374343,248559634,44602034,,352375,240300095,43110398,,21968,8259539,1491636,PDN
EC261,,2011,1966,,374343,248559634,44602034,,354217,241959377,43407486,,20126,6600257,1194548,PDN
EC261,,2012,1966,,374343,248559634,44602034,,357344,243677579,43716343,,16999,4882055,885692,PDN
EC261,,2013,1966,,374343,248559634,44602034,,361107,246039759,44140422,,13236,2519875,461612,PDN
EC261,,2014,1966,,365432,250601585,44956461,,362251,247161386,44341143,,3181,3440199,615316,PDN
EC261,,2015,1966,,365432,250601585,44956461,,362694,247561238,44412735,,2738,3040347,543725,PDN
EC261,,2016,1966,,362721,247570442,44414399,,362721,247570442,44414399,,0,0,0,PDN
EC261,,2017,1966,,362721,247570438,44414399,,362721,247570438,44414399,,0,0,0,PDN
EC261,,2017,1966,,362721,247570438,44414399,,362721,247570438,44414399,,0,0,0,PDN
EC265,,1975,1963,,1497084,182649000,33996906,,484177,57976322,10800249,,1012907,124672678,23196657,PDP
EC265,,1976,1963,,1497084,182649000,33996906,,500399,65240366,12109005,,996685,117408634,21887901,PDP
EC265,,1977,1963,,1518778,192473000,35766643,,516026,72910995,13489513,,1002752,119562005,22277130,PDP
EC265,,1978,1963,,1557686,202241000,37543629,,539048,80106530,14792879,,1018638,122134470,22750750,PDP
EC265,,1979,1963,,857687,202241965,36843802,,334615,86838876,15786372,,523072,115403089,21057430,PDP
EC265,,1980,1963,,857687,202241965,36843802,,349055,91840433,16690769,,508632,110401532,20153033,PDP
EC265,,1981,1963,,445310,126713708,22992233,,351374,93925359,17064071,,93936,32788349,5928162,PDP
EC265,,1982,1963,,482983,135298642,24557474,,351374,95115839,17275901,,131609,40182803,7281573,PDP
EC265,,1983,1963,,482983,135298642,24557474,,351374,96062291,17444308,,131609,39236351,7113166,PDP
EC265,,1984,1963,,482983,135298642,24557474,,351374,97832475,17759288,,131609,37466167,6798186,PDP
EC265,,1985,1963,,490935,138057308,25056292,,352860,99976896,18142343,,138075,38080412,6913949,PDP
EC265,,1986,1963,,495549,139015735,25231445,,358443,101719396,18457980,,137106,37296339,6773465,PDP
EC265,,1987,1963,,667707,159343851,29020705,,361090,102319597,18567424,,306617,57024254,10453281,PDP
EC265,,1988,1963,,571029,148798616,27047651,,390757,106146687,19278068,,180272,42651929,7769583,PDP
EC265,,1989,1963,,2084598,297327353,54989821,,477152,117292076,21347628,,1607446,180035277,33642193,PDP
EC265,,1990,1963,,1464033,342084522,62333165,,689988,155566835,28370919,,774045,186517687,33962246,PDP
EC265,,1991,1963,,1432158,350486071,63796228,,816888,193700635,35283193,,615270,156785436,28513035,PDP
EC265,,1992,1963,,1493507,403453522,73282390,,953310,237620641,43234563,,540197,165832881,30047827,PDP
EC265,,1993,1963,,1720781,455156327,82709451,,1133018,282853327,51462791,,587763,172303000,31246660,PDP
EC265,,1994,1963,,1708828,454729875,82621617,,1324250,318515098,57999534,,384578,136214777,24622083,PDP
EC265,,1995,1963,,1994179,475213709,86551778,,1458766,349511797,63649477,,535413,125701912,22902301,PDP
EC265,,1996,1963,,2095142,489047225,89114221,,1581224,376576283,68587680,,513918,112470942,20526541,PDP
EC265,,1997,1963,,2192148,498964483,90975864,,1685537,398816610,72649347,,506611,100147873,18326517,PDP
EC265,,1998,1963,,2198700,498623939,90921821,,1752557,414847936,75568916,,446143,83776003,15352905,PDP
EC265,,1999,1963,,2009735,455394966,83040868,,1773775,423086630,77056094,,235960,32308336,5984774,PDP
EC265,,2000,1963,,1936429,463242136,84363855,,1800408,430647810,78428132,,136021,32594326,5935723,PDP
EC265,,2001,1963,,1870268,459348488,83604874,,1803915,433949132,79019063,,66353,25399356,4585811,PDP
EC265,,2002,1963,,1822000,452133014,82272714,,1803915,436013864,79386453,,18085,16119150,2886261,PDP
EC265,,2003,1963,,1822000,454536648,82700407,,1803915,438017202,79742919,,18085,16519446,2957488,PDP
EC265,,2004,1963,,1819146,460085822,83684951,,1803915,439956114,80087921,,15231,20129708,3597030,PDP
EC265,,2005,1963,,2286234,528903636,96397202,,1849007,443519933,80767145,,437227,85383703,15630057,PDP
EC265,,2006,1963,,1953887,513395759,93305446,,1913954,456423673,83128131,,39933,56972086,10177315,PDP
EC265,,2007,1963,,1953887,513395759,93305446,,1933976,466657482,84969115,,19911,46738277,8336331,PDP
EC265,,2008,1963,,2038694,518622307,94320243,,1933990,471837083,85890766,,104704,46785224,8429477,PDP
EC265,,2009,1963,,2018017,529235024,96187950,,1933990,480072018,87356057,,84027,49163006,8831892,PDP
EC265,,2010,1963,,2018017,529235260,96187992,,1960041,489024880,88975145,,57976,40210380,7212848,PDP
EC265,,2011,1963,,2011198,526471556,95689411,,1971698,494769538,90008981,,39500,31702018,5680429,PDP
EC265,,2012,1963,,2014974,530613944,96430267,,1979675,501316372,91181878,,35299,29297572,5248390,PDP
EC265,,2013,1963,,2014974,530613944,96430267,,1983804,507089764,92213300,,31170,23524180,4216968,PDP
EC265,,2014,1963,,2017016,537876944,97724658,,1987846,511642917,93027512,,29170,26234027,4697147,PDP
EC265,,2015,1963,,2017016,537876944,97724658,,1990633,514837743,93598773,,26383,23039201,4125885,PDP
EC265,,2016,1963,,2018157,530976472,96497957,,1991417,516064691,93817877,,26740,14911781,2680082,PDP
EC265,,2017,1963,,2007180,524368689,95311216,,1991492,516980943,93980984,,15688,7387746,1330234,PDP
EC265,,2017,1963,,2007180,524368689,95311216,,1991492,516980943,93980984,,15688,7387746,1330234,PDP
EC267,,1987,1985,,13108,32496028,5795319,,1195,3223582,574786,,11913,29272446,5220533,PDN
EC267,,1988,1985,,11839,36337553,6477596,,2063,7202395,1283628,,9776,29135158,5193968,PDN
EC267,,1989,1985,,10615,32177810,5736204,,3053,11236481,2002427,,7562,20941329,3733777,PDN
EC267,,1990,1985,,10787,32519464,5797168,,3633,14090421,2510825,,7154,18429043,3286343,PDN
EC267,,1991,1985,,9384,35712093,6363849,,3758,15496096,2761070,,5626,20215997,3602779,PDN
EC267,,1992,1985,,4573,20937887,3730176,,3928,16521210,2943645,,645,4416677,786531,PDN
EC267,,1993,1985,,3965,16780259,2989776,,3965,16780259,2989776,,0,0,0,PDN
EC267,,1994,1985,,3965,16780259,2989776,,3965,16780259,2989776,,0,0,0,PDN
EC267,,1995,1985,,3965,16780259,2989776,,3965,16780259,2989776,,0,0,0,PDN
EC267,,1996,1985,,3965,16780259,2989776,,3965,16780259,2989776,,0,0,0,PDN
EC267,,1997,1985,,3965,16780259,2989776,,3965,16780259,2989776,,0,0,0,PDN
EC267,,1998,1985,,3965,16780259,2989776,,3965,16780259,2989776,,0,0,0,PDN
EC267,,1999,1985,,3965,16780259,2989776,,3965,16780259,2989776,,0,0,0,PDN
EC267,,2000,1985,,3965,16780259,2989776,,3965,16780259,2989776,,0,0,0,PDN
EC267,,2001,1985,,3965,16780259,2989776,,3965,16780259,2989776,,0,0,0,PDN
EC267,,2002,1985,,42901,23204628,4171838,,8056,17245281,3076611,,34845,5959347,1095227,PDN
EC267,,2003,1985,,38072,23062502,4141720,,28777,20807848,3731241,,9295,2254654,410479,PDN
EC267,,2004,1985,,35820,23062502,4139468,,33280,22316324,4004156,,2540,746178,135312,PDN
EC267,,2005,1985,,36870,23947099,4297920,,34234,22797753,4090774,,2636,1149346,207146,PDN
EC267,,2006,1985,,35498,23299453,4181308,,35032,23172076,4158177,,466,127377,23131,PDN
EC267,,2007,1985,,35498,23299453,4181308,,35498,23299453,4181308,,0,0,0,PDN
EC267,,2008,1985,,35498,23299453,4181308,,35498,23299453,4181308,,0,0,0,PDN
EC267,,2009,1985,,39923,32486212,5820387,,35498,23635510,4241104,,4425,8850702,1579283,PDN
EC267,,2010,1985,,39923,32486212,5820387,,37168,23762356,4265344,,2755,8723856,1555043,PDN
EC267,,2011,1985,,134593,26328770,4819427,,79792,24940462,4517596,,54801,1388308,301831,PDN
EC267,,2012,1985,,134593,26328770,4819427,,129828,25032729,4584049,,4765,1296041,235377,PDN
EC267,,2013,1985,,160947,27040023,4972338,,139542,25441596,4666516,,21405,1598427,305822,PDN
EC267,,2014,1985,,160947,27040023,4972338,,146783,25691112,4718155,,14164,1348911,254183,PDN
EC267,,2015,1985,,149431,25694629,4721428,,149431,25694629,4721428,,0,0,0,PDN
EC267,,2016,1985,,149431,25694629,4721428,,149431,25694629,4721428,,0,0,0,PDN
EC267,,2017,1985,,149431,25694673,4721436,,149431,25694673,4721436,,0,0,0,PDN
EC267,,2017,1985,,149431,25694673,4721436,,149431,25694673,4721436,,0,0,0,PDN
EC271,,1975,1971,,41254768,1590000000,324172917,,10480025,518927912,102815952,,30774743,1071072088,221356965,PDP
EC271,,1976,1971,,41325597,1660828800,336846736,,13759071,635764080,126884352,,27566526,1025064720,209962384,PDP
EC271,,1977,1971,,45615941,1077044308,237260836,,18575731,716788897,146118239,,27040210,360255411,91142597,PDP
EC271,,1978,1971,,46041653,1149453467,250570740,,21658152,777657071,160031296,,24383501,371796396,90539444,PDP
EC271,,1979,1971,,42885653,1149453467,247414740,,21307428,842878094,171285737,,21578225,306575373,76129003,PDP
EC271,,1980,1971,,47668562,1147058326,251771467,,25651202,920490875,189439614,,22017360,226567451,62331853,PDP
EC271,,1981,1971,,48794365,1217922594,265506570,,30585177,985792032,205993012,,18209188,232130562,59513558,PDP
EC271,,1982,1971,,49497853,1189342496,261124632,,33308807,1022696352,215283247,,16189046,166646144,45841385,PDP
EC271,,1983,1971,,50109970,1197337766,263159395,,36082931,1045089785,222041967,,14027039,152247981,41117428,PDP
EC271,,1984,1971,,52006210,1207255046,266820275,,38437089,1061797113,227368960,,13569121,145457933,39451315,PDP
EC271,,1985,1971,,52107877,1209634782,267345383,,40863750,1071421240,231508099,,11244127,138213542,35837284,PDP
EC271,,1986,1971,,55750445,1215070843,271955221,,43574364,1078451778,235469698,,12176081,136619065,36485523,PDP
EC271,,1987,1971,,57270435,1229257014,275999441,,45832535,1085815379,239038118,,11437900,143441635,36961323,PDP
EC271,,1988,1971,,57177149,1239255079,277685170,,47856513,1094187650,242551824,,9320636,145067429,35133346,PDP
EC271,,1989,1971,,59894912,1181915120,270200093,,49296884,1102715752,245509651,,10598028,79199368,24690442,PDP
EC271,,1990,1971,,60476957,1185216587,271369588,,50580300,1108731113,247863416,,9896657,76485474,23506172,PDP
EC271,,1991,1971,,61583209,1177979535,271188108,,52028582,1115497252,250515638,,9554627,62482283,20672470,PDP
EC271,,1992,1971,,61785589,1182214348,272144014,,53426457,1122087342,253086126,,8359132,60127006,19057888,PDP
EC271,,1993,1971,,61809733,1185724619,272792761,,54892175,1132598670,256422187,,6917558,53125949,16370574,PDP
EC271,,1994,1971,,63489394,1214340772,279564264,,56141629,1144721153,259828667,,7347765,69619619,19735597,PDP
EC271,,1995,1971,,63899240,1215081343,280105885,,57366590,1152947797,262517444,,6532650,62133546,17588441,PDP
EC271,,1996,1971,,67853506,1395407854,316146718,,59064004,1170225009,267289095,,8789502,225182845,48857623,PDP
EC271,,1997,1971,,68180024,1350915826,308556505,,60602535,1193967514,273052271,,7577489,156948312,35504234,PDP
EC271,,1998,1971,,68778151,1361461907,311031159,,61860525,1215846293,278203282,,6917626,145615614,32827877,PDP
EC271,,1999,1971,,67755229,1304509796,299874410,,63090959,1233746642,282618831,,4664270,70763154,17255579,PDP
EC271,,2000,1971,,68124470,1358148125,309787837,,64238986,1261398869,288687183,,3885484,96749256,21100654,PDP
EC271,,2001,1971,,68844145,1362978856,311367073,,65106541,1278078159,292522584,,3737604,84900697,18844489,PDP
EC271,,2002,1971,,69180901,1336991838,307079805,,65918645,1289146343,295304115,,3262256,47845495,11775690,PDP
EC271,,2003,1971,,68880048,1326762771,304958833,,66678067,1298348189,297700876,,2201981,28414582,7257957,PDP
EC271,,2004,1971,,69087280,1327014029,305210773,,67238972,1306065722,299635008,,1848308,20948307,5575765,PDP
EC271,,2005,1971,,70144220,1333582363,307436456,,67460211,1308453962,300281201,,2684009,25128401,7155255,PDP
EC271,,2006,1971,,70685320,1336409546,308480613,,67534342,1309278268,300502005,,3150978,27131278,7978608,PDP
EC271,,2007,1971,,70760864,1334827559,308274665,,68010722,1312049318,301471455,,2750142,22778241,6803210,PDP
EC271,,2008,1971,,70669200,1333807036,308001413,,68366829,1313422768,302071948,,2302371,20384268,5929465,PDP
EC271,,2009,1971,,70607268,1351600641,311105603,,68567848,1338714047,306773194,,2039420,12886594,4332409,PDP
EC271,,2010,1971,,70607268,1351600641,311105603,,68724795,1340057678,307169222,,1882473,11542963,3936381,PDP
EC271,,2011,1971,,70648383,1347590026,310433085,,68854797,1340899628,307449037,,1793586,6690398,2984048,PDP
EC271,,2012,1971,,70648383,1347849619,310479276,,69200825,1342302138,308044622,,1447558,5547481,2434654,PDP
EC271,,2013,1971,,73336185,1349887298,313529653,,69484182,1342513736,308365629,,3852003,7373562,5164025,PDP
EC271,,2014,1971,,74611055,1349933582,314812759,,70115913,1342903945,309066792,,4495142,7029637,5745968,PDP
EC271,,2015,1971,,75798765,1349318086,315890950,,71334915,1343331262,310361827,,4463850,5986824,5529122,PDP
EC271,,2016,1971,,75798765,1349318086,315890950,,71994034,1343600971,311068936,,3804731,5717115,4822012,PDP
EC271,,2017,1971,,76253523,1355427591,317432808,,72578456,1343841279,311696120,,3675067,11586312,5736689,PDP
EC271,,2017,1971,,76253523,1355427591,317432808,,72578456,1343841279,311696120,,3675067,11586312,5736689,PDP
EC275,,1999,1999,,1649314,9214001,3288816,,0,0,0,,1649314,9214001,3288816,PDN
EC275,,2000,1999,,18642,4454618,811279,,18339,1418025,270657,,303,3036593,540622,PDN
EC275,,2001,1999,,18530,4012137,732433,,18346,2326169,432255,,184,1685968,300178,PDN
EC275,,2002,1999,,18530,4012137,732433,,18346,2666626,492835,,184,1345511,239598,PDN
EC275,,2003,1999,,18530,4012137,732433,,18346,2666879,492880,,184,1345258,239553,PDN
EC275,,2004,1999,,18444,3650437,667988,,18346,2666879,492880,,98,983558,175108,PDN
EC275,,2005,1999,,18346,2666879,492880,,18346,2666879,492880,,0,0,0,PDN
EC275,,2006,1999,,18346,2666879,492880,,18346,2666879,492880,,0,0,0,PDN
EC275,,2007,1999,,18346,2666879,492880,,18346,2666879,492880,,0,0,0,PDN
EC275,,2008,1999,,18346,2666879,492880,,18346,2666879,492880,,0,0,0,PDN
EC275,,2009,1999,,18346,2666879,492880,,18346,2666879,492880,,0,0,0,PDN
EC275,,2010,1999,,18346,2666879,492880,,18346,2666879,492880,,0,0,0,PDN
EC275,,2011,1999,,18346,2666879,492880,,18346,2666879,492880,,0,0,0,PDN
EC275,,2012,1999,,18346,2666879,492880,,18346,2666879,492880,,0,0,0,PDN
EC275,,2013,1999,,18346,2666879,492880,,18346,2666879,492880,,0,0,0,PDN
EC275,,2014,1999,,18346,2666879,492880,,18346,2666879,492880,,0,0,0,PDN
EC275,,2015,1999,,18346,2666879,492880,,18346,2666879,492880,,0,0,0,PDN
EC275,,2016,1999,,18346,2666879,492880,,18346,2666879,492880,,0,0,0,PDN
EC275,,2017,1999,,18346,2666879,492880,,18346,2666879,492880,,0,0,0,PDN
EC275,,2017,1999,,18346,2666879,492880,,18346,2666879,492880,,0,0,0,PDN
EC276,,1996,1996,,34644,5376783,991367,,1349,152681,28516,,33295,5224102,962851,PDN
EC276,,1997,1996,,40605,6328217,1166622,,29885,4043754,749414,,10720,2284463,417208,PDN
EC276,,1998,1996,,42290,6885573,1267481,,37888,5564903,1028084,,4402,1320670,239397,PDN
EC276,,1999,1996,,84096,13015817,2400078,,58425,8881631,1638786,,25671,4134186,761292,PDN
EC276,,2000,1996,,112439,17586167,3241650,,74814,11803494,2175080,,37625,5782673,1066570,PDN
EC276,,2001,1996,,112439,17586167,3241650,,87300,13450979,2480713,,25139,4135188,760937,PDN
EC276,,2002,1996,,112439,17586167,3241650,,91533,13991424,2581110,,20906,3594743,660540,PDN
EC276,,2003,1996,,93132,14179128,2616109,,93132,14179128,2616109,,0,0,0,PDN
EC276,,2004,1996,,93132,14179128,2616109,,93132,14179128,2616109,,0,0,0,PDN
EC276,,2005,1996,,93132,14179128,2616109,,93132,14179128,2616109,,0,0,0,PDN
EC276,,2006,1996,,93132,14179128,2616109,,93132,14179128,2616109,,0,0,0,PDN
EC276,,2007,1996,,93132,14179128,2616109,,93132,14179128,2616109,,0,0,0,PDN
EC276,,2008,1996,,93132,14179128,2616109,,93132,14179128,2616109,,0,0,0,PDN
EC276,,2009,1996,,93132,14284687,2634891,,93132,14284687,2634891,,0,0,0,PDN
EC276,,2010,1996,,93132,14284687,2634891,,93132,14284687,2634891,,0,0,0,PDN
EC276,,2011,1996,,93132,14284687,2634891,,93132,14284687,2634891,,0,0,0,PDN
EC276,,2012,1996,,93132,14284687,2634891,,93132,14284687,2634891,,0,0,0,PDN
EC276,,2013,1996,,93132,14284687,2634891,,93132,14284687,2634891,,0,0,0,PDN
EC276,,2014,1996,,93132,14284687,2634891,,93132,14284687,2634891,,0,0,0,PDN
EC276,,2015,1996,,93132,14284687,2634891,,93132,14284687,2634891,,0,0,0,PDN
EC276,,2016,1996,,93132,14284687,2634891,,93132,14284687,2634891,,0,0,0,PDN
EC276,,2017,1996,,93132,14284687,2634891,,93132,14284687,2634891,,0,0,0,PDN
EC276,,2017,1996,,93132,14284687,2634891,,93132,14284687,2634891,,0,0,0,PDN
EC286,,1975,1972,,406061,40240491,7566291,,166790,9448372,1847995,,239271,30792119,5718296,PDN
EC286,,1976,1972,,406061,40240491,7566291,,200916,14356211,2755402,,205145,25884280,4810889,PDN
EC286,,1977,1972,,606527,51596466,9787393,,240107,23970689,4505354,,366420,27625777,5282039,PDN
EC286,,1978,1972,,605750,70727303,13190679,,285270,35338621,6573281,,320480,35388682,6617398,PDN
EC286,,1979,1972,,605750,70727303,13190679,,333455,42514825,7898370,,272295,28212478,5292309,PDN
EC286,,1980,1972,,605750,70727303,13190679,,367271,46722482,8680880,,238479,24004821,4509799,PDN
EC286,,1981,1972,,605750,73727303,13724487,,388004,50022961,9288887,,217746,23704342,4435600,PDN
EC286,,1982,1972,,605750,83727303,15503847,,406549,52605555,9766968,,199201,31121748,5736879,PDN
EC286,,1983,1972,,648462,78341541,14588238,,435394,55121920,10243565,,213068,23219621,4344673,PDN
EC286,,1984,1972,,648462,78341541,14588238,,448328,57331352,10649636,,200134,21010189,3938602,PDN
EC286,,1985,1972,,648462,78341541,14588238,,457823,58777342,10916425,,190639,19564199,3671813,PDN
EC286,,1986,1972,,648462,78341541,14588238,,463494,59808028,11105492,,184968,18533513,3482746,PDN
EC286,,1987,1972,,648462,78341541,14588238,,470313,61157984,11352517,,178149,17183557,3235721,PDN
EC286,,1988,1972,,648462,78341541,14588238,,477657,62798359,11651742,,170805,15543182,2936496,PDN
EC286,,1989,1972,,648462,78341541,14588238,,480671,63501422,11779856,,167791,14840119,2808382,PDN
EC286,,1990,1972,,754154,95730293,17788014,,490242,67436076,12489544,,263912,28294217,5298470,PDN
EC286,,1991,1972,,520255,95730293,17554115,,491326,74158086,13686715,,28929,21572207,3867400,PDN
EC286,,1992,1972,,511441,99408831,18199845,,492870,81543939,15002468,,18571,17864892,3197377,PDN
EC286,,1993,1972,,844850,140096100,25772982,,560525,96946862,17810856,,284325,43149238,7962126,PDN
EC286,,1994,1972,,1134494,169986022,31381117,,625572,119072679,21812881,,508922,50913343,9568236,PDN
EC286,,1995,1972,,736143,144929966,26524393,,628159,124733052,22822652,,107984,20196914,3701741,PDN
EC286,,1996,1972,,634197,167753654,30483602,,628917,132884098,24273774,,5280,34869556,6209828,PDN
EC286,,1997,1972,,632609,151949588,27669902,,629063,134319153,24529268,,3546,17630435,3140634,PDN
EC286,,1998,1972,,985291,181017565,33194822,,640907,136263068,24887005,,344384,44754497,8307817,PDN
EC286,,1999,1972,,993137,182319643,33434355,,723967,152026220,27774896,,269170,30293423,5659459,PDN
EC286,,2000,1972,,975728,191390623,35030999,,750279,163629693,29865883,,225449,27760930,5165116,PDN
EC286,,2001,1972,,858465,190092479,34682750,,764364,169463774,30918060,,94101,20628705,3764690,PDN
EC286,,2002,1972,,869767,190016355,34680506,,783140,173555830,31664960,,86627,16460525,3015546,PDN
EC286,,2003,1972,,870261,190092576,34694563,,797137,176109798,32133400,,73124,13982778,2561163,PDN
EC286,,2004,1972,,855360,186687402,34073759,,803746,177022502,32302412,,51614,9664900,1771347,PDN
EC286,,2005,1972,,900429,198669246,36250829,,804111,177403933,32370647,,96318,21265313,3880182,PDN
EC286,,2006,1972,,912944,198669246,36263344,,806194,178202713,32514862,,106750,20466533,3748482,PDN
EC286,,2007,1972,,871498,190663086,34797314,,814039,179874145,32820115,,57459,10788941,1977199,PDN
EC286,,2008,1972,,817146,180444370,32924685,,817146,180444370,32924685,,0,0,0,PDN
EC286,,2009,1972,,817145,183144166,33405074,,817145,183144166,33405074,,0,0,0,PDN
EC286,,2010,1972,,817145,183144166,33405074,,817145,183144166,33405074,,0,0,0,PDN
EC286,,2011,1972,,817145,183144166,33405074,,817145,183144166,33405074,,0,0,0,PDN
EC286,,2012,1972,,817145,183144166,33405074,,817145,183144166,33405074,,0,0,0,PDN
EC286,,2013,1972,,817145,183144166,33405074,,817145,183144166,33405074,,0,0,0,PDN
EC286,,2014,1972,,817145,183144166,33405074,,817145,183144166,33405074,,0,0,0,PDN
EC286,,2015,1972,,817145,183144166,33405074,,817145,183144166,33405074,,0,0,0,PDN
EC286,,2016,1972,,817145,183144166,33405074,,817145,183144166,33405074,,0,0,0,PDN
EC286,,2017,1972,,817145,183144166,33405074,,817145,183144166,33405074,,0,0,0,PDN
EC286,,2017,1972,,817145,183144166,33405074,,817145,183144166,33405074,,0,0,0,PDN
EC294,,1979,1971,,36000,29500000,5285110,,4455,2031899,366003,,31545,27468101,4919107,PDN
EC294,,1980,1971,,60446,29738600,5352012,,9490,6074992,1090449,,50956,23663608,4261563,PDN
EC294,,1981,1971,,50872,26733600,4807740,,11174,7742844,1388904,,39698,18990756,3418836,PDN
EC294,,1982,1971,,50872,26748600,4810409,,15251,9659247,1733978,,35621,17089353,3076431,PDN
EC294,,1983,1971,,50872,26748600,4810409,,16501,10007653,1797222,,34371,16740947,3013187,PDN
EC294,,1984,1971,,16501,10007653,1797222,,16501,10007653,1797222,,0,0,0,PDN
EC294,,1985,1971,,16501,10007653,1797222,,16501,10007653,1797222,,0,0,0,PDN
EC294,,1986,1971,,16501,10007653,1797222,,16501,10007653,1797222,,0,0,0,PDN
EC294,,1987,1971,,16501,10007653,1797222,,16501,10007653,1797222,,0,0,0,PDN
EC294,,1988,1971,,16501,10007653,1797222,,16501,10007653,1797222,,0,0,0,PDN
EC294,,1989,1971,,16501,10007653,1797222,,16501,10007653,1797222,,0,0,0,PDN
EC294,,1990,1971,,16501,10007653,1797222,,16501,10007653,1797222,,0,0,0,PDN
EC294,,1991,1971,,16501,10007653,1797222,,16501,10007653,1797222,,0,0,0,PDN
EC294,,1992,1971,,16501,10007653,1797222,,16501,10007653,1797222,,0,0,0,PDN
EC294,,1993,1971,,16501,10007653,1797222,,16501,10007653,1797222,,0,0,0,PDN
EC294,,1994,1971,,16501,10007653,1797222,,16501,10007653,1797222,,0,0,0,PDN
EC294,,1995,1971,,16501,10007653,1797222,,16501,10007653,1797222,,0,0,0,PDN
EC294,,1996,1971,,16501,10007653,1797222,,16501,10007653,1797222,,0,0,0,PDN
EC294,,1997,1971,,16501,10007653,1797222,,16501,10007653,1797222,,0,0,0,PDN
EC294,,1998,1971,,16501,10007653,1797222,,16501,10007653,1797222,,0,0,0,PDN
EC294,,1999,1971,,16501,10007653,1797222,,16501,10007653,1797222,,0,0,0,PDN
EC294,,2000,1971,,16501,10007653,1797222,,16501,10007653,1797222,,0,0,0,PDN
EC294,,2001,1971,,16501,10007653,1797222,,16501,10007653,1797222,,0,0,0,PDN
EC294,,2002,1971,,16771,16120691,2885221,,16771,14783325,2647256,,0,1337366,237965,PDN
EC294,,2003,1971,,16771,16000105,2863765,,16771,15912375,2848154,,0,87730,15611,PDN
EC294,,2004,1971,,16771,16037624,2870441,,16771,15977226,2859694,,0,60398,10747,PDN
EC294,,2005,1971,,16771,16000928,2863911,,16771,16000928,2863911,,0,0,0,PDN
EC294,,2006,1971,,16771,16000928,2863911,,16771,16000928,2863911,,0,0,0,PDN
EC294,,2007,1971,,16771,16000928,2863911,,16771,16000928,2863911,,0,0,0,PDN
EC294,,2008,1971,,16771,16000928,2863911,,16771,16000928,2863911,,0,0,0,PDN
EC294,,2009,1971,,16771,16201350,2899575,,16771,16201350,2899575,,0,0,0,PDN
EC294,,2010,1971,,16771,16201350,2899575,,16771,16201350,2899575,,0,0,0,PDN
EC294,,2011,1971,,16771,16201350,2899575,,16771,16201350,2899575,,0,0,0,PDN
EC294,,2012,1971,,16771,16201350,2899575,,16771,16201350,2899575,,0,0,0,PDN
EC294,,2013,1971,,16771,16201350,2899575,,16771,16201350,2899575,,0,0,0,PDN
EC294,,2014,1971,,16771,16201350,2899575,,16771,16201350,2899575,,0,0,0,PDN
EC294,,2015,1971,,16771,16201350,2899575,,16771,16201350,2899575,,0,0,0,PDN
EC294,,2016,1971,,16771,16201350,2899575,,16771,16201350,2899575,,0,0,0,PDN
EC294,,2017,1971,,16771,16201350,2899575,,16771,16201350,2899575,,0,0,0,PDN
EC294,,2017,1971,,16771,16201350,2899575,,16771,16201350,2899575,,0,0,0,PDN
EC299,,1985,1984,,2090950,146852704,28221324,,427374,38483850,7275034,,1663576,108368854,20946290,PDN
EC299,,1986,1984,,4055855,402143045,75611557,,1074457,82928446,15830408,,2981398,319214599,59781149,PDN
EC299,,1987,1984,,4513457,430659096,81143189,,1698160,141019675,26790629,,2815297,289639421,54352560,PDN
EC299,,1988,1984,,4513457,430659096,81143189,,2057386,174617281,33128077,,2456071,256041815,48015112,PDN
EC299,,1989,1984,,6624352,372003690,72817179,,2799052,215428686,41131558,,3825300,156575004,31685621,PDN
EC299,,1990,1984,,6641991,376794685,73687309,,3223655,245163667,46847083,,3418336,131631018,26840226,PDN
EC299,,1991,1984,,6630566,400478800,77890139,,3645931,277674578,53054219,,2984635,122804222,24835920,PDN
EC299,,1992,1984,,6089898,465303867,88884180,,3898514,299143466,57126889,,2191384,166160401,31757291,PDN
EC299,,1993,1984,,6089450,465991058,89006008,,4177627,318354402,60824318,,1911823,147636656,28181690,PDN
EC299,,1994,1984,,6100366,466729108,89148250,,4410026,335208319,64055634,,1690340,131520789,25092616,PDN
EC299,,1995,1984,,5071584,390307025,74521233,,4513131,343613046,65654242,,558453,46693979,8866991,PDN
EC299,,1996,1984,,5113529,392118932,74885581,,4621078,352701923,67379427,,492451,39417009,7506154,PDN
EC299,,1997,1984,,5113529,392118932,74885581,,4657843,356892386,68161826,,455686,35226546,6723755,PDN
EC299,,1998,1984,,5113529,392118932,74885581,,4695054,361783060,69069264,,418475,30335872,5816317,PDN
EC299,,1999,1984,,5056231,386276343,73788676,,4733137,366724935,69986684,,323094,19551408,3801992,PDN
EC299,,2000,1984,,5056249,386452288,73820001,,4756301,369382238,70482678,,299948,17070050,3337323,PDN
EC299,,2001,1984,,4847540,379667441,72404024,,4771695,370805488,70751319,,75845,8861953,1652705,PDN
EC299,,2002,1984,,4847540,379667441,72404024,,4780768,371363448,70859673,,66772,8303993,1544351,PDN
EC299,,2003,1984,,4847540,379667715,72404073,,4787831,371879440,70958550,,59709,7788275,1445523,PDN
EC299,,2004,1984,,5097074,383351756,73309130,,4823767,373732992,71324299,,273307,9618764,1984831,PDN
EC299,,2005,1984,,5393198,398838004,76360815,,4921783,377747994,72136729,,471415,21090010,4224086,PDN
EC299,,2006,1984,,5179210,399767850,76312279,,5010054,381829995,72951334,,169156,17937855,3360945,PDN
EC299,,2007,1984,,5179209,399752656,76309575,,5069475,385380781,73642568,,109734,14371875,2667007,PDN
EC299,,2008,1984,,5179218,399747245,76308621,,5102509,389734533,74450291,,76709,10012712,1858330,PDN
EC299,,2009,1984,,5170368,406156977,77440293,,5129145,399029667,76130865,,41223,7127310,1309428,PDN
EC299,,2010,1984,,5170368,406156977,77440293,,5136856,401471111,76572997,,33512,4685866,867297,PDN
EC299,,2011,1984,,5160172,405382692,77292323,,5136905,401796480,76630941,,23267,3586212,661384,PDN
EC299,,2012,1984,,5159916,402824959,76836954,,5136905,401896911,76648811,,23011,928048,188145,PDN
EC299,,2013,1984,,5159916,402824959,76836954,,5136905,401980770,76663733,,23011,844189,173223,PDN
EC299,,2014,1984,,5137496,402088658,76683521,,5136905,401985596,76664591,,591,103062,18929,PDN
EC299,,2015,1984,,5136905,401985596,76664591,,5136905,401985596,76664591,,0,0,0,PDN
EC299,,2016,1984,,5136905,401985596,76664591,,5136905,401985596,76664591,,0,0,0,PDN
EC299,,2017,1984,,5136905,401985596,76664591,,5136905,401985596,76664591,,0,0,0,PDN
EC299,,2017,1984,,5136905,401985596,76664591,,5136905,401985596,76664591,,0,0,0,PDN
EC300,,1987,1984,,51014,5917620,1103971,,0,0,0,,51014,5917620,1103971,PDN
EC300,,1988,1984,,95530,11081455,2067319,,0,0,0,,95530,11081455,2067319,PDN
EC300,,1989,1984,,545613,18120421,3769887,,144331,4066469,867902,,401282,14053952,2901985,PDN
EC300,,1990,1984,,978149,28917702,6123648,,273904,8195522,1732182,,704245,20722180,4391466,PDN
EC300,,1991,1984,,820698,27197305,5660076,,361149,10699802,2265028,,459549,16497503,3395048,PDN
EC300,,1992,1984,,854847,24459353,5207045,,403342,12104912,2557241,,451505,12354441,2649804,PDN
EC300,,1993,1984,,791295,23657111,5000745,,458652,13680664,2892934,,332643,9976447,2107811,PDN
EC300,,1994,1984,,791295,23657111,5000745,,479780,14521154,3063615,,311515,9135957,1937130,PDN
EC300,,1995,1984,,791295,23657111,5000745,,485596,14758746,3111707,,305699,8898365,1889038,PDN
EC300,,1996,1984,,589478,17867345,3768721,,487084,14796989,3120000,,102394,3070356,648721,PDN
EC300,,1997,1984,,589478,17867345,3768721,,487344,14807391,3122111,,102134,3059954,646610,PDN
EC300,,1998,1984,,487898,14827698,3126278,,487574,14820396,3124655,,324,7302,1623,PDN
EC300,,1999,1984,,487898,14827698,3126278,,487898,14827698,3126278,,0,0,0,PDN
EC300,,2000,1984,,487898,14827698,3126278,,487898,14827698,3126278,,0,0,0,PDN
EC300,,2001,1984,,487898,14827698,3126278,,487898,14827698,3126278,,0,0,0,PDN
EC300,,2002,1984,,487898,14827698,3126278,,487898,14827698,3126278,,0,0,0,PDN
EC300,,2003,1984,,487898,14827698,3126278,,487898,14827698,3126278,,0,0,0,PDN
EC300,,2004,1984,,487898,14827698,3126278,,487898,14827698,3126278,,0,0,0,PDN
EC300,,2005,1984,,487898,14827698,3126278,,487898,14827698,3126278,,0,0,0,PDN
EC300,,2006,1984,,487898,14827698,3126278,,487898,14827698,3126278,,0,0,0,PDN
EC300,,2007,1984,,487898,14827698,3126278,,487898,14827698,3126278,,0,0,0,PDN
EC300,,2008,1984,,487898,14827698,3126278,,487898,14827698,3126278,,0,0,0,PDN
EC300,,2009,1984,,487898,15124320,3179058,,487898,15124320,3179058,,0,0,0,PDN
EC300,,2010,1984,,487898,15124320,3179058,,487898,15124320,3179058,,0,0,0,PDN
EC300,,2011,1984,,487898,15124320,3179058,,487898,15124320,3179058,,0,0,0,PDN
EC300,,2012,1984,,487898,15124320,3179058,,487898,15124320,3179058,,0,0,0,PDN
EC300,,2013,1984,,487898,15124320,3179058,,487898,15124320,3179058,,0,0,0,PDN
EC300,,2014,1984,,487898,15124320,3179058,,487898,15124320,3179058,,0,0,0,PDN
EC300,,2015,1984,,487898,15124320,3179058,,487898,15124320,3179058,,0,0,0,PDN
EC300,,2016,1984,,487898,15124320,3179058,,487898,15124320,3179058,,0,0,0,PDN
EC300,,2017,1984,,487898,15124320,3179058,,487898,15124320,3179058,,0,0,0,PDN
EC300,,2017,1984,,487898,15124320,3179058,,487898,15124320,3179058,,0,0,0,PDN
EC303,,1995,1975,,122118,16078217,2983011,,0,0,0,,122118,16078217,2983011,PDN
EC303,,1996,1975,,122118,16078217,2983011,,0,0,0,,122118,16078217,2983011,PDN
EC303,,1997,1975,,34958,12813021,2314855,,1977,627933,113709,,32981,12185088,2201146,PDN
EC303,,1998,1975,,34964,12797013,2312013,,4522,4199783,751814,,30442,8597230,1560199,PDN
EC303,,1999,1975,,26629,11196905,2018961,,8951,7228654,1295188,,17678,3968251,723773,PDN
EC303,,2000,1975,,24161,10540606,1899714,,10162,7360199,1319806,,13999,3180407,579908,PDN
EC303,,2001,1975,,10374,7402793,1327597,,10374,7402793,1327597,,0,0,0,PDN
EC303,,2002,1975,,10374,7402793,1327597,,10374,7402793,1327597,,0,0,0,PDN
EC303,,2003,1975,,10374,7402793,1327597,,10374,7402793,1327597,,0,0,0,PDN
EC303,,2004,1975,,10374,7402793,1327597,,10374,7402793,1327597,,0,0,0,PDN
EC303,,2005,1975,,11291,7417594,1331148,,11291,7417594,1331148,,0,0,0,PDN
EC303,,2006,1975,,11291,7417594,1331148,,11291,7417594,1331148,,0,0,0,PDN
EC303,,2007,1975,,11291,7417594,1331148,,11291,7417594,1331148,,0,0,0,PDN
EC303,,2008,1975,,11291,7417594,1331148,,11291,7417594,1331148,,0,0,0,PDN
EC303,,2009,1975,,11291,7481296,1342483,,11291,7481296,1342483,,0,0,0,PDN
EC303,,2010,1975,,11291,7481296,1342483,,11291,7481296,1342483,,0,0,0,PDN
EC303,,2011,1975,,11291,7481296,1342483,,11291,7481296,1342483,,0,0,0,PDN
EC303,,2012,1975,,11291,7481296,1342483,,11291,7481296,1342483,,0,0,0,PDN
EC303,,2013,1975,,11291,7481296,1342483,,11291,7481296,1342483,,0,0,0,PDN
EC303,,2014,1975,,11291,7481296,1342483,,11291,7481296,1342483,,0,0,0,PDN
EC303,,2015,1975,,11291,7481296,1342483,,11291,7481296,1342483,,0,0,0,PDN
EC303,,2016,1975,,11291,7481296,1342483,,11291,7481296,1342483,,0,0,0,PDN
EC303,,2017,1975,,11291,7481296,1342483,,11291,7481296,1342483,,0,0,0,PDN
EC303,,2017,1975,,11291,7481296,1342483,,11291,7481296,1342483,,0,0,0,PDN
EC306,,1992,1990,,201227,3939247,902161,,0,0,0,,201227,3939247,902161,PDN
EC306,,1993,1990,,204046,4221075,955127,,400,39995,7517,,203646,4181080,947610,PDN
EC306,,1994,1990,,204046,4221075,955127,,1678,463806,84206,,202368,3757269,870921,PDN
EC306,,1995,1990,,203093,4123914,936886,,3644,917586,166916,,199449,3206328,769970,PDN
EC306,,1996,1990,,6906,2466333,445755,,6906,2466333,445755,,0,0,0,PDN
EC306,,1997,1990,,6906,2466333,445755,,6906,2466333,445755,,0,0,0,PDN
EC306,,1998,1990,,6906,2466333,445755,,6906,2466333,445755,,0,0,0,PDN
EC306,,1999,1990,,6906,2466333,445755,,6906,2466333,445755,,0,0,0,PDN
EC306,,2000,1990,,6906,2466333,445755,,6906,2466333,445755,,0,0,0,PDN
EC306,,2001,1990,,7595,4141869,744582,,7371,3331777,600214,,224,810092,144368,PDN
EC306,,2002,1990,,7595,4141869,744582,,7595,4141869,744582,,0,0,0,PDN
EC306,,2003,1990,,7595,4141869,744582,,7595,4141869,744582,,0,0,0,PDN
EC306,,2004,1990,,7595,4141869,744582,,7595,4141869,744582,,0,0,0,PDN
EC306,,2005,1990,,7595,4141869,744582,,7595,4141869,744582,,0,0,0,PDN
EC306,,2006,1990,,7595,4141869,744582,,7595,4141869,744582,,0,0,0,PDN
EC306,,2007,1990,,27386,13884314,2497905,,7595,4141869,744582,,19791,9742445,1753323,PDN
EC306,,2008,1990,,27386,13893660,2499567,,7595,4169797,749552,,19791,9723863,1750015,PDN
EC306,,2009,1990,,7599,6462203,1157458,,7599,6329580,1133859,,0,132623,23599,PDN
EC306,,2010,1990,,7599,6462203,1157458,,7599,6462203,1157458,,0,0,0,PDN
EC306,,2011,1990,,7599,6462203,1157458,,7599,6462203,1157458,,0,0,0,PDN
EC306,,2012,1990,,7599,6462203,1157458,,7599,6462203,1157458,,0,0,0,PDN
EC306,,2013,1990,,7599,6462203,1157458,,7599,6462203,1157458,,0,0,0,PDN
EC306,,2014,1990,,7599,6462203,1157458,,7599,6462203,1157458,,0,0,0,PDN
EC306,,2015,1990,,7599,6462203,1157458,,7599,6462203,1157458,,0,0,0,PDN
EC306,,2016,1990,,7599,6462203,1157458,,7599,6462203,1157458,,0,0,0,PDN
EC306,,2017,1990,,7599,6462203,1157458,,7599,6462203,1157458,,0,0,0,PDN
EC306,,2017,1990,,7599,6462203,1157458,,7599,6462203,1157458,,0,0,0,PDN
EC317,,1989,1985,,4794,47934222,8534015,,0,98607,17546,,4794,47835615,8516469,PDN
EC317,,1990,1985,,4794,47934222,8534015,,0,4032634,717551,,4794,43901588,7816464,PDN
EC317,,1991,1985,,4794,47934222,8534015,,0,7500912,1334682,,4794,40433310,7199333,PDN
EC317,,1992,1985,,4794,47934222,8534015,,0,14787822,2631285,,4794,33146400,5902730,PDN
EC317,,1993,1985,,4794,47934222,8534015,,0,21972913,3909771,,4794,25961309,4624244,PDN
EC317,,1994,1985,,250,62198818,11067655,,0,28948767,5151026,,250,33250051,5916629,PDN
EC317,,1995,1985,,250,62198818,11067655,,0,34288471,6101151,,250,27910347,4966504,PDN
EC317,,1996,1985,,250,62236739,11074403,,0,38802610,6904379,,250,23434129,4170024,PDN
EC317,,1997,1985,,1245,62236739,11075398,,329,42485514,7560029,,916,19751225,3515369,PDN
EC317,,1998,1985,,1245,62236739,11075398,,666,46488198,8272587,,579,15748541,2802811,PDN
EC317,,1999,1985,,1245,62236739,11075398,,839,50182318,8930077,,406,12054421,2145321,PDN
EC317,,2000,1985,,1595,69175331,12310373,,1059,56594640,10071280,,536,12580691,2239093,PDN
EC317,,2001,1985,,1775,74224339,13208953,,1253,62095159,11050214,,522,12129180,2158739,PDN
EC317,,2002,1985,,1775,77136262,13727089,,1290,66713829,11872078,,485,10422433,1855011,PDN
EC317,,2003,1985,,1559,77720504,13830830,,1290,70641068,12570875,,269,7079436,1259955,PDN
EC317,,2004,1985,,1646,87694847,15605711,,1290,75519697,13438959,,356,12175150,2166752,PDN
EC317,,2005,1985,,1702,94740644,16859468,,1290,78430355,13956869,,412,16310289,2902599,PDN
EC317,,2006,1985,,53087,92389535,16492506,,1290,81658080,14531197,,51797,10731455,1961309,PDN
EC317,,2007,1985,,13776,90144891,16053792,,11695,84921396,15122264,,2081,5223495,931528,PDN
EC317,,2008,1985,,16377,90583322,16134406,,11799,86057130,15324456,,4578,4526192,809950,PDN
EC317,,2009,1985,,16503,90953146,16200335,,11799,87022617,15496250,,4704,3930529,704087,PDN
EC317,,2010,1985,,16503,90953146,16200335,,12271,87939250,15659824,,4232,3013896,540512,PDN
EC317,,2011,1985,,13442,90500940,16116811,,12458,88435787,15748362,,984,2065153,368449,PDN
EC317,,2012,1985,,13442,90500940,16116811,,12730,89048026,15857574,,712,1452914,259238,PDN
EC317,,2013,1985,,13442,90500940,16116811,,12731,89464412,15931664,,711,1036528,185146,PDN
EC317,,2014,1985,,13442,91174180,16236605,,12731,89799098,15991217,,711,1375082,245388,PDN
EC317,,2015,1985,,13442,91174180,16236605,,12740,90002759,16027465,,702,1171421,209140,PDN
EC317,,2016,1985,,13442,91174180,16236605,,12744,90178183,16058683,,698,995997,177922,PDN
EC317,,2017,1985,,12744,90178994,16058828,,12744,90178994,16058828,,0,0,0,PDN
EC317,,2017,1985,,12744,90178994,16058828,,12744,90178994,16058828,,0,0,0,PDN
EC321,,1975,1971,,15732680,292750714,67823554,,2715005,2268359,3118628,,13017675,290482355,64704926,PDP
EC321,,1976,1971,,15732680,33166517,21634195,,4547542,4593557,5364901,,11185138,28572960,16269294,PDP
EC321,,1977,1971,,16894470,33953220,22935968,,6491128,7248512,7780899,,10403342,26704708,15155069,PDP
EC321,,1978,1971,,16900470,32766069,22730731,,8219455,9963126,9992253,,8681015,22802943,12738478,PDP
EC321,,1979,1971,,20875071,36414039,27354437,,9813742,12327446,12007238,,11061329,24086593,15347199,PDP
EC321,,1980,1971,,21450571,37038675,28041083,,10633647,14962910,13296087,,10816924,22075765,14744996,PDP
EC321,,1981,1971,,22871051,39762257,29946186,,11413784,17213826,14476742,,11457267,22548431,15469444,PDP
EC321,,1982,1971,,20839566,44116434,28689465,,13316022,20516433,16966633,,7523544,23600001,11722832,PDP
EC321,,1983,1971,,23779135,36236884,30226979,,16340333,23374623,20499519,,7438802,12862261,9727460,PDP
EC321,,1984,1971,,36404531,49714351,45250501,,20591847,27811728,25540553,,15812684,21902623,19709948,PDP
EC321,,1985,1971,,38330371,52794735,47724452,,25133626,33135058,31029544,,13196745,19659677,16694908,PDP
EC321,,1986,1971,,42561075,62091264,53609343,,29676930,37334909,36320152,,12884145,24756355,17289191,PDP
EC321,,1987,1971,,50575026,75730563,64050215,,33332553,40938787,40617035,,17242473,34791776,23433180,PDP
EC321,,1988,1971,,51632317,72534818,64538868,,37359212,45669179,45485400,,14273105,26865639,19053468,PDP
EC321,,1989,1971,,58041894,81061544,72465656,,41096413,49446159,49894662,,16945481,31615385,22570994,PDP
EC321,,1990,1971,,61710276,84231744,76698131,,44725384,53735917,54286935,,16984892,30495827,22411196,PDP
EC321,,1991,1971,,69161377,88917642,84983021,,48574512,59775853,59210785,,20586865,29141789,25772236,PDP
EC321,,1992,1971,,69434390,89749955,85404133,,52046517,65824526,63759066,,17387873,23925429,21645067,PDP
EC321,,1993,1971,,69539071,98440789,87055226,,54996931,70775207,67590384,,14542140,27665582,19464842,PDP
EC321,,1994,1971,,72005279,106597872,90972872,,57839812,78194361,71753399,,14165467,28403511,19219473,PDP
EC321,,1995,1971,,75080795,125711786,97449440,,60240350,84519604,75279425,,14840445,41192182,22170015,PDP
EC321,,1996,1971,,76534589,140378713,101513008,,62788055,96975645,80043508,,13746534,43403068,21469500,PDP
EC321,,1997,1971,,76103783,148498412,102526988,,64552810,103418649,82954705,,11550973,45079763,19572283,PDP
EC321,,1998,1971,,76455159,148601502,102896707,,66018449,109341193,85474177,,10436710,39260309,17422530,PDP
EC321,,1999,1971,,75833909,132056569,99331519,,67313915,113448837,87500541,,8519994,18607732,11830978,PDP
EC321,,2000,1971,,72961877,130288676,96144915,,68408709,115876565,89027315,,4553168,14412111,7117600,PDP
EC321,,2001,1971,,72891441,127548459,95586896,,69398929,117805506,90360763,,3492512,9742953,5226133,PDP
EC321,,2002,1971,,73700812,125744860,96075342,,70293659,119391986,91537785,,3407153,6352874,4537557,PDP
EC321,,2003,1971,,75230717,135333373,99311388,,71081772,121143613,92637575,,4148945,14189760,6673813,PDP
EC321,,2004,1971,,75219767,133997365,99062715,,72030569,125526806,94366300,,3189198,8470559,4696415,PDP
EC321,,2005,1971,,81041406,159703343,109458371,,72783952,128993251,95736488,,8257454,30710092,13721883,PDP
EC321,,2006,1971,,80873225,175388746,112081187,,73685248,129699805,96763505,,7187977,45688941,15317682,PDP
EC321,,2007,1971,,80150409,159994139,108619117,,75096871,137819444,99619904,,5053538,22174695,8999213,PDP
EC321,,2008,1971,,80615330,156597794,108479706,,76105246,142405185,101444247,,4510084,14192609,7035459,PDP
EC321,,2009,1971,,80724423,153677377,108069152,,77183892,148165774,103547911,,3540531,5511603,4521243,PDP
EC321,,2010,1971,,80724423,153677377,108069152,,77932954,149773110,104582975,,2791469,3904267,3486176,PDP
EC321,,2011,1971,,80930465,154422912,108407853,,78568942,150709512,105385581,,2361523,3713400,3022272,PDP
EC321,,2012,1971,,80930466,154422912,108407854,,79160196,151423450,106103872,,1770270,2999462,2303982,PDP
EC321,,2013,1971,,81563017,155055463,109152959,,79508862,151788375,106517468,,2054155,3267088,2635490,PDP
EC321,,2014,1971,,82475735,157134849,110435673,,79898339,152134288,106968498,,2577396,5000561,3467179,PDP
EC321,,2015,1971,,82582904,153876844,109963129,,80378648,152348350,107486896,,2204256,1528494,2476233,PDP
EC321,,2016,1971,,82968614,156716322,110854080,,80957102,152931452,108169104,,2011512,3784870,2684977,PDP
EC321,,2017,1971,,83556668,156112338,111334663,,81587493,153579767,108914854,,1969175,2532571,2419810,PDP
EC321,,2017,1971,,83556668,156112338,111334663,,81587493,153579767,108914854,,1969175,2532571,2419810,PDP
EC322,,1975,1973,,9959256,28525500,15034968,,14115,4892,14985,,9945141,28520608,15019983,PDP
EC322,,1976,1973,,9959256,28525500,15034968,,724222,1614344,1011472,,9235034,26911156,14023496,PDP
EC322,,1977,1973,,11561850,30806948,17043513,,2150775,4866100,3016629,,9411075,25940848,14026884,PDP
EC322,,1978,1973,,8144090,24293349,12466750,,2779711,6624093,3958375,,5364379,17669256,8508375,PDP
EC322,,1979,1973,,7367654,24773570,11775763,,2651407,7213047,3934867,,4716247,17560523,7840896,PDP
EC322,,1980,1973,,7561826,25929070,12175540,,2964793,9599620,4672910,,4597033,16329450,7502630,PDP
EC322,,1981,1973,,7903232,25930211,12517149,,3228100,10519686,5099930,,4675132,15410525,7417219,PDP
EC322,,1982,1973,,7781742,24145269,12078053,,3468653,11089342,5441846,,4313089,13055927,6636207,PDP
EC322,,1983,1973,,5379707,22456409,9375509,,3655085,11761647,5747905,,1724622,10694762,3627604,PDP
EC322,,1984,1973,,5613159,22751095,9661397,,3919599,12195158,6089556,,1693560,10555937,3571841,PDP
EC322,,1985,1973,,5730434,32256142,11469961,,4057065,15038647,6732981,,1673369,17217495,4736980,PDP
EC322,,1986,1973,,5862802,33291454,11786548,,4141877,15685557,6932901,,1720925,17605897,4853647,PDP
EC322,,1987,1973,,5856706,31103662,11391165,,4186229,14302949,6731238,,1670477,16800713,4659927,PDP
EC322,,1988,1973,,5830897,31054060,11356530,,4361853,14603868,6960406,,1469044,16450192,4396124,PDP
EC322,,1989,1973,,6018707,30488675,11443738,,4556744,14801974,7190547,,1461963,15686701,4253191,PDP
EC322,,1990,1973,,6122575,82462391,20795598,,4710590,21649515,8562817,,1411985,60812876,12232781,PDP
EC322,,1991,1973,,6122250,82462391,20795273,,4858107,35815893,11231042,,1264143,46646498,9564231,PDP
EC322,,1992,1973,,5828314,75612847,19282557,,4986816,45259328,13040077,,841498,30353519,6242480,PDP
EC322,,1993,1973,,5833380,75697608,19302705,,5110966,54656515,14836325,,722414,21041093,4466380,PDP
EC322,,1994,1973,,6834151,81345751,21308484,,5217791,59471689,15799942,,1616360,21874062,5508542,PDP
EC322,,1995,1973,,10831582,87890432,26470449,,6414806,64479094,17887954,,4416776,23411338,8582495,PDP
EC322,,1996,1973,,10649289,86939537,26118958,,7034231,69150130,19338525,,3615058,17789407,6780433,PDP
EC322,,1997,1973,,13553214,93001263,30101481,,8240476,73822159,21376091,,5312738,19179104,8725390,PDP
EC322,,1998,1973,,13720903,95334902,30684409,,9844474,78634539,23836385,,3876429,16700363,6848024,PDP
EC322,,1999,1973,,14627228,92263886,31044290,,10928557,82220416,25558524,,3698671,10043470,5485766,PDP
EC322,,2000,1973,,15111499,93617449,31769408,,11691689,84235924,26680288,,3419810,9381525,5089120,PDP
EC322,,2001,1973,,14695590,92553630,31164207,,12229383,84931230,27341702,,2466207,7622400,3822505,PDP
EC322,,2002,1973,,15983987,94023291,32714110,,12776654,85689753,28023941,,3207333,8333538,4690169,PDP
EC322,,2003,1973,,15972294,93492172,32607912,,13231100,86629579,28645616,,2741194,6862593,3962296,PDP
EC322,,2004,1973,,15447663,92926670,31982658,,13642947,87629720,29235424,,1804716,5296950,2747234,PDP
EC322,,2005,1973,,24784670,108691467,44124789,,13869359,88407790,29600282,,10915311,20283677,14524507,PDP
EC322,,2006,1973,,24235488,114166058,44549734,,14541320,36196455,20981970,,9694168,77969603,23567764,PDP
EC322,,2007,1973,,20223609,98658534,37778508,,15419056,90874895,31588966,,4804553,7783639,6189542,PDP
EC322,,2008,1973,,19861400,94552483,36685685,,16024502,92475745,32479261,,3836898,2076738,4206424,PDP
EC322,,2009,1973,,19772951,96320784,36911880,,16147337,94153983,32900716,,3625614,2166801,4011166,PDP
EC322,,2010,1973,,20134312,96142191,37241463,,16664028,94571116,33491630,,3470284,1571075,3749834,PDP
EC322,,2011,1973,,20162387,95843889,37216461,,17283065,94871488,34164113,,2879322,972401,3052348,PDP
EC322,,2012,1973,,20162387,95843889,37216461,,18200108,95268204,35151746,,1962279,575685,2064712,PDP
EC322,,2013,1973,,20161475,95843694,37215514,,18956902,95524846,35954205,,1204573,318848,1261307,PDP
EC322,,2014,1973,,20585691,96410573,37740599,,19445802,95785606,36489505,,1139889,624967,1251094,PDP
EC322,,2015,1973,,22066531,96970922,39321145,,19990314,96035239,37078435,,2076217,935683,2242707,PDP
EC322,,2016,1973,,22330599,97145112,39616207,,20568904,96304048,37704857,,1761695,841064,1911350,PDP
EC322,,2017,1973,,22278047,98122018,39737481,,21009980,96628621,38203685,,1268067,1493397,1533797,PDP
EC322,,2017,1973,,22278047,98122018,39737481,,21009980,96628621,38203685,,1268067,1493397,1533797,PDP
EC334,,1975,1972,,1700000,170000000,31949110,,0,0,0,,1700000,170000000,31949110,PDP
EC334,,1976,1972,,400767,400767000,71711621,,0,0,0,,400767,400767000,71711621,PDP
EC334,,1977,1972,,942473,430166500,77484555,,58123,20822482,3763191,,884350,409344018,73721364,PDP
EC334,,1978,1972,,942473,430166500,77484555,,215415,89644463,16166387,,727058,340522037,61318168,PDP
EC334,,1979,1972,,1019720,433578500,78168919,,336778,151068757,27217340,,682942,282509743,50951579,PDP
EC334,,1980,1972,,1382132,568928500,102614961,,452606,208140762,37488329,,929526,360787738,65126632,PDP
EC334,,1981,1972,,1642576,629268500,113612060,,575677,266677496,48027189,,1066899,362591004,65584871,PDP
EC334,,1982,1972,,2725026,803968500,145779919,,689002,316001171,56916968,,2036024,487967329,88862951,PDP
EC334,,1983,1972,,2475283,817568500,147950105,,778305,351674100,63353768,,1696978,465894400,84596337,PDP
EC334,,1984,1972,,2494723,837204210,151463444,,873321,399285385,71920543,,1621402,437918825,79542901,PDP
EC334,,1985,1972,,2469356,837204210,151438077,,947717,438637049,78997014,,1521639,398567161,72441063,PDP
EC334,,1986,1972,,1297050,633740701,114062299,,995954,464814897,83703231,,301096,168925804,30359068,PDP
EC334,,1987,1972,,1297050,633740701,114062299,,1043846,485195383,87377544,,253204,148545318,26684755,PDP
EC334,,1988,1972,,1297050,633740701,114062299,,1087506,502417302,90485602,,209544,131323399,23576697,PDP
EC334,,1989,1972,,1364108,630655081,113580315,,1119291,522497086,94090303,,244817,108157995,19490012,PDP
EC334,,1990,1972,,1335439,638050556,114867566,,1145591,539694452,97176632,,189848,98356104,17690934,PDP
EC334,,1991,1972,,1521377,721738071,129944521,,1180487,562694922,101304139,,340890,159043149,28640382,PDP
EC334,,1992,1972,,1442203,699037164,125826040,,1224631,588515064,105942614,,217572,110522100,19883426,PDP
EC334,,1993,1972,,1485346,708638825,127577664,,1255482,610545859,109893535,,229864,98092966,17684129,PDP
EC334,,1994,1972,,1533952,712861736,128377677,,1276491,626322255,112721732,,257461,86539481,15655945,PDP
EC334,,1995,1972,,1761258,734532506,132460992,,1341416,643027995,115759209,,419842,91504511,16701783,PDP
EC334,,1996,1972,,2828607,792691226,143876868,,1536386,659138326,118820786,,1292221,133552900,25056082,PDP
EC334,,1997,1972,,7834568,934821266,174172872,,4780727,752045504,138596653,,3053841,182775762,35576219,PDP
EC334,,1998,1972,,8173425,935821060,174689628,,6354031,803230945,149277687,,1819394,132590115,25411941,PDP
EC334,,1999,1972,,8285852,892894823,167163934,,6893521,829324639,154460183,,1392331,63570184,12703751,PDP
EC334,,2000,1972,,9263634,925338874,173914679,,7547368,852566126,159249526,,1716266,72772748,14665153,PDP
EC334,,2001,1972,,8571662,907910950,170121653,,7918665,866472257,162095223,,652997,41438693,8026430,PDP
EC334,,2002,1972,,8775353,918581987,172224105,,8228315,880678215,164932624,,547038,37903772,7291481,PDP
EC334,,2003,1972,,8774062,917935463,172107774,,8365862,887520378,166287637,,408200,30415085,5820137,PDP
EC334,,2004,1972,,8663200,915453071,171555206,,8459823,894787732,167674722,,203377,20665339,3880484,PDP
EC334,,2005,1972,,8754331,922665419,172929672,,8510885,898748614,168430567,,243446,23916805,4499105,PDP
EC334,,2006,1972,,8752553,929376325,174122005,,8546585,903976894,169396566,,205968,25399431,4725439,PDP
EC334,,2007,1972,,8787298,923853868,173174107,,8619550,908439871,170263655,,167748,15413997,2910452,PDP
EC334,,2008,1972,,9007697,936114841,175576174,,8639401,910865647,170715139,,368296,25249194,4861035,PDP
EC334,,2009,1972,,9132040,946832558,177607586,,8639401,926774838,173545958,,492639,20057720,4061628,PDP
EC334,,2010,1972,,9132040,946832558,177607586,,8657544,930124020,174160041,,474496,16708538,3447545,PDP
EC334,,2011,1972,,9132040,946832558,177607586,,8815278,935046695,175193695,,316762,11785863,2413889,PDP
EC334,,2012,1972,,9179677,949526360,178134548,,8896187,937869388,175776863,,283490,11656972,2357683,PDP
EC334,,2013,1972,,9179677,949526360,178134548,,8993496,941117809,176452184,,186181,8408551,1682363,PDP
EC334,,2014,1972,,9335322,952250781,178774964,,9077237,943587761,176975417,,258085,8663020,1799546,PDP
EC334,,2015,1972,,9335322,952250781,178774964,,9112203,945083556,177276538,,223119,7167225,1498425,PDP
EC334,,2016,1972,,9335322,952250781,178774964,,9122070,945364823,177336452,,213252,6885958,1438510,PDP
EC334,,2017,1972,,9170433,947627514,177787429,,9128977,945582753,177382137,,41456,2044761,405291,PDP
EC334,,2017,1972,,9170433,947627514,177787429,,9128977,945582753,177382137,,41456,2044761,405291,PDP
EC338,,1975,1972,,4787595,123072189,26686561,,0,0,0,,4787595,123072189,26686561,PDP
EC338,,1976,1972,,4787595,123072189,26686561,,0,0,0,,4787595,123072189,26686561,PDP
EC338,,1977,1972,,4787595,123072189,26686561,,21235,1685843,321207,,4766360,121386346,26365354,PDP
EC338,,1978,1972,,5433658,125840544,27825214,,46733,3288079,631800,,5386925,122552465,27193414,PDP
EC338,,1979,1972,,23880105,124265159,45991343,,4203784,19868346,7739077,,19676321,104396813,38252266,PDP
EC338,,1980,1972,,27173611,127517871,49863624,,5829874,27356105,10697508,,21343737,100161766,39166116,PDP
EC338,,1981,1972,,34095611,135746371,58249770,,8611554,36507940,15107629,,25484057,99238431,43142141,PDP
EC338,,1982,1972,,34282278,140566646,59294137,,11250369,44257097,19125297,,23031909,96309549,40168840,PDP
EC338,,1983,1972,,39493392,155762926,67209215,,14434519,49301277,23206988,,25058873,106461649,44002227,PDP
EC338,,1984,1972,,38652148,121798522,60324483,,18474702,56569300,28540414,,20177446,65229222,31784069,PDP
EC338,,1985,1972,,38652148,121798522,60324483,,21752441,63125492,32984735,,16899707,58673030,27339748,PDP
EC338,,1986,1972,,38652148,121798522,60324483,,24479593,70940123,37102391,,14172555,50858399,23222092,PDP
EC338,,1987,1972,,39775756,126800986,62338209,,26048125,79733151,40235518,,13727631,47067835,22102691,PDP
EC338,,1988,1972,,39775756,126800986,62338209,,27535184,88626330,43304994,,12240572,38174656,19033215,PDP
EC338,,1989,1972,,40219070,141712212,65434766,,28683585,95182681,45620005,,11535485,46529531,19814761,PDP
EC338,,1990,1972,,40731671,142140186,66023519,,29983354,101912166,48117191,,10748317,40228020,17906328,PDP
EC338,,1991,1972,,40711879,142959856,66149576,,31148954,107625878,50299466,,9562925,35333978,15850110,PDP
EC338,,1992,1972,,36231613,130340891,59423942,,32139652,111660696,52008103,,4091961,18680195,7415839,PDP
EC338,,1993,1972,,36510712,137903089,61048628,,33244275,115529354,53801100,,3266437,22373735,7247528,PDP
EC338,,1994,1972,,43560784,167518381,73368325,,34940732,120988092,56468862,,8620052,46530289,16899463,PDP
EC338,,1995,1972,,50330763,234279856,92017570,,37932645,148639287,64380917,,12398118,85640569,27636653,PDP
EC338,,1996,1972,,50259977,261491817,96788770,,39924376,169334650,70055097,,10335601,92157167,26733673,PDP
EC338,,1997,1972,,52913217,303905198,106988875,,41811425,187594685,75191262,,11101792,116310513,31797613,PDP
EC338,,1998,1972,,57195595,320412660,114208524,,44163996,214462281,82324544,,13031599,105950379,31883980,PDP
EC338,,1999,1972,,52432379,266078091,99777235,,46488102,227539528,86975562,,5944277,38538563,12801673,PDP
EC338,,2000,1972,,54336506,282332113,104573537,,48110017,236066854,90114795,,6226489,46265259,14458742,PDP
EC338,,2001,1972,,53277997,276964261,102559894,,49226634,243672519,92584733,,4051363,33291742,9975161,PDP
EC338,,2002,1972,,52569923,275444374,101581378,,50095436,249151789,94428495,,2474487,26292585,7152883,PDP
EC338,,2003,1972,,52901154,276218933,102050431,,50841680,253800742,96001954,,2059474,22418191,6048477,PDP
EC338,,2004,1972,,53154138,271092178,101391180,,51574439,258884301,97639261,,1579699,12207877,3751919,PDP
EC338,,2005,1972,,55025723,280002461,104848225,,51914083,261291484,98407230,,3111640,18710977,6440995,PDP
EC338,,2006,1972,,57824700,287166595,108921959,,52152085,263295090,99001745,,5672615,23871505,9920214,PDP
EC338,,2007,1972,,59370901,283650757,109842566,,52721975,265744774,100007522,,6648926,17905983,9835044,PDP
EC338,,2008,1972,,59370915,283572132,109828589,,53725825,267488740,101321686,,5645090,16083392,8506903,PDP
EC338,,2009,1972,,57706107,288596047,109057715,,54725842,272509787,103215126,,2980265,16086260,5842589,PDP
EC338,,2010,1972,,57706107,288596047,109057715,,55439558,273314798,104072081,,2266549,15281249,4985632,PDP
EC338,,2011,1972,,57706107,288596047,109057715,,55917952,274156526,104700248,,1788155,14439521,4357465,PDP
EC338,,2012,1972,,57706107,288596047,109057715,,56287134,274806329,105185055,,1418973,13789718,3872659,PDP
EC338,,2013,1972,,57782769,288861765,109181658,,56573417,275274320,105554612,,1209352,13587445,3627048,PDP
EC338,,2014,1972,,58432625,289462002,109938318,,56810824,275622123,105853903,,1621801,13839879,4084414,PDP
EC338,,2015,1972,,58341614,289369058,109830768,,57097907,275820584,106176300,,1243707,13548474,3654468,PDP
EC338,,2016,1972,,58356090,289907967,109941134,,57302561,276087235,106428402,,1053529,13820732,3512733,PDP
EC338,,2017,1972,,58783902,290383679,110453592,,57586997,276457268,106778680,,1196905,13926411,3674916,PDP
EC338,,2017,1972,,58783902,290383679,110453592,,57586997,276457268,106778680,,1196905,13926411,3674916,PDP
EC347,,1978,1976,,12000,12000000,2147231,,0,0,0,,12000,12000000,2147231,PDN
EC347,,1979,1976,,0,4000000,711744,,0,0,0,,0,4000000,711744,PDN
EC347,,1980,1976,,4000,4000000,715744,,0,0,0,,4000,4000000,715744,PDN
EC347,,1981,1976,,4000,4000000,715744,,0,0,0,,4000,4000000,715744,PDN
EC347,,1982,1976,,28521,22816464,4088390,,3603,3145901,563372,,24918,19670563,3525018,PDN
EC347,,1983,1976,,28521,22816464,4088390,,5383,6576699,1175614,,23138,16239765,2912776,PDN
EC347,,1984,1976,,21609,20643703,3694866,,6739,8952560,1599721,,14870,11691143,2095145,PDN
EC347,,1985,1976,,707175,18770751,4047166,,8731,10424058,1863546,,698444,8346693,2183620,PDN
EC347,,1986,1976,,707175,18770751,4047166,,10683,11099324,1985652,,696492,7671427,2061514,PDN
EC347,,1987,1976,,711802,19560575,4192331,,12638,11631705,2082336,,699164,7928870,2109995,PDN
EC347,,1988,1976,,711493,19309536,4147353,,15175,12588536,2255128,,696318,6721000,1892225,PDN
EC347,,1989,1976,,264194,27516615,5160389,,20645,16177709,2899241,,243549,11338906,2261148,PDN
EC347,,1990,1976,,71122,27249716,4919826,,24610,19834716,3553919,,46512,7415000,1365907,PDN
EC347,,1991,1976,,74315,24263376,4391642,,25823,21898009,3922266,,48492,2365367,469376,PDN
EC347,,1992,1976,,26003,22408298,4013245,,26003,22408298,4013245,,0,0,0,PDN
EC347,,1993,1976,,26003,22408298,4013245,,26003,22408298,4013245,,0,0,0,PDN
EC347,,1994,1976,,26003,22408298,4013245,,26003,22408298,4013245,,0,0,0,PDN
EC347,,1995,1976,,26003,22408298,4013245,,26003,22408298,4013245,,0,0,0,PDN
EC347,,1996,1976,,26002,22408298,4013244,,26002,22408298,4013244,,0,0,0,PDN
EC347,,1997,1976,,26002,22408298,4013244,,26002,22408298,4013244,,0,0,0,PDN
EC347,,1998,1976,,26002,22408298,4013244,,26002,22408298,4013244,,0,0,0,PDN
EC347,,1999,1976,,26002,22408298,4013244,,26002,22408298,4013244,,0,0,0,PDN
EC347,,2000,1976,,105552,33130132,6000593,,52735,25427324,4577170,,52817,7702808,1423423,PDN
EC347,,2001,1976,,606246,33131744,6501574,,223326,26548869,4947324,,382920,6582875,1554250,PDN
EC347,,2002,1976,,606246,33131744,6501574,,335984,26797895,5104293,,270262,6333849,1397281,PDN
EC347,,2003,1976,,463527,27976588,5441568,,338707,26808016,5108817,,124820,1168572,332751,PDN
EC347,,2004,1976,,1003634,27976588,5981675,,519325,27069252,5335918,,484309,907336,645757,PDN
EC347,,2005,1976,,670651,27265698,5522199,,607820,27207059,5448934,,62831,58639,73265,PDN
EC347,,2006,1976,,683569,27341179,5548547,,624557,27222679,5468450,,59012,118500,80097,PDN
EC347,,2007,1976,,683569,27341179,5548547,,641125,27256760,5491082,,42444,84419,57465,PDN
EC347,,2008,1976,,683569,27341217,5548554,,658841,27285990,5513999,,24728,55227,34555,PDN
EC347,,2009,1976,,663348,27746927,5600524,,663348,27746927,5600524,,0,0,0,PDN
EC347,,2010,1976,,663348,27746927,5600524,,663348,27746927,5600524,,0,0,0,PDN
EC347,,2011,1976,,663348,27746927,5600524,,663348,27746927,5600524,,0,0,0,PDN
EC347,,2012,1976,,663348,27746927,5600524,,663348,27746927,5600524,,0,0,0,PDN
EC347,,2013,1976,,663348,27746927,5600524,,663348,27746927,5600524,,0,0,0,PDN
EC347,,2014,1976,,663348,27746927,5600524,,663348,27746927,5600524,,0,0,0,PDN
EC347,,2015,1976,,663348,27746927,5600524,,663348,27746927,5600524,,0,0,0,PDN
EC347,,2016,1976,,663348,27746927,5600524,,663348,27746927,5600524,,0,0,0,PDN
EC347,,2017,1976,,663348,27746927,5600524,,663348,27746927,5600524,,0,0,0,PDN
EC347,,2017,1976,,663348,27746927,5600524,,663348,27746927,5600524,,0,0,0,PDN
EC353,,1975,1973,,879000,87900000,16519569,,0,0,0,,879000,87900000,16519569,PDN
EC353,,1976,1973,,55044,55044000,9849350,,0,0,0,,55044,55044000,9849350,PDN
EC353,,1977,1973,,48780,48780000,8728495,,0,0,0,,48780,48780000,8728495,PDN
EC353,,1978,1973,,48780,48780000,8728495,,0,0,0,,48780,48780000,8728495,PDN
EC353,,1979,1973,,48780,48780000,8728495,,0,0,0,,48780,48780000,8728495,PDN
EC353,,1980,1973,,48780,48780000,8728495,,91,3208777,571048,,48689,45571223,8157447,PDN
EC353,,1981,1973,,48780,48858166,8742404,,276,10576655,1882243,,48504,38281511,6860161,PDN
EC353,,1982,1973,,38075,86283167,15390952,,529,17828175,3172802,,37546,68454992,12218150,PDN
EC353,,1983,1973,,4200,66979418,11922246,,677,23236144,4135222,,3523,43743274,7787024,PDN
EC353,,1984,1973,,4200,66979418,11922246,,708,30917504,5502043,,3492,36061914,6420203,PDN
EC353,,1985,1973,,2370,66979418,11920416,,803,37620990,6694929,,1567,29358428,5225487,PDN
EC353,,1986,1973,,4373,73957835,13164130,,1032,44196127,7865112,,3341,29761708,5299018,PDN
EC353,,1987,1973,,4373,73957835,13164130,,1147,48873716,8697538,,3226,25084119,4466592,PDN
EC353,,1988,1973,,4373,73957835,13164130,,1186,51236939,9118079,,3187,22720896,4046051,PDN
EC353,,1989,1973,,4373,73957835,13164130,,1186,53933869,9597960,,3187,20023966,3566170,PDN
EC353,,1990,1973,,4373,73957835,13164130,,1186,56000776,9965737,,3187,17957059,3198393,PDN
EC353,,1991,1973,,4373,73957835,13164130,,1186,57293052,10195679,,3187,16664783,2968451,PDN
EC353,,1992,1973,,4373,73957835,13164130,,1186,58463614,10403964,,3187,15494221,2760166,PDN
EC353,,1993,1973,,2784,68604758,12210036,,1186,59211952,10537121,,1598,9392806,1672915,PDN
EC353,,1994,1973,,2785,68604758,12210037,,1186,60945934,10845658,,1599,7658824,1364379,PDN
EC353,,1995,1973,,5748,72820031,12963049,,1186,62808149,11177013,,4562,10011882,1786036,PDN
EC353,,1996,1973,,3882,68564777,12204020,,1186,64599518,11495762,,2696,3965259,708258,PDN
EC353,,1997,1973,,7126,78703440,14011297,,1186,67478995,12008125,,5940,11224445,2003172,PDN
EC353,,1998,1973,,7126,78703440,14011297,,1186,70910807,12618767,,5940,7792633,1392530,PDN
EC353,,1999,1973,,7349,80944370,14410262,,1186,73332055,13049594,,6163,7612315,1360668,PDN
EC353,,2000,1973,,7349,80944370,14410262,,1186,75228485,13387037,,6163,5715885,1023225,PDN
EC353,,2001,1973,,5044,78495260,13972172,,1186,76359080,13588211,,3858,2136180,383961,PDN
EC353,,2002,1973,,5044,78495260,13972172,,1186,77072416,13715139,,3858,1422844,257033,PDN
EC353,,2003,1973,,1186,78946199,14048552,,1186,77697180,13826307,,0,1249019,222245,PDN
EC353,,2004,1973,,1186,78054554,13889897,,1186,78054554,13889897,,0,0,0,PDN
EC353,,2005,1973,,1186,78054554,13889897,,1186,78054554,13889897,,0,0,0,PDN
EC353,,2006,1973,,1186,78054554,13889897,,1186,78054554,13889897,,0,0,0,PDN
EC353,,2007,1973,,1186,78054554,13889897,,1186,78054554,13889897,,0,0,0,PDN
EC353,,2008,1973,,1186,78054554,13889897,,1186,78054554,13889897,,0,0,0,PDN
EC353,,2009,1973,,1186,79455190,14139121,,1186,79455190,14139121,,0,0,0,PDN
EC353,,2010,1973,,1186,79455190,14139121,,1186,79455190,14139121,,0,0,0,PDN
EC353,,2011,1973,,1186,79455190,14139121,,1186,79455190,14139121,,0,0,0,PDN
EC353,,2012,1973,,1186,79455190,14139121,,1186,79455190,14139121,,0,0,0,PDN
EC353,,2013,1973,,1186,79455190,14139121,,1186,79455190,14139121,,0,0,0,PDN
EC353,,2014,1973,,1186,79455190,14139121,,1186,79455190,14139121,,0,0,0,PDN
EC353,,2015,1973,,1186,79455190,14139121,,1186,79455190,14139121,,0,0,0,PDN
EC353,,2016,1973,,1186,79455190,14139121,,1186,79455190,14139121,,0,0,0,PDN
EC353,,2017,1973,,1186,79455190,14139121,,1186,79455190,14139121,,0,0,0,PDN
EC353,,2017,1973,,1186,79455190,14139121,,1186,79455190,14139121,,0,0,0,PDN
EC359,,1980,1974,,29000,29000000,5189142,,0,0,0,,29000,29000000,5189142,PDP
EC359,,1981,1974,,29000,29000000,5189142,,0,0,0,,29000,29000000,5189142,PDP
EC359,,1982,1974,,311922,39057208,7261603,,6672,10225689,1826190,,305250,28831519,5435413,PDP
EC359,,1983,1974,,208342,39057208,7158023,,13235,15587166,2786752,,195107,23470042,4371271,PDP
EC359,,1984,1974,,32786,41656133,7444909,,17138,19955242,3567893,,15648,21700891,3877016,PDP
EC359,,1985,1974,,34121,41656133,7446244,,19150,21970737,3928534,,14971,19685396,3517710,PDP
EC359,,1986,1974,,95726,48802284,8779406,,22921,26813146,4793943,,72805,21989138,3985463,PDP
EC359,,1987,1974,,102610,59165722,10630319,,28864,37578958,6715511,,73746,21586764,3914808,PDP
EC359,,1988,1974,,6603055,107411682,25715454,,379742,45649554,8502438,,6223313,61762128,17213016,PDP
EC359,,1989,1974,,8785265,115019683,29251401,,1223238,56927881,11352754,,7562027,58091802,17898647,PDP
EC359,,1990,1974,,8039718,115437116,28580130,,2131913,67026380,14058315,,5907805,48410736,14521815,PDP
EC359,,1991,1974,,3998166,99451920,21694237,,2813234,74116794,16001276,,1184932,25335126,5692961,PDP
EC359,,1992,1974,,4023189,101339729,22055169,,3289067,78149325,17194641,,734122,23190404,4860528,PDP
EC359,,1993,1974,,4454695,104093178,22976613,,3655709,81502725,18157973,,798986,22590453,4818640,PDP
EC359,,1994,1974,,5018829,96103493,22119095,,3933378,83844676,18852359,,1085451,12258817,3266736,PDP
EC359,,1995,1974,,5027841,96346488,22171344,,4174059,85882847,19455704,,853782,10463641,2715640,PDP
EC359,,1996,1974,,5344766,96542576,22523160,,4406348,88199635,20100233,,938418,8342941,2422927,PDP
EC359,,1997,1974,,5352324,96604480,22541733,,4573846,89678296,20530838,,778478,6926184,2010895,PDP
EC359,,1998,1974,,5352775,99265738,23015718,,4714397,90935826,20895149,,638378,8329912,2120569,PDP
EC359,,1999,1974,,5147952,95835492,22200531,,4817234,91695344,21133132,,330718,4140148,1067399,PDP
EC359,,2000,1974,,5182113,94859458,22061020,,4910158,92577413,21383007,,271955,2282045,678013,PDP
EC359,,2001,1974,,5253066,94463418,22061503,,4998945,93250102,21591490,,254121,1213316,470013,PDP
EC359,,2002,1974,,5255705,94475537,22066299,,5062667,93494603,21698717,,193038,980934,367582,PDP
EC359,,2003,1974,,5209951,94280150,21985778,,5107060,93650572,21770863,,102891,629578,214915,PDP
EC359,,2004,1974,,5226234,94183198,21984810,,5135224,93777680,21821644,,91010,405518,163166,PDP
EC359,,2005,1974,,13138355,110690809,32834228,,5934847,95352775,22901533,,7203508,15338034,9932695,PDP
EC359,,2006,1974,,9481368,103867032,27963046,,6552810,96380346,23702338,,2928558,7486686,4260708,PDP
EC359,,2007,1974,,11139962,111119743,30912159,,7559766,98537999,25093218,,3580196,12581744,5818941,PDP
EC359,,2008,1974,,11139962,111119379,30912094,,7734152,99068918,25362073,,3405810,12050461,5550021,PDP
EC359,,2009,1974,,8780694,104506701,27376192,,8177711,103803016,26647998,,602983,703685,728194,PDP
EC359,,2010,1974,,8780694,104506701,27376192,,8286486,103930111,26779387,,494208,576590,596804,PDP
EC359,,2011,1974,,8789179,104513703,27385923,,8394384,104058274,26910090,,394795,455429,475833,PDP
EC359,,2012,1974,,8903049,104615121,27517838,,8472814,104161614,27006908,,430235,453507,510930,PDP
EC359,,2013,1974,,8903049,104615121,27517838,,8547902,104258107,27099165,,355147,357014,418673,PDP
EC359,,2014,1974,,8910941,105404355,27666163,,8630657,104465265,27218780,,280284,939090,447383,PDP
EC359,,2015,1974,,9535002,106451629,28476571,,8899920,104940386,27572584,,635082,1511243,903987,PDP
EC359,,2016,1974,,9535002,106451629,28476571,,9173697,105550733,27954964,,361305,900896,521607,PDP
EC359,,2017,1974,,10199245,107674758,29358453,,9403741,105812963,28231669,,795504,1861795,1126784,PDP
EC359,,2017,1974,,10199245,107674758,29358453,,9403741,105812963,28231669,,795504,1861795,1126784,PDP
EC360,,1999,1986,,217,2171686,386638,,0,0,0,,217,2171686,386638,PDP
EC360,,2000,1986,,3979393,8974007,5576191,,0,0,0,,3979393,8974007,5576191,PDP
EC360,,2001,1986,,2923953,12435936,5136753,,301764,1659718,597087,,2622189,10776218,4539666,PDP
EC360,,2002,1986,,2297021,8941406,3888019,,1089495,5384920,2047666,,1207526,3556486,1840353,PDP
EC360,,2003,1986,,2885003,13386554,5266952,,1521808,7132147,2790873,,1363195,6254407,2476079,PDP
EC360,,2004,1986,,2052987,11623150,4121163,,1766527,8424709,3265586,,286460,3198441,855577,PDP
EC360,,2005,1986,,3066647,13725096,5508835,,1810575,8628860,3345959,,1256072,5096236,2162876,PDP
EC360,,2006,1986,,2332311,12028489,4472612,,2006299,9259416,3653882,,326012,2769073,818730,PDP
EC360,,2007,1986,,2279679,11705059,4362430,,2113238,9542588,3811207,,166441,2162471,551223,PDP
EC360,,2008,1986,,2279679,11705059,4362430,,2133351,9642702,3849134,,146328,2062357,513296,PDP
EC360,,2009,1986,,2653743,12204556,4825372,,2176300,9850166,3928999,,477443,2354390,896374,PDP
EC360,,2010,1986,,2653743,12204556,4825372,,2230664,9984002,4007178,,423079,2220554,818194,PDP
EC360,,2011,1986,,2653743,12204556,4825372,,2321444,10119121,4122000,,332299,2085435,703372,PDP
EC360,,2012,1986,,2802871,12441083,5016587,,2419805,10245066,4242771,,383066,2196017,773815,PDP
EC360,,2013,1986,,2802871,12441083,5016587,,2506909,10385714,4354901,,295962,2055369,661686,PDP
EC360,,2014,1986,,2769597,12347835,4966720,,2583976,10536575,4458812,,185621,1811260,507909,PDP
EC360,,2015,1986,,2771158,12539374,5002363,,2649445,10626938,4540359,,121713,1912436,462004,PDP
EC360,,2016,1986,,2944065,12712825,5206133,,2717788,10762354,4632797,,226277,1950471,573335,PDP
EC360,,2017,1986,,2944065,12712825,5206133,,2773841,11001846,4731465,,170224,1710979,474667,PDP
EC360,,2017,1986,,2944065,12712825,5206133,,2773841,11001846,4731465,,170224,1710979,474667,PDP
EC364,,1999,1980,,1026,10260681,1826770,,0,0,0,,1026,10260681,1826770,PDN
EC364,,2000,1980,,1026,10263945,1827351,,220,245748,43947,,806,10018197,1783404,PDN
EC364,,2001,1980,,10781,6432338,1155325,,6670,5276850,945611,,4111,1155488,209714,PDN
EC364,,2002,1980,,10781,6433344,1155504,,7906,5650082,1013259,,2875,783262,142245,PDN
EC364,,2003,1980,,10781,6484216,1164556,,9021,5862078,1052095,,1760,622138,112461,PDN
EC364,,2004,1980,,9342,6058488,1087365,,9047,5968325,1071027,,295,90163,16338,PDN
EC364,,2005,1980,,9571,5978793,1073413,,9061,5974066,1072062,,510,4727,1351,PDN
EC364,,2006,1980,,9571,5978793,1073413,,9149,5974881,1072295,,422,3912,1118,PDN
EC364,,2007,1980,,10322,6352579,1140674,,10322,6346401,1139575,,0,6178,1099,PDN
EC364,,2008,1980,,10322,6346671,1139623,,10322,6346671,1139623,,0,0,0,PDN
EC364,,2009,1980,,10322,6346671,1139623,,10322,6346671,1139623,,0,0,0,PDN
EC364,,2010,1980,,10322,6346671,1139623,,10322,6346671,1139623,,0,0,0,PDN
EC364,,2011,1980,,10322,6346671,1139623,,10322,6346671,1139623,,0,0,0,PDN
EC364,,2012,1980,,10322,6346671,1139623,,10322,6346671,1139623,,0,0,0,PDN
EC364,,2013,1980,,10322,6346671,1139623,,10322,6346671,1139623,,0,0,0,PDN
EC364,,2014,1980,,10322,6346671,1139623,,10322,6346671,1139623,,0,0,0,PDN
EC364,,2015,1980,,10322,6346671,1139623,,10322,6346671,1139623,,0,0,0,PDN
EC364,,2016,1980,,10322,6346671,1139623,,10322,6346671,1139623,,0,0,0,PDN
EC364,,2017,1980,,10322,6346671,1139623,,10322,6346671,1139623,,0,0,0,PDN
EC364,,2017,1980,,10322,6346671,1139623,,10322,6346671,1139623,,0,0,0,PDN
EC368,,2001,2001,,37399,4919424,912741,,0,0,0,,37399,4919424,912741,PDN
EC368,,2002,2001,,38951,6940130,1273850,,0,0,0,,38951,6940130,1273850,PDN
EC368,,2003,2001,,98488,14667873,2708430,,19652,3529648,647703,,78836,11138225,2060727,PDN
EC368,,2004,2001,,232959,11184001,2222995,,105573,7423737,1426523,,127386,3760264,796472,PDN
EC368,,2005,2001,,168035,9048598,1778106,,162574,8626929,1697615,,5461,421669,80491,PDN
EC368,,2006,2001,,436312,9513694,2129140,,162574,8626929,1697615,,273738,886765,431525,PDN
EC368,,2007,2001,,436308,9513170,2129043,,189406,8689602,1735599,,246902,823568,393444,PDN
EC368,,2008,2001,,436308,9632054,2150197,,268014,8969326,1863979,,168294,662728,286218,PDN
EC368,,2009,2001,,268205,8970271,1864339,,268097,8969326,1864063,,108,945,276,PDN
EC368,,2010,2001,,268205,8970271,1864339,,268205,8970271,1864339,,0,0,0,PDN
EC368,,2011,2001,,268205,8970271,1864339,,268205,8970271,1864339,,0,0,0,PDN
EC368,,2012,2001,,268205,8970271,1864339,,268205,8970271,1864339,,0,0,0,PDN
EC368,,2013,2001,,268205,8970271,1864339,,268205,8970271,1864339,,0,0,0,PDN
EC368,,2014,2001,,268205,8970271,1864339,,268205,8970271,1864339,,0,0,0,PDN
EC368,,2015,2001,,268205,8970271,1864339,,268205,8970271,1864339,,0,0,0,PDN
EC368,,2016,2001,,268205,8970271,1864339,,268205,8970271,1864339,,0,0,0,PDN
EC368,,2017,2001,,268205,8970271,1864339,,268205,8970271,1864339,,0,0,0,PDN
EC368,,2017,2001,,268205,8970271,1864339,,268205,8970271,1864339,,0,0,0,PDN
EC369,,1996,1986,,32953,6590519,1205643,,0,0,0,,32953,6590519,1205643,PDN
EC369,,2000,1986,,54989,10997810,2011895,,0,0,0,,54989,10997810,2011895,PDN
EC369,,2001,1986,,18452,42167312,7521533,,39,319037,56807,,18413,41848275,7464726,PDN
EC369,,2002,1986,,17615,42917852,7654244,,3382,5842578,1042987,,14233,37075274,6611257,PDN
EC369,,2003,1986,,17615,42917852,7654244,,5235,10600888,1891514,,12380,32316964,5762730,PDN
EC369,,2004,1986,,15310,31703441,5656492,,6207,12313462,2197214,,9103,19389979,3459278,PDN
EC369,,2005,1986,,19213,33119283,5912323,,7523,12784255,2282301,,11690,20335028,3630022,PDN
EC369,,2006,1986,,14960,30344023,5414253,,8332,13383968,2389821,,6628,16960055,3024432,PDN
EC369,,2007,1986,,14953,30143588,5378581,,8470,13730778,2451669,,6483,16412810,2926912,PDN
EC369,,2008,1986,,14953,30142940,5378465,,8670,14128966,2522721,,6283,16013974,2855744,PDN
EC369,,2009,1986,,13308,26184555,4672481,,8670,14128966,2522721,,4638,12055589,2149760,PDN
EC369,,2010,1986,,13308,26184555,4672481,,8670,14128966,2522721,,4638,12055589,2149760,PDN
EC369,,2011,1986,,8670,14128966,2522721,,8670,14128966,2522721,,0,0,0,PDN
EC369,,2012,1986,,8670,14128966,2522721,,8670,14128966,2522721,,0,0,0,PDN
EC369,,2013,1986,,8670,14128966,2522721,,8670,14128966,2522721,,0,0,0,PDN
EC369,,2014,1986,,8670,14128966,2522721,,8670,14128966,2522721,,0,0,0,PDN
EC369,,2015,1986,,8670,14128966,2522721,,8670,14128966,2522721,,0,0,0,PDN
EC369,,2016,1986,,8670,14128966,2522721,,8670,14128966,2522721,,0,0,0,PDN
EC369,,2017,1986,,8670,14128966,2522721,,8670,14128966,2522721,,0,0,0,PDN
EC369,,2017,1986,,8670,14128966,2522721,,8670,14128966,2522721,,0,0,0,PDN
EC377,,2001,1987,,279430,7090951,1541165,,0,0,0,,279430,7090951,1541165,PDN
EC377,,2002,1987,,279430,7090951,1541166,,5048,125032,27296,,274382,6965919,1513870,PDN
EC377,,2003,1987,,278498,7051753,1533258,,89070,2502854,534418,,189428,4548899,998840,PDN
EC377,,2004,1987,,278498,7051753,1533258,,131011,3471748,748760,,147487,3580005,784498,PDN
EC377,,2005,1987,,368643,6823603,1582807,,144718,3764321,814526,,223925,3059282,768281,PDN
EC377,,2006,1987,,260416,6338327,1388232,,156523,3817048,835713,,103893,2521279,552519,PDN
EC377,,2007,1987,,260416,6338327,1388232,,160133,3831131,841829,,100283,2507196,546403,PDN
EC377,,2008,1987,,163636,3838828,846701,,163636,3838828,846701,,0,0,0,PDN
EC377,,2009,1987,,163636,3838828,846702,,163636,3838828,846702,,0,0,0,PDN
EC377,,2010,1987,,163636,3838828,846702,,163636,3838828,846702,,0,0,0,PDN
EC377,,2011,1987,,163636,3838828,846702,,163636,3838828,846702,,0,0,0,PDN
EC377,,2012,1987,,163636,3838828,846702,,163636,3838828,846702,,0,0,0,PDN
EC377,,2013,1987,,163636,3838828,846702,,163636,3838828,846702,,0,0,0,PDN
EC377,,2014,1987,,163636,3838828,846702,,163636,3838828,846702,,0,0,0,PDN
EC377,,2015,1987,,163636,3838828,846702,,163636,3838828,846702,,0,0,0,PDN
EC377,,2016,1987,,163636,3838828,846702,,163636,3838828,846702,,0,0,0,PDN
EC377,,2017,1987,,163636,3838828,846702,,163636,3838828,846702,,0,0,0,PDN
EC377,,2017,1987,,163636,3838828,846702,,163636,3838828,846702,,0,0,0,PDN
EC378,,1987,1985,,26017,3018017,563031,,0,0,0,,26017,3018017,563031,PDN
EC378,,1996,1985,,59394,8909134,1644649,,0,0,0,,59394,8909134,1644649,PDN
EC378,,1997,1985,,59394,8909134,1644649,,0,0,0,,59394,8909134,1644649,PDN
EC378,,1998,1985,,2548,8905567,1587168,,869,3036716,541210,,1679,5868851,1045958,PDN
EC378,,1999,1985,,4417,17558257,3128662,,2273,8720682,1553996,,2144,8837575,1574666,PDN
EC378,,2000,1985,,65724,30335904,5463572,,4498,14030801,2501082,,61226,16305103,2962490,PDN
EC378,,2001,1985,,63970,35788262,6431988,,4391,19496153,3473457,,59579,16292109,2958531,PDN
EC378,,2002,1985,,63686,35819782,6437313,,4632,23239080,4139700,,59054,12580702,2297613,PDN
EC378,,2003,1985,,63686,35819782,6437313,,4941,25625134,4564573,,58745,10194648,1872740,PDN
EC378,,2004,1985,,264745,39895929,7363665,,5104,27059474,4819957,,259641,12836455,2543708,PDN
EC378,,2005,1985,,215140,40996562,7509902,,14669,28022478,5000875,,200471,12974084,2509027,PDN
EC378,,2006,1985,,214867,41134562,7534184,,32643,29150545,5219573,,182224,11984017,2314611,PDN
EC378,,2007,1985,,214867,41134562,7534184,,32643,29426437,5268664,,182224,11708125,2265520,PDN
EC378,,2008,1985,,214867,41134562,7534184,,32643,29615087,5302231,,182224,11519475,2231953,PDN
EC378,,2009,1985,,32643,29714880,5319989,,32643,29714880,5319989,,0,0,0,PDN
EC378,,2010,1985,,32643,29714880,5319989,,32643,29714880,5319989,,0,0,0,PDN
EC378,,2011,1985,,32643,29714880,5319989,,32643,29714880,5319989,,0,0,0,PDN
EC378,,2012,1985,,32643,29714880,5319989,,32643,29714880,5319989,,0,0,0,PDN
EC378,,2013,1985,,32643,29714880,5319989,,32643,29714880,5319989,,0,0,0,PDN
EC378,,2014,1985,,32643,29714880,5319989,,32643,29714880,5319989,,0,0,0,PDN
EC378,,2015,1985,,32643,29714880,5319989,,32643,29714880,5319989,,0,0,0,PDN
EC378,,2016,1985,,32643,29714880,5319989,,32643,29714880,5319989,,0,0,0,PDN
EC378,,2017,1985,,32643,29714880,5319989,,32643,29714880,5319989,,0,0,0,PDN
EC378,,2017,1985,,32643,29714880,5319989,,32643,29714880,5319989,,0,0,0,PDN
EI023,,1993,1993,,4253153,4678471,5085621,,0,0,0,,4253153,4678471,5085621,PDN
EI023,,1994,1993,,3188650,3507515,3812763,,35624,241365,78572,,3153026,3266150,3734191,PDN
EI023,,1995,1993,,52855,241365,95803,,52855,241365,95803,,0,0,0,PDN
EI023,,1996,1993,,52320,241365,95268,,52320,241365,95268,,0,0,0,PDN
EI023,,1997,1993,,52320,241365,95268,,52320,241365,95268,,0,0,0,PDN
EI023,,1998,1993,,52320,241365,95268,,52320,241365,95268,,0,0,0,PDN
EI023,,1999,1993,,52320,241365,95268,,52320,241365,95268,,0,0,0,PDN
EI023,,2000,1993,,52320,241365,95268,,52320,241365,95268,,0,0,0,PDN
EI023,,2001,1993,,52320,241365,95268,,52320,241365,95268,,0,0,0,PDN
EI023,,2002,1993,,52320,241365,95268,,52320,241365,95268,,0,0,0,PDN
EI023,,2003,1993,,52320,241365,95268,,52320,241365,95268,,0,0,0,PDN
EI023,,2004,1993,,52320,241365,95268,,52320,241365,95268,,0,0,0,PDN
EI023,,2005,1993,,52320,241365,95268,,52320,241365,95268,,0,0,0,PDN
EI023,,2006,1993,,52320,241365,95268,,52320,241365,95268,,0,0,0,PDN
EI023,,2007,1993,,52320,241365,95268,,52320,241365,95268,,0,0,0,PDN
EI023,,2008,1993,,52320,241365,95268,,52320,241365,95268,,0,0,0,PDN
EI023,,2009,1993,,52320,246199,96128,,52320,246199,96128,,0,0,0,PDN
EI023,,2010,1993,,52320,246199,96128,,52320,246199,96128,,0,0,0,PDN
EI023,,2011,1993,,52320,246199,96128,,52320,246199,96128,,0,0,0,PDN
EI023,,2012,1993,,52320,246199,96128,,52320,246199,96128,,0,0,0,PDN
EI023,,2013,1993,,52320,246199,96128,,52320,246199,96128,,0,0,0,PDN
EI023,,2014,1993,,52320,246199,96128,,52320,246199,96128,,0,0,0,PDN
EI023,,2015,1993,,52320,246199,96128,,52320,246199,96128,,0,0,0,PDN
EI023,,2016,1993,,52320,246199,96128,,52320,246199,96128,,0,0,0,PDN
EI023,,2017,1993,,52320,246199,96128,,52320,246199,96128,,0,0,0,PDN
EI023,,2017,1993,,52320,246199,96128,,52320,246199,96128,,0,0,0,PDN
EI024,,1980,1980,,16000,16000000,2862975,,0,0,0,,16000,16000000,2862975,PDP
EI024,,1981,1980,,16000,16000000,2862975,,0,0,0,,16000,16000000,2862975,PDP
EI024,,1982,1980,,16000,16000000,2862975,,0,0,0,,16000,16000000,2862975,PDP
EI024,,1983,1980,,2731300,82938979,17489125,,293194,10565303,2173141,,2438106,72373676,15315984,PDP
EI024,,1984,1980,,3821409,124988121,26061288,,666777,22936063,4747927,,3154632,102052058,21313361,PDP
EI024,,1985,1980,,3821409,124988121,26061288,,857695,30330156,6254520,,2963714,94657965,19806768,PDP
EI024,,1986,1980,,3821409,124988121,26061288,,996223,37268441,7627618,,2825186,87719680,18433670,PDP
EI024,,1987,1980,,3904043,128224921,26719865,,1444354,53730781,11004991,,2459689,74494140,15714874,PDP
EI024,,1988,1980,,3948968,130216793,27119216,,1874551,67552863,13894633,,2074417,62663930,13224583,PDP
EI024,,1989,1980,,4261739,145356298,30125849,,2194361,77933261,16061489,,2067378,67423037,14064360,PDP
EI024,,1990,1980,,4261739,145356298,30125849,,2601127,87571031,18183161,,1660612,57785267,11942688,PDP
EI024,,1991,1980,,4196543,141959607,29456260,,2897234,94376470,19690200,,1299309,47583137,9766060,PDP
EI024,,1992,1980,,3922052,136169143,28151437,,2959450,96703537,20166485,,962602,39465606,7984952,PDP
EI024,,1993,1980,,4246137,137902341,28783920,,3245430,103048768,21581510,,1000707,34853573,7202410,PDP
EI024,,1994,1980,,4931708,142464370,30281240,,3552475,110850678,23276795,,1379233,31613692,7004445,PDP
EI024,,1995,1980,,4892784,141419244,30056351,,3761835,116916002,24565394,,1130949,24503242,5490957,PDP
EI024,,1996,1980,,4892784,141419244,30056351,,3915455,121745956,25578436,,977329,19673288,4477915,PDP
EI024,,1997,1980,,4892784,141419244,30056351,,3990178,124038032,26061002,,902606,17381212,3995349,PDP
EI024,,1998,1980,,4892784,141419244,30056351,,4043328,125589618,26390235,,849456,15829626,3666116,PDP
EI024,,1999,1980,,4083993,126783137,26643270,,4081531,126728637,26631111,,2462,54500,12159,PDP
EI024,,2000,1980,,4083993,126783137,26643270,,4083993,126783137,26643270,,0,0,0,PDP
EI024,,2001,1980,,4083993,126783137,26643270,,4083993,126783137,26643270,,0,0,0,PDP
EI024,,2002,1980,,4413943,136427779,28689349,,4112203,128786779,27028000,,301740,7641000,1661349,PDP
EI024,,2003,1980,,4597085,141556383,29785054,,4295050,133096352,27977675,,302035,8460031,1807379,PDP
EI024,,2004,1980,,4749076,145545550,30646861,,4369100,135160406,28418994,,379976,10385144,2227867,PDP
EI024,,2005,1980,,4595568,140772684,29644088,,4411363,136471841,28694609,,184205,4300843,949479,PDP
EI024,,2006,1980,,7777802,283636026,58246846,,4519085,138954003,29243997,,3258717,144682023,29002849,PDP
EI024,,2007,1980,,8529589,319721779,65419585,,4809240,151393623,31747607,,3720349,168328156,33671978,PDP
EI024,,2008,1980,,8018177,300093083,61415523,,5193532,168944941,35254909,,2824645,131148142,26160614,PDP
EI024,,2009,1980,,8463249,331855026,67512187,,6108929,211307117,43708061,,2354320,120547909,23804126,PDP
EI024,,2010,1980,,8526484,332787330,67741312,,6810182,242781008,50009651,,1716302,90006322,17731661,PDP
EI024,,2011,1980,,8526484,332787330,67741312,,7334096,269194195,55233420,,1192388,63593135,12507892,PDP
EI024,,2012,1980,,8526484,332787330,67741312,,7754082,292980673,59885875,,772402,39806657,7855437,PDP
EI024,,2013,1980,,8531547,332833324,67754559,,8154630,318789803,64878794,,376917,14043521,2875764,PDP
EI024,,2014,1980,,9078471,385643000,77698222,,8476881,341763237,69288846,,601590,43879763,8409377,PDP
EI024,,2015,1980,,9580590,426346178,85442900,,8754111,364189782,73556564,,826479,62156396,11886336,PDP
EI024,,2016,1980,,9580590,426346178,85442900,,8930398,384147538,77284053,,650192,42198640,8158847,PDP
EI024,,2017,1980,,9801887,468203707,93112156,,9075565,400449190,80329869,,726322,67754517,12782286,PDP
EI024,,2017,1980,,9801887,468203707,93112156,,9075565,400449190,80329869,,726322,67754517,12782286,PDP
EI027,,1988,1956,,170912,8195547,1629194,,170912,8195547,1629194,,0,0,0,PDN
EI027,,1989,1956,,170912,8195547,1629194,,170912,8195547,1629194,,0,0,0,PDN
EI027,,1990,1956,,426422,10156738,2233671,,171462,8394194,1665091,,254960,1762544,568580,PDN
EI027,,1991,1956,,170912,8195547,1629194,,170912,8195547,1629194,,0,0,0,PDN
EI027,,1992,1956,,170912,8195547,1629194,,170912,8195547,1629194,,0,0,0,PDN
EI027,,1993,1956,,170912,8195547,1629194,,170912,8195547,1629194,,0,0,0,PDN
EI027,,1994,1956,,170912,8195547,1629194,,170912,8195547,1629194,,0,0,0,PDN
EI027,,1995,1956,,170912,8195547,1629194,,170912,8195547,1629194,,0,0,0,PDN
EI027,,1996,1956,,170912,8195547,1629194,,170912,8195547,1629194,,0,0,0,PDN
EI027,,1997,1956,,170912,8195547,1629194,,170912,8195547,1629194,,0,0,0,PDN
EI027,,1998,1956,,170912,8195547,1629194,,170912,8195547,1629194,,0,0,0,PDN
EI027,,1999,1956,,170912,8195547,1629194,,170912,8195547,1629194,,0,0,0,PDN
EI027,,2000,1956,,170912,8195547,1629194,,170912,8195547,1629194,,0,0,0,PDN
EI027,,2001,1956,,356277,17084171,3396165,,170912,8195547,1629194,,185365,8888624,1766971,PDN
EI027,,2002,1956,,334633,18982413,3712287,,170912,8195547,1629194,,163721,10786866,2083093,PDN
EI027,,2003,1956,,334633,18982413,3712287,,217117,11405245,2246520,,117516,7577168,1465767,PDN
EI027,,2004,1956,,267385,18752766,3604176,,262272,17324520,3344927,,5113,1428246,259249,PDN
EI027,,2005,1956,,291545,20116604,3871012,,270078,18242752,3516119,,21467,1873852,354893,PDN
EI027,,2006,1956,,291545,20116604,3871012,,284317,19431926,3741955,,7228,684678,129057,PDN
EI027,,2007,1956,,322190,23745386,4547348,,296724,20738193,3986794,,25466,3007193,560554,PDN
EI027,,2008,1956,,322190,23745386,4547348,,303634,21606060,4148129,,18556,2139326,399219,PDN
EI027,,2009,1956,,328589,24216993,4637662,,306786,22505053,4311244,,21803,1711940,326419,PDN
EI027,,2010,1956,,328589,24216993,4637662,,310447,23028214,4407994,,18142,1188779,229669,PDN
EI027,,2011,1956,,328589,24216993,4637662,,315251,23633913,4520574,,13338,583080,117089,PDN
EI027,,2012,1956,,328589,24216993,4637662,,316369,23897594,4568610,,12220,319399,69053,PDN
EI027,,2013,1956,,316369,23897594,4568610,,316369,23897594,4568610,,0,0,0,PDN
EI027,,2014,1956,,316369,23897594,4568610,,316369,23897594,4568610,,0,0,0,PDN
EI027,,2015,1956,,316369,23897594,4568610,,316369,23897594,4568610,,0,0,0,PDN
EI027,,2016,1956,,316369,23897594,4568610,,316369,23897594,4568610,,0,0,0,PDN
EI027,,2017,1956,,316369,23897594,4568610,,316369,23897594,4568610,,0,0,0,PDN
EI027,,2017,1956,,316369,23897594,4568610,,316369,23897594,4568610,,0,0,0,PDN
EI028,,1987,1985,,856916,18610229,4168345,,0,0,0,,856916,18610229,4168345,PDN
EI028,,1988,1985,,482524,43427081,8209763,,0,0,0,,482524,43427081,8209763,PDN
EI028,,1989,1985,,482524,43427081,8209763,,0,0,0,,482524,43427081,8209763,PDN
EI028,,1990,1985,,1233501,45960649,9411552,,317885,2464232,756360,,915616,43496417,8655192,PDN
EI028,,1991,1985,,2107249,46082030,10306898,,886724,8100490,2328092,,1220525,37981540,7978806,PDN
EI028,,1992,1985,,2107249,46082030,10306898,,1272638,12675239,3528019,,834611,33406791,6778879,PDN
EI028,,1993,1985,,2442741,46082030,10642390,,1511357,16822282,4504646,,931384,29259748,6137744,PDN
EI028,,1994,1985,,2094201,30612702,7541301,,1714661,22176748,5660702,,379540,8435954,1880599,PDN
EI028,,1995,1985,,2115124,31658846,7748371,,1830943,25576177,6381864,,284181,6082669,1366507,PDN
EI028,,1996,1985,,2115124,31658846,7748371,,1917007,27768693,6858056,,198117,3890153,890315,PDN
EI028,,1997,1985,,2115124,31658846,7748371,,1957654,28476517,7024650,,157470,3182329,723721,PDN
EI028,,1998,1985,,2086949,30207005,7461861,,1998230,28700993,7105168,,88719,1506012,356693,PDN
EI028,,1999,1985,,2060636,28930820,7208469,,2050182,28887490,7190305,,10454,43330,18164,PDN
EI028,,2000,1985,,2526843,51759469,11736713,,2115952,29074843,7289412,,410891,22684626,4447301,PDN
EI028,,2001,1985,,2526843,51759469,11736713,,2180749,29231219,7382034,,346094,22528250,4354679,PDN
EI028,,2002,1985,,2526843,51759469,11736713,,2223851,29318100,7440595,,302992,22441369,4296118,PDN
EI028,,2003,1985,,2594326,51857933,11821716,,2260181,29423552,7495688,,334145,22434381,4326028,PDN
EI028,,2004,1985,,2775211,52423561,12103247,,2298612,29504334,7548493,,476599,22919227,4554754,PDN
EI028,,2005,1985,,2775211,52423561,12103247,,2299046,29505973,7549219,,476165,22917588,4554028,PDN
EI028,,2006,1985,,2528395,30210141,7903865,,2299046,29505973,7549219,,229349,704168,354646,PDN
EI028,,2007,1985,,2528395,30210141,7903865,,2306107,29535827,7561592,,222288,674314,342273,PDN
EI028,,2008,1985,,2528395,30210141,7903865,,2347853,29706437,7633696,,180542,503704,270169,PDN
EI028,,2009,1985,,2528395,30687724,7988844,,2393538,30439806,7809873,,134857,247918,178971,PDN
EI028,,2010,1985,,2698600,33829957,8718165,,2535354,31172081,8081987,,163246,2657876,636178,PDN
EI028,,2011,1985,,2698600,33829957,8718165,,2598432,32313830,8348223,,100168,1516127,369941,PDN
EI028,,2012,1985,,2698600,33829957,8718165,,2633038,32805451,8470307,,65562,1024506,247858,PDN
EI028,,2013,1985,,2697730,34085034,8762682,,2644650,33520797,8609204,,53080,564237,153478,PDN
EI028,,2014,1985,,2697730,34085034,8762682,,2670872,33757781,8677594,,26858,327253,85088,PDN
EI028,,2015,1985,,2697730,34085034,8762682,,2690496,33820704,8708414,,7234,264330,54268,PDN
EI028,,2016,1985,,2690543,33821296,8708567,,2690543,33821296,8708567,,0,0,0,PDN
EI028,,2017,1985,,2690543,33821296,8708567,,2690543,33821296,8708567,,0,0,0,PDN
EI028,,2017,1985,,2690543,33821296,8708567,,2690543,33821296,8708567,,0,0,0,PDN
EI029,,1988,1987,,112486,563402,212735,,0,0,0,,112486,563402,212735,PDN
EI029,,2003,1987,,93375,803292,236310,,0,0,0,,93375,803292,236310,PDN
EI029,,2004,1987,,176571,921530,340545,,17291,205212,53806,,159280,716318,286739,PDN
EI029,,2005,1987,,176571,921530,340545,,32117,594510,137902,,144454,327020,202643,PDN
EI029,,2006,1987,,176571,921530,340545,,32119,594580,137916,,144452,326950,202629,PDN
EI029,,2007,1987,,32119,594580,137916,,32119,594580,137916,,0,0,0,PDN
EI029,,2008,1987,,32119,594580,137916,,32119,594580,137916,,0,0,0,PDN
EI029,,2009,1987,,32119,594580,137916,,32119,594580,137916,,0,0,0,PDN
EI029,,2010,1987,,32119,594580,137916,,32119,594580,137916,,0,0,0,PDN
EI029,,2011,1987,,32119,594580,137916,,32119,594580,137916,,0,0,0,PDN
EI029,,2012,1987,,32119,594580,137916,,32119,594580,137916,,0,0,0,PDN
EI029,,2013,1987,,32119,594580,137916,,32119,594580,137916,,0,0,0,PDN
EI029,,2014,1987,,32119,594580,137916,,32119,594580,137916,,0,0,0,PDN
EI029,,2015,1987,,32119,594580,137916,,32119,594580,137916,,0,0,0,PDN
EI029,,2016,1987,,32119,594580,137916,,32119,594580,137916,,0,0,0,PDN
EI029,,2017,1987,,32119,594580,137916,,32119,594580,137916,,0,0,0,PDN
EI029,,2017,1987,,32119,594580,137916,,32119,594580,137916,,0,0,0,PDN
EI030,,1990,1989,,764531,75508508,14200209,,49350,4411754,834360,,715181,71096754,13365849,PDN
EI030,,1991,1989,,632675,75508508,14068353,,80448,8384396,1572333,,552227,67124112,12496020,PDN
EI030,,1992,1989,,327021,38165016,7117949,,116741,12341402,2312720,,210280,25823614,4805229,PDN
EI030,,1993,1989,,327021,38165016,7117949,,164282,17424364,3264703,,162739,20740652,3853246,PDN
EI030,,1994,1989,,327021,38165016,7117949,,227346,26468259,4937001,,99675,11696757,2180948,PDN
EI030,,1995,1989,,360126,41902606,7816106,,263046,32543528,6053709,,97080,9359078,1762397,PDN
EI030,,1996,1989,,612481,52021815,9869032,,470741,36002104,6876809,,141740,16019711,2992223,PDN
EI030,,1997,1989,,701024,56464379,10748067,,550298,38617786,7421790,,150726,17846593,3326277,PDN
EI030,,1998,1989,,1142567,77017826,14846807,,657338,42386982,8199506,,485229,34630844,6647301,PDN
EI030,,1999,1989,,834966,53940337,10432891,,743573,47093501,9123200,,91393,6846836,1309691,PDN
EI030,,2000,1989,,1114862,64295475,12555338,,877784,50780458,9913453,,237078,13515017,2641885,PDN
EI030,,2001,1989,,1124616,65380056,12758078,,953222,52800187,10348273,,171394,12579869,2409805,PDN
EI030,,2002,1989,,1164584,65510797,12821309,,1026513,54489120,10722086,,138071,11021677,2099223,PDN
EI030,,2003,1989,,1179471,65567076,12846211,,1040923,54826650,10796555,,138548,10740426,2049656,PDN
EI030,,2004,1989,,1277573,65178582,12875185,,1056615,54979328,10839414,,220958,10199254,2035771,PDN
EI030,,2005,1989,,1269188,64630236,12769230,,1075143,55071642,10874368,,194045,9558594,1894862,PDN
EI030,,2006,1989,,1269188,64630236,12769230,,1082790,55194847,10903937,,186398,9435389,1865293,PDN
EI030,,2007,1989,,1269188,64630236,12769230,,1083071,55196876,10904579,,186117,9433360,1864651,PDN
EI030,,2008,1989,,1269188,64630236,12769230,,1087060,55212399,10911330,,182128,9417837,1857900,PDN
EI030,,2009,1989,,1277453,65682068,12964654,,1090492,56037191,11061522,,186961,9644877,1903132,PDN
EI030,,2010,1989,,1277453,65682068,12964654,,1099470,56062108,11074934,,177983,9619960,1889720,PDN
EI030,,2011,1989,,1277453,65682068,12964654,,1106220,56073405,11083694,,171233,9608663,1880960,PDN
EI030,,2012,1989,,1277453,65682068,12964654,,1106220,56073405,11083694,,171233,9608663,1880960,PDN
EI030,,2013,1989,,1106220,56073405,11083694,,1106220,56073405,11083694,,0,0,0,PDN
EI030,,2014,1989,,1106220,56073405,11083694,,1106220,56073405,11083694,,0,0,0,PDN
EI030,,2015,1989,,1106220,56073405,11083694,,1106220,56073405,11083694,,0,0,0,PDN
EI030,,2016,1989,,1106220,56073405,11083694,,1106220,56073405,11083694,,0,0,0,PDN
EI030,,2017,1989,,1106220,56073405,11083694,,1106220,56073405,11083694,,0,0,0,PDN
EI030,,2017,1989,,1106220,56073405,11083694,,1106220,56073405,11083694,,0,0,0,PDN
EI032,,1975,1949,,46667808,788620820,186991797,,32211096,585895368,136462941,,14456712,202725452,50528856,PDP
EI032,,1976,1949,,46667808,788620820,186991797,,32928529,587839146,137526242,,13739279,200781674,49465555,PDP
EI032,,1977,1949,,47097998,849396622,198236187,,33657456,593223540,139213246,,13440542,256173082,59022941,PDP
EI032,,1978,1949,,47574158,849902754,198802406,,34381567,597290356,140660990,,13192591,252612398,58141416,PDP
EI032,,1979,1949,,43494273,899853950,203610634,,28671995,702781385,153722064,,14822278,197072565,49888570,PDP
EI032,,1980,1949,,43815314,917630566,207094774,,29910892,732481829,160245737,,13904422,185148737,46849037,PDP
EI032,,1981,1949,,43815314,917630566,207094774,,30634833,734427809,161315938,,13180481,183202757,45778836,PDP
EI032,,1982,1949,,45425800,849746338,196626216,,31369331,736311758,162385658,,14056469,113434580,34240558,PDP
EI032,,1983,1949,,44850876,845142821,195232161,,32054429,737218586,163232113,,12796447,107924235,32000048,PDP
EI032,,1984,1949,,45800745,850249176,197090634,,32684059,737728725,163952515,,13116686,112520451,33138119,PDP
EI032,,1985,1949,,47115706,851376134,198606121,,33258093,738582524,164678471,,13857613,112793610,33927650,PDP
EI032,,1986,1949,,47132068,850732815,198508014,,34023557,739954618,165688080,,13108511,110778197,32819934,PDP
EI032,,1987,1949,,41638166,776629304,179828434,,34752381,742599103,166887453,,6885785,34030201,12940981,PDP
EI032,,1988,1949,,42401072,779216435,181051683,,35328020,745376353,167957264,,7073052,33840082,13094419,PDP
EI032,,1989,1949,,42792095,786489569,182736858,,35976904,750784727,169568492,,6815191,35704842,13168366,PDP
EI032,,1990,1949,,43055143,799314472,185281917,,36535914,754651955,170815621,,6519229,44662517,14466296,PDP
EI032,,1991,1949,,44233617,777515629,182581594,,37112907,757072391,171823297,,7120710,20443238,10758297,PDP
EI032,,1992,1949,,45466728,802958880,188341974,,37667485,764748340,173743702,,7799243,38210540,14598272,PDP
EI032,,1993,1949,,46448447,819454349,192258829,,38347061,771379633,175603223,,8101386,48074716,16655606,PDP
EI032,,1994,1949,,46327350,821821155,192558872,,39059013,777885866,177472868,,7268337,43935289,15086004,PDP
EI032,,1995,1949,,47236812,804467010,190380408,,39711028,780561589,178600990,,7525784,23905421,11779418,PDP
EI032,,1996,1949,,47392189,804196500,190487652,,40403290,783034661,179733301,,6988899,21161839,10754351,PDP
EI032,,1997,1949,,47460071,816284812,192706479,,41013258,786102310,180889114,,6446813,30182502,11817365,PDP
EI032,,1998,1949,,47326771,839827687,196762302,,41421785,791337227,182229121,,5904986,48490460,14533181,PDP
EI032,,1999,1949,,48045809,822578676,194412121,,41825348,794934530,183272773,,6220461,27644146,11139348,PDP
EI032,,2000,1949,,47830422,824679777,194570596,,42173962,797270024,184036956,,5656460,27409753,10533640,PDP
EI032,,2001,1949,,46132730,806976907,189722927,,42410630,798549785,184501339,,3722100,8427122,5221588,PDP
EI032,,2002,1949,,46333781,807589341,190032952,,42651258,800836092,185148783,,3682523,6753249,4884169,PDP
EI032,,2003,1949,,46717214,812262112,191247839,,42994468,802388440,185768212,,3722746,9873672,5479627,PDP
EI032,,2004,1949,,46873961,809234103,190865794,,43383624,803829882,186413852,,3490337,5404221,4451942,PDP
EI032,,2005,1949,,46505896,808541378,190374469,,43713100,804856330,186925970,,2792796,3685048,3448499,PDP
EI032,,2006,1949,,46750952,809127761,190723863,,43904099,805148482,187168953,,2846853,3979279,3554910,PDP
EI032,,2007,1949,,46750952,809127761,190723863,,44034980,805439265,187351575,,2715972,3688496,3372288,PDP
EI032,,2008,1949,,47150665,808978070,191096941,,44126051,805723579,187493236,,3024614,3254491,3603705,PDP
EI032,,2009,1949,,47391761,825227212,194229341,,44399479,821851871,190636468,,2992282,3375341,3592876,PDP
EI032,,2010,1949,,48011326,826675636,195106632,,44690693,822563325,191054274,,3320633,4112311,4052360,PDP
EI032,,2011,1949,,48011326,826674129,195106363,,44882589,823142041,191349143,,3128737,3532088,3757222,PDP
EI032,,2012,1949,,48079298,827405980,195304558,,45059209,823377886,191567727,,3020089,4028094,3736832,PDP
EI032,,2013,1949,,48032132,827389945,195254539,,45195476,823500019,191725728,,2836656,3889926,3528812,PDP
EI032,,2014,1949,,48357936,827905018,195671993,,45440175,823679630,192002386,,2917761,4225388,3669608,PDP
EI032,,2015,1949,,48452109,828069929,195795510,,45665716,823832655,192255155,,2786393,4237274,3540356,PDP
EI032,,2016,1949,,48454503,828069929,195797904,,45834575,823957313,192446195,,2619928,4112616,3351710,PDP
EI032,,2017,1949,,48804738,827063847,195969120,,45957361,824051487,192585737,,2847377,3012360,3383383,PDP
EI032,,2017,1949,,48804738,827063847,195969120,,45957361,824051487,192585737,,2847377,3012360,3383383,PDP
EI045,,1975,1948,,11208696,11873906,13321491,,8473625,9106870,10094065,,2735071,2767036,3227426,PDN
EI045,,1976,1948,,19458157,17937260,22649840,,12033858,11597219,14097420,,7424299,6340041,8552420,PDN
EI045,,1977,1948,,19458157,17937260,22649840,,12494543,11901679,14612279,,6963614,6035581,8037561,PDN
EI045,,1978,1948,,19458157,17937260,22649840,,12936830,12221693,15111508,,6521327,5715567,7538332,PDN
EI045,,1979,1948,,20381430,32036219,26081825,,13224590,23354396,17380176,,7156840,8681823,8701649,PDN
EI045,,1980,1948,,20831430,32036219,26531825,,13688659,24136073,17983334,,7142771,7900146,8548491,PDN
EI045,,1981,1948,,20917430,37536219,27596473,,14153846,27248817,19002390,,6763584,10287402,8594083,PDN
EI045,,1982,1948,,21305305,48871762,30001348,,14607378,30643128,20059892,,6697927,18228634,9941456,PDN
EI045,,1983,1948,,23623591,63901494,34993964,,15138782,37513664,21813811,,8484809,26387830,13180153,PDN
EI045,,1984,1948,,27612715,131450539,51002491,,15666269,52109222,24938373,,11946446,79341317,26064118,PDN
EI045,,1985,1948,,28025704,148290342,54411886,,16280497,74792104,29588701,,11745207,73498238,24823185,PDN
EI045,,1986,1948,,28430526,205948953,65076247,,16936879,108394219,36224107,,11493647,97554734,28852140,PDN
EI045,,1987,1948,,28436262,221609795,67868610,,17540369,138572702,42197433,,10895893,83037093,25671177,PDN
EI045,,1988,1948,,28367750,231526550,69564645,,17948748,157174623,45915763,,10419002,74351927,23648882,PDN
EI045,,1989,1948,,21792894,223153922,61499998,,18285006,167201083,48036088,,3507888,55952839,13463910,PDN
EI045,,1990,1948,,21820894,226624256,62145495,,18535807,175607014,49782607,,3285087,51017242,12362888,PDN
EI045,,1991,1948,,21596812,213355295,59560388,,18832800,180933152,51027311,,2764012,32422143,8533077,PDN
EI045,,1992,1948,,21626937,214262081,59751862,,19141200,186025279,52241783,,2485737,28236802,7510079,PDN
EI045,,1993,1948,,21640347,215468936,59980015,,19333548,191284337,53369907,,2306799,24184599,6610108,PDN
EI045,,1994,1948,,21687414,222904051,61350057,,19444093,196111605,54339396,,2243321,26792446,7010661,PDN
EI045,,1995,1948,,22971809,224116089,62850117,,19495262,199754462,55038761,,3476547,24361627,7811356,PDN
EI045,,1996,1948,,22331714,216289525,60817395,,19521639,200145496,55134717,,2810075,16144029,5682678,PDN
EI045,,1997,1948,,22549598,212137192,60296429,,19714295,201888170,55637457,,2835303,10249022,4658972,PDN
EI045,,1998,1948,,22693226,212291718,60467553,,19979154,203168625,56130155,,2714072,9123093,4337398,PDN
EI045,,1999,1948,,22791821,218208115,61618888,,20172359,207582381,57108726,,2619462,10625734,4510162,PDN
EI045,,2000,1948,,21205444,241272486,64136491,,20410589,214011949,58491007,,794855,27260537,5645484,PDN
EI045,,2001,1948,,21337080,253899427,66514914,,20633216,221584260,60061020,,703864,32315167,6453894,PDN
EI045,,2002,1948,,21337632,253941711,66522990,,20776562,229916465,61686965,,561070,24025246,4836025,PDN
EI045,,2003,1948,,21366767,258035715,67280595,,20860854,234378507,62565215,,505913,23657208,4715380,PDN
EI045,,2004,1948,,21439635,257098950,67186779,,20963434,240428475,63744301,,476201,16670475,3442478,PDN
EI045,,2005,1948,,21419307,257348977,67210939,,21094611,245516452,64780812,,324696,11832525,2430127,PDN
EI045,,2006,1948,,21419307,257348977,67210939,,21128814,247318150,65135602,,290493,10030827,2075337,PDN
EI045,,2007,1948,,21419307,257348977,67210939,,21133022,247759439,65218331,,286285,9589538,1992608,PDN
EI045,,2008,1948,,21187315,253000546,66205205,,21135651,247882214,65242807,,51664,5118332,962398,PDN
EI045,,2009,1948,,21188345,257130661,66941132,,21135718,251995959,65974857,,52627,5134702,966275,PDN
EI045,,2010,1948,,21167382,255243973,66584459,,21135718,251995959,65974857,,31664,3248014,609602,PDN
EI045,,2011,1948,,21167382,255243973,66584459,,21135718,251995959,65974857,,31664,3248014,609602,PDN
EI045,,2012,1948,,21167382,255243973,66584459,,21135718,251995959,65974857,,31664,3248014,609602,PDN
EI045,,2013,1948,,21167382,255243973,66584459,,21135718,251995959,65974857,,31664,3248014,609602,PDN
EI045,,2014,1948,,21167382,255243973,66584459,,21135718,251995959,65974857,,31664,3248014,609602,PDN
EI045,,2015,1948,,21135718,251995959,65974857,,21135718,251995959,65974857,,0,0,0,PDN
EI045,,2016,1948,,21135718,251995959,65974857,,21135718,251995959,65974857,,0,0,0,PDN
EI045,,2017,1948,,21135718,251995959,65974857,,21135718,251995959,65974857,,0,0,0,PDN
EI045,,2017,1948,,21135718,251995959,65974857,,21135718,251995959,65974857,,0,0,0,PDN
EI047,,1975,1955,,117124,12341000,2313031,,0,0,0,,117124,12341000,2313031,PDN
EI047,,1976,1955,,117124,12341000,2313031,,0,0,0,,117124,12341000,2313031,PDN
EI047,,1977,1955,,117124,12341000,2313031,,7566,521601,100378,,109558,11819399,2212653,PDN
EI047,,1978,1955,,232453,17573100,3359339,,59419,3337848,653342,,173034,14235252,2705997,PDN
EI047,,1979,1955,,332453,27573100,5238699,,102884,5632815,1105164,,229569,21940285,4133535,PDN
EI047,,1980,1955,,349453,29573100,5611570,,135243,7388497,1449922,,214210,22184603,4161648,PDN
EI047,,1981,1955,,628793,36693100,7157814,,176708,9388854,1847323,,452085,27304246,5310491,PDN
EI047,,1982,1955,,642793,37693100,7349750,,242205,11044378,2207397,,400588,26648722,5142353,PDN
EI047,,1983,1955,,1109524,28973123,6264884,,262668,11662745,2337890,,846856,17310378,3926994,PDN
EI047,,1984,1955,,1109524,28973123,6264884,,271526,12063624,2418078,,837998,16909499,3846806,PDN
EI047,,1985,1955,,1109524,28973123,6264884,,286388,12356908,2485126,,823136,16616215,3779758,PDN
EI047,,1986,1955,,291490,12513039,2518009,,289341,12459058,2506255,,2149,53981,11754,PDN
EI047,,1987,1955,,334445,15763802,3139392,,291513,13126425,2627176,,42932,2637377,512216,PDN
EI047,,1988,1955,,174685,8732971,1728594,,133285,6581241,1304324,,41400,2151730,424270,PDN
EI047,,1989,1955,,168960,10066835,1960212,,152956,8365346,1641452,,16004,1701489,318760,PDN
EI047,,1990,1955,,249101,17801097,3416556,,165813,9620710,1877683,,83288,8180387,1538873,PDN
EI047,,1991,1955,,351599,19432259,3809296,,223010,12747884,2491317,,128589,6684375,1317979,PDN
EI047,,1992,1955,,370085,21382232,4174753,,287830,18123663,3512681,,82255,3258569,662072,PDN
EI047,,1993,1955,,452133,32245384,6189746,,322181,22261478,4283298,,129952,9983906,1906448,PDN
EI047,,1994,1955,,452133,32245384,6189746,,343565,26134321,4993800,,108568,6111063,1195946,PDN
EI047,,1995,1955,,412022,37051968,7004899,,351472,27185720,5188789,,60550,9866248,1816110,PDN
EI047,,1996,1955,,393378,31002556,5909847,,356480,27560648,5260510,,36898,3441908,649337,PDN
EI047,,1997,1955,,514664,40356303,7695501,,395043,30318473,5789789,,119621,10037830,1905712,PDN
EI047,,1998,1955,,618631,47869364,9136311,,449641,34577385,6602201,,168990,13291979,2534110,PDN
EI047,,1999,1955,,685052,52554100,10036315,,516363,40286770,7684827,,168689,12267330,2351488,PDN
EI047,,2000,1955,,713238,61513941,11658779,,575984,46188392,8794559,,137254,15325549,2864220,PDN
EI047,,2001,1955,,730371,68250696,12874623,,652769,57116057,10815768,,77602,11134639,2058855,PDN
EI047,,2002,1955,,759675,71620696,13503571,,680523,62933924,11878730,,79152,8686772,1624841,PDN
EI047,,2003,1955,,771848,72570408,13684732,,699586,65826731,12412527,,72262,6743677,1272205,PDN
EI047,,2004,1955,,756025,72666006,13685919,,711853,68215260,12849800,,44172,4450746,836119,PDN
EI047,,2005,1955,,749414,72108937,13580186,,721640,69582986,13102954,,27774,2525951,477232,PDN
EI047,,2006,1955,,772521,74128789,13962697,,728741,70320633,13241309,,43780,3808156,721388,PDN
EI047,,2007,1955,,763369,73504779,13842511,,736252,71044753,13377667,,27117,2460026,464844,PDN
EI047,,2008,1955,,742927,71790864,13517102,,738357,71238277,13414207,,4570,552587,102895,PDN
EI047,,2009,1955,,743012,72465659,13637257,,741051,72223661,13592236,,1961,241998,45021,PDN
EI047,,2010,1955,,753985,73578775,13846293,,745598,72695356,13680714,,8387,883419,165579,PDN
EI047,,2011,1955,,753985,73578775,13846293,,748769,73030424,13743506,,5216,548351,102787,PDN
EI047,,2012,1955,,753985,73578775,13846293,,751006,73277375,13789685,,2979,301400,56609,PDN
EI047,,2013,1955,,753985,73578775,13846293,,752164,73418664,13815983,,1821,160111,30311,PDN
EI047,,2014,1955,,752869,73463547,13824674,,752869,73463547,13824674,,0,0,0,PDN
EI047,,2015,1955,,752869,73463547,13824674,,752869,73463547,13824674,,0,0,0,PDN
EI047,,2016,1955,,752869,73463547,13824674,,752869,73463547,13824674,,0,0,0,PDN
EI047,,2017,1955,,752869,73463547,13824674,,752869,73463547,13824674,,0,0,0,PDN
EI047,,2017,1955,,752869,73463547,13824674,,752869,73463547,13824674,,0,0,0,PDN
EI048,,1990,1990,,1637,16364551,2913479,,0,0,0,,1637,16364551,2913479,PDN
EI048,,1991,1990,,270042,16364551,3181884,,72435,4468555,867552,,197607,11895996,2314332,PDN
EI048,,1992,1990,,270042,16364551,3181884,,178877,13431858,2568887,,91165,2932693,612997,PDN
EI048,,1993,1990,,352504,29801219,5655212,,221449,20628602,3892019,,131055,9172617,1763193,PDN
EI048,,1994,1990,,400852,32256589,6140459,,265232,26338637,4951822,,135620,5917952,1188637,PDN
EI048,,1995,1990,,406298,40846100,7674287,,304025,30897589,5801817,,102273,9948511,1872470,PDN
EI048,,1996,1990,,406298,40846100,7674287,,321784,32943838,6183677,,84514,7902262,1490610,PDN
EI048,,1997,1990,,323119,33504254,6284730,,323119,33504254,6284730,,0,0,0,PDN
EI048,,1998,1990,,323119,33504254,6284730,,323119,33504254,6284730,,0,0,0,PDN
EI048,,1999,1990,,323119,33504254,6284730,,323119,33504254,6284730,,0,0,0,PDN
EI048,,2000,1990,,323119,33504254,6284730,,323119,33504254,6284730,,0,0,0,PDN
EI048,,2001,1990,,323119,33504254,6284730,,323119,33504254,6284730,,0,0,0,PDN
EI048,,2002,1990,,323119,33504254,6284730,,323119,33504254,6284730,,0,0,0,PDN
EI048,,2003,1990,,323119,33504254,6284730,,323119,33504254,6284730,,0,0,0,PDN
EI048,,2004,1990,,323119,33504254,6284730,,323119,33504254,6284730,,0,0,0,PDN
EI048,,2005,1990,,323119,33504254,6284730,,323119,33504254,6284730,,0,0,0,PDN
EI048,,2006,1990,,377149,38946958,7307213,,323119,33504254,6284730,,54030,5442704,1022483,PDN
EI048,,2007,1990,,377149,38946958,7307213,,333977,34756197,6518354,,43172,4190761,788859,PDN
EI048,,2008,1990,,362057,37600825,7052595,,338631,35565976,6667096,,23426,2034849,385499,PDN
EI048,,2009,1990,,362521,38311266,7179472,,354628,37662157,7056079,,7893,649109,123393,PDN
EI048,,2010,1990,,393373,41640316,7802681,,370645,39273238,7358765,,22728,2367078,443916,PDN
EI048,,2011,1990,,393373,41640316,7802681,,381663,40544517,7595989,,11710,1095799,206692,PDN
EI048,,2012,1990,,393373,41640316,7802681,,386365,41187584,7715116,,7008,452732,87565,PDN
EI048,,2013,1990,,393373,41640316,7802681,,387974,41327240,7741575,,5399,313076,61106,PDN
EI048,,2014,1990,,393373,41640316,7802681,,388400,41358570,7747576,,4973,281746,55106,PDN
EI048,,2015,1990,,388400,41358570,7747576,,388400,41358570,7747576,,0,0,0,PDN
EI048,,2016,1990,,388400,41358570,7747576,,388400,41358570,7747576,,0,0,0,PDN
EI048,,2017,1990,,388400,41358570,7747576,,388400,41358570,7747576,,0,0,0,PDN
EI048,,2017,1990,,388400,41358570,7747576,,388400,41358570,7747576,,0,0,0,PDN
EI053,,1975,1957,,145633,12862857,2434398,,123972,11422539,2156452,,21661,1440318,277946,PDP
EI053,,1976,1957,,145633,12862857,2434398,,125234,11625996,2193917,,20399,1236861,240481,PDP
EI053,,1977,1957,,145633,12862857,2434398,,131997,11983511,2264294,,13636,879346,170104,PDP
EI053,,1978,1957,,147899,13541144,2557355,,135757,12356289,2334385,,12142,1184855,222970,PDP
EI053,,1979,1957,,158359,13745722,2604217,,149027,13031327,2467768,,9332,714395,136449,PDP
EI053,,1980,1957,,173471,15095032,2859420,,152211,13312558,2520994,,21260,1782474,338426,PDP
EI053,,1981,1957,,173471,15095032,2859420,,155848,13647603,2584247,,17623,1447429,275173,PDP
EI053,,1982,1957,,173471,15095032,2859420,,159623,14003321,2651317,,13848,1091711,208103,PDP
EI053,,1983,1957,,2089814,18541053,5388934,,162820,14272586,2702426,,1926994,4268467,2686508,PDP
EI053,,1984,1957,,2878412,21696676,6739031,,166196,14549482,2755072,,2712216,7147194,3983959,PDP
EI053,,1985,1957,,2878412,21696676,6739031,,217815,15700924,3011574,,2660597,5995752,3727457,PDP
EI053,,1986,1957,,1641679,25804521,6233231,,407437,22618623,4432103,,1234242,3185898,1801128,PDP
EI053,,1987,1957,,725974,36936897,7298376,,497960,28703070,5605268,,228014,8233827,1693108,PDP
EI053,,1988,1957,,725974,36936897,7298376,,525215,32818827,6364864,,200759,4118070,933512,PDP
EI053,,1989,1957,,651028,41540065,8042499,,536781,35752761,6898482,,114247,5787304,1144017,PDP
EI053,,1990,1957,,902287,67420829,12898876,,566330,40374376,7750383,,335957,27046453,5148493,PDP
EI053,,1991,1957,,1030284,78226867,14949655,,647742,49479618,9451944,,382542,28747249,5497711,PDP
EI053,,1992,1957,,1063658,80336304,15358374,,707502,57103543,10868275,,356156,23232761,4490099,PDP
EI053,,1993,1957,,1355165,101768985,19463525,,810747,65581467,12480047,,544418,36187518,6983478,PDP
EI053,,1994,1957,,1423400,103088984,19766636,,879179,72085867,13705846,,544221,31003117,6060790,PDP
EI053,,1995,1957,,1086021,95293256,18042116,,907031,75694829,14375862,,178990,19598427,3666254,PDP
EI053,,1996,1957,,1283961,89631374,17232604,,965663,78220120,14883834,,318298,11411254,2348770,PDP
EI053,,1997,1957,,1918306,107487675,21044227,,1150535,85608840,16383425,,767771,21878835,4660802,PDP
EI053,,1998,1957,,2197808,128251612,25018380,,1479784,99850859,19246841,,718024,28400753,5771539,PDP
EI053,,1999,1957,,2706639,161838005,31503437,,1952629,125360232,24258720,,754010,36477773,7244717,PDP
EI053,,2000,1957,,2708193,164704770,32015092,,2179336,140694088,27213871,,528857,24010682,4801221,PDP
EI053,,2001,1957,,2782191,184979373,35696670,,2322317,151304476,29244822,,459874,33674897,6451848,PDP
EI053,,2002,1957,,2848128,185046788,35774603,,2450557,159474601,30826821,,397571,25572187,4947782,PDP
EI053,,2003,1957,,2970857,196428590,37922563,,2582702,171255141,33055147,,388155,25173449,4867416,PDP
EI053,,2004,1957,,2853875,193849309,37346635,,2658754,178149190,34357898,,195121,15700119,2988737,PDP
EI053,,2005,1957,,2902636,203969491,39196140,,2741952,184612796,35591204,,160684,19356695,3604936,PDP
EI053,,2006,1957,,3090529,212657544,40929950,,2843575,192244855,37050845,,246954,20412689,3879105,PDP
EI053,,2007,1957,,3135274,212770993,40994881,,2936341,199242457,38388735,,198933,13528536,2606146,PDP
EI053,,2008,1957,,3153246,214083805,41246450,,3009308,204272451,39356719,,143938,9811354,1889731,PDP
EI053,,2009,1957,,3309555,228126158,43901397,,3082625,211290230,40678751,,226930,16835928,3222648,PDP
EI053,,2010,1957,,3419422,228693452,44112205,,3172983,216740461,41738900,,246439,11952991,2373305,PDP
EI053,,2011,1957,,3419422,228693452,44112205,,3239974,220890184,42544276,,179448,7803268,1567929,PDP
EI053,,2012,1957,,3425209,228915136,44157438,,3300250,223470088,43063610,,124959,5445048,1093829,PDP
EI053,,2013,1957,,3425209,228915136,44157438,,3340913,225132878,43400143,,84296,3782258,757296,PDP
EI053,,2014,1957,,3452323,231514771,44647121,,3368240,226692518,43704986,,84083,4822253,942136,PDP
EI053,,2015,1957,,3449810,232394354,44801117,,3386641,228004156,43956774,,63169,4390198,844343,PDP
EI053,,2016,1957,,3449810,232394354,44801117,,3402745,229165520,44179526,,47065,3228834,621591,PDP
EI053,,2017,1957,,3472619,234596389,45215747,,3416254,230225623,44381666,,56365,4370766,834081,PDP
EI053,,2017,1957,,3472619,234596389,45215747,,3416254,230225623,44381666,,56365,4370766,834081,PDP
EI057,,1976,1974,,17500000,175000000,48638790,,0,0,0,,17500000,175000000,48638790,PDP
EI057,,1977,1974,,4313924,296774680,57120807,,0,0,0,,4313924,296774680,57120807,PDP
EI057,,1978,1974,,4313924,296774680,57120807,,0,0,0,,4313924,296774680,57120807,PDP
EI057,,1979,1974,,5354098,318946280,62106105,,381802,46569817,8668246,,4972296,272376463,53437859,PDP
EI057,,1980,1974,,5503761,357646830,69141987,,821390,104335595,19386442,,4682371,253311235,49755545,PDP
EI057,,1981,1974,,6687255,411399276,79889973,,1205453,161732353,29983452,,5481802,249666923,49906521,PDP
EI057,,1982,1974,,7874320,448931137,87755305,,1447014,203921206,37731926,,6427306,245009931,50023379,PDP
EI057,,1983,1974,,7924320,456278187,89112610,,1605242,232752175,43020220,,6319078,223526012,46092390,PDP
EI057,,1984,1974,,8068864,486188350,94579247,,1791173,270431522,49910661,,6277691,215756828,44668586,PDP
EI057,,1985,1974,,8305093,520469686,100915357,,1892799,289073614,53329385,,6412294,231396072,47585972,PDP
EI057,,1986,1974,,8305093,520469686,100915357,,1927912,297596882,54881094,,6377181,222872804,46034263,PDP
EI057,,1987,1974,,7402291,524900140,100800892,,2098114,327575905,60385642,,5304177,197324235,40415250,PDP
EI057,,1988,1974,,6895469,510473034,97726970,,2366481,377511341,69539317,,4528988,132961693,28187653,PDP
EI057,,1989,1974,,4458353,734416787,135137497,,2650560,432818553,79664537,,1807793,301598234,55472960,PDP
EI057,,1990,1974,,4508834,743152174,136742317,,2842762,477329808,87776892,,1666072,265822366,48965425,PDP
EI057,,1991,1974,,3968609,787031309,144009767,,2974748,517893071,95126540,,993861,269138238,48883227,PDP
EI057,,1992,1974,,3895764,760347792,139188965,,3051283,544396710,99919025,,844481,215951082,39269940,PDP
EI057,,1993,1974,,3922842,747944126,137008985,,3152265,563076074,103343737,,770577,184868052,33665248,PDP
EI057,,1994,1974,,3922842,747944126,137008985,,3173799,569805354,104562652,,749043,178138772,32446333,PDP
EI057,,1995,1974,,3324649,611766261,112179856,,3185036,573719462,105270350,,139613,38046799,6909506,PDP
EI057,,1996,1974,,3353036,617370103,113205367,,3195896,576482322,105772822,,157140,40887781,7432545,PDP
EI057,,1997,1974,,3353036,617370103,113205367,,3213584,579635748,106351617,,139452,37734355,6853750,PDP
EI057,,1998,1974,,3365265,618760500,113464998,,3228999,581991067,106786128,,136266,36769433,6678870,PDP
EI057,,1999,1974,,3308708,592032557,108652579,,3236209,582447425,106874541,,72499,9585132,1778038,PDP
EI057,,2000,1974,,3569715,620842060,114039833,,3287032,589929973,108256778,,282683,30912087,5783055,PDP
EI057,,2001,1974,,3713868,655556571,120360945,,3372780,602404241,110562147,,341088,53152330,9798798,PDP
EI057,,2002,1974,,3727117,656602685,120560335,,3432631,612809290,112473430,,294486,43793395,8086905,PDP
EI057,,2003,1974,,3735908,657897733,120799562,,3475341,619682984,113739217,,260567,38214749,7060345,PDP
EI057,,2004,1974,,3765218,658622061,120957756,,3536727,632081085,116006671,,228491,26540976,4951085,PDP
EI057,,2005,1974,,3906535,674661465,123953059,,3602649,640927067,117646611,,303886,33734398,6306448,PDP
EI057,,2006,1974,,3974624,685715249,125988014,,3695047,654587024,120169606,,279577,31128225,5818408,PDP
EI057,,2007,1974,,3971421,685050705,125866564,,3743164,661869638,121513562,,228257,23181067,4353002,PDP
EI057,,2008,1974,,3949544,683485158,125566120,,3762795,665412799,122163649,,186749,18072359,3402471,PDP
EI057,,2009,1974,,3954713,695606724,127728148,,3769147,677986606,124407329,,185566,17620118,3320818,PDP
EI057,,2010,1974,,4015537,702157664,128954619,,3797894,681286983,125023332,,217643,20870681,3931286,PDP
EI057,,2011,1974,,4015537,702157664,128954619,,3820360,683539031,125446519,,195177,18618633,3508100,PDP
EI057,,2012,1974,,4005250,700929194,128725744,,3854275,686723007,126046976,,150975,14206187,2678766,PDP
EI057,,2013,1974,,4001002,700579206,128659221,,3868103,688705857,126413626,,132899,11873349,2245594,PDP
EI057,,2014,1974,,4035310,705073274,129493186,,3891214,691794410,126986303,,144096,13278864,2506882,PDP
EI057,,2015,1974,,4076216,707010323,129878762,,3910213,694602660,127504990,,166003,12407663,2373772,PDP
EI057,,2016,1974,,4087632,709372168,130310435,,3936425,697299485,128011064,,151207,12072683,2299372,PDP
EI057,,2017,1974,,4105502,708716294,130211600,,3947907,697811899,128113723,,157595,10904395,2097879,PDP
EI057,,2017,1974,,4105502,708716294,130211600,,3947907,697811899,128113723,,157595,10904395,2097879,PDP
EI064,,1975,1969,,2688361,120915080,24203500,,0,0,0,,2688361,120915080,24203500,PDP
EI064,,1976,1969,,2688361,120915080,24203500,,0,0,0,,2688361,120915080,24203500,PDP
EI064,,1977,1969,,2688361,120915080,24203500,,0,0,0,,2688361,120915080,24203500,PDP
EI064,,1978,1969,,2688361,120915080,24203500,,627,43595,8384,,2687734,120871485,24195116,PDP
EI064,,1979,1969,,2980724,120915080,24495863,,71459,1982596,424234,,2909265,118932484,24071629,PDP
EI064,,1980,1969,,4019111,126915080,26601865,,138138,3991773,848418,,3880973,122923307,25753447,PDP
EI064,,1981,1969,,3405899,105148293,22115560,,238571,6626754,1417709,,3167328,98521539,20697851,PDP
EI064,,1982,1969,,3271484,105683329,22076347,,344793,9152271,1973311,,2926691,96531058,20103036,PDP
EI064,,1983,1969,,3460421,109665428,22973842,,419556,11682432,2498281,,3040865,97982996,20475561,PDP
EI064,,1984,1969,,3375099,109665428,22888520,,475995,13669926,2908366,,2899104,95995502,19980154,PDP
EI064,,1985,1969,,3466547,116576867,24209762,,525737,15336645,3254677,,2940810,101240222,20955085,PDP
EI064,,1986,1969,,3466547,116576867,24209762,,569857,16720557,3545045,,2896690,99856310,20664717,PDP
EI064,,1987,1969,,1194022,59286817,11743278,,642155,19079877,4037151,,551867,40206940,7706127,PDP
EI064,,1988,1969,,1194022,59286817,11743278,,722426,21574975,4561390,,471596,37711842,7181888,PDP
EI064,,1989,1969,,1194022,59286817,11743278,,831637,24711822,5228758,,362385,34574995,6514520,PDP
EI064,,1990,1969,,2077031,61589611,13036037,,1003031,29561419,6263070,,1074000,32028192,6772967,PDP
EI064,,1991,1969,,2077031,61589611,13036037,,1164765,34418199,7289000,,912266,27171412,5747037,PDP
EI064,,1992,1969,,2105932,64190679,13527761,,1323228,38947224,8253339,,782704,25243455,5274422,PDP
EI064,,1993,1969,,2194959,65586995,13865243,,1517500,45358217,9588357,,677459,20228778,4276886,PDP
EI064,,1994,1969,,2339208,70998815,14972449,,1711682,51755711,10920883,,627526,19243104,4051566,PDP
EI064,,1995,1969,,3091897,94227329,19858326,,1883651,56973629,12021307,,1208246,37253700,7837019,PDP
EI064,,1996,1969,,3077302,92178621,19479192,,1995028,60097167,12688474,,1082274,32081454,6790718,PDP
EI064,,1997,1969,,3758243,114682277,24164342,,2422764,73783192,15551446,,1335479,40899085,8612896,PDP
EI064,,1998,1969,,3951747,120612622,25413068,,3074566,99893655,20849238,,877181,20718967,4563830,PDP
EI064,,1999,1969,,4305778,151861973,31327482,,3470331,120574104,24924798,,835447,31287869,6402684,PDP
EI064,,2000,1969,,4691471,183240642,37296568,,3724761,134810586,27712410,,966710,48430056,9584158,PDP
EI064,,2001,1969,,4698079,183701435,37385167,,3926720,146282205,29955582,,771359,37419230,7429585,PDP
EI064,,2002,1969,,4725744,186235030,37863650,,4072739,155103857,31671290,,653005,31131173,6192360,PDP
EI064,,2003,1969,,5086294,205146736,41589272,,4226982,164831484,33556428,,859312,40315252,8032844,PDP
EI064,,2004,1969,,5135352,203984376,41431505,,4327985,170994697,34754088,,807367,32989679,6677417,PDP
EI064,,2005,1969,,5134216,204252788,41478129,,4419089,177320071,35970703,,715127,26932717,5507426,PDP
EI064,,2006,1969,,4869748,210518053,42328477,,4512976,184972561,37426243,,356772,25545492,4902234,PDP
EI064,,2007,1969,,4869748,210518053,42328477,,4590872,191733146,38707090,,278876,18784907,3621387,PDP
EI064,,2008,1969,,5014945,221189086,44372434,,4658331,197235009,39753528,,356614,23954077,4618906,PDP
EI064,,2009,1969,,5090613,225477774,45211214,,4717321,204631357,41128594,,373292,20846417,4082618,PDP
EI064,,2010,1969,,5093196,225596354,45234897,,4773996,209666866,42081268,,319200,15929488,3153627,PDP
EI064,,2011,1969,,5197067,230540617,46218530,,4815646,213711400,42842587,,381421,16829217,3375943,PDP
EI064,,2012,1969,,5219502,235229917,47075360,,4858445,217640360,43584489,,361057,17589557,3490871,PDP
EI064,,2013,1969,,5219502,235229917,47075360,,4895398,221398488,44290148,,324104,13831429,2785212,PDP
EI064,,2014,1969,,5209423,238877364,47714293,,4930658,224632101,44900784,,278765,14245263,2813508,PDP
EI064,,2015,1969,,5276530,242962818,48508349,,4961459,227312799,45408577,,315071,15650019,3099771,PDP
EI064,,2016,1969,,5276530,242962818,48508349,,4987209,229933230,45900595,,289321,13029588,2607752,PDP
EI064,,2017,1969,,5253629,244100332,48687852,,5023697,232804137,46447922,,229932,11296195,2239931,PDP
EI064,,2017,1969,,5253629,244100332,48687852,,5023697,232804137,46447922,,229932,11296195,2239931,PDP
EI070,,1991,1981,,538572,13033437,2857689,,770,18632,4085,,537802,13014805,2853604,PDN
EI070,,1992,1981,,538572,13033437,2857689,,127816,2793099,624809,,410756,10240338,2232880,PDN
EI070,,1993,1981,,538572,13033437,2857689,,244205,5612063,1242793,,294367,7421374,1614896,PDN
EI070,,1994,1981,,538572,13033437,2857689,,370370,8827094,1941027,,168202,4206343,916662,PDN
EI070,,1995,1981,,538572,13033437,2857689,,513956,12379520,2716718,,24616,653917,140971,PDN
EI070,,1996,1981,,699156,16919577,3709757,,645058,15936266,3480693,,54098,983311,229064,PDN
EI070,,1997,1981,,752937,18221083,3995123,,693659,17085913,3733857,,59278,1135170,261266,PDN
EI070,,1998,1981,,752937,18221083,3995123,,709775,17606917,3842678,,43162,614166,152445,PDN
EI070,,1999,1981,,806719,19522589,4280489,,721079,17963076,3917356,,85640,1559513,363133,PDN
EI070,,2000,1981,,729836,18221083,3972022,,723308,18057962,3936468,,6528,163121,35554,PDN
EI070,,2001,1981,,747932,18741685,4082751,,728124,18194563,3965591,,19808,547122,117160,PDN
EI070,,2002,1981,,747932,18741685,4082751,,738640,18509043,4032064,,9292,232642,50687,PDN
EI070,,2003,1981,,747932,18741685,4082751,,738692,18509668,4032227,,9240,232017,50524,PDN
EI070,,2004,1981,,738692,18509668,4032227,,738692,18509668,4032227,,0,0,0,PDN
EI070,,2005,1981,,738692,18509668,4032227,,738692,18509668,4032227,,0,0,0,PDN
EI070,,2006,1981,,738692,18509668,4032227,,738692,18509668,4032227,,0,0,0,PDN
EI070,,2007,1981,,738692,18509668,4032227,,738692,18509668,4032227,,0,0,0,PDN
EI070,,2008,1981,,738692,18509668,4032227,,738692,18509668,4032227,,0,0,0,PDN
EI070,,2009,1981,,738692,18859144,4094412,,738692,18859144,4094412,,0,0,0,PDN
EI070,,2010,1981,,738692,18859144,4094412,,738692,18859144,4094412,,0,0,0,PDN
EI070,,2011,1981,,738692,18859144,4094412,,738692,18859144,4094412,,0,0,0,PDN
EI070,,2012,1981,,738692,18859144,4094412,,738692,18859144,4094412,,0,0,0,PDN
EI070,,2013,1981,,738692,18859144,4094412,,738692,18859144,4094412,,0,0,0,PDN
EI070,,2014,1981,,738692,18859144,4094412,,738692,18859144,4094412,,0,0,0,PDN
EI070,,2015,1981,,738692,18859144,4094412,,738692,18859144,4094412,,0,0,0,PDN
EI070,,2016,1981,,738692,18859144,4094412,,738692,18859144,4094412,,0,0,0,PDN
EI070,,2017,1981,,738692,18859144,4094412,,738692,18859144,4094412,,0,0,0,PDN
EI070,,2017,1981,,738692,18859144,4094412,,738692,18859144,4094412,,0,0,0,PDN
EI071,,1996,1978,,546073,34020719,6599582,,14775,4380585,794239,,531298,29640134,5805343,PDN
EI071,,1997,1978,,546073,34020719,6599582,,234210,14707481,2851200,,311863,19313238,3748382,PDN
EI071,,1998,1978,,333127,27776236,5275518,,317138,19148538,3724351,,15989,8627698,1551167,PDN
EI071,,1999,1978,,384411,29364391,5609392,,379826,24040351,4657469,,4585,5324040,951923,PDN
EI071,,2000,1978,,759201,32210173,6490549,,480364,25274435,4977594,,278837,6935738,1512955,PDN
EI071,,2001,1978,,759134,32209661,6490390,,483485,25383212,5000071,,275649,6826449,1490319,PDN
EI071,,2002,1978,,759134,32209661,6490390,,520047,25517444,5060517,,239087,6692217,1429873,PDN
EI071,,2003,1978,,864253,30801576,6344960,,582061,27146511,5412401,,282192,3655065,932559,PDN
EI071,,2004,1978,,878982,30900819,6377348,,661975,28591840,5749491,,217007,2308979,627857,PDN
EI071,,2005,1978,,1062026,32280695,6805922,,753375,29850771,6064900,,308651,2429924,741022,PDN
EI071,,2006,1978,,1061638,32250744,6800205,,826046,30603844,6271570,,235592,1646900,528635,PDN
EI071,,2007,1978,,958428,31939776,6641662,,826321,30613138,6273499,,132107,1326638,368163,PDN
EI071,,2008,1978,,985876,32688445,6802325,,895020,31544151,6507858,,90856,1144294,294467,PDN
EI071,,2009,1978,,995325,33179000,6899062,,916229,32099686,6627918,,79096,1079314,271145,PDN
EI071,,2010,1978,,995325,33179000,6899062,,947558,32618140,6751498,,47767,560860,147564,PDN
EI071,,2011,1978,,995325,33179000,6899062,,948255,32644501,6756886,,47070,534499,142177,PDN
EI071,,2012,1978,,995325,33179000,6899062,,948255,32644501,6756886,,47070,534499,142177,PDN
EI071,,2013,1978,,948255,32644501,6756886,,948255,32644501,6756886,,0,0,0,PDN
EI071,,2014,1978,,948255,32644501,6756886,,948255,32644501,6756886,,0,0,0,PDN
EI071,,2015,1978,,948255,32644501,6756886,,948255,32644501,6756886,,0,0,0,PDN
EI071,,2016,1978,,948255,32644501,6756886,,948255,32644501,6756886,,0,0,0,PDN
EI071,,2017,1978,,948255,32644501,6756886,,948255,32644501,6756886,,0,0,0,PDN
EI071,,2017,1978,,948255,32644501,6756886,,948255,32644501,6756886,,0,0,0,PDN
EI074,,1975,1972,,1349019,110525750,21015523,,0,0,0,,1349019,110525750,21015523,PDN
EI074,,1976,1972,,1349019,110525750,21015523,,0,0,0,,1349019,110525750,21015523,PDN
EI074,,1977,1972,,1349019,110525750,21015523,,0,0,0,,1349019,110525750,21015523,PDN
EI074,,1978,1972,,1349019,110525750,21015523,,1284,74723,14580,,1347735,110451027,21000943,PDN
EI074,,1979,1972,,1349019,110525750,21015523,,154586,4471250,950182,,1194433,106054500,20065341,PDN
EI074,,1980,1972,,1349019,110525750,21015523,,339355,14070504,2843003,,1009664,96455246,18172520,PDN
EI074,,1981,1972,,1349019,110525750,21015523,,482264,21913242,4381417,,866755,88612508,16634106,PDN
EI074,,1982,1972,,1490433,117832910,22457143,,575757,26572859,5304024,,914676,91260051,17153119,PDN
EI074,,1983,1972,,1490433,117832910,22457143,,647984,29963884,5979636,,842449,87869026,16477507,PDN
EI074,,1984,1972,,1490433,117832910,22457143,,711381,33134248,6607155,,779052,84698662,15849988,PDN
EI074,,1985,1972,,1490433,117832910,22457143,,762201,36373284,7234316,,728232,81459626,15222827,PDN
EI074,,1986,1972,,1490433,117832910,22457143,,799294,38023111,7564972,,691139,79809799,14892171,PDN
EI074,,1987,1972,,1464729,121247484,23039014,,851278,41431393,8223412,,613451,79816091,14815602,PDN
EI074,,1988,1972,,1539548,127737820,24268697,,892655,44130533,8745063,,646893,83607287,15523634,PDN
EI074,,1989,1972,,1601022,80374182,15902478,,926147,46290501,9162891,,674875,34083681,6739587,PDN
EI074,,1990,1972,,1598902,80374182,15900358,,963556,48762680,9640189,,635346,31611502,6260169,PDN
EI074,,1991,1972,,1615345,81770202,16165203,,990372,50496560,9975525,,624973,31273642,6189678,PDN
EI074,,1992,1972,,1632219,87950485,17281771,,1027648,53944147,10626251,,604571,34006338,6655520,PDN
EI074,,1993,1972,,1632219,87950485,17281771,,1061544,57570051,11305325,,570675,30380434,5976446,PDN
EI074,,1994,1972,,1632238,87951473,17281966,,1088587,60127589,11787446,,543651,27823884,5494520,PDN
EI074,,1995,1972,,1660721,85794302,16926611,,1223770,68283519,13373862,,436951,17510783,3552749,PDN
EI074,,1996,1972,,2488411,106613452,21458776,,1392261,77152821,15120521,,1096150,29460631,6338255,PDN
EI074,,1997,1972,,2503265,105682593,21307997,,1535218,84816522,16627126,,968047,20866071,4680871,PDN
EI074,,1998,1972,,2015682,111038785,21773473,,1609067,90573897,17725419,,406615,20464888,4048054,PDN
EI074,,1999,1972,,2064138,121367504,23659780,,1641425,94474894,18451904,,422713,26892610,5207876,PDN
EI074,,2000,1972,,2115793,127062302,24724743,,1667115,97653431,19043170,,448678,29408871,5681573,PDN
EI074,,2001,1972,,2115793,127062302,24724743,,1687880,100345469,19542946,,427913,26716833,5181797,PDN
EI074,,2002,1972,,2135020,131448124,25524366,,1701993,102634613,19964380,,433027,28813511,5559986,PDN
EI074,,2003,1972,,2135020,131448124,25524366,,1713451,104397933,20289596,,421569,27050191,5234770,PDN
EI074,,2004,1972,,2031672,127508528,24720022,,1717811,105208104,20438114,,313861,22300424,4281908,PDN
EI074,,2005,1972,,2031672,127508528,24720022,,1721153,105815741,20549577,,310519,21692787,4170445,PDN
EI074,,2006,1972,,2632238,141157378,27749209,,1721153,105815741,20549577,,911085,35341637,7199632,PDN
EI074,,2007,1972,,2632238,141157378,27749209,,1780101,107196994,20854299,,852137,33960384,6894910,PDN
EI074,,2008,1972,,2632238,141157378,27749209,,1884318,109713180,21406236,,747920,31444198,6342973,PDN
EI074,,2009,1972,,2650443,143646100,28210248,,1970367,114353018,22317880,,680076,29293082,5892368,PDN
EI074,,2010,1972,,2650443,143646100,28210248,,2003946,116182812,22677045,,646497,27463288,5533203,PDN
EI074,,2011,1972,,2006743,116363749,22712038,,2006743,116363749,22712038,,0,0,0,PDN
EI074,,2012,1972,,2006743,116363749,22712038,,2006743,116363749,22712038,,0,0,0,PDN
EI074,,2013,1972,,2006743,116363749,22712038,,2006743,116363749,22712038,,0,0,0,PDN
EI074,,2014,1972,,2006743,116363749,22712038,,2006743,116363749,22712038,,0,0,0,PDN
EI074,,2015,1972,,2006743,116363749,22712038,,2006743,116363749,22712038,,0,0,0,PDN
EI074,,2016,1972,,2006743,116363749,22712038,,2006743,116363749,22712038,,0,0,0,PDN
EI074,,2017,1972,,2006743,116363749,22712038,,2006743,116363749,22712038,,0,0,0,PDN
EI074,,2017,1972,,2006743,116363749,22712038,,2006743,116363749,22712038,,0,0,0,PDN
EI077,,1975,1949,,2000000,80000000,16234875,,988156,45317537,9051775,,1011844,34682463,7183100,PDP
EI077,,1976,1949,,2000000,80000000,16234875,,1014225,48711016,9681666,,985775,31288984,6553209,PDP
EI077,,1977,1949,,2000000,80000000,16234875,,1062628,50899038,10119396,,937372,29100962,6115479,PDP
EI077,,1978,1949,,1293287,69568066,13671946,,1041732,51379993,10184080,,251555,18188073,3487866,PDP
EI077,,1979,1949,,980476,68557231,13179272,,771254,46954420,9126133,,209222,21602811,4053139,PDP
EI077,,1980,1949,,1019302,69157231,13324859,,799988,49204130,9555171,,219314,19953101,3769688,PDP
EI077,,1981,1949,,1111238,77049231,14821066,,827896,51978146,10076676,,283342,25071085,4744390,PDP
EI077,,1982,1949,,1490037,116324231,22188299,,860673,57198535,11038348,,629364,59125696,11149951,PDP
EI077,,1983,1949,,2572423,177887616,34225024,,932623,65140767,12523507,,1639800,112746849,21701517,PDP
EI077,,1984,1949,,3499599,197676678,38673385,,1377855,78872202,15412055,,2121744,118804476,23261330,PDP
EI077,,1985,1949,,4062371,209552456,41349285,,1757252,89174578,17624615,,2305119,120377878,23724670,PDP
EI077,,1986,1949,,4975565,233601729,46541709,,2325048,98011620,19764838,,2650517,135590109,26776871,PDP
EI077,,1987,1949,,5249691,246439405,49100119,,2678441,108981991,22070254,,2571250,137457414,27029865,PDP
EI077,,1988,1949,,5496756,249033013,49808680,,2891481,118708249,24013945,,2605275,130324764,25794735,PDP
EI077,,1989,1949,,5550206,215129148,43829414,,3177872,131757699,26622302,,2372334,83371449,17207112,PDP
EI077,,1990,1949,,5625362,218290410,44467072,,3432005,146285417,29461439,,2193357,72004993,15005633,PDP
EI077,,1991,1949,,5667877,229638249,46528775,,3567831,157051714,31512976,,2100046,72586535,15015799,PDP
EI077,,1992,1949,,5765243,241460912,48729818,,3742799,170466488,34074914,,2022444,70994424,14654904,PDP
EI077,,1993,1949,,5280661,269387155,53214318,,3923985,187298833,37251179,,1356676,82088322,15963139,PDP
EI077,,1994,1949,,5526078,277640459,54928295,,4097599,201758531,39997693,,1428479,75881928,14930602,PDP
EI077,,1995,1949,,5288764,271955867,53679488,,4310868,215652208,42683147,,977896,56303659,10996341,PDP
EI077,,1996,1949,,5472035,282671949,55769535,,4475091,228249555,45088891,,996944,54422394,10680644,PDP
EI077,,1997,1949,,5607596,291676998,57507418,,4605439,239705022,47257578,,1002157,51971976,10249840,PDP
EI077,,1998,1949,,5404708,276387820,54584035,,4698095,248063568,48837520,,706613,28324252,5746515,PDP
EI077,,1999,1949,,5718284,314327040,61648362,,4922324,264781482,52036467,,795960,49545558,9611895,PDP
EI077,,2000,1949,,5582824,301040200,59148696,,5083707,277210728,54409459,,499117,23829472,4739237,PDP
EI077,,2001,1949,,5668317,301100672,59244949,,5315107,285183194,56059448,,353210,15917478,3185501,PDP
EI077,,2002,1949,,5593070,304499654,59774503,,5385907,292225676,57383358,,207163,12273978,2391145,PDP
EI077,,2003,1949,,5735510,320672558,62794684,,5560254,305665241,59949087,,175256,15007317,2845597,PDP
EI077,,2004,1949,,5860628,331051709,64766626,,5645705,313428758,61415947,,214923,17622951,3350679,PDP
EI077,,2005,1949,,5860628,331050384,64766390,,5715499,319442884,62555870,,145129,11607500,2210520,PDP
EI077,,2006,1949,,6349288,338428570,66567895,,5933458,325549824,63860473,,415830,12878746,2707422,PDP
EI077,,2007,1949,,6349288,338428570,66567895,,6016402,330671384,64854727,,332886,7757186,1713168,PDP
EI077,,2008,1949,,6466239,346904131,68192953,,6073265,334330174,65562620,,392974,12573957,2630333,PDP
EI077,,2009,1949,,6510316,353059135,69332225,,6176450,344297940,67439429,,333866,8761195,1892797,PDP
EI077,,2010,1949,,6594076,359491895,70560605,,6226356,347854113,68122106,,367720,11637782,2438498,PDP
EI077,,2011,1949,,6607647,361663287,70960545,,6262822,351264185,68765348,,344825,10399102,2195199,PDP
EI077,,2012,1949,,6594927,365829011,71689057,,6302535,355031987,69475488,,292392,10797024,2213570,PDP
EI077,,2013,1949,,6528350,364061367,71307953,,6446524,359871942,70480677,,81826,4189425,827276,PDP
EI077,,2014,1949,,6735731,365111539,71702198,,6526867,361576634,70864347,,208864,3534905,837851,PDP
EI077,,2015,1949,,6608509,364084104,71392158,,6552209,362041909,70972478,,56300,2042195,419680,PDP
EI077,,2016,1949,,6605708,363404027,71268347,,6568013,362151689,71007815,,37695,1252338,260532,PDP
EI077,,2017,1949,,6576139,362186592,71022152,,6576139,362186592,71022152,,0,0,0,PDP
EI077,,2017,1949,,6576139,362186592,71022152,,6576139,362186592,71022152,,0,0,0,PDP
EI078,,1993,1991,,52953,4765813,900962,,10101,763649,145982,,42852,4002164,754980,PDN
EI078,,1994,1991,,52953,4765813,900962,,29962,2747012,518754,,22991,2018801,382208,PDN
EI078,,1995,1991,,52953,4765813,900962,,48601,4488555,847276,,4352,277258,53686,PDN
EI078,,1996,1991,,97845,9147490,1725512,,63001,6030869,1136109,,34844,3116621,589403,PDN
EI078,,1997,1991,,134073,11872177,2246560,,89085,8574447,1614787,,44988,3297730,631773,PDN
EI078,,1998,1991,,161401,14418668,2727000,,130645,13190439,2477698,,30756,1228229,249302,PDN
EI078,,1999,1991,,180909,18922988,3547989,,144051,14965517,2806954,,36858,3957471,741035,PDN
EI078,,2000,1991,,180909,18922988,3547989,,145300,15231709,2855569,,35609,3691279,692420,PDN
EI078,,2001,1991,,204769,21571415,4043099,,145300,15231709,2855569,,59469,6339706,1187530,PDN
EI078,,2002,1991,,217710,23357564,4373860,,148014,15591525,2922307,,69696,7766039,1451553,PDN
EI078,,2003,1991,,217710,23357564,4373860,,165289,17634897,3303171,,52421,5722667,1070689,PDN
EI078,,2004,1991,,184427,20709553,3869401,,171319,18708660,3500262,,13108,2000893,369139,PDN
EI078,,2005,1991,,176025,20425866,3810521,,173387,19312207,3609723,,2638,1113659,200798,PDN
EI078,,2006,1991,,175160,20807524,3877566,,174432,19685552,3677199,,728,1121972,200367,PDN
EI078,,2007,1991,,175103,20741605,3865780,,175103,20741605,3865780,,0,0,0,PDN
EI078,,2008,1991,,175103,20741605,3865780,,175103,20741605,3865780,,0,0,0,PDN
EI078,,2009,1991,,175103,20976591,3907593,,175103,20976591,3907593,,0,0,0,PDN
EI078,,2010,1991,,175103,20976591,3907593,,175103,20976591,3907593,,0,0,0,PDN
EI078,,2011,1991,,175103,20976591,3907593,,175103,20976591,3907593,,0,0,0,PDN
EI078,,2012,1991,,175103,20976591,3907593,,175103,20976591,3907593,,0,0,0,PDN
EI078,,2013,1991,,175103,20976591,3907593,,175103,20976591,3907593,,0,0,0,PDN
EI078,,2014,1991,,175103,20976591,3907593,,175103,20976591,3907593,,0,0,0,PDN
EI078,,2015,1991,,175103,20976591,3907593,,175103,20976591,3907593,,0,0,0,PDN
EI078,,2016,1991,,175103,20976591,3907593,,175103,20976591,3907593,,0,0,0,PDN
EI078,,2017,1991,,175103,20976591,3907593,,175103,20976591,3907593,,0,0,0,PDN
EI078,,2017,1991,,175103,20976591,3907593,,175103,20976591,3907593,,0,0,0,PDN
EI079,,1986,1984,,15828,1582751,297456,,77,595654,106065,,15751,987097,191391,PDN
EI079,,1987,1984,,888,4000000,712632,,405,1802175,321077,,483,2197825,391555,PDN
EI079,,1988,1984,,888,4000000,712632,,636,2851757,508066,,252,1148243,204566,PDN
EI079,,1989,1984,,658,2943751,524457,,658,2943751,524457,,0,0,0,PDN
EI079,,1990,1984,,658,2943751,524457,,658,2943751,524457,,0,0,0,PDN
EI079,,1991,1984,,658,2943751,524457,,658,2943751,524457,,0,0,0,PDN
EI079,,1992,1984,,658,2943751,524457,,658,2943751,524457,,0,0,0,PDN
EI079,,1993,1984,,658,2943751,524457,,658,2943751,524457,,0,0,0,PDN
EI079,,1994,1984,,658,2943751,524457,,658,2943751,524457,,0,0,0,PDN
EI079,,1995,1984,,658,2943751,524457,,658,2943751,524457,,0,0,0,PDN
EI079,,1996,1984,,658,2943751,524457,,658,2943751,524457,,0,0,0,PDN
EI079,,1997,1984,,658,2943751,524457,,658,2943751,524457,,0,0,0,PDN
EI079,,1998,1984,,658,2943751,524457,,658,2943751,524457,,0,0,0,PDN
EI079,,1999,1984,,658,2943751,524457,,658,2943751,524457,,0,0,0,PDN
EI079,,2000,1984,,658,2943751,524457,,658,2943751,524457,,0,0,0,PDN
EI079,,2001,1984,,658,2943751,524457,,658,2943751,524457,,0,0,0,PDN
EI079,,2002,1984,,658,2943751,524457,,658,2943751,524457,,0,0,0,PDN
EI079,,2003,1984,,658,2943751,524457,,658,2943751,524457,,0,0,0,PDN
EI079,,2004,1984,,658,2943751,524457,,658,2943751,524457,,0,0,0,PDN
EI079,,2005,1984,,658,2943751,524457,,658,2943751,524457,,0,0,0,PDN
EI079,,2006,1984,,658,2943751,524457,,658,2943751,524457,,0,0,0,PDN
EI079,,2007,1984,,658,2943751,524457,,658,2943751,524457,,0,0,0,PDN
EI079,,2008,1984,,658,2943751,524457,,658,2943751,524457,,0,0,0,PDN
EI079,,2009,1984,,658,3002708,534948,,658,3002708,534948,,0,0,0,PDN
EI079,,2010,1984,,658,3002708,534948,,658,3002708,534948,,0,0,0,PDN
EI079,,2011,1984,,658,3002708,534948,,658,3002708,534948,,0,0,0,PDN
EI079,,2012,1984,,658,3002708,534948,,658,3002708,534948,,0,0,0,PDN
EI079,,2013,1984,,658,3002708,534948,,658,3002708,534948,,0,0,0,PDN
EI079,,2014,1984,,658,3002708,534948,,658,3002708,534948,,0,0,0,PDN
EI079,,2015,1984,,658,3002708,534948,,658,3002708,534948,,0,0,0,PDN
EI079,,2016,1984,,658,3002708,534948,,658,3002708,534948,,0,0,0,PDN
EI079,,2017,1984,,658,3002708,534948,,658,3002708,534948,,0,0,0,PDN
EI079,,2017,1984,,658,3002708,534948,,658,3002708,534948,,0,0,0,PDN
EI085,,1985,1984,,4497663,18473221,7784713,,88931,327244,147159,,4408732,18145977,7637554,PDN
EI085,,1986,1984,,4497663,18473221,7784713,,336371,1274965,563233,,4161292,17198256,7221480,PDN
EI085,,1987,1984,,2188484,10835160,4116448,,380641,2204321,772869,,1807843,8630839,3343579,PDN
EI085,,1988,1984,,2252984,14076649,4757726,,399709,3204153,969843,,1853275,10872496,3787883,PDN
EI085,,1989,1984,,399709,3204153,969843,,399709,3204153,969843,,0,0,0,PDN
EI085,,1990,1984,,399709,3204153,969843,,399709,3204153,969843,,0,0,0,PDN
EI085,,1991,1984,,399709,3204153,969843,,399709,3204153,969843,,0,0,0,PDN
EI085,,1992,1984,,399709,3204153,969843,,399709,3204153,969843,,0,0,0,PDN
EI085,,1993,1984,,399709,3204153,969843,,399709,3204153,969843,,0,0,0,PDN
EI085,,1994,1984,,399709,3204153,969843,,399709,3204153,969843,,0,0,0,PDN
EI085,,1995,1984,,399709,3204153,969843,,399709,3204153,969843,,0,0,0,PDN
EI085,,1996,1984,,399709,3204153,969843,,399709,3204153,969843,,0,0,0,PDN
EI085,,1997,1984,,399709,3204153,969843,,399709,3204153,969843,,0,0,0,PDN
EI085,,1998,1984,,399709,3204153,969843,,399709,3204153,969843,,0,0,0,PDN
EI085,,1999,1984,,399709,3204153,969843,,399709,3204153,969843,,0,0,0,PDN
EI085,,2000,1984,,399709,3204153,969843,,399709,3204153,969843,,0,0,0,PDN
EI085,,2001,1984,,399709,3204153,969843,,399709,3204153,969843,,0,0,0,PDN
EI085,,2002,1984,,399709,3204153,969843,,399709,3204153,969843,,0,0,0,PDN
EI085,,2003,1984,,399709,3204153,969843,,399709,3204153,969843,,0,0,0,PDN
EI085,,2004,1984,,1485815,14942736,4144665,,399709,3204153,969843,,1086106,11738583,3174822,PDN
EI085,,2005,1984,,1565758,17792554,4731693,,808401,7435783,2131494,,757357,10356771,2600199,PDN
EI085,,2006,1984,,1793281,17792554,4959216,,980750,9733307,2712655,,812531,8059247,2246561,PDN
EI085,,2007,1984,,1793281,17792554,4959216,,1400808,11843118,3508124,,392473,5949436,1451092,PDN
EI085,,2008,1984,,2189727,19734497,5701203,,1792459,14474470,4367987,,397268,5260027,1333216,PDN
EI085,,2009,1984,,2109659,16948838,5125466,,2028706,16313704,4931501,,80953,635134,193967,PDN
EI085,,2010,1984,,2109659,16948838,5125466,,2104774,16896589,5111285,,4885,52249,14182,PDN
EI085,,2011,1984,,2109659,16948839,5125466,,2109659,16948839,5125466,,0,0,0,PDN
EI085,,2012,1984,,2109659,16948839,5125466,,2109659,16948839,5125466,,0,0,0,PDN
EI085,,2013,1984,,2109659,16948839,5125466,,2109659,16948839,5125466,,0,0,0,PDN
EI085,,2014,1984,,2109659,16948839,5125466,,2109659,16948839,5125466,,0,0,0,PDN
EI085,,2015,1984,,2109659,16948839,5125466,,2109659,16948839,5125466,,0,0,0,PDN
EI085,,2016,1984,,2109659,16948839,5125466,,2109659,16948839,5125466,,0,0,0,PDN
EI085,,2017,1984,,2109659,16948839,5125466,,2109659,16948839,5125466,,0,0,0,PDN
EI085,,2017,1984,,2109659,16948839,5125466,,2109659,16948839,5125466,,0,0,0,PDN
EI087,,1993,1993,,35685,3211665,607156,,0,0,0,,35685,3211665,607156,PDN
EI087,,1994,1993,,35685,3211665,607156,,0,0,0,,35685,3211665,607156,PDN
EI087,,1995,1993,,30972,2787486,526966,,7122,839318,156467,,23850,1948168,370499,PDN
EI087,,1996,1993,,144624,14993484,2812504,,71246,7186311,1349949,,73378,7807173,1462555,PDN
EI087,,1997,1993,,144624,14993484,2812504,,93985,9569714,1796781,,50639,5423770,1015723,PDN
EI087,,1998,1993,,144624,14993484,2812504,,105736,10795845,2026705,,38888,4197639,785799,PDN
EI087,,1999,1993,,144624,14993484,2812504,,121005,11657276,2195253,,23619,3336208,617251,PDN
EI087,,2000,1993,,231160,24220853,4540921,,147189,13507732,2550700,,83971,10713121,1990221,PDN
EI087,,2001,1993,,238794,24900246,4669443,,156458,14946900,2816049,,82336,9953346,1853394,PDN
EI087,,2002,1993,,238794,24900246,4669443,,159266,15752988,2962289,,79528,9147258,1707154,PDN
EI087,,2003,1993,,231476,25343736,4741038,,161584,16309834,3063690,,69892,9033902,1677348,PDN
EI087,,2004,1993,,231476,25343736,4741038,,161864,16365950,3073955,,69612,8977786,1667083,PDN
EI087,,2005,1993,,199705,23232966,4333685,,173813,17889219,3356948,,25892,5343747,976737,PDN
EI087,,2006,1993,,198850,23477869,4376407,,182575,19162616,3592293,,16275,4315253,784114,PDN
EI087,,2007,1993,,183914,19314038,3620576,,183914,19314038,3620576,,0,0,0,PDN
EI087,,2008,1993,,183914,19314038,3620576,,183914,19314038,3620576,,0,0,0,PDN
EI087,,2009,1993,,183914,19523528,3657852,,183914,19523528,3657852,,0,0,0,PDN
EI087,,2010,1993,,183914,19523528,3657852,,183914,19523528,3657852,,0,0,0,PDN
EI087,,2011,1993,,183914,19523528,3657852,,183914,19523528,3657852,,0,0,0,PDN
EI087,,2012,1993,,183914,19523528,3657852,,183914,19523528,3657852,,0,0,0,PDN
EI087,,2013,1993,,183914,19523528,3657852,,183914,19523528,3657852,,0,0,0,PDN
EI087,,2014,1993,,183914,19523528,3657852,,183914,19523528,3657852,,0,0,0,PDN
EI087,,2015,1993,,183914,19523528,3657852,,183914,19523528,3657852,,0,0,0,PDN
EI087,,2016,1993,,183914,19523528,3657852,,183914,19523528,3657852,,0,0,0,PDN
EI087,,2017,1993,,183914,19523528,3657852,,183914,19523528,3657852,,0,0,0,PDN
EI087,,2017,1993,,183914,19523528,3657852,,183914,19523528,3657852,,0,0,0,PDN
EI089,,1975,1949,,10000000,15000000,12669039,,5908344,8636897,7445158,,4091656,6363103,5223881,PDN
EI089,,1976,1949,,8000000,11000000,9957295,,6341686,8895758,7924561,,1658314,2104242,2032734,PDN
EI089,,1977,1949,,8000000,11000000,9957295,,6630827,9093630,8248911,,1369173,1906370,1708384,PDN
EI089,,1978,1949,,8000000,11000000,9957295,,6925831,9565943,8627956,,1074169,1434057,1329339,PDN
EI089,,1979,1949,,15264629,53250525,24739811,,7848956,27513881,12744664,,7415673,25736644,11995147,PDN
EI089,,1980,1949,,15419900,69845175,27847867,,8334517,30127187,13695226,,7085383,39717988,14152641,PDN
EI089,,1981,1949,,15646518,74732532,28944122,,8754294,31300483,14323775,,6892224,43432049,14620347,PDN
EI089,,1982,1949,,16946676,64981074,28509145,,9138652,32724734,14961558,,7808024,32256340,13547587,PDN
EI089,,1983,1949,,18050321,74489024,31304596,,9602483,35712755,15957066,,8447838,38776269,15347530,PDN
EI089,,1984,1949,,18933218,77142082,32659567,,10118595,37169654,16732412,,8814623,39972428,15927155,PDN
EI089,,1985,1949,,19350948,91127456,35565798,,10475941,38073004,17250497,,8875007,53054452,18315301,PDN
EI089,,1986,1949,,19496752,91873618,35844371,,10720441,39285688,17710777,,8776311,52587930,18133594,PDN
EI089,,1987,1949,,13084210,56481039,23134217,,10896850,42124225,18392264,,2187360,14356814,4741953,PDN
EI089,,1988,1949,,12306608,51858177,21534042,,11038985,44728087,18997719,,1267623,7130090,2536323,PDN
EI089,,1989,1949,,12538898,49631559,21370136,,11219567,45358380,19290453,,1319331,4273179,2079683,PDN
EI089,,1990,1949,,12573842,52983991,22001598,,11347891,45605692,19462783,,1225951,7378299,2538815,PDN
EI089,,1991,1949,,12678668,52856971,22083823,,11493896,45855817,19653294,,1184772,7001154,2430529,PDN
EI089,,1992,1949,,12680674,47781691,21182754,,11636202,46237751,19863560,,1044472,1543940,1319194,PDN
EI089,,1993,1949,,13293809,50154738,22218140,,11871798,47238038,20277143,,1422011,2916700,1940997,PDN
EI089,,1994,1949,,13393228,58791092,23854276,,12100995,48035744,20648280,,1292233,10755348,3205996,PDN
EI089,,1995,1949,,14203787,94761379,31065242,,12619713,60741853,23427872,,1584074,34019526,7637370,PDN
EI089,,1996,1949,,16015035,171086946,46457552,,13486069,94701503,30336870,,2528966,76385443,16120682,PDN
EI089,,1997,1949,,16080219,167975991,45969185,,14153558,123787940,36179882,,1926661,44188051,9789303,PDN
EI089,,1998,1949,,16389156,179438858,48317778,,14518859,143033073,39969584,,1870297,36405785,8348194,PDN
EI089,,1999,1949,,15274389,189113470,48924473,,14727306,160446860,43276569,,547083,28666610,5647904,PDN
EI089,,2000,1949,,22366246,224952059,62393303,,14946598,174325129,45965304,,7419648,50626930,16427999,PDN
EI089,,2001,1949,,22687267,223637716,62480455,,15186842,183554872,47847851,,7500425,40082844,14632604,PDN
EI089,,2002,1949,,23854147,236237675,65889321,,15459184,188357446,48974744,,8394963,47880229,16914577,PDN
EI089,,2003,1949,,24689893,245915489,68447098,,15936402,195487708,50720692,,8753491,50427781,17726406,PDN
EI089,,2004,1949,,24308385,245379785,67970269,,16404405,204928991,52868638,,7903980,40450794,15101631,PDN
EI089,,2005,1949,,24666862,245700339,68385784,,16627187,209691720,53938881,,8039675,36008619,14446903,PDN
EI089,,2006,1949,,24440275,250548750,69021903,,16820256,212801429,54685279,,7620019,37747321,14336624,PDN
EI089,,2007,1949,,24318210,250533835,68897184,,17169455,218514562,56051050,,7148755,32019273,12846134,PDN
EI089,,2008,1949,,24496237,248187366,68657690,,17324279,221352021,56710760,,7171958,26835345,11946930,PDN
EI089,,2009,1949,,22103770,242147300,65190485,,17560880,225643127,57710908,,4542890,16504173,7479576,PDN
EI089,,2010,1949,,22195599,247897577,66305496,,17802976,227972349,58367457,,4392623,19925228,7938040,PDN
EI089,,2011,1949,,22195599,247897577,66305496,,18045559,230252415,59015746,,4150040,17645162,7289749,PDN
EI089,,2012,1949,,22231644,247928152,66346981,,18260997,231577732,59467004,,3970647,16350420,6879975,PDN
EI089,,2013,1949,,22353718,248116293,66502532,,18406621,232713453,59814715,,3947097,15402840,6687817,PDN
EI089,,2014,1949,,22466878,249075808,66786424,,18523948,233075272,59996421,,3942930,16000536,6790002,PDN
EI089,,2015,1949,,22556007,248985321,66859451,,18571394,233304895,60084723,,3984613,15680426,6774724,PDN
EI089,,2016,1949,,20121698,236922324,62278698,,18571394,233304895,60084723,,1550304,3617429,2193975,PDN
EI089,,2017,1949,,18571394,233304895,60084723,,18571394,233304895,60084723,,0,0,0,PDN
EI089,,2017,1949,,18571394,233304895,60084723,,18571394,233304895,60084723,,0,0,0,PDN
EI098,,2000,2000,,99878,8989061,1699355,,11073,925190,175698,,88805,8063871,1523657,PDN
EI098,,2001,2000,,36162,3254529,615260,,21539,1489970,286658,,14623,1764559,328602,PDN
EI098,,2002,2000,,36162,3254529,615260,,28717,2079960,398817,,7445,1174569,216443,PDN
EI098,,2003,2000,,36162,3254529,615260,,28719,2079960,398819,,7443,1174569,216441,PDN
EI098,,2004,2000,,28719,2079960,398819,,28719,2079960,398819,,0,0,0,PDN
EI098,,2005,2000,,254893,10222225,2073794,,80884,3789527,755177,,174009,6432698,1318617,PDN
EI098,,2006,2000,,254893,10222225,2073794,,163243,6861020,1384065,,91650,3361205,689729,PDN
EI098,,2007,2000,,176216,7689014,1544368,,176216,7689014,1544368,,0,0,0,PDN
EI098,,2008,2000,,226612,13786982,2679812,,176216,7689014,1544368,,50396,6097968,1135444,PDN
EI098,,2009,2000,,227618,13908752,2702485,,198316,10334739,2037238,,29302,3574013,665247,PDN
EI098,,2010,2000,,227618,13908752,2702485,,209185,11783328,2305863,,18433,2125424,396622,PDN
EI098,,2011,2000,,227618,13908752,2702485,,215538,12705062,2476225,,12080,1203690,226260,PDN
EI098,,2012,2000,,227618,13908752,2702485,,216738,12862284,2505401,,10880,1046468,197084,PDN
EI098,,2013,2000,,216738,12862284,2505401,,216738,12862284,2505401,,0,0,0,PDN
EI098,,2014,2000,,216738,12862284,2505401,,216738,12862284,2505401,,0,0,0,PDN
EI098,,2015,2000,,216738,12862284,2505401,,216738,12862284,2505401,,0,0,0,PDN
EI098,,2016,2000,,216738,12862284,2505401,,216738,12862284,2505401,,0,0,0,PDN
EI098,,2017,2000,,216738,12862284,2505401,,216738,12862284,2505401,,0,0,0,PDN
EI098,,2017,2000,,216738,12862284,2505401,,216738,12862284,2505401,,0,0,0,PDN
EI100,,1975,1960,,20000000,120000000,41352313,,14355511,76415103,27952504,,5644489,43584897,13399809,PDP
EI100,,1976,1960,,17000000,83997000,31946085,,14887778,78491690,28854271,,2112222,5505310,3091814,PDP
EI100,,1977,1960,,17000000,83997000,31946085,,15253632,79829335,29458140,,1746368,4167665,2487945,PDP
EI100,,1978,1960,,16312744,93665498,32979203,,14341713,84164305,29317568,,1971031,9501193,3661635,PDP
EI100,,1979,1960,,16510447,100768312,34440752,,14819056,85862376,30097059,,1691391,14905936,4343693,PDP
EI100,,1980,1960,,17713525,112149099,37668881,,15581106,91034170,31779357,,2132419,21114929,5889524,PDP
EI100,,1981,1960,,19284484,119020347,40462482,,16621269,94341116,33407944,,2663215,24679231,7054538,PDP
EI100,,1982,1960,,20711003,120398435,42134212,,17306244,96426704,34464021,,3404759,23971731,7670191,PDP
EI100,,1983,1960,,23808795,134938380,47819183,,17986117,98885704,35581438,,5822678,36052676,12237745,PDP
EI100,,1984,1960,,25603916,152526691,52743897,,19337072,108363703,38618870,,6266844,44162988,14125027,PDP
EI100,,1985,1960,,26184422,171351220,56673963,,20451013,115036524,40920145,,5733409,56314696,15753818,PDP
EI100,,1986,1960,,28035918,188189003,61521506,,21332307,119101547,42524753,,6703611,69087456,18996753,PDP
EI100,,1987,1960,,28380495,193377633,62789326,,22034874,122419337,43817674,,6345621,70958296,18971652,PDP
EI100,,1988,1960,,29146861,193244331,63531973,,22734865,124670302,44918193,,6411996,68574029,18613780,PDP
EI100,,1989,1960,,29094516,192422298,63333359,,23426481,126412885,45919877,,5668035,66009413,17413482,PDP
EI100,,1990,1960,,28728624,150041798,55426453,,24131893,129945151,47253806,,4596731,20096647,8172647,PDP
EI100,,1991,1960,,28788186,148317289,55179163,,24735024,133359364,48464448,,4053162,14957925,6714715,PDP
EI100,,1992,1960,,29285689,155050117,56874678,,25330086,134684577,49295313,,3955603,20365540,7579365,PDP
EI100,,1993,1960,,31851323,180700170,64004378,,26314964,142982458,51756683,,5536359,37717712,12247695,PDP
EI100,,1994,1960,,32021743,195703185,66844374,,26980931,148030088,53320804,,5040812,47673097,13523570,PDP
EI100,,1995,1960,,32500713,209363903,69754077,,27698293,155233294,55319876,,4802420,54130609,14434201,PDP
EI100,,1996,1960,,32257792,200957692,68015388,,28241103,157843851,56327197,,4016689,43113841,11688191,PDP
EI100,,1997,1960,,32875231,230891317,73959095,,28862248,189723958,62620959,,4012983,41167359,11338136,PDP
EI100,,1998,1960,,33682353,241991438,76741328,,29489080,193627515,63942374,,4193273,48363923,12798954,PDP
EI100,,1999,1960,,31979879,211374549,69591009,,30109048,198090074,65356392,,1870831,13284475,4234617,PDP
EI100,,2000,1960,,33345121,214243003,71466652,,30482789,199693634,66015464,,2862332,14549369,5451188,PDP
EI100,,2001,1960,,33091804,208450370,70182617,,31083450,200796171,66812306,,2008354,7654199,3370311,PDP
EI100,,2002,1960,,33212548,210709889,70705411,,31570167,202650423,67628961,,1642381,8059466,3076450,PDP
EI100,,2003,1960,,33496962,219756926,72599618,,31946443,205892734,68582161,,1550519,13864192,4017457,PDP
EI100,,2004,1960,,33189460,218771947,72116853,,32302166,208865859,69466910,,887294,9906088,2649943,PDP
EI100,,2005,1960,,33545560,222370807,73113319,,32787194,212591676,70614894,,758366,9779131,2498425,PDP
EI100,,2006,1960,,33899331,221984295,73398316,,33103328,215211953,71397270,,796003,6772342,2001046,PDP
EI100,,2007,1960,,34022826,221858586,73499442,,33373656,216162320,71836702,,649170,5696266,1662740,PDP
EI100,,2008,1960,,37508560,234262245,79192233,,33930974,217460062,72624935,,3577586,16802183,6567298,PDP
EI100,,2009,1960,,37439569,234468609,79159963,,34667049,223330061,74405495,,2772520,11138548,4754466,PDP
EI100,,2010,1960,,38691388,235900629,80666589,,35241620,225476260,75361952,,3449768,10424369,5304637,PDP
EI100,,2011,1960,,38499208,236095227,80509037,,36057850,227554302,76547941,,2441358,8540925,3961095,PDP
EI100,,2012,1960,,38562936,236334411,80615327,,36847807,229711678,77721772,,1715129,6622733,2893551,PDP
EI100,,2013,1960,,38541030,236145345,80559778,,37529696,230771503,78592244,,1011334,5373842,1967534,PDP
EI100,,2014,1960,,38897856,236291694,80942642,,37892740,231271785,79044304,,1005116,5019909,1898338,PDP
EI100,,2015,1960,,38890993,236197533,80919023,,38072722,231512532,79267123,,818271,4685001,1651900,PDP
EI100,,2016,1960,,38942236,236270431,80983238,,38226445,231712330,79456399,,715791,4558101,1526841,PDP
EI100,,2017,1960,,39036167,236463386,81111503,,38392335,231953047,79665120,,643832,4510339,1446384,PDP
EI100,,2017,1960,,39036167,236463386,81111503,,38392335,231953047,79665120,,643832,4510339,1446384,PDP
EI108,,1980,1979,,3000000,90000000,19014235,,57,1373,301,,2999943,89998627,19013934,PDN
EI108,,1981,1979,,4300000,90000000,20314235,,293,6183,1393,,4299707,89993817,20312842,PDN
EI108,,1982,1979,,4300065,90001380,20314545,,65,1380,311,,4300000,90000000,20314234,PDN
EI108,,1983,1979,,1582918,68949854,13851575,,203007,6487569,1357379,,1379911,62462285,12494196,PDN
EI108,,1984,1979,,1856627,80510450,16182330,,747415,24480022,5103291,,1109212,56030428,11079039,PDN
EI108,,1985,1979,,5762179,194386802,40350578,,1157531,37136810,7765504,,4604648,157249992,32585074,PDN
EI108,,1986,1979,,5762279,197027831,40820612,,1710768,61688768,12687417,,4051511,135339063,28133195,PDN
EI108,,1987,1979,,5950495,207592215,42888612,,2076095,84700703,17147394,,3874400,122891512,25741218,PDN
EI108,,1988,1979,,6004969,220490706,45238191,,2426541,110321541,22056708,,3578428,110169165,23181483,PDN
EI108,,1989,1979,,5245256,242992264,48482314,,2751370,138171570,27337059,,2493886,104820694,21145255,PDN
EI108,,1990,1979,,5417808,270734956,53591288,,3097065,168216685,33028859,,2320743,102518271,20562429,PDN
EI108,,1991,1979,,5509828,281136614,55534137,,3280808,186512706,36468122,,2229020,94623908,19066015,PDN
EI108,,1992,1979,,5494919,274559090,54348850,,3456418,206310521,40166475,,2038501,68248569,14182375,PDN
EI108,,1993,1979,,4149966,281302332,54203762,,3538061,215327014,41852476,,611905,65975318,12351286,PDN
EI108,,1994,1979,,4149966,281302332,54203762,,3584914,220632173,42843308,,565052,60670159,11360454,PDN
EI108,,1995,1979,,4087351,263699472,51008965,,3634168,223895933,43473302,,453183,39803539,7535663,PDN
EI108,,1996,1979,,4222061,270778285,52403251,,3753447,230670684,44798053,,468614,40107601,7605198,PDN
EI108,,1997,1979,,4308339,246324263,48138279,,3913925,213903785,41975097,,394414,32420478,6163182,PDN
EI108,,1998,1979,,4686168,272958891,53255366,,4031383,223311408,43766509,,654785,49647483,9488857,PDN
EI108,,1999,1979,,4539422,280448670,54441321,,4205858,234064175,45854288,,333564,46384495,8587033,PDN
EI108,,2000,1979,,4673734,287832196,55889427,,4289941,239762965,46952390,,383793,48069231,8937037,PDN
EI108,,2001,1979,,4583628,292816887,56686277,,4348232,245870730,48097472,,235396,46946157,8588805,PDN
EI108,,2002,1979,,4633001,296241416,57344997,,4400662,251843953,49212753,,232339,44397463,8132244,PDN
EI108,,2003,1979,,4769127,307282777,59445777,,4526383,259828128,50759146,,242744,47454649,8686631,PDN
EI108,,2004,1979,,4689912,299772141,58030151,,4556216,263305367,51407705,,133696,36466774,6622446,PDN
EI108,,2005,1979,,4770336,303816659,58830240,,4569209,264956249,51714449,,201127,38860410,7115791,PDN
EI108,,2006,1979,,4937202,307020935,59567262,,4607549,267156521,52144297,,329653,39864414,7422965,PDN
EI108,,2007,1979,,4937202,307020935,59567262,,4695627,271618275,53026281,,241575,35402660,6540981,PDN
EI108,,2008,1979,,5025465,313440963,60797878,,4765001,273725852,53470669,,260464,39715111,7327209,PDN
EI108,,2009,1979,,5032729,295413942,57597488,,4776190,278845761,54392874,,256539,16568181,3204615,PDN
EI108,,2010,1979,,5032729,295413942,57597488,,4778411,279025524,54427082,,254318,16388418,3170407,PDN
EI108,,2011,1979,,5032729,295414827,57597645,,4807496,279992880,54628294,,225233,15421947,2969351,PDN
EI108,,2012,1979,,5148874,302883297,59042699,,4821932,280775595,54782003,,326942,22107702,4260696,PDN
EI108,,2013,1979,,5150412,304004755,59243785,,4855200,283931490,55376818,,295212,20073265,3866967,PDN
EI108,,2014,1979,,5150412,304004755,59243785,,4866893,286568446,55857721,,283519,17436309,3386064,PDN
EI108,,2015,1979,,4870508,287244803,55981685,,4870508,287244803,55981685,,0,0,0,PDN
EI108,,2016,1979,,4870508,287244803,55981685,,4870508,287244803,55981685,,0,0,0,PDN
EI108,,2017,1979,,4870508,287244803,55981685,,4870508,287244803,55981685,,0,0,0,PDN
EI108,,2017,1979,,4870508,287244803,55981685,,4870508,287244803,55981685,,0,0,0,PDN
EI113B,,2004,2004,,118047,1864352,449782,,29,0,29,,118018,1864352,449753,PDN
EI113B,,2005,2004,,118010,1863768,449641,,45937,710594,172377,,72073,1153174,277264,PDN
EI113B,,2006,2004,,338959,5105919,1247486,,141424,2066079,509054,,197535,3039840,738432,PDN
EI113B,,2007,2004,,338959,5105919,1247486,,223463,3459927,839108,,115496,1645992,408378,PDN
EI113B,,2008,2004,,338959,5105919,1247486,,229955,3693364,887137,,109004,1412555,360349,PDN
EI113B,,2009,2004,,344827,5193937,1269015,,238965,3881847,929685,,105862,1312090,339330,PDN
EI113B,,2010,2004,,239034,3882128,929804,,239034,3882128,929804,,0,0,0,PDN
EI113B,,2011,2004,,239034,3882128,929804,,239034,3882128,929804,,0,0,0,PDN
EI113B,,2012,2004,,239034,3882128,929804,,239034,3882128,929804,,0,0,0,PDN
EI113B,,2013,2004,,239034,3882128,929804,,239034,3882128,929804,,0,0,0,PDN
EI113B,,2014,2004,,239034,3882128,929804,,239034,3882128,929804,,0,0,0,PDN
EI113B,,2015,2004,,239034,3882128,929804,,239034,3882128,929804,,0,0,0,PDN
EI113B,,2016,2004,,239034,3882128,929804,,239034,3882128,929804,,0,0,0,PDN
EI113B,,2017,2004,,239034,3882128,929804,,239034,3882128,929804,,0,0,0,PDN
EI113B,,2017,2004,,239034,3882128,929804,,239034,3882128,929804,,0,0,0,PDN
EI117,,2004,2004,,6090,365416,71111,,0,0,0,,6090,365416,71111,PDN
EI117,,2005,2004,,6673,417719,81000,,6500,409251,79320,,173,8468,1680,PDN
EI117,,2006,2004,,6587,404151,78500,,6587,404151,78500,,0,0,0,PDN
EI117,,2007,2004,,6587,404151,78500,,6587,404151,78500,,0,0,0,PDN
EI117,,2008,2004,,6587,404151,78500,,6587,404151,78500,,0,0,0,PDN
EI117,,2009,2004,,6587,404151,78500,,6587,404151,78500,,0,0,0,PDN
EI117,,2010,2004,,6587,404151,78500,,6587,404151,78500,,0,0,0,PDN
EI117,,2011,2004,,6587,404151,78500,,6587,404151,78500,,0,0,0,PDN
EI117,,2012,2004,,6587,404151,78500,,6587,404151,78500,,0,0,0,PDN
EI117,,2013,2004,,6587,404151,78500,,6587,404151,78500,,0,0,0,PDN
EI117,,2014,2004,,6587,404151,78500,,6587,404151,78500,,0,0,0,PDN
EI117,,2015,2004,,6587,404151,78500,,6587,404151,78500,,0,0,0,PDN
EI117,,2016,2004,,6587,404151,78500,,6587,404151,78500,,0,0,0,PDN
EI117,,2017,2004,,6587,404151,78500,,6587,404151,78500,,0,0,0,PDN
EI117,,2017,2004,,6587,404151,78500,,6587,404151,78500,,0,0,0,PDN
EI123,,2005,2005,,195209,1281509,423236,,0,0,0,,195209,1281509,423236,PDP
EI123,,2006,2005,,195209,1281509,423236,,108659,816627,253966,,86550,464882,169270,PDP
EI123,,2007,2005,,554640,1728355,862176,,155612,1210811,371059,,399028,517544,491117,PDP
EI123,,2008,2005,,1033945,4354276,1808727,,297287,1486845,561850,,736658,2867431,1246877,PDP
EI123,,2009,2005,,1265061,4493812,2064672,,724475,3256728,1303963,,540586,1237084,760708,PDP
EI123,,2010,2005,,1265061,4493812,2064672,,951648,4015363,1666125,,313413,478449,398547,PDP
EI123,,2011,2005,,1265061,4493812,2064672,,1140924,4356953,1916183,,124137,136859,148489,PDP
EI123,,2012,2005,,1294493,4640443,2120195,,1200528,4424933,1987883,,93965,215510,132312,PDP
EI123,,2013,2005,,1294493,4640443,2120195,,1253560,4516123,2057141,,40933,124320,63054,PDP
EI123,,2014,2005,,1560422,5379075,2517553,,1343017,4756886,2189438,,217405,622189,328115,PDP
EI123,,2015,2005,,1552851,5417474,2516814,,1405232,4892333,2275754,,147619,525141,241060,PDP
EI123,,2016,2005,,1552851,5417474,2516814,,1447785,4993297,2336272,,105066,424177,180542,PDP
EI123,,2017,2005,,1562653,5143028,2477782,,1481242,5011423,2372954,,81411,131605,104829,PDP
EI123,,2017,2005,,1562653,5143028,2477782,,1481242,5011423,2372954,,81411,131605,104829,PDP
EI126,,1975,1950,,111500000,106460000,130443060,,90772000,91540000,107060256,,20728000,14920000,23382804,PDP
EI126,,1976,1950,,111500000,120005000,132853203,,93819334,112931029,113913823,,17680666,7073971,18939380,PDP
EI126,,1977,1950,,111500000,120005000,132853203,,96265867,116410446,116979469,,15234133,3594554,15873734,PDP
EI126,,1978,1950,,111500000,130035000,134637900,,98312700,119026939,119491871,,13187300,11008061,15146029,PDP
EI126,,1979,1950,,117540723,171783439,148107171,,101564410,124615011,123737900,,15976313,47168428,24369271,PDP
EI126,,1980,1950,,122932870,180153265,154988611,,103299194,127132696,125920670,,19633676,53020569,29067941,PDP
EI126,,1981,1950,,123427710,180832761,155604358,,104393309,129122787,127368894,,19034401,51709974,28235464,PDP
EI126,,1982,1950,,124065621,183272683,156676419,,105506086,131020805,128819396,,18559535,52251878,27857023,PDP
EI126,,1983,1950,,128602366,186198213,161733721,,106745960,132808313,130377332,,21856406,53389900,31356389,PDP
EI126,,1984,1950,,130422433,190778971,164368869,,107904567,134460168,131829864,,22517866,56318803,32539005,PDP
EI126,,1985,1950,,131986401,190729011,165923947,,108900118,135624247,133032546,,23086283,55104764,32891401,PDP
EI126,,1986,1950,,132921687,192062399,167096491,,110197686,136748794,134530212,,22724001,55313605,32566279,PDP
EI126,,1987,1950,,131113934,185753903,164166230,,111398593,138315101,136009821,,19715341,47438802,28156409,PDP
EI126,,1988,1950,,131870607,184078842,164624849,,112652150,139658348,137502390,,19218457,44420494,27122459,PDP
EI126,,1989,1950,,124132124,155174428,151743232,,114017822,140869582,139083584,,10114302,14304846,12659648,PDP
EI126,,1990,1950,,123978293,153396641,151273069,,115205840,141903813,140455629,,8772453,11492828,10817440,PDP
EI126,,1991,1950,,126988758,164434220,156247516,,116640819,144525706,142357137,,10347939,19908514,13890379,PDP
EI126,,1992,1950,,125617003,162914179,154605291,,118011668,146401742,144061800,,7605335,16512437,10543491,PDP
EI126,,1993,1950,,129323628,170958245,159743245,,119294540,149443214,145885859,,10029088,21515031,13857386,PDP
EI126,,1994,1950,,129715464,171137557,160166987,,120542353,152946593,147757049,,9173111,18190964,12409938,PDP
EI126,,1995,1950,,129475304,169787910,159686676,,121655207,155847744,149386122,,7820097,13940166,10300554,PDP
EI126,,1996,1950,,128243656,168447536,158216527,,122449514,158137223,150587810,,5794142,10310313,7628717,PDP
EI126,,1997,1950,,129268514,183484787,161917053,,123438631,162418090,152338647,,5829883,21066697,9578406,PDP
EI126,,1998,1950,,130750262,185002343,163668828,,124787000,168637034,154793590,,5963262,16365309,8875238,PDP
EI126,,1999,1950,,132682857,185853402,165752857,,126675221,173208337,157495210,,6007636,12645065,8257647,PDP
EI126,,2000,1950,,138992949,232793434,180415269,,128674378,182821242,161204848,,10318571,49972192,19210421,PDP
EI126,,2001,1950,,138155654,218348562,177007712,,130118137,198882369,165506459,,8037517,19466193,11501253,PDP
EI126,,2002,1950,,139067219,225827496,179250048,,131122426,204891071,167579912,,7944793,20936425,11670136,PDP
EI126,,2003,1950,,140678331,231560466,181881261,,133097233,210515878,170555574,,7581098,21044588,11325687,PDP
EI126,,2004,1950,,141508604,228058175,182088351,,134287300,213313254,172243395,,7221304,14744921,9844956,PDP
EI126,,2005,1950,,141182028,226261236,181442035,,135312990,215695732,173693013,,5869038,10565504,7749022,PDP
EI126,,2006,1950,,142066238,226726528,182409037,,136178794,217019942,174794442,,5887444,9706586,7614595,PDP
EI126,,2007,1950,,142415406,232326951,183754721,,136865776,218254064,175701019,,5549630,14072887,8053702,PDP
EI126,,2008,1950,,142780170,233058678,184249686,,137438308,220915284,176747077,,5341862,12143394,7502609,PDP
EI126,,2009,1950,,143019761,236701914,185137541,,137935433,225625250,178082274,,5084328,11076664,7055266,PDP
EI126,,2010,1950,,144277452,238431009,186702899,,138592887,228682800,179283779,,5684565,9748209,7419124,PDP
EI126,,2011,1950,,144297820,238477642,186731564,,139065566,229663145,179930895,,5232254,8814497,6800670,PDP
EI126,,2012,1950,,144336505,239123688,186885204,,139532095,230568289,180558482,,4804410,8555399,6326725,PDP
EI126,,2013,1950,,144492377,239614479,187128406,,139785912,231083351,180903950,,4706465,8531128,6224456,PDP
EI126,,2014,1950,,144890054,241141222,187797746,,140223124,232085661,181519508,,4666930,9055561,6278235,PDP
EI126,,2015,1950,,145373521,242059288,188444571,,140601679,233137857,182085289,,4771842,8921431,6359282,PDP
EI126,,2016,1950,,145646869,242916665,188870478,,140936901,233804948,182539210,,4709968,9111717,6331266,PDP
EI126,,2017,1950,,145844370,243146823,189108932,,141192761,234501020,182918930,,4651609,8645803,6190005,PDP
EI126,,2017,1950,,145844370,243146823,189108932,,141192761,234501020,182918930,,4651609,8645803,6190005,PDP
EI128,,1975,1955,,43000000,70004000,55456228,,35591665,57426050,45809823,,7408335,12577950,9646405,PDN
EI128,,1976,1955,,43000000,70004000,55456228,,36686636,58681292,47128147,,6313364,11322708,8328081,PDN
EI128,,1977,1955,,43000000,70004000,55456228,,37546877,59922470,48209238,,5453123,10081530,7246990,PDN
EI128,,1978,1955,,43000000,70004000,55456228,,38384987,60806172,49204591,,4615013,9197828,6251637,PDN
EI128,,1979,1955,,50655295,97773285,68052677,,43807766,71762963,56576976,,6847529,26010322,11475701,PDN
EI128,,1980,1955,,54318025,101470283,72373235,,45572492,74501934,58829064,,8745533,26968349,13544171,PDN
EI128,,1981,1955,,55603399,102963056,73924227,,46403614,75270848,59797003,,9199785,27692208,14127224,PDN
EI128,,1982,1955,,56057505,103460092,74466774,,47300659,76206490,60860533,,8756846,27253602,13606241,PDN
EI128,,1983,1955,,56463259,103906597,74951977,,47981637,76916644,61667873,,8481622,26989953,13284104,PDN
EI128,,1984,1955,,58378711,106165316,77269337,,48750229,77624230,62562370,,9628482,28541086,14706967,PDN
EI128,,1985,1955,,58759870,106507262,77711340,,49250185,78210592,63166660,,9509685,28296670,14544680,PDN
EI128,,1986,1955,,62900004,113134735,83030740,,49905214,78929640,63949634,,12994790,34205095,19081106,PDN
EI128,,1987,1955,,65555844,114104433,85859124,,51623661,80709562,65984793,,13932183,33394871,19874331,PDN
EI128,,1988,1955,,67822745,117730813,88771288,,53094202,82763384,67820783,,14728543,34967429,20950505,PDN
EI128,,1989,1955,,68958757,119586482,90237490,,54459594,84550411,69504151,,14499163,35036071,20733339,PDN
EI128,,1990,1955,,66339921,101394123,84381580,,55463569,86272148,70814485,,10876352,15121975,13567095,PDN
EI128,,1991,1955,,68052954,104798014,86700287,,56451498,87547819,72029402,,11601456,17250195,14670885,PDN
EI128,,1992,1955,,67707959,103408084,86107974,,57624287,89573818,73562689,,10083672,13834266,12545285,PDN
EI128,,1993,1955,,67183359,102654928,85449360,,58346471,90426372,74436573,,8836888,12228556,11012787,PDN
EI128,,1994,1955,,68003993,105280620,86737199,,59055995,91263487,75295050,,8947998,14017133,11442149,PDN
EI128,,1995,1955,,66540478,100931794,84499872,,59634568,91806685,75970277,,6905910,9125109,8529595,PDN
EI128,,1996,1955,,67265798,102027543,85420165,,60063803,92311659,76489365,,7201995,9715884,8930800,PDN
EI128,,1997,1955,,65880880,105309699,84619261,,60486033,93522488,77127045,,5394847,11787211,7492216,PDN
EI128,,1998,1955,,65472548,102905121,83783068,,60854444,94550929,77678453,,4618104,8354192,6104615,PDN
EI128,,1999,1955,,64429596,100939375,82390339,,61195912,95406421,78172143,,3233684,5532954,4218196,PDN
EI128,,2000,1955,,64950371,104531443,83550272,,61624205,96048721,78714725,,3326166,8482722,4835547,PDN
EI128,,2001,1955,,65050849,105526279,83827767,,62393649,97222251,79692982,,2657200,8304028,4134785,PDN
EI128,,2002,1955,,65546191,106098874,84424994,,62881659,98007207,80320664,,2664532,8091667,4104330,PDN
EI128,,2003,1955,,65546191,106098874,84424994,,63192580,98380736,80698049,,2353611,7718138,3726945,PDN
EI128,,2004,1955,,65248722,105803556,84074977,,63398465,98593475,80941788,,1850257,7210081,3133189,PDN
EI128,,2005,1955,,65120214,105309382,83858538,,63524409,98723690,81090902,,1595805,6585692,2767636,PDN
EI128,,2006,1955,,65399413,106233465,84302165,,63649781,99031199,81270991,,1749632,7202266,3031174,PDN
EI128,,2007,1955,,65399413,106233778,84302220,,63759725,99518201,81467590,,1639688,6715577,2834630,PDN
EI128,,2008,1955,,65476745,106282546,84388230,,63819734,99744772,81567914,,1657011,6537774,2820316,PDN
EI128,,2009,1955,,65317128,108135551,84558330,,63880078,101852198,82003244,,1437050,6283353,2555085,PDN
EI128,,2010,1955,,65197815,108140534,84439904,,63884426,101862689,82009458,,1313389,6277845,2430445,PDN
EI128,,2011,1955,,63884426,101862689,82009458,,63884426,101862689,82009458,,0,0,0,PDN
EI128,,2012,1955,,63884426,101862689,82009458,,63884426,101862689,82009458,,0,0,0,PDN
EI128,,2013,1955,,63884426,101862689,82009458,,63884426,101862689,82009458,,0,0,0,PDN
EI128,,2014,1955,,63884426,101862689,82009458,,63884426,101862689,82009458,,0,0,0,PDN
EI128,,2015,1955,,63884426,101862689,82009458,,63884426,101862689,82009458,,0,0,0,PDN
EI128,,2016,1955,,63884426,101862689,82009458,,63884426,101862689,82009458,,0,0,0,PDN
EI128,,2017,1955,,63884426,101862689,82009458,,63884426,101862689,82009458,,0,0,0,PDN
EI128,,2017,1955,,63884426,101862689,82009458,,63884426,101862689,82009458,,0,0,0,PDN
EI136,,1979,1977,,0,30000000,5338078,,0,0,0,,0,30000000,5338078,PDP
EI136,,1980,1977,,32000,32000000,5725950,,0,0,0,,32000,32000000,5725950,PDP
EI136,,1981,1977,,32000,32000000,5725950,,11602,304498,65783,,20398,31695502,5660167,PDP
EI136,,1982,1977,,1490640,70794000,14087437,,72645,1997291,428035,,1417995,68796709,13659402,PDP
EI136,,1983,1977,,1458640,38794000,8361487,,72645,1997291,428035,,1385995,36796709,7933452,PDP
EI136,,1984,1977,,1458640,38794000,8361487,,72645,1997291,428035,,1385995,36796709,7933452,PDP
EI136,,1985,1977,,1458640,38794000,8361487,,116012,3292157,701805,,1342628,35501843,7659682,PDP
EI136,,1986,1977,,1458640,38794000,8361487,,235485,7004187,1481782,,1223155,31789813,6879705,PDP
EI136,,1987,1977,,1458640,38794000,8361487,,354713,10348911,2196156,,1103927,28445089,6165331,PDP
EI136,,1988,1977,,1458640,38794000,8361487,,468738,13735282,2912738,,989902,25058718,5448749,PDP
EI136,,1989,1977,,1458640,38794000,8361487,,596297,17709721,3747493,,862343,21084279,4613994,PDP
EI136,,1990,1977,,1742372,57288441,11936045,,717828,22057380,4642629,,1024544,35231061,7293416,PDP
EI136,,1991,1977,,1742372,57288441,11936045,,840932,26052425,5476595,,901440,31236016,6459450,PDP
EI136,,1992,1977,,1742372,57288441,11936045,,963659,30416457,6375840,,778713,26871984,5560205,PDP
EI136,,1993,1977,,1742372,57288441,11936045,,1147142,36084759,7567918,,595230,21203682,4368127,PDP
EI136,,1994,1977,,1742372,57288441,11936045,,1325751,41655070,8737685,,416621,15633371,3198360,PDP
EI136,,1995,1977,,2831145,90359829,18909406,,1449211,46701325,9759055,,1381934,43658504,9150351,PDP
EI136,,1996,1977,,2831145,90359829,18909406,,1585442,51092119,10676566,,1245703,39267710,8232840,PDP
EI136,,1997,1977,,3258818,100666290,21170969,,1807086,56126560,11794018,,1451732,44539730,9376951,PDP
EI136,,1998,1977,,4341987,131266401,27698998,,2375312,72721319,15315048,,1966675,58545082,12383950,PDP
EI136,,1999,1977,,6185536,176241521,37545237,,3140383,92298502,19563604,,3045153,83943019,17981633,PDP
EI136,,2000,1977,,6891955,196173581,41798286,,3762945,107870810,22957039,,3129010,88302771,18841247,PDP
EI136,,2001,1977,,7696046,214460726,45856318,,4661956,132087307,28165036,,3034090,82373419,17691282,PDP
EI136,,2002,1977,,7334177,210324698,44758501,,5149127,145149724,30976480,,2185050,65174974,13782021,PDP
EI136,,2003,1977,,7334177,210324698,44758501,,5539597,156770737,33434746,,1794580,53553961,11323755,PDP
EI136,,2004,1977,,6792326,194950369,41481004,,5845306,167488453,35647522,,947020,27461916,5833482,PDP
EI136,,2005,1977,,6792326,194950369,41481004,,6082117,177145451,37602660,,710209,17804918,3878344,PDP
EI136,,2006,1977,,6792326,194950369,41481004,,6157732,180538067,38281943,,634594,14412302,3199061,PDP
EI136,,2007,1977,,6792326,194950369,41481004,,6350117,186783598,39585633,,442209,8166771,1895371,PDP
EI136,,2008,1977,,6756387,201865542,42675523,,6473310,191060799,40469893,,283077,10804743,2205630,PDP
EI136,,2009,1977,,6863410,205200800,43376008,,6549448,195068770,41259193,,313962,10132030,2116814,PDP
EI136,,2010,1977,,6863410,205200800,43376008,,6613485,197362672,41731398,,249925,7838128,1644609,PDP
EI136,,2011,1977,,6863410,205200800,43376008,,6655677,199247889,42109037,,207733,5952911,1266969,PDP
EI136,,2012,1977,,6863410,205200800,43376008,,6689332,200870304,42431378,,174078,4330496,944630,PDP
EI136,,2013,1977,,6803536,204390948,43172031,,6715541,202355023,42721773,,87995,2035925,450259,PDP
EI136,,2014,1977,,7189749,214505937,45358064,,6790652,204410771,43162673,,399097,10095166,2195390,PDP
EI136,,2015,1977,,7068185,216866630,45656553,,6829226,205636077,43419274,,238959,11230553,2237278,PDP
EI136,,2016,1977,,7102883,216866630,45691251,,6902230,208721922,44041361,,200653,8144708,1649890,PDP
EI136,,2017,1977,,7169107,218157385,45987147,,6967022,211101710,44529604,,202085,7055675,1457543,PDP
EI136,,2017,1977,,7169107,218157385,45987147,,6967022,211101710,44529604,,202085,7055675,1457543,PDP
EI143,,2002,2002,,829859,17964967,4026472,,0,0,0,,829859,17964967,4026472,PDN
EI143,,2003,2002,,829859,17964967,4026472,,158234,3211402,729658,,671625,14753565,3296814,PDN
EI143,,2004,2002,,1209153,29149800,6395950,,453933,9984897,2230605,,755220,19164903,4165345,PDN
EI143,,2005,2002,,1209153,29149800,6395950,,674535,16023434,3525680,,534618,13126366,2870270,PDN
EI143,,2006,2002,,1075036,28074461,6070492,,761927,19761431,4278196,,313109,8313030,1792296,PDN
EI143,,2007,2002,,1075036,28074461,6070492,,820366,22272714,4783482,,254670,5801747,1287010,PDN
EI143,,2008,2002,,1075036,28074461,6070492,,853815,23819909,5092233,,221221,4254552,978259,PDN
EI143,,2009,2002,,1178426,31595309,6800368,,909302,25130891,5380991,,269124,6464418,1419377,PDN
EI143,,2010,2002,,1178426,31595309,6800368,,1050792,28081621,6047522,,127634,3513688,752846,PDN
EI143,,2011,2002,,1178426,31595309,6800368,,1108923,29958131,6439552,,69503,1637178,360816,PDN
EI143,,2012,2002,,1178426,31595309,6800368,,1109664,29988204,6445643,,68762,1607105,354723,PDN
EI143,,2013,2002,,1109664,29988204,6445643,,1109664,29988204,6445643,,0,0,0,PDN
EI143,,2014,2002,,1109664,29988204,6445643,,1109664,29988204,6445643,,0,0,0,PDN
EI143,,2015,2002,,1109664,29988204,6445643,,1109664,29988204,6445643,,0,0,0,PDN
EI143,,2016,2002,,1109664,29988204,6445643,,1109664,29988204,6445643,,0,0,0,PDN
EI143,,2017,2002,,1109664,29988204,6445643,,1109664,29988204,6445643,,0,0,0,PDN
EI143,,2017,2002,,1109664,29988204,6445643,,1109664,29988204,6445643,,0,0,0,PDN
EI147,,1984,1982,,491548,4478991,1288521,,0,0,0,,491548,4478991,1288521,PDN
EI147,,1985,1982,,491548,4478991,1288521,,0,0,0,,491548,4478991,1288521,PDN
EI147,,1986,1982,,491548,4478991,1288521,,0,0,0,,491548,4478991,1288521,PDN
EI147,,1987,1982,,1452923,19272264,4882151,,5520,144562,31243,,1447403,19127702,4850908,PDN
EI147,,1988,1982,,542160,10409469,2394379,,179779,3454825,794517,,362381,6954644,1599862,PDN
EI147,,1989,1982,,542160,10409469,2394379,,303925,5941226,1361083,,238235,4468243,1033296,PDN
EI147,,1990,1982,,542160,10409469,2394379,,380623,7269771,1674177,,161537,3139698,720202,PDN
EI147,,1991,1982,,5231856,23983732,9499424,,769769,7113200,2035463,,4462087,16870532,7463961,PDN
EI147,,1992,1982,,5818627,38676898,12700637,,1715201,18121619,4939688,,4103426,20555279,7760949,PDN
EI147,,1993,1982,,3726073,28359953,8772328,,2032536,19643025,5527736,,1693537,8716928,3244592,PDN
EI147,,1994,1982,,3808098,35743334,10168122,,2322004,22138290,6261202,,1486094,13605044,3906920,PDN
EI147,,1995,1982,,3355220,30295846,8745940,,2498736,24418257,6843622,,856484,5877589,1902318,PDN
EI147,,1996,1982,,3023431,30123074,8383409,,2628523,25229726,7117798,,394908,4893348,1265611,PDN
EI147,,1997,1982,,3050023,30166678,8417759,,2659177,25518422,7199821,,390846,4648256,1217938,PDN
EI147,,1998,1982,,2936447,28032505,7924437,,2662347,25787342,7250842,,274100,2245163,673595,PDN
EI147,,1999,1982,,2975876,26807721,7745933,,2755952,26065171,7393883,,219924,742550,352050,PDN
EI147,,2000,1982,,3134545,29841126,8444354,,2859378,26463106,7568116,,275167,3378020,876238,PDN
EI147,,2001,1982,,3141380,30661214,8597112,,3049336,29416323,8283557,,92044,1244891,313555,PDN
EI147,,2002,1982,,4475272,63729921,15815116,,3198152,33742612,9202175,,1277120,29987309,6612941,PDN
EI147,,2003,1982,,4475272,63729921,15815116,,3463108,42859748,11089398,,1012164,20870173,4725718,PDN
EI147,,2004,1982,,4522710,69594318,16906041,,3670335,52719262,13050987,,852375,16875056,3855054,PDN
EI147,,2005,1982,,5050679,77206278,18788451,,3819405,60402236,14567134,,1231274,16804042,4221317,PDN
EI147,,2006,1982,,4273662,76204936,17833259,,4063821,67013453,15987923,,209841,9191483,1845336,PDN
EI147,,2007,1982,,4273662,76204936,17833259,,4142570,70276347,16647258,,131092,5928589,1186001,PDN
EI147,,2008,1982,,4190455,75686630,17657827,,4157518,71566441,16891760,,32937,4120189,766067,PDN
EI147,,2009,1982,,4205208,77020592,17909940,,4163808,73235949,17195116,,41400,3784643,714824,PDN
EI147,,2010,1982,,4205208,77020592,17909940,,4168097,73875683,17313236,,37111,3144909,596703,PDN
EI147,,2011,1982,,4205208,77020592,17909940,,4179466,74711194,17473273,,25742,2309398,436666,PDN
EI147,,2012,1982,,4205208,77020592,17909940,,4182926,74894871,17509416,,22282,2125721,400524,PDN
EI147,,2013,1982,,4182926,74894871,17509416,,4182926,74894871,17509416,,0,0,0,PDN
EI147,,2014,1982,,4182926,74894871,17509416,,4182926,74894871,17509416,,0,0,0,PDN
EI147,,2015,1982,,4182948,74894871,17509438,,4182948,74894871,17509438,,0,0,0,PDN
EI147,,2016,1982,,4182948,74894871,17509438,,4182948,74894871,17509438,,0,0,0,PDN
EI147,,2017,1982,,4182948,74894871,17509438,,4182948,74894871,17509438,,0,0,0,PDN
EI147,,2017,1982,,4182948,74894871,17509438,,4182948,74894871,17509438,,0,0,0,PDN
EI159,,1985,1972,,1061196,68385911,13229508,,245,10197,2059,,1060951,68375714,13227449,PDN
EI159,,1986,1972,,1310535,76888502,14991763,,155232,5533983,1139926,,1155303,71354519,13851837,PDN
EI159,,1987,1972,,957014,35360580,7248932,,258281,9710687,1986161,,698733,25649893,5262771,PDN
EI159,,1988,1972,,957014,35360580,7248932,,317229,12397547,2523198,,639785,22963033,4725734,PDN
EI159,,1989,1972,,957014,35360580,7248932,,347372,14567278,2939414,,609642,20793302,4309518,PDN
EI159,,1990,1972,,957014,35360580,7248932,,370438,16207517,3254338,,586576,19153063,3994594,PDN
EI159,,1991,1972,,917866,37466860,7584567,,386770,17656963,3528578,,531096,19809897,4055989,PDN
EI159,,1992,1972,,822328,40344971,8001148,,397132,18769105,3736830,,425196,21575866,4264318,PDN
EI159,,1993,1972,,822328,40344971,8001148,,407180,19570577,3889489,,415148,20774394,4111659,PDN
EI159,,1994,1972,,822328,40344971,8001148,,421981,20206336,4017414,,400347,20138635,3983734,PDN
EI159,,1995,1972,,795345,36427616,7277127,,424924,20417449,4057922,,370421,16010167,3219205,PDN
EI159,,1996,1972,,800487,36552727,7304531,,426897,20426518,4061509,,373590,16126209,3243022,PDN
EI159,,1997,1972,,846321,39019403,7789275,,427382,20568931,4087334,,418939,18450472,3701941,PDN
EI159,,1998,1972,,935099,43296280,8639063,,494850,23854373,4739400,,440249,19441907,3899663,PDN
EI159,,1999,1972,,814529,38825521,7722985,,536192,26759278,5297629,,278337,12066243,2425356,PDN
EI159,,2000,1972,,936996,43995714,8765415,,551974,27589383,5461117,,385022,16406331,3304298,PDN
EI159,,2001,1972,,937982,44041755,8774593,,551974,27589383,5461117,,386008,16452372,3313476,PDN
EI159,,2002,1972,,612358,29290807,5824245,,551974,27589383,5461117,,60384,1701424,363128,PDN
EI159,,2003,1972,,683227,35314649,6966972,,566427,28554712,5647337,,116800,6759937,1319635,PDN
EI159,,2004,1972,,683227,35314649,6966972,,580689,30086274,5934119,,102538,5228375,1032853,PDN
EI159,,2005,1972,,622843,33613225,6603844,,594919,31199336,6146402,,27924,2413889,457442,PDN
EI159,,2006,1972,,710689,32357036,6468169,,671368,31955145,6357337,,39321,401891,110832,PDN
EI159,,2007,1972,,710689,32357036,6468169,,672522,31963552,6359987,,38167,393484,108182,PDN
EI159,,2008,1972,,710689,32357036,6468169,,672522,31963552,6359987,,38167,393484,108182,PDN
EI159,,2009,1972,,713015,32836438,6555797,,672522,32419695,6441150,,40493,416743,114647,PDN
EI159,,2010,1972,,672522,32419695,6441150,,672522,32419695,6441150,,0,0,0,PDN
EI159,,2011,1972,,672522,32419695,6441150,,672522,32419695,6441150,,0,0,0,PDN
EI159,,2012,1972,,672522,32419695,6441150,,672522,32419695,6441150,,0,0,0,PDN
EI159,,2013,1972,,672522,32419695,6441150,,672522,32419695,6441150,,0,0,0,PDN
EI159,,2014,1972,,672522,32419695,6441150,,672522,32419695,6441150,,0,0,0,PDN
EI159,,2015,1972,,672522,32419695,6441150,,672522,32419695,6441150,,0,0,0,PDN
EI159,,2016,1972,,672522,32419695,6441150,,672522,32419695,6441150,,0,0,0,PDN
EI159,,2017,1972,,672522,32419695,6441150,,672522,32419695,6441150,,0,0,0,PDN
EI159,,2017,1972,,672522,32419695,6441150,,672522,32419695,6441150,,0,0,0,PDN
EI162,,1992,1991,,406463,36581607,6915646,,90907,2738332,578155,,315556,33843275,6337491,PDN
EI162,,1993,1991,,858855,36581607,7368038,,414134,11821004,2517515,,444721,24760603,4850523,PDN
EI162,,1994,1991,,1020673,40804530,8281266,,807921,23954553,5070297,,212752,16849977,3210969,PDN
EI162,,1995,1991,,1852277,62120015,12905660,,1198437,38152661,7987167,,653840,23967354,4918493,PDN
EI162,,1996,1991,,2226563,80823695,16608003,,1525288,52370112,10843813,,701275,28453583,5764190,PDN
EI162,,1997,1991,,2478663,81301975,16945207,,1775897,63943022,13153659,,702766,17358953,3791548,PDN
EI162,,1998,1991,,2486790,81515869,16991393,,2014425,73885201,15161258,,472365,7630668,1830135,PDN
EI162,,1999,1991,,2487869,95872563,19547044,,2139080,81977000,16725735,,348789,13895563,2821309,PDN
EI162,,2000,1991,,2372457,100598253,20272502,,2227449,87916722,17870994,,145008,12681531,2401508,PDN
EI162,,2001,1991,,2373117,100598253,20273162,,2273235,91500788,18554514,,99882,9097465,1718648,PDN
EI162,,2002,1991,,2532829,104685891,21160212,,2305965,94022024,19035863,,226864,10663867,2124349,PDN
EI162,,2003,1991,,2532829,104685891,21160212,,2341489,96803032,19566228,,191340,7882859,1593984,PDN
EI162,,2004,1991,,2532829,104685891,21160212,,2377471,99429356,20069527,,155358,5256535,1090685,PDN
EI162,,2005,1991,,2494500,103333130,20881178,,2405296,101548783,20474474,,89204,1784347,406704,PDN
EI162,,2006,1991,,2514289,107324694,21611210,,2431469,103286563,20809861,,82820,4038131,801349,PDN
EI162,,2007,1991,,2514289,107324694,21611210,,2451179,104419370,21031138,,63110,2905324,580072,PDN
EI162,,2008,1991,,2514289,107324694,21611210,,2459249,104934151,21130806,,55040,2390543,480404,PDN
EI162,,2009,1991,,2555762,109369710,22016564,,2464665,106769079,21462722,,91097,2600631,553843,PDN
EI162,,2010,1991,,2555762,109369710,22016564,,2468130,107013221,21509628,,87632,2356489,506936,PDN
EI162,,2011,1991,,2469303,107064571,21519938,,2469303,107064571,21519938,,0,0,0,PDN
EI162,,2012,1991,,2469303,107064571,21519938,,2469303,107064571,21519938,,0,0,0,PDN
EI162,,2013,1991,,2469303,107064571,21519938,,2469303,107064571,21519938,,0,0,0,PDN
EI162,,2014,1991,,2469303,107064571,21519938,,2469303,107064571,21519938,,0,0,0,PDN
EI162,,2015,1991,,2469303,107064571,21519938,,2469303,107064571,21519938,,0,0,0,PDN
EI162,,2016,1991,,2469303,107064571,21519938,,2469303,107064571,21519938,,0,0,0,PDN
EI162,,2017,1991,,2469303,107064571,21519938,,2469303,107064571,21519938,,0,0,0,PDN
EI162,,2017,1991,,2469303,107064571,21519938,,2469303,107064571,21519938,,0,0,0,PDN
EI166,,2006,2006,,55291,3593974,694788,,0,0,0,,55291,3593974,694788,PDN
EI166,,2007,2006,,55291,3593974,694788,,9630,613245,118748,,45661,2980729,576040,PDN
EI166,,2008,2006,,55291,3593974,694788,,12417,902614,173024,,42874,2691360,521764,PDN
EI166,,2009,2006,,325122,4842697,1186811,,57801,1376468,302724,,267321,3466229,884088,PDN
EI166,,2010,2006,,325122,4842697,1186811,,168077,2524161,617215,,157045,2318536,569596,PDN
EI166,,2011,2006,,325122,4842697,1186811,,247443,3894685,940447,,77679,948012,246364,PDN
EI166,,2012,2006,,325122,4842697,1186811,,257793,4057087,979694,,67329,785610,207117,PDN
EI166,,2013,2006,,257793,4057087,979694,,257793,4057087,979694,,0,0,0,PDN
EI166,,2014,2006,,257793,4057087,979694,,257793,4057087,979694,,0,0,0,PDN
EI166,,2015,2006,,257793,4057087,979694,,257793,4057087,979694,,0,0,0,PDN
EI166,,2016,2006,,257793,4057087,979694,,257793,4057087,979694,,0,0,0,PDN
EI166,,2017,2006,,257793,4057087,979694,,257793,4057087,979694,,0,0,0,PDN
EI166,,2017,2006,,257793,4057087,979694,,257793,4057087,979694,,0,0,0,PDN
EI172,,1975,1956,,542273,24341000,4873412,,541955,24316835,4868794,,318,24165,4618,PDP
EI172,,1976,1956,,542273,24341000,4873412,,541955,24316835,4868794,,318,24165,4618,PDP
EI172,,1977,1956,,542273,24341000,4873412,,541955,24316835,4868794,,318,24165,4618,PDP
EI172,,1978,1956,,542273,24341000,4873412,,542273,24341000,4873412,,0,0,0,PDP
EI172,,1979,1956,,582262,25369938,5096486,,582262,25369938,5096486,,0,0,0,PDP
EI172,,1980,1956,,582262,25369938,5096486,,582262,25369938,5096486,,0,0,0,PDP
EI172,,1981,1956,,582263,25369938,5096487,,582263,25369938,5096487,,0,0,0,PDP
EI172,,1982,1956,,582263,25369938,5096487,,582263,25369938,5096487,,0,0,0,PDP
EI172,,1983,1956,,582263,25369938,5096487,,582263,25369938,5096487,,0,0,0,PDP
EI172,,1984,1956,,582263,25369938,5096487,,582263,25369938,5096487,,0,0,0,PDP
EI172,,1985,1956,,1311516,40179742,8460936,,584204,25384748,5101063,,727312,14794994,3359873,PDP
EI172,,1986,1956,,1311516,40179742,8460936,,584204,25384748,5101063,,727312,14794994,3359873,PDP
EI172,,1987,1956,,1545514,53346941,11037852,,612683,26795905,5380638,,932831,26551036,5657214,PDP
EI172,,1988,1956,,2070487,55291154,11908771,,722610,32097788,6433960,,1347877,23193366,5474811,PDP
EI172,,1989,1956,,2415377,55655592,12318507,,732666,32687992,6549035,,1682711,22967600,5769472,PDP
EI172,,1990,1956,,8223994,73761352,21348790,,782681,34506858,6922691,,7441313,39254494,14426099,PDP
EI172,,1991,1956,,10273152,79466110,24413029,,2037284,42195255,9545336,,8235868,37270855,14867693,PDP
EI172,,1992,1956,,10314240,82923707,25069348,,2599886,46706804,10910705,,7714354,36216903,14158643,PDP
EI172,,1993,1956,,10754870,82653145,25461835,,3208042,52011716,12462796,,7546828,30641429,12999039,PDP
EI172,,1994,1956,,6148787,89084808,22000176,,3825795,58121648,14167725,,2322992,30963160,7832451,PDP
EI172,,1995,1956,,5062423,74787316,18369775,,4213402,63143348,15448873,,849021,11643968,2920902,PDP
EI172,,1996,1956,,5517656,76969781,19213347,,4729026,68322050,16885974,,788630,8647731,2327373,PDP
EI172,,1997,1956,,5572283,78769660,19588237,,5071548,71592622,17810449,,500735,7177038,1777788,PDP
EI172,,1998,1956,,9177206,86737541,24610932,,5840072,74657365,19124301,,3337134,12080176,5486631,PDP
EI172,,1999,1956,,10227946,96174683,27340879,,7238361,79366929,21360590,,2989585,16807754,5980289,PDP
EI172,,2000,1956,,11341273,103851483,29820184,,7874846,83455641,22724604,,3466427,20395842,7095580,PDP
EI172,,2001,1956,,11076085,103047970,29412023,,8230855,85349460,23417592,,2845230,17698510,5994431,PDP
EI172,,2002,1956,,11076085,103047970,29412023,,8476035,86794514,23919899,,2600050,16253456,5492124,PDP
EI172,,2003,1956,,11076085,103047970,29412023,,8713794,88100896,24390110,,2362291,14947074,5021913,PDP
EI172,,2004,1956,,11239157,103368094,29632057,,8903598,89100347,24757752,,2335559,14267747,4874305,PDP
EI172,,2005,1956,,11189656,101313528,29216975,,9041057,89773066,25014912,,2148599,11540462,4202063,PDP
EI172,,2006,1956,,11205504,102610971,29463684,,9157911,90402175,25243707,,2047593,12208796,4219977,PDP
EI172,,2007,1956,,11205504,102610971,29463684,,9263997,90947600,25446844,,1941507,11663371,4016840,PDP
EI172,,2008,1956,,11974370,112021175,31906964,,9553035,92650845,26038950,,2421335,19370330,5868014,PDP
EI172,,2009,1956,,10910527,112810693,30983606,,9964564,98625992,27513674,,945963,14184701,3469931,PDP
EI172,,2010,1956,,11095147,111268262,30893772,,10122198,99905452,27898970,,972949,11362810,2994802,PDP
EI172,,2011,1956,,11095147,111268262,30893772,,10207092,100325782,28058655,,888055,10942480,2835117,PDP
EI172,,2012,1956,,11095147,111268262,30893772,,10276533,100697051,28194158,,818614,10571211,2699614,PDP
EI172,,2013,1956,,11065561,111237997,30858801,,10338033,100850470,28282957,,727528,10387527,2575844,PDP
EI172,,2014,1956,,11149446,114487612,31520909,,10387875,101506796,28449582,,761571,12980816,3071326,PDP
EI172,,2015,1956,,11149446,114487612,31520909,,10411702,101571094,28484850,,737744,12916518,3036058,PDP
EI172,,2016,1956,,11225063,114536990,31605312,,10424384,101603476,28503294,,800679,12933514,3102017,PDP
EI172,,2017,1956,,11117059,111721707,30996368,,10434859,101629697,28518435,,682200,10092010,2477933,PDP
EI172,,2017,1956,,11117059,111721707,30996368,,10434859,101629697,28518435,,682200,10092010,2477933,PDP
EI173,,1988,1983,,455069,514228,546569,,257966,304393,312128,,197103,209835,234441,PDP
EI173,,1989,1983,,268526,317434,325009,,268526,317434,325009,,0,0,0,PDP
EI173,,1990,1983,,268700,317434,325183,,268700,317434,325183,,0,0,0,PDP
EI173,,1991,1983,,268700,317434,325183,,268700,317434,325183,,0,0,0,PDP
EI173,,1992,1983,,268700,317434,325183,,268700,317434,325183,,0,0,0,PDP
EI173,,1993,1983,,268700,317434,325183,,268700,317434,325183,,0,0,0,PDP
EI173,,1994,1983,,268700,317434,325183,,268700,317434,325183,,0,0,0,PDP
EI173,,1995,1983,,268700,317434,325183,,268700,317434,325183,,0,0,0,PDP
EI173,,1996,1983,,268700,317434,325183,,268700,317434,325183,,0,0,0,PDP
EI173,,1997,1983,,4753844,9780641,6494172,,1264498,1521252,1535183,,3489346,8259389,4958989,PDP
EI173,,1998,1983,,4273657,9504080,5964774,,2135776,3005624,2670585,,2137881,6498456,3294189,PDP
EI173,,1999,1983,,4271236,6633397,5451556,,2800242,3553656,3432565,,1470994,3079741,2018991,PDP
EI173,,2000,1983,,3561230,4593184,4378523,,3064659,4064965,3787962,,496571,528219,590561,PDP
EI173,,2001,1983,,3712622,4732688,4554737,,3256785,4178824,4000348,,455837,553864,554389,PDP
EI173,,2002,1983,,3856891,4797733,4710580,,3422508,4260715,4180642,,434383,537018,529938,PDP
EI173,,2003,1983,,4094237,4952558,4975475,,3613456,4369083,4390873,,480781,583475,584602,PDP
EI173,,2004,1983,,4094670,4952821,4975955,,3745796,4490812,4544873,,348874,462009,431082,PDP
EI173,,2005,1983,,4094411,4757147,4940878,,3817780,4534518,4624634,,276631,222629,316244,PDP
EI173,,2006,1983,,4094411,4756887,4940832,,3893469,4552241,4703476,,200942,204646,237356,PDP
EI173,,2007,1983,,4141098,4803299,4995778,,3952867,4611128,4773352,,188231,192171,222426,PDP
EI173,,2008,1983,,4588735,4942919,5468258,,4081974,4688219,4916177,,506761,254700,552081,PDP
EI173,,2009,1983,,4685842,5015078,5578205,,4231526,4797055,5085094,,454316,218023,493110,PDP
EI173,,2010,1983,,4689550,5018788,5582574,,4302298,4813064,5158715,,387252,205724,423858,PDP
EI173,,2011,1983,,4689550,5018788,5582574,,4378295,4829547,5237645,,311255,189241,344927,PDP
EI173,,2012,1983,,4689550,5018788,5582574,,4440506,4852529,5303946,,249044,166259,278627,PDP
EI173,,2013,1983,,4797689,5235768,5729320,,4550100,4934325,5428095,,247589,301443,301226,PDP
EI173,,2014,1983,,4797689,5235768,5729320,,4589204,5009884,5480643,,208485,225884,248678,PDP
EI173,,2015,1983,,4940784,5575839,5932927,,4636482,5097401,5543494,,304302,478438,389433,PDP
EI173,,2016,1983,,4974351,5590383,5969081,,4725155,5209265,5652071,,249196,381118,317011,PDP
EI173,,2017,1983,,5152747,5607355,6150497,,4804894,5257073,5740316,,347853,350282,410181,PDP
EI173,,2017,1983,,5152747,5607355,6150497,,4804894,5257073,5740316,,347853,350282,410181,PDP
EI175,,1975,1956,,66105892,121016961,87639159,,41910915,66547419,53752093,,24194977,54469542,33887066,PDP
EI175,,1976,1956,,66105892,121016961,87639159,,45532580,77154482,59261136,,20573312,43862479,28378023,PDP
EI175,,1977,1956,,76950768,155392440,104600668,,49521359,85654827,64762431,,27429409,69737613,39838237,PDP
EI175,,1978,1956,,76871452,169478690,107027803,,52081741,93414461,68703531,,24789711,76064229,38324272,PDP
EI175,,1979,1956,,74578234,175541388,105813356,,53450590,102363678,71664768,,21127644,73177710,34148588,PDP
EI175,,1980,1956,,78981839,181686354,111310372,,55338525,106379883,74267330,,23643314,75306471,37043042,PDP
EI175,,1981,1956,,79970634,182690567,112477852,,57986504,111140945,77762473,,21984130,71549622,34715379,PDP
EI175,,1982,1956,,81005138,190330184,114871719,,61198674,117358812,82081025,,19806464,72971372,32790694,PDP
EI175,,1983,1956,,83516310,205834053,120141586,,63853299,125637994,86208814,,19663011,80196059,33932772,PDP
EI175,,1984,1956,,87871591,225473805,127991485,,67213770,133386295,90947986,,20657821,92087510,37043499,PDP
EI175,,1985,1956,,98039081,259168509,144154474,,70388356,147963470,96716376,,27650725,111205039,47438098,PDP
EI175,,1986,1956,,99802574,289486669,151312657,,73186141,164207403,102404540,,26616433,125279266,48908117,PDP
EI175,,1987,1956,,89602715,252419411,134517201,,75169561,172832849,105922737,,14433154,79586562,28594464,PDP
EI175,,1988,1956,,91254516,258232201,137203306,,76705199,180738318,108865042,,14549317,77493883,28338264,PDP
EI175,,1989,1956,,86110282,221151915,125461157,,78303539,187176700,111609002,,7806743,33975215,13852155,PDP
EI175,,1990,1956,,86643518,223302921,126377134,,79729625,190666508,113656050,,6913893,32636413,12721084,PDP
EI175,,1991,1956,,87035296,226369787,127314618,,81147195,194603672,115774183,,5888101,31766115,11540435,PDP
EI175,,1992,1956,,88107962,221001397,127432054,,82831759,198451261,118143371,,5276203,22550136,9288683,PDP
EI175,,1993,1956,,89358496,224537467,129311782,,84547887,203600140,120775670,,4810609,20937327,8536112,PDP
EI175,,1994,1956,,91820250,263816013,138762601,,86466615,212281065,124239046,,5353635,51534948,14523555,PDP
EI175,,1995,1956,,100468805,296616517,153247545,,89544349,233544438,131100299,,10924456,63072079,22147246,PDP
EI175,,1996,1956,,106849513,359377845,170795749,,93447220,271576445,141770431,,13402293,87801400,29025318,PDP
EI175,,1997,1956,,106914919,372884273,173264434,,96679270,300691942,150183174,,10235649,72192331,23081260,PDP
EI175,,1998,1956,,108312671,390714046,177834743,,99159495,321674374,156396928,,9153176,69039672,21437815,PDP
EI175,,1999,1956,,107478568,400691731,178776029,,101004231,342201478,161894174,,6474337,58490253,16881855,PDP
EI175,,2000,1956,,111256915,423336134,186583630,,103299091,357432142,166899116,,7957824,65903992,19684514,PDP
EI175,,2001,1956,,111373960,425256263,187042334,,105093069,375377975,171886303,,6280891,49878288,15156031,PDP
EI175,,2002,1956,,111991752,432192682,188894365,,106486795,392177111,176269199,,5504957,40015571,12625166,PDP
EI175,,2003,1956,,112174703,438133051,190134321,,107456230,405582909,179624007,,4718473,32550142,10510314,PDP
EI175,,2004,1956,,112412201,445282312,191643929,,108479008,416243430,182543675,,3933193,29038882,9100254,PDP
EI175,,2005,1956,,112352876,439835806,190615475,,109120307,421265223,184078532,,3232569,18570583,6536943,PDP
EI175,,2006,1956,,113586222,471547520,197491475,,109786714,428153741,185970654,,3799508,43393779,11520821,PDP
EI175,,2007,1956,,113573499,470950404,197372503,,110527465,437954059,188455234,,3046034,32996345,8917269,PDP
EI175,,2008,1956,,114402506,478414814,199529697,,111177254,445866718,190512969,,3225252,32548096,9016728,PDP
EI175,,2009,1956,,114413780,486383313,200958849,,111825680,461197060,193889213,,2588100,25186253,7069641,PDP
EI175,,2010,1956,,114416226,486470545,200976817,,112199531,467934342,195461868,,2216695,18536203,5514953,PDP
EI175,,2011,1956,,114520249,490788160,201849097,,112390397,470441477,196098840,,2129852,20346683,5750256,PDP
EI175,,2012,1956,,114947714,485927132,201411610,,112824144,473623960,197098866,,2123570,12303172,4312746,PDP
EI175,,2013,1956,,114875556,485737491,201305709,,113139315,476695810,197960630,,1736241,9041681,3345079,PDP
EI175,,2014,1956,,114645567,492828721,202337506,,113509835,479711213,198867698,,1135732,13117508,3469808,PDP
EI175,,2015,1956,,115023283,489763566,202169821,,113697594,481686759,199406975,,1325689,8076807,2762842,PDP
EI175,,2016,1956,,115023283,489823195,202180431,,113958685,483642489,200016061,,1064598,6180706,2164368,PDP
EI175,,2017,1956,,116304512,498364069,204981388,,114291535,485860781,200743627,,2012977,12503288,4237762,PDP
EI175,,2017,1956,,116304512,498364069,204981388,,114291535,485860781,200743627,,2012977,12503288,4237762,PDP
EI186,,1994,1994,,509796,14099948,3018684,,19434,537508,115076,,490362,13562440,2903608,PDN
EI186,,1995,1994,,509796,14099948,3018684,,102379,2824683,604992,,407417,11275265,2413692,PDN
EI186,,1996,1994,,102379,2824683,604992,,102379,2824683,604992,,0,0,0,PDN
EI186,,1997,1994,,102379,2824683,604992,,102379,2824683,604992,,0,0,0,PDN
EI186,,1998,1994,,102379,2824683,604992,,102379,2824683,604992,,0,0,0,PDN
EI186,,1999,1994,,102379,2824683,604992,,102379,2824683,604992,,0,0,0,PDN
EI186,,2000,1994,,102379,2824683,604992,,102379,2824683,604992,,0,0,0,PDN
EI186,,2001,1994,,102379,2824683,604992,,102379,2824683,604992,,0,0,0,PDN
EI186,,2002,1994,,102379,2824683,604992,,102379,2824683,604992,,0,0,0,PDN
EI186,,2003,1994,,102379,2824683,604992,,102379,2824683,604992,,0,0,0,PDN
EI186,,2004,1994,,102379,2824683,604992,,102379,2824683,604992,,0,0,0,PDN
EI186,,2005,1994,,102379,2824683,604992,,102379,2824683,604992,,0,0,0,PDN
EI186,,2006,1994,,102379,2824683,604992,,102379,2824683,604992,,0,0,0,PDN
EI186,,2007,1994,,102379,2824683,604992,,102379,2824683,604992,,0,0,0,PDN
EI186,,2008,1994,,102379,2824683,604992,,102379,2824683,604992,,0,0,0,PDN
EI186,,2009,1994,,102379,2881254,615058,,102379,2881254,615058,,0,0,0,PDN
EI186,,2010,1994,,102379,2881254,615058,,102379,2881254,615058,,0,0,0,PDN
EI186,,2011,1994,,102379,2881254,615058,,102379,2881254,615058,,0,0,0,PDN
EI186,,2012,1994,,102379,2881254,615058,,102379,2881254,615058,,0,0,0,PDN
EI186,,2013,1994,,102379,2881254,615058,,102379,2881254,615058,,0,0,0,PDN
EI186,,2014,1994,,102379,2881254,615058,,102379,2881254,615058,,0,0,0,PDN
EI186,,2015,1994,,102379,2881254,615058,,102379,2881254,615058,,0,0,0,PDN
EI186,,2016,1994,,102379,2881254,615058,,102379,2881254,615058,,0,0,0,PDN
EI186,,2017,1994,,102379,2881254,615058,,102379,2881254,615058,,0,0,0,PDN
EI186,,2017,1994,,102379,2881254,615058,,102379,2881254,615058,,0,0,0,PDN
EI188,,1975,1956,,50000000,64000000,61387900,,39352742,53651443,48899262,,10647258,10348557,12488638,PDP
EI188,,1976,1956,,46000000,71990000,58809609,,40597826,59172387,51126720,,5402174,12817613,7682889,PDP
EI188,,1977,1956,,46000000,71990000,58809609,,41834047,62041619,52873481,,4165953,9948381,5936128,PDP
EI188,,1978,1956,,55819428,121896633,77509220,,41719035,70504035,54264237,,14100393,51392598,23244983,PDP
EI188,,1979,1956,,55745522,121805833,77419158,,43316713,72370594,56194043,,12428809,49435239,21225115,PDP
EI188,,1980,1956,,55745603,121852515,77427545,,42201541,71963850,55006497,,13544062,49888665,22421048,PDP
EI188,,1981,1956,,55915595,122255391,77669223,,42491017,72661646,55420136,,13424578,49593745,22249087,PDP
EI188,,1982,1956,,56679387,122798305,78529619,,42740994,73276844,55779578,,13938393,49521461,22750041,PDP
EI188,,1983,1956,,56815566,127112314,79433415,,42947441,73425923,56012552,,13868125,53686391,23420863,PDP
EI188,,1984,1956,,59443432,130087009,82590587,,43325250,74045539,56500613,,16118182,56041470,26089974,PDP
EI188,,1985,1956,,63143726,135971431,87337931,,45191938,76150819,58741906,,17951788,59820612,28596025,PDP
EI188,,1986,1956,,66009377,142471771,91360226,,47905369,80756152,62274791,,18104008,61715619,29085435,PDP
EI188,,1987,1956,,63360480,132523749,86941218,,49222619,86767744,64661719,,14137861,45756005,22279499,PDP
EI188,,1988,1956,,65782736,160946498,94420903,,50285253,99997073,68078326,,15497483,60949425,26342577,PDP
EI188,,1989,1956,,66874703,171982428,97476559,,51135077,109185452,70563093,,15739626,62796976,26913466,PDP
EI188,,1990,1956,,59974467,149221584,86526350,,52151770,113387833,72327541,,7822697,35833751,14198809,PDP
EI188,,1991,1956,,60976727,157029963,88918002,,53093907,117819187,74058175,,7882820,39210776,14859827,PDP
EI188,,1992,1956,,61655198,162680999,90601995,,53867503,124018135,75934787,,7787695,38662864,14667208,PDP
EI188,,1993,1956,,63180722,190104702,97007181,,54556219,126785403,77115899,,8624503,63319299,19891282,PDP
EI188,,1994,1956,,65529411,226050357,105751894,,55722180,143929742,81332454,,9807231,82120615,24419440,PDP
EI188,,1995,1956,,64313229,262041711,110939868,,56970707,163756751,86108919,,7342522,98284960,24830949,PDP
EI188,,1996,1956,,65248452,260434214,111589059,,57731145,178243820,89447127,,7517307,82190394,22141932,PDP
EI188,,1997,1956,,62694751,262342765,109374958,,57009655,182363080,89458602,,5685096,79979685,19916356,PDP
EI188,,1998,1956,,61916323,261186137,108390725,,57478519,187546371,90849759,,4437804,73639766,17540966,PDP
EI188,,1999,1956,,62500917,232604280,103889579,,57777264,192533176,92035836,,4723653,40071104,11853743,PDP
EI188,,2000,1956,,70802445,246672469,114694344,,58105929,198110778,93356957,,12696516,48561691,21337387,PDP
EI188,,2001,1956,,69320694,252056073,114170529,,58358193,203145522,94505083,,10962501,48910551,19665446,PDP
EI188,,2002,1956,,69512915,252515794,114444551,,58542702,206561651,95297444,,10970213,45954143,19147107,PDP
EI188,,2003,1956,,69572369,252515794,114504005,,58761778,209589712,96055321,,10810591,42926082,18448684,PDP
EI188,,2004,1956,,69655395,250784224,114278923,,58944778,212549874,96765040,,10710617,38234350,17513883,PDP
EI188,,2005,1956,,69245995,247705535,113321713,,59045664,214529434,97218161,,10200331,33176101,16103552,PDP
EI188,,2006,1956,,69651519,251689331,114436098,,59137813,216139273,97596758,,10513706,35550058,16839340,PDP
EI188,,2007,1956,,69651508,251689331,114436087,,59310056,218176159,98131437,,10341452,33513172,16304650,PDP
EI188,,2008,1956,,70087091,257700866,115941338,,59490606,220289869,98688092,,10596485,37410997,17253246,PDP
EI188,,2009,1956,,67994118,260051577,114266635,,59508197,224200539,99401529,,8485921,35851038,14865105,PDP
EI188,,2010,1956,,68218991,258788859,114266825,,59708089,226414318,99995333,,8510902,32374541,14271493,PDP
EI188,,2011,1956,,68218991,258788859,114266825,,59994979,228950890,100733569,,8224012,29837969,13533255,PDP
EI188,,2012,1956,,68218991,258788859,114266825,,60129079,230005206,101055271,,8089912,28783653,13211554,PDP
EI188,,2013,1956,,68407355,259253996,114537953,,60268522,230926300,101358609,,8138833,28327696,13179343,PDP
EI188,,2014,1956,,68702944,261859904,115297226,,60551102,232232466,101873602,,8151842,29627438,13423623,PDP
EI188,,2015,1956,,68946187,264099092,115938901,,60718997,233795212,102319567,,8227190,30303880,13619336,PDP
EI188,,2016,1956,,69048587,264452543,116104192,,60803461,234561363,102540356,,8245126,29891180,13563837,PDP
EI188,,2017,1956,,69043987,264058349,116029452,,60872510,235444200,102766494,,8171477,28614149,13262958,PDP
EI188,,2017,1956,,69043987,264058349,116029452,,60872510,235444200,102766494,,8171477,28614149,13262958,PDP
EI198,,1975,1958,,5009131,60714540,15812430,,3445366,53233813,12917575,,1563765,7480727,2894855,PDN
EI198,,1976,1958,,4931730,90073816,20959099,,3679876,78311666,17614336,,1251854,11762150,3344763,PDN
EI198,,1977,1958,,5350026,97083574,22624683,,3836578,80843168,18221483,,1513448,16240406,4403200,PDN
EI198,,1978,1958,,5350026,97083574,22624683,,4067577,84276356,19063370,,1282449,12807218,3561313,PDN
EI198,,1979,1958,,5550621,101007708,23523523,,4765716,83114205,19554720,,784905,17893503,3968803,PDN
EI198,,1980,1958,,5550621,101007708,23523523,,4957569,86041862,20267509,,593052,14965846,3256014,PDN
EI198,,1981,1958,,6175874,101020248,24151007,,5125363,88566761,20884573,,1050511,12453487,3266434,PDN
EI198,,1982,1958,,6175874,101135304,24171480,,5244860,90608521,21367373,,931014,10526783,2804107,PDN
EI198,,1983,1958,,7346305,106640185,26321427,,5342571,91758160,21669646,,2003734,14882025,4651781,PDN
EI198,,1984,1958,,7346305,106640185,26321427,,5485704,93261756,22080323,,1860601,13378429,4241104,PDN
EI198,,1985,1958,,7522184,107409261,26634152,,5683841,94517458,22501894,,1838343,12891803,4132258,PDN
EI198,,1986,1958,,7522184,107409261,26634152,,5847718,95722458,22880184,,1674466,11686803,3753968,PDN
EI198,,1987,1958,,7647469,107719764,26814687,,5961412,96881591,23200129,,1686057,10838173,3614558,PDN
EI198,,1988,1958,,7837399,107722002,27005015,,6079091,98485221,23603152,,1758308,9236781,3401863,PDN
EI198,,1989,1958,,9553364,111666957,29422929,,6192416,100452375,24066504,,3360948,11214582,5356425,PDN
EI198,,1990,1958,,9800467,118010299,30798741,,6323150,102987367,24648304,,3477317,15022932,6150437,PDN
EI198,,1991,1958,,9885726,120959357,31408743,,6475764,105841915,25308845,,3409962,15117442,6099898,PDN
EI198,,1992,1958,,7373492,129630509,30439419,,6593039,109404956,26060113,,780453,20225553,4379306,PDN
EI198,,1993,1958,,7639771,137181850,32049353,,6654382,111150042,26431970,,985389,26031808,5617383,PDN
EI198,,1994,1958,,7680740,137700315,32182575,,6725233,113107079,26851048,,955507,24593236,5331527,PDN
EI198,,1995,1958,,7599441,133238148,31307297,,6757136,114108885,27061208,,842305,19129263,4246089,PDN
EI198,,1996,1958,,7503803,133047610,31177755,,6774140,114754653,27193117,,729663,18292957,3984638,PDN
EI198,,1997,1958,,7503803,133047610,31177755,,6788892,115301602,27305191,,714911,17746008,3872564,PDN
EI198,,1998,1958,,7738006,138109139,32312586,,6798738,115608767,27369693,,939268,22500372,4942893,PDN
EI198,,1999,1958,,6856406,117821083,27821012,,6820557,116079102,27475201,,35849,1741981,345811,PDN
EI198,,2000,1958,,8173306,157737315,36240444,,7121700,124084262,29200750,,1051606,33653053,7039694,PDN
EI198,,2001,1958,,8207995,160413377,36751301,,7481761,132181484,31001598,,726234,28231893,5749703,PDN
EI198,,2002,1958,,8295233,164969687,37649270,,7618427,139244161,32394968,,676806,25725526,5254302,PDN
EI198,,2003,1958,,8301604,165652097,37777066,,7765316,147213529,33959894,,536288,18438568,3817172,PDN
EI198,,2004,1958,,8511362,160022700,36985152,,7979074,150787091,34809517,,532288,9235609,2175635,PDN
EI198,,2005,1958,,8502749,159307049,36849199,,8254656,152891909,35459622,,248093,6415140,1389577,PDN
EI198,,2006,1958,,8373499,158036262,36493830,,8317415,154368740,35785162,,56084,3667522,708668,PDN
EI198,,2007,1958,,8395344,158941000,36676661,,8334017,154498174,35824795,,61327,4442826,851866,PDN
EI198,,2008,1958,,8395148,158941000,36676465,,8341890,154976547,35917788,,53258,3964453,758677,PDN
EI198,,2009,1958,,8396391,161343432,37105187,,8347547,157681873,36404820,,48844,3661559,700366,PDN
EI198,,2010,1958,,8379991,160601786,36956821,,8347547,157681873,36404820,,32444,2919913,552001,PDN
EI198,,2011,1958,,8379991,160601786,36956821,,8347547,157681873,36404820,,32444,2919913,552001,PDN
EI198,,2012,1958,,8379991,160601786,36956821,,8347547,157681873,36404820,,32444,2919913,552001,PDN
EI198,,2013,1958,,8379991,160601786,36956821,,8347547,157681873,36404820,,32444,2919913,552001,PDN
EI198,,2014,1958,,8379991,160601786,36956821,,8347547,157681873,36404820,,32444,2919913,552001,PDN
EI198,,2015,1958,,8347547,157681873,36404820,,8347547,157681873,36404820,,0,0,0,PDN
EI198,,2016,1958,,8347547,157681873,36404820,,8347547,157681873,36404820,,0,0,0,PDN
EI198,,2017,1958,,8347547,157681873,36404820,,8347547,157681873,36404820,,0,0,0,PDN
EI198,,2017,1958,,8347547,157681873,36404820,,8347547,157681873,36404820,,0,0,0,PDN
EI205,,1975,1961,,14000112,250000000,58484098,,7288522,147787854,33585293,,6711590,102212146,24898805,PDP
EI205,,1976,1961,,14000000,350000000,76277580,,8711773,195584854,43513348,,5288227,154415146,32764232,PDP
EI205,,1977,1961,,14000000,350000000,76277580,,11804561,237254831,54020723,,2195439,112745169,22256857,PDP
EI205,,1978,1961,,16587678,350000000,78865258,,12567965,265180630,59753130,,4019713,84819370,19112128,PDP
EI205,,1979,1961,,11777014,348746228,73831503,,9450283,289004441,60874561,,2326731,59741787,12956942,PDP
EI205,,1980,1961,,12048245,352902979,74842369,,9766397,299204476,63005628,,2281848,53698503,11836741,PDP
EI205,,1981,1961,,12454654,354564493,75544421,,10185360,307213453,64849675,,2269294,47351040,10694746,PDP
EI205,,1982,1961,,14027730,370693544,79987435,,10422101,311784333,65899740,,3605629,58909211,14087695,PDP
EI205,,1983,1961,,14671845,379596620,82215728,,10747092,321898790,68024457,,3924753,57697830,14191271,PDP
EI205,,1984,1961,,12405492,394229478,82553086,,10981255,330504341,69789857,,1424237,63725137,12763229,PDP
EI205,,1985,1961,,13215661,397405504,83928384,,11135948,336957704,71092835,,2079713,60447800,12835549,PDP
EI205,,1986,1961,,13215661,397405504,83928384,,11216237,340188128,71747932,,1999424,57217376,12180452,PDP
EI205,,1987,1961,,13200654,397413248,83914755,,11290107,343103602,72340570,,1910547,54309646,11574185,PDP
EI205,,1988,1961,,13134938,396383793,83665862,,11349765,345267902,72785335,,1785173,51115891,10880527,PDP
EI205,,1989,1961,,14208866,416320893,88287317,,11479771,353507885,74381530,,2729095,62813008,13905787,PDP
EI205,,1990,1961,,14139770,409353124,86978404,,11682289,359891358,75719897,,2457481,49461766,11258507,PDP
EI205,,1991,1961,,13503509,383216772,81691547,,11947856,363509525,76629266,,1555653,19707247,5062281,PDP
EI205,,1992,1961,,13533778,385620610,82149545,,12225629,366459082,77431871,,1308149,19161528,4717674,PDP
EI205,,1993,1961,,14107438,399537755,85199565,,12423703,371854350,78589957,,1683735,27683405,6609608,PDP
EI205,,1994,1961,,15632509,437821854,93536753,,12894450,386491973,81665264,,2738059,51329881,11871489,PDP
EI205,,1995,1961,,15289613,443955276,94285214,,13391595,403587370,85204294,,1898018,40367906,9080920,PDP
EI205,,1996,1961,,15229582,465101535,97987862,,13763564,421577298,88777318,,1466018,43524237,9210544,PDP
EI205,,1997,1961,,16761874,501435234,105985225,,14087007,445778203,93406972,,2674867,55657031,12578253,PDP
EI205,,1998,1961,,18761722,532065764,113435345,,14413680,459499898,96175228,,4348042,72565866,17260117,PDP
EI205,,1999,1961,,18587165,513529436,109962510,,14808184,466510621,97817191,,3778981,47018815,12145319,PDP
EI205,,2000,1961,,16602989,522743753,109617892,,15020713,471525420,98922033,,1582276,51218333,10695859,PDP
EI205,,2001,1961,,16814058,526824695,110555107,,15167140,477112419,100062588,,1646918,49712276,10492519,PDP
EI205,,2002,1961,,17264862,527163886,111066265,,15616384,485149961,101942000,,1648478,42013925,9124265,PDP
EI205,,2003,1961,,17990895,535434667,113263967,,16132780,492909879,103839164,,1858115,42524788,9424803,PDP
EI205,,2004,1961,,18394863,542904709,114997124,,16490105,498719195,105230175,,1904758,44185514,9766949,PDP
EI205,,2005,1961,,18368217,543969000,115159854,,16845052,508447743,107316181,,1523165,35521257,7843673,PDP
EI205,,2006,1961,,19198286,556619830,118240960,,17483764,520743623,110142772,,1714522,35876207,8098188,PDP
EI205,,2007,1961,,19183028,552527046,117497449,,17734265,528233899,111726062,,1448763,24293147,5771387,PDP
EI205,,2008,1961,,19158977,550693425,117147130,,17875259,529494208,112091310,,1283718,21199217,5055820,PDP
EI205,,2009,1961,,19156798,559672825,118742712,,17998889,539274405,113955189,,1157909,20398420,4787522,PDP
EI205,,2010,1961,,19174802,559708971,118767148,,18113359,539645586,114135707,,1061443,20063385,4631441,PDP
EI205,,2011,1961,,19215171,559782529,118820605,,18113767,539648100,114136562,,1101404,20134429,4684042,PDP
EI205,,2012,1961,,19388549,560371966,119098865,,18201844,539743168,114241556,,1186705,20628798,4857311,PDP
EI205,,2013,1961,,19388549,560366816,119097949,,18278450,539889820,114344255,,1110099,20476996,4753692,PDP
EI205,,2014,1961,,20029450,560228918,119714312,,18425357,540078292,114524698,,1604093,20150626,5189613,PDP
EI205,,2015,1961,,20293100,560307123,119991877,,18633421,540276027,114767946,,1659679,20031096,5223931,PDP
EI205,,2016,1961,,20293100,560307123,119991877,,18792307,540452056,114958154,,1500793,19855067,5033723,PDP
EI205,,2017,1961,,20271777,560469250,119999403,,18916193,540603747,115109032,,1355584,19865503,4890371,PDP
EI205,,2017,1961,,20271777,560469250,119999403,,18916193,540603747,115109032,,1355584,19865503,4890371,PDP
EI208,,1975,1958,,27000000,70011000,39457473,,25400514,65440065,37044654,,1599486,4570935,2412819,PDP
EI208,,1976,1958,,40000000,110000000,59572954,,29105347,77810488,42950630,,10894653,32189512,16622324,PDP
EI208,,1977,1958,,40000000,110000000,59572954,,32768933,86182321,48103866,,7231067,23817679,11469088,PDP
EI208,,1978,1958,,46000000,126500000,68508897,,36270199,98392808,53777816,,9729801,28107192,14731081,PDP
EI208,,1979,1958,,46000000,126500000,68508897,,38883323,101074041,56868028,,7116677,25425959,11640869,PDP
EI208,,1980,1958,,56364412,149780437,83015735,,40670934,108958108,60058498,,15693478,40822329,22957237,PDP
EI208,,1981,1958,,56874108,155139342,84478973,,42078701,116741078,62851135,,14795407,38398264,21627838,PDP
EI208,,1982,1958,,58336960,162324102,87220252,,44008361,124747683,66205458,,14328599,37576419,21014794,PDP
EI208,,1983,1958,,60017451,194668931,94656051,,45667918,131271388,69025816,,14349533,63397543,25630235,PDP
EI208,,1984,1958,,66034106,213331411,103993432,,47544262,140930024,72620779,,18489844,72401387,31372653,PDP
EI208,,1985,1958,,68534102,233644475,110107852,,49546796,150591233,76342389,,18987306,83053242,33765463,PDP
EI208,,1986,1958,,70269363,248137844,114422004,,50907931,160961504,79548768,,19361432,87176340,34873236,PDP
EI208,,1987,1958,,75803501,292570198,127862255,,52136166,170338602,82445526,,23667335,122231596,45416729,PDP
EI208,,1988,1958,,77714510,305713110,132111861,,53443616,178318641,85172912,,24270894,127394469,46938949,PDP
EI208,,1989,1958,,64187215,237806564,106501550,,54577111,184195535,87352117,,9610104,53611029,19149433,PDP
EI208,,1990,1958,,64186906,237815248,106502786,,55380283,187931678,88820083,,8806623,49883570,17682703,PDP
EI208,,1991,1958,,65968946,244869215,109539981,,55943349,193426050,90360796,,10025597,51443165,19179185,PDP
EI208,,1992,1958,,60441888,239933162,103134621,,56668898,200233710,92297672,,3772990,39699452,10836949,PDP
EI208,,1993,1958,,72454794,261571567,118997777,,57916604,209668588,95224182,,14538190,51902979,23773595,PDP
EI208,,1994,1958,,73640323,274990715,122571055,,58852246,221321567,98233308,,14788077,53669148,24337747,PDP
EI208,,1995,1958,,65436214,266472137,112851185,,59616379,227209373,100045093,,5819835,39262764,12806092,PDP
EI208,,1996,1958,,68142737,280306069,118019262,,60406122,232915341,101850133,,7736615,47390728,16169129,PDP
EI208,,1997,1958,,68800252,284863315,119487675,,61825159,239147553,104378104,,6975093,45715762,15109571,PDP
EI208,,1998,1958,,70183458,300122986,123586125,,63535940,241849919,106569733,,6647518,58273067,17016392,PDP
EI208,,1999,1958,,69152654,266638121,116597160,,64438562,243001212,107677212,,4714092,23636909,8919948,PDP
EI208,,2000,1958,,73431204,289161528,124883433,,64941405,243860442,108332943,,8489799,45301086,16550490,PDP
EI208,,2001,1958,,73393479,286453983,124363939,,65769543,251500447,110520512,,7623936,34953536,13843427,PDP
EI208,,2002,1958,,73405983,286846650,124446313,,66238165,254242492,111477043,,7167818,32604158,12969270,PDP
EI208,,2003,1958,,74558928,289355772,126045721,,66819933,255134545,112217539,,7738995,34221227,13828182,PDP
EI208,,2004,1958,,74195254,293727616,126459955,,67359158,256257441,112956567,,6836096,37470175,13503388,PDP
EI208,,2005,1958,,75487752,286249750,126421871,,68076621,263223283,114913504,,7411131,23026467,11508367,PDP
EI208,,2006,1958,,75742736,287194634,126844984,,69281903,267382825,116858918,,6460833,19811809,9986066,PDP
EI208,,2007,1958,,76271289,281611686,126380130,,69849988,268489479,117623917,,6421301,13122207,8756213,PDP
EI208,,2008,1958,,76513236,283465155,126951876,,70354379,269077125,118232871,,6158857,14388030,8719005,PDP
EI208,,2009,1958,,75313092,287304204,126434840,,70950948,275972711,120056416,,4362144,11331493,6378427,PDP
EI208,,2010,1958,,76530673,287989870,127774424,,71712619,276974009,120996249,,4818054,11015861,6778174,PDP
EI208,,2011,1958,,76843570,288234172,128130791,,72300842,277614046,121698361,,4542728,10620126,6432432,PDP
EI208,,2012,1958,,76843570,288234172,128130791,,72783260,278008227,122250917,,4060310,10225945,5879875,PDP
EI208,,2013,1958,,76874874,288286330,128171375,,73134733,278297678,122653892,,3740141,9988652,5517483,PDP
EI208,,2014,1958,,77469859,289782878,129032650,,73544276,279097939,123205835,,3925583,10684939,5826821,PDP
EI208,,2015,1958,,77646438,289929810,129235374,,73942700,279669271,123705914,,3703738,10260539,5529459,PDP
EI208,,2016,1958,,77877147,290161323,129507276,,74207282,279986051,124026862,,3669865,10175272,5480413,PDP
EI208,,2017,1958,,78104002,290276283,129754586,,74462203,280221445,124323670,,3641799,10054838,5430916,PDP
EI208,,2017,1958,,78104002,290276283,129754586,,74462203,280221445,124323670,,3641799,10054838,5430916,PDP
EI212,,1986,1984,,9013683,57011974,19158162,,0,0,0,,9013683,57011974,19158162,PDP
EI212,,1987,1984,,9013683,57011974,19158162,,399272,1374434,643833,,8614411,55637540,18514329,PDP
EI212,,1988,1984,,9384910,57617074,19637058,,800626,3195379,1369199,,8584284,54421695,18267859,PDP
EI212,,1989,1984,,5768226,78946691,19815680,,1220428,4907905,2093721,,4547798,74038786,17721959,PDP
EI212,,1990,1984,,6132038,79346884,20250701,,1586343,6551224,2752041,,4545695,72795660,17498660,PDP
EI212,,1991,1984,,6618622,79346884,20737285,,2015631,10340342,3855550,,4602991,69006542,16881735,PDP
EI212,,1992,1984,,6618622,79346884,20737285,,2437200,15432513,5183199,,4181422,63914371,15554086,PDP
EI212,,1993,1984,,7679802,86171484,23012806,,2724338,19335142,6164755,,4955464,66836342,16848051,PDP
EI212,,1994,1984,,7679737,86172795,23012975,,3142472,24826419,7559984,,4537265,61346376,15452991,PDP
EI212,,1995,1984,,7298339,77742299,21131488,,3801688,32525854,9589207,,3496651,45216445,11542281,PDP
EI212,,1996,1984,,7304241,77945706,21173584,,4365249,39826466,11451809,,2938992,38119240,9721775,PDP
EI212,,1997,1984,,7605226,79523986,21755401,,4848039,44805356,12820522,,2757187,34718630,8934879,PDP
EI212,,1998,1984,,6505022,65833636,18219192,,5214128,47200764,13612840,,1290894,18632872,4606352,PDP
EI212,,1999,1984,,7330627,69158671,19636440,,5539661,49933194,14424571,,1790966,19225477,5211869,PDP
EI212,,2000,1984,,7349157,72681367,20281784,,5964195,58340350,16345040,,1384962,14341017,3936744,PDP
EI212,,2001,1984,,7349157,72681367,20281784,,6313656,62863987,17499419,,1035501,9817380,2782365,PDP
EI212,,2002,1984,,7496920,65832072,19210812,,6551228,63445995,17840551,,945692,2386077,1370261,PDP
EI212,,2003,1984,,7496920,65832072,19210812,,6719956,63801114,18072467,,776964,2030958,1138345,PDP
EI212,,2004,1984,,7496920,65832072,19210812,,6851787,64379387,18307194,,645133,1452685,903618,PDP
EI212,,2005,1984,,7546693,66618350,19400492,,6949182,64843134,18487106,,597511,1775216,913386,PDP
EI212,,2006,1984,,7546693,66618350,19400492,,7027223,65261205,18639537,,519470,1357145,760955,PDP
EI212,,2007,1984,,7546693,66618350,19400492,,7094357,65599331,18766836,,452336,1019019,633656,PDP
EI212,,2008,1984,,7792217,67090415,19730013,,7143506,65848240,18860275,,648711,1242175,869738,PDP
EI212,,2009,1984,,7795777,68043311,19903128,,7198103,67066269,19131603,,597674,977042,771525,PDP
EI212,,2010,1984,,7795073,68043311,19902424,,7245339,67285866,19217914,,549734,757445,684511,PDP
EI212,,2011,1984,,7795073,68043311,19902424,,7295785,67402838,19289174,,499288,640473,613251,PDP
EI212,,2012,1984,,7971143,71059841,20615244,,7343150,67517297,19356905,,627993,3542544,1258338,PDP
EI212,,2013,1984,,7971143,71059841,20615244,,7406531,68396645,19576754,,564612,2663196,1038490,PDP
EI212,,2014,1984,,7971186,71060174,20615346,,7448932,68902877,19709231,,522254,2157297,906115,PDP
EI212,,2015,1984,,7532470,69936293,19976651,,7471979,69100592,19767459,,60491,835701,209192,PDP
EI212,,2016,1984,,7532470,69936293,19976651,,7493823,69288498,19822739,,38647,647795,153913,PDP
EI212,,2017,1984,,7575268,69898452,20012716,,7517117,69451370,19875013,,58151,447082,137703,PDP
EI212,,2017,1984,,7575268,69898452,20012716,,7517117,69451370,19875013,,58151,447082,137703,PDP
EI213,,2005,2004,,21553,1487142,286169,,20198,1403129,269865,,1355,84013,16304,PDN
EI213,,2006,2004,,21553,1487142,286169,,20894,1445933,278177,,659,41209,7992,PDN
EI213,,2007,2004,,21041,1457535,280389,,21041,1457535,280389,,0,0,0,PDN
EI213,,2008,2004,,21041,1457535,280389,,21041,1457535,280389,,0,0,0,PDN
EI213,,2009,2004,,21041,1457535,280389,,21041,1457535,280389,,0,0,0,PDN
EI213,,2010,2004,,21041,1457535,280389,,21041,1457535,280389,,0,0,0,PDN
EI213,,2011,2004,,21041,1457535,280389,,21041,1457535,280389,,0,0,0,PDN
EI213,,2012,2004,,21041,1457535,280389,,21041,1457535,280389,,0,0,0,PDN
EI213,,2013,2004,,21041,1457535,280389,,21041,1457535,280389,,0,0,0,PDN
EI213,,2014,2004,,21041,1457535,280389,,21041,1457535,280389,,0,0,0,PDN
EI213,,2015,2004,,21041,1457535,280389,,21041,1457535,280389,,0,0,0,PDN
EI213,,2016,2004,,21041,1457535,280389,,21041,1457535,280389,,0,0,0,PDN
EI213,,2017,2004,,21041,1457535,280389,,21041,1457535,280389,,0,0,0,PDN
EI213,,2017,2004,,21041,1457535,280389,,21041,1457535,280389,,0,0,0,PDN
EI231,,1975,1966,,1000000,64000000,12387900,,302832,21073556,4052575,,697168,42926444,8335325,PDP
EI231,,1976,1966,,598599,44000000,8427780,,312289,25269996,4808730,,286310,18730004,3619050,PDP
EI231,,1977,1966,,598599,44000000,8427780,,368816,30870345,5861760,,229783,13129655,2566020,PDP
EI231,,1978,1966,,610418,54000000,10218959,,425923,38217846,7226251,,184495,15782154,2992708,PDP
EI231,,1979,1966,,610418,54000000,10218959,,334971,42830244,7956011,,275447,11169756,2262948,PDP
EI231,,1980,1966,,1416303,208699191,38551390,,359339,46390116,8613808,,1056964,162309075,29937582,PDP
EI231,,1981,1966,,1416303,208699191,38551390,,388169,50480315,9370431,,1028134,158218876,29180959,PDP
EI231,,1982,1966,,1483552,213857336,39536459,,416237,54657220,10141721,,1067315,159200116,29394738,PDP
EI231,,1983,1966,,1283221,215857336,39692000,,440151,57888131,10740530,,843070,157969205,28951470,PDP
EI231,,1984,1966,,1283221,215857336,39692000,,461638,60728377,11267399,,821583,155128959,28424601,PDP
EI231,,1985,1966,,1302529,217788143,40054868,,477898,62796133,11651587,,824631,154992010,28403281,PDP
EI231,,1986,1966,,1302529,217788143,40054868,,492235,64123644,11902136,,810294,153664499,28152732,PDP
EI231,,1987,1966,,1350622,220467543,40579722,,523349,66261746,12313695,,827273,154205797,28266027,PDP
EI231,,1988,1966,,1409894,225296898,41498310,,579251,70894970,13194014,,830643,154401928,28304296,PDP
EI231,,1989,1966,,1409894,225296898,41498310,,605653,73448832,13674840,,804241,151848066,27823470,PDP
EI231,,1990,1966,,941613,112953208,21040049,,646389,76091106,14185732,,295224,36862102,6854317,PDP
EI231,,1991,1966,,952117,114755338,21371216,,694201,82287767,15336152,,257916,32467571,6035064,PDP
EI231,,1992,1966,,954700,115156974,21445265,,738872,89429339,16651566,,215828,25727635,4793699,PDP
EI231,,1993,1966,,1029734,126712433,23576430,,773855,95757791,17812608,,255879,30954642,5763822,PDP
EI231,,1994,1966,,1068055,130161180,24228407,,804424,102716087,19081308,,263631,27445093,5147099,PDP
EI231,,1995,1966,,1405321,205725447,38011272,,839615,114829536,21271917,,565706,90895911,16739355,PDP
EI231,,1996,1966,,1402612,203865441,37677602,,864067,123970601,22922893,,538545,79894840,14754709,PDP
EI231,,1997,1966,,1374184,202389378,37386529,,876763,128312532,23708174,,497421,74076846,13678355,PDP
EI231,,1998,1966,,2941127,219988228,42084940,,1019001,132782648,24645807,,1922126,87205580,17439133,PDP
EI231,,1999,1966,,1837388,189020135,35470864,,1076154,136943610,25443344,,761234,52076525,10027520,PDP
EI231,,2000,1966,,2033094,224046769,41899067,,1115528,139806223,25992080,,917566,84240546,15906987,PDP
EI231,,2001,1966,,1979838,226292467,42245402,,1232898,154333498,28694375,,746940,71958969,13551027,PDP
EI231,,2002,1966,,2050031,233884797,43666543,,1303054,162309222,30183698,,746977,71575575,13482845,PDP
EI231,,2003,1966,,2128844,236447699,44201389,,1417295,168255102,31355925,,711549,68192597,12845464,PDP
EI231,,2004,1966,,2106644,233849519,43716879,,1420414,169613029,31600668,,686230,64236490,12116211,PDP
EI231,,2005,1966,,2084183,229735461,42962379,,1436952,169991954,31684631,,647231,59743507,11277748,PDP
EI231,,2006,1966,,2041803,226577495,42358084,,1442479,170310996,31746927,,599324,56266499,10611157,PDP
EI231,,2007,1966,,2041803,226577495,42358084,,1445436,170744313,31826986,,596367,55833182,10531098,PDP
EI231,,2008,1966,,2071766,228502448,42730565,,1448470,170922122,31861659,,623296,57580326,10868906,PDP
EI231,,2009,1966,,1843415,211007931,39389307,,1461972,174384176,32491183,,381443,36623755,6898125,PDP
EI231,,2010,1966,,1843415,211008119,39389341,,1470657,174910768,32593567,,372758,36097351,6795774,PDP
EI231,,2011,1966,,1843415,211008119,39389341,,1477308,175640269,32730023,,366107,35367850,6659319,PDP
EI231,,2012,1966,,1649345,190643728,35571713,,1481082,175895479,32779208,,168263,14748249,2792507,PDP
EI231,,2013,1966,,1647528,190071829,35468136,,1483180,175973362,32795164,,164348,14098467,2672972,PDP
EI231,,2014,1966,,1675502,192597881,35945585,,1489305,176412774,32879476,,186197,16185107,3066109,PDP
EI231,,2015,1966,,1681104,193220346,36061948,,1496839,177154933,33019069,,184265,16065413,3042879,PDP
EI231,,2016,1966,,1682422,193323494,36081620,,1498122,177255781,33038296,,184300,16067713,3043324,PDP
EI231,,2017,1966,,1680216,193471877,36105817,,1498118,177248788,33037048,,182098,16223089,3068769,PDP
EI231,,2017,1966,,1680216,193471877,36105817,,1498118,177248788,33037048,,182098,16223089,3068769,PDP
EI238,,1975,1964,,15000375,200000000,50587564,,11573416,64477913,23046354,,3426959,135522087,27541210,PDP
EI238,,1976,1964,,17000000,110007000,36574199,,12752150,72949497,25732488,,4247850,37057503,10841711,PDP
EI238,,1977,1964,,17000000,110007000,36574199,,14389613,78910944,28430706,,2610387,31096056,8143493,PDP
EI238,,1978,1964,,40321242,427077009,116313592,,16466956,120962676,37990564,,23854286,306114333,78323028,PDP
EI238,,1979,1964,,42119025,472139557,126129622,,16956069,145472723,42840895,,25162956,326666834,83288727,PDP
EI238,,1980,1964,,57109488,570687804,158655361,,19771662,251648518,64548978,,37337826,319039286,94106383,PDP
EI238,,1981,1964,,59362786,695597654,183134611,,22501381,383400745,90722154,,36861405,312196909,92412457,PDP
EI238,,1982,1964,,61101280,758530674,196071151,,24893787,473160214,109085996,,36207493,285370460,86985155,PDP
EI238,,1983,1964,,71794282,1186960264,282997176,,26952913,537115742,122525109,,44841369,649844522,160472067,PDP
EI238,,1984,1964,,73653207,1203399932,287781309,,29519122,587569818,134068912,,44134085,615830114,153712397,PDP
EI238,,1985,1964,,73415240,1207406311,288256221,,31366785,619741664,141641102,,42048455,587664647,146615119,PDP
EI238,,1986,1964,,73501350,1209250508,288670480,,32757754,645009386,147528107,,40743596,564241122,141142373,PDP
EI238,,1987,1964,,72498492,1224488710,290379045,,34424014,670770866,153778261,,38074478,553717844,136600784,PDP
EI238,,1988,1964,,72233078,1220950847,289484118,,36247683,690454072,159104279,,35985395,530496775,130379839,PDP
EI238,,1989,1964,,61705514,999607051,239571537,,37872051,713109088,164759789,,23833463,286497963,74811748,PDP
EI238,,1990,1964,,60939481,1019339904,242316688,,39433577,742910431,171624045,,21505904,276429473,70692643,PDP
EI238,,1991,1964,,62884012,1034364784,246934685,,41198031,776937459,179443130,,21685981,257427325,67491555,PDP
EI238,,1992,1964,,67220612,1084620931,260213660,,43359663,821245053,189488676,,23860949,263375878,70724984,PDP
EI238,,1993,1964,,63734237,1141040842,266766415,,45508033,867103078,199796837,,18226204,273937764,66969578,PDP
EI238,,1994,1964,,66295600,1190225433,278079485,,46895323,914756369,209663360,,19400277,275469064,68416125,PDP
EI238,,1995,1964,,68357961,1283100097,296667587,,50477111,983712600,225514940,,17880850,299387497,71152647,PDP
EI238,,1996,1964,,75418005,1308962329,308329451,,54109182,1038699142,238931093,,21308823,270263187,69398358,PDP
EI238,,1997,1964,,83087455,1363560062,325713801,,56891386,1093788006,251515586,,26196069,269772056,74198215,PDP
EI238,,1998,1964,,81962763,1442652823,338662554,,60280499,1149646234,264843886,,21682264,293006589,73818668,PDP
EI238,,1999,1964,,75959124,1413450286,327462734,,63798395,1200485521,277407918,,12160729,212964765,50054816,PDP
EI238,,2000,1964,,83632678,1415829404,335559618,,68190160,1242770683,289323733,,15442518,173058721,46235885,PDP
EI238,,2001,1964,,87204574,1415258017,339029844,,72461033,1284155147,300958390,,14743541,131102870,38071454,PDP
EI238,,2002,1964,,91310447,1472239336,353274741,,76649454,1318896036,311328464,,14660993,153343300,41946277,PDP
EI238,,2003,1964,,92149120,1492648231,357744890,,79959247,1352890365,320687070,,12189873,139757866,37057820,PDP
EI238,,2004,1964,,93810327,1479696142,357101455,,82466842,1380611708,328127288,,11343485,99084434,28974167,PDP
EI238,,2005,1964,,96597255,1496237799,362831739,,84137178,1404020607,333962909,,12460077,92217192,28868830,PDP
EI238,,2006,1964,,95887563,1501309189,363024429,,85778793,1423928721,339146893,,10108770,77380468,23877536,PDP
EI238,,2007,1964,,96732241,1504408995,364420674,,86877081,1439549041,343024597,,9855160,64859954,21396077,PDP
EI238,,2008,1964,,98988590,1527956017,370866884,,87549185,1447323722,345080096,,11439405,80632295,25786788,PDP
EI238,,2009,1964,,97630083,1550294684,373483222,,88442575,1477240373,351296728,,9187508,73054311,22186496,PDP
EI238,,2010,1964,,100419094,1568086746,379438081,,89519744,1488081465,354302917,,10899350,80005281,25135169,PDP
EI238,,2011,1964,,100419094,1568086746,379438081,,90887241,1500030353,357796551,,9531853,68056393,21641529,PDP
EI238,,2012,1964,,100419094,1568086746,379438081,,91943137,1510071157,360639068,,8475957,58015589,18799013,PDP
EI238,,2013,1964,,100731168,1568417124,379808940,,92837344,1516660817,362705811,,7893824,51756307,17103131,PDP
EI238,,2014,1964,,100847727,1570762368,380342802,,93540537,1520213266,364041114,,7307190,50549102,16301692,PDP
EI238,,2015,1964,,102178199,1580290948,383368751,,93992418,1526333538,365582010,,8185781,53957410,17786744,PDP
EI238,,2016,1964,,102638744,1582185831,384166465,,94297279,1529893894,366520386,,8341465,52291937,17646079,PDP
EI238,,2017,1964,,102547982,1612681442,389501967,,94687654,1537087613,368190781,,7860328,75593829,21311186,PDP
EI238,,2017,1964,,102547982,1612681442,389501967,,94687654,1537087613,368190781,,7860328,75593829,21311186,PDP
EI240,,1983,1981,,0,71747296,12766423,,0,0,0,,0,71747296,12766423,PDN
EI240,,1984,1981,,1322123,111855632,21225260,,0,0,0,,1322123,111855632,21225260,PDN
EI240,,1985,1981,,1322123,111855632,21225260,,0,0,0,,1322123,111855632,21225260,PDN
EI240,,1986,1981,,1322123,111855632,21225260,,0,0,0,,1322123,111855632,21225260,PDN
EI240,,1987,1981,,1322123,111855632,21225260,,55073,1854122,384988,,1267050,110001510,20840272,PDN
EI240,,1988,1981,,3274897,115242842,23780741,,549841,19213096,3968541,,2725056,96029746,19812200,PDN
EI240,,1989,1981,,3274897,115242842,23780741,,1221577,50016994,10121398,,2053320,65225848,13659343,PDN
EI240,,1990,1981,,3411165,120568906,24864707,,1680076,73842900,14819382,,1731089,46726006,10045325,PDN
EI240,,1991,1981,,3061269,117606119,23987625,,2034772,92189173,18438539,,1026497,25416946,5549086,PDN
EI240,,1992,1981,,2709383,121209243,24276864,,2326240,112316702,22311418,,383143,8892541,1965446,PDN
EI240,,1993,1981,,3109292,158392580,31293025,,2498983,127992659,25273477,,610309,30399921,6019548,PDN
EI240,,1994,1981,,2867928,168127126,32783787,,2574015,137629410,27063234,,293913,30497716,5720553,PDN
EI240,,1995,1981,,4297350,196062328,39183885,,3934969,170938939,34351150,,362381,25123389,4832735,PDN
EI240,,1996,1981,,4624709,202874166,40723315,,4029104,180114578,36077961,,595605,22759588,4645354,PDN
EI240,,1997,1981,,4624709,202874166,40723315,,4069002,185547534,37084577,,555707,17326632,3638738,PDN
EI240,,1998,1981,,4617970,204085686,40932149,,4100554,189854023,37882409,,517416,14231663,3049740,PDN
EI240,,1999,1981,,4650450,207567485,41584166,,4212829,194925011,38896995,,437621,12642474,2687171,PDN
EI240,,2000,1981,,4612976,206901179,41428132,,4331028,199706484,39865990,,281948,7194695,1562142,PDN
EI240,,2001,1981,,4851526,223060798,44542059,,4377432,202582491,40424139,,474094,20478307,4117920,PDN
EI240,,2002,1981,,4862807,220238147,44051089,,4502562,211127906,42069805,,360245,9110241,1981284,PDN
EI240,,2003,1981,,4862807,220238147,44051089,,4549318,213711409,42576259,,313489,6526738,1474830,PDN
EI240,,2004,1981,,4923913,224524824,44874949,,4568953,215437884,42903096,,354960,9086940,1971853,PDN
EI240,,2005,1981,,4671485,220427653,43893487,,4597949,217253801,43255209,,73536,3173852,638278,PDN
EI240,,2006,1981,,4643665,220422498,43864750,,4604056,218728824,43523776,,39609,1693674,340974,PDN
EI240,,2007,1981,,4865983,220579479,44115001,,4617297,219829759,43732912,,248686,749720,382089,PDN
EI240,,2008,1981,,4865983,220579479,44115001,,4643983,220579479,43893001,,222000,0,222000,PDN
EI240,,2009,1981,,4718268,225784272,44893406,,4657893,224871625,44670638,,60375,912647,222767,PDN
EI240,,2010,1981,,4724174,226150790,44964528,,4675861,225390460,44780925,,48313,760330,183603,PDN
EI240,,2011,1981,,4709422,226256678,44968618,,4693569,225874566,44884772,,15853,382112,83844,PDN
EI240,,2012,1981,,4698227,226088726,44927539,,4695540,225971458,44903985,,2687,117268,23554,PDN
EI240,,2013,1981,,4695540,225971458,44903985,,4695540,225971458,44903985,,0,0,0,PDN
EI240,,2014,1981,,4695540,225971458,44903985,,4695540,225971458,44903985,,0,0,0,PDN
EI240,,2015,1981,,4695551,225971458,44903996,,4695551,225971458,44903996,,0,0,0,PDN
EI240,,2016,1981,,4695551,225971458,44903996,,4695551,225971458,44903996,,0,0,0,PDN
EI240,,2017,1981,,4695551,225971458,44903996,,4695551,225971458,44903996,,0,0,0,PDN
EI240,,2017,1981,,4695551,225971458,44903996,,4695551,225971458,44903996,,0,0,0,PDN
EI245,,1992,1992,,254973,22947570,4338171,,0,0,0,,254973,22947570,4338171,PDN
EI245,,1993,1992,,254973,22947570,4338171,,0,4561775,811704,,254973,18385795,3526467,PDN
EI245,,1994,1992,,254973,22947570,4338171,,0,8376896,1490551,,254973,14570674,2847620,PDN
EI245,,1995,1992,,254973,22947570,4338171,,0,10576662,1881968,,254973,12370908,2456203,PDN
EI245,,1996,1992,,222243,20001900,3781300,,0,12235617,2177156,,222243,7766283,1604144,PDN
EI245,,1997,1992,,222243,20001900,3781300,,0,13954619,2483028,,222243,6047281,1298272,PDN
EI245,,1998,1992,,0,14528517,2585145,,0,14528517,2585145,,0,0,0,PDN
EI245,,1999,1992,,0,14528517,2585145,,0,14528517,2585145,,0,0,0,PDN
EI245,,2000,1992,,0,14528517,2585145,,0,14528517,2585145,,0,0,0,PDN
EI245,,2001,1992,,0,14528517,2585145,,0,14528517,2585145,,0,0,0,PDN
EI245,,2002,1992,,0,14528517,2585145,,0,14528517,2585145,,0,0,0,PDN
EI245,,2003,1992,,0,14528517,2585145,,0,14528517,2585145,,0,0,0,PDN
EI245,,2004,1992,,0,14528517,2585145,,0,14528517,2585145,,0,0,0,PDN
EI245,,2005,1992,,0,14528517,2585145,,0,14528517,2585145,,0,0,0,PDN
EI245,,2006,1992,,0,14528517,2585145,,0,14528517,2585145,,0,0,0,PDN
EI245,,2007,1992,,0,14528517,2585145,,0,14528517,2585145,,0,0,0,PDN
EI245,,2008,1992,,0,14528517,2585145,,0,14528517,2585145,,0,0,0,PDN
EI245,,2009,1992,,0,14819477,2636918,,0,14819477,2636918,,0,0,0,PDN
EI245,,2010,1992,,0,14819477,2636918,,0,14819477,2636918,,0,0,0,PDN
EI245,,2011,1992,,0,14819477,2636918,,0,14819477,2636918,,0,0,0,PDN
EI245,,2012,1992,,0,14819477,2636918,,0,14819477,2636918,,0,0,0,PDN
EI245,,2013,1992,,0,14819477,2636918,,0,14819477,2636918,,0,0,0,PDN
EI245,,2014,1992,,0,14819477,2636918,,0,14819477,2636918,,0,0,0,PDN
EI245,,2015,1992,,0,14819477,2636918,,0,14819477,2636918,,0,0,0,PDN
EI245,,2016,1992,,0,14819477,2636918,,0,14819477,2636918,,0,0,0,PDN
EI245,,2017,1992,,0,14819477,2636918,,0,14819477,2636918,,0,0,0,PDN
EI245,,2017,1992,,0,14819477,2636918,,0,14819477,2636918,,0,0,0,PDN
EI258,,1975,1970,,15000000,69990000,27453737,,5010725,49188082,13763053,,9989275,20801918,13690684,PDP
EI258,,1976,1970,,17526167,252784583,62505630,,7309605,81742023,21854449,,10216562,171042560,40651181,PDP
EI258,,1977,1970,,20232449,267697783,67865506,,9179018,104741453,27816287,,11053431,162956330,40049219,PDP
EI258,,1978,1970,,20469007,271190802,68723598,,10551978,129157945,33533819,,9917029,142032857,35189779,PDP
EI258,,1979,1970,,14369412,271631113,62702350,,9845916,153915793,37233068,,4523496,117715320,25469282,PDP
EI258,,1980,1970,,15853717,287418850,66995861,,10975682,185705440,44019355,,4878035,101713410,22976506,PDP
EI258,,1981,1970,,20351183,473233471,104556427,,11881083,213235625,49823365,,8470100,259997846,54733062,PDP
EI258,,1982,1970,,20351183,473421571,104589897,,12651414,238595779,55106179,,7699769,234825792,49483718,PDP
EI258,,1983,1970,,20379446,486284751,106906982,,13217890,257330645,59006261,,7161556,228954106,47900721,PDP
EI258,,1984,1970,,20464582,511593801,111495507,,13790678,285069841,64514849,,6673904,226523960,46980658,PDP
EI258,,1985,1970,,20465568,511593801,111496493,,14176609,295025304,66672215,,6288959,216568497,44824278,PDP
EI258,,1986,1970,,20587565,514434801,112124006,,14488754,302509214,68316016,,6098811,211925587,43807990,PDP
EI258,,1987,1970,,20021320,448798459,99878697,,14843109,312079843,70373330,,5178211,136718616,29505367,PDP
EI258,,1988,1970,,20020846,448743897,99868515,,15258635,326741885,73397760,,4762211,122002012,26470755,PDP
EI258,,1989,1970,,20067094,462868029,102427953,,15601447,337586097,75670148,,4465647,125281932,26757805,PDP
EI258,,1990,1970,,18755546,434264546,96026818,,15936480,347190169,77714090,,2819066,87074377,18312728,PDP
EI258,,1991,1970,,22033073,447439476,101648638,,16828087,358369721,80594941,,5204986,89069755,21053697,PDP
EI258,,1992,1970,,23736394,458240829,105273908,,18062240,368946438,83711072,,5674154,89294391,21562836,PDP
EI258,,1993,1970,,25540736,459681936,107334675,,19278486,386173060,87992554,,6262250,73508876,19342121,PDP
EI258,,1994,1970,,27548588,466347311,110528537,,21437124,403608246,93253538,,6111464,62739065,17274999,PDP
EI258,,1995,1970,,30467983,473439082,114709813,,23871492,418875085,98404425,,6596491,54563997,16305388,PDP
EI258,,1996,1970,,31996484,484672205,118237090,,26573228,433073898,103632640,,5423256,51598307,14604450,PDP
EI258,,1997,1970,,32471527,488346842,119365983,,29115855,446153061,108502521,,3355672,42193781,10863462,PDP
EI258,,1998,1970,,35525437,501936559,124837992,,31601474,457584479,113022200,,3923963,44352080,11815792,PDP
EI258,,1999,1970,,35273455,488174606,122137264,,31242714,461166373,113300787,,4030741,27008233,8836477,PDP
EI258,,2000,1970,,36991690,489387205,124071264,,32833825,466468676,115835369,,4157865,22918529,8235895,PDP
EI258,,2001,1970,,36854208,482466068,122702263,,34116417,469208771,117605522,,2737791,13257297,5096741,PDP
EI258,,2002,1970,,37329961,480767477,122875775,,35075775,471079455,118897742,,2254186,9688022,3978033,PDP
EI258,,2003,1970,,45780469,488638829,132726880,,36120342,473795403,120425574,,9660127,14843426,12301306,PDP
EI258,,2004,1970,,39543329,483672282,125606013,,37139324,477057517,122025003,,2404005,6614765,3581010,PDP
EI258,,2005,1970,,40176660,486522355,126746474,,37859088,479584393,123194389,,2317572,6937962,3552085,PDP
EI258,,2006,1970,,41059816,491276433,128475551,,38506806,481966500,124265970,,2553010,9309933,4209581,PDP
EI258,,2007,1970,,41026407,487921511,127845181,,39201913,484863892,125476627,,1824494,3057619,2368554,PDP
EI258,,2008,1970,,41485828,488222155,128358098,,39717141,485592452,126121492,,1768687,2629703,2236606,PDP
EI258,,2009,1970,,41490940,497211337,129962707,,40159827,495151641,128265101,,1331113,2059696,1697607,PDP
EI258,,2010,1970,,42664115,497765231,131234440,,40557876,495914545,128798896,,2106239,1850686,2435542,PDP
EI258,,2011,1970,,42664115,497765231,131234440,,40970474,496321994,129283996,,1693641,1443237,1950444,PDP
EI258,,2012,1970,,42664115,497765231,131234440,,41386180,496664504,129760645,,1277935,1100727,1473793,PDP
EI258,,2013,1970,,42664115,497765231,131234440,,41730364,497030637,130169978,,933751,734594,1064461,PDP
EI258,,2014,1970,,42754647,497983195,131363756,,42024518,497338650,130518939,,730129,644545,844816,PDP
EI258,,2015,1970,,42772892,498133542,131408752,,42270690,497581267,130808282,,502202,552275,600471,PDP
EI258,,2016,1970,,43119629,498278970,131781368,,42490894,497762518,131060737,,628735,516452,720631,PDP
EI258,,2017,1970,,43119629,498328647,131790207,,42667835,497891405,131260611,,451794,437242,529595,PDP
EI258,,2017,1970,,43119629,498328647,131790207,,42667835,497891405,131260611,,451794,437242,529595,PDP
EI266,,1975,1962,,4501992,1130000000,205569608,,838808,391174756,70442857,,3663184,738825244,135126751,PDP
EI266,,1976,1962,,3306773,830000000,150993606,,890217,453563154,81595405,,2416556,376436846,69398201,PDP
EI266,,1977,1962,,1698185,707196670,127533891,,1241068,509266625,91857905,,457117,197930045,35675986,PDP
EI266,,1978,1962,,1761466,771002730,138950564,,1261561,566221614,102012738,,499905,204781116,36937826,PDP
EI266,,1979,1962,,715129,781507172,139773345,,295415,629957783,112387547,,419714,151549389,27385798,PDP
EI266,,1980,1962,,792774,851887309,152374146,,312998,665145215,118666239,,479776,186742094,33707907,PDP
EI266,,1981,1962,,810532,870200581,155650493,,335268,691937903,123455891,,475264,178262678,32194602,PDP
EI266,,1982,1962,,832799,910433978,162831727,,347187,724101236,129190823,,485612,186332742,33640904,PDP
EI266,,1983,1962,,741748,901971006,161234810,,148109,468489874,83509297,,593639,433481132,77725513,PDP
EI266,,1984,1962,,1128300,938109787,168051750,,158822,487239868,86856307,,969478,450869919,81195443,PDP
EI266,,1985,1962,,856983,686248234,122965210,,168536,508863969,90713726,,688447,177384265,32251484,PDP
EI266,,1986,1962,,858818,686828526,123070299,,175555,528850396,94277049,,683263,157978130,28793250,PDP
EI266,,1987,1962,,853755,690740455,123761309,,180981,559845416,99797603,,672774,130895039,23963706,PDP
EI266,,1988,1962,,869216,708729823,126977725,,223335,590871909,105360685,,645881,117857914,21617040,PDP
EI266,,1989,1962,,1031410,743111658,133257684,,304017,618956336,110438596,,727393,124155322,22819088,PDP
EI266,,1990,1962,,2018862,830939434,149872854,,536039,654230323,116947129,,1482823,176709111,32925725,PDP
EI266,,1991,1962,,2055949,835152811,150659652,,792363,686918308,123019820,,1263586,148234503,27639832,PDP
EI266,,1992,1962,,3446342,900092907,163605222,,1262554,717268172,128890343,,2183788,182824735,34714879,PDP
EI266,,1993,1962,,3511573,904374001,164432214,,1637930,747807891,134699832,,1873643,156566110,29732382,PDP
EI266,,1994,1962,,3862769,936303437,170464804,,1828380,773700681,139497540,,2034389,162602756,30967264,PDP
EI266,,1995,1962,,3426908,893678602,162444453,,2256110,797749415,144204404,,1170798,95929187,18240049,PDP
EI266,,1996,1962,,4633457,925652704,169340344,,2853762,831912616,150880918,,1779695,93740088,18459426,PDP
EI266,,1997,1962,,4976588,935507288,171436960,,3484491,867141006,157780044,,1492097,68366282,13656916,PDP
EI266,,1998,1962,,7659331,1058497428,196004069,,4559279,909893092,166461964,,3100052,148604336,29542105,PDP
EI266,,1999,1962,,8575217,1040188937,193662216,,5250002,945499443,173488337,,3325215,94689494,20173879,PDP
EI266,,2000,1962,,9974362,1135961333,212102713,,6000757,990624644,182268487,,3973605,145336689,29834226,PDP
EI266,,2001,1962,,9460556,1170235788,217687565,,6773025,1042777241,192320577,,2687531,127458547,25366988,PDP
EI266,,2002,1962,,9668219,1184743503,220476671,,7197482,1074310984,198356020,,2470737,110432519,22120651,PDP
EI266,,2003,1962,,9543150,1183693557,220164779,,7587152,1100545836,203413813,,1955998,83147721,16750966,PDP
EI266,,2004,1962,,8641092,1149049034,213098215,,7862032,1115116568,206281350,,779060,33932466,6816865,PDP
EI266,,2005,1962,,8408949,1141442474,211512592,,8016207,1123542071,207934725,,392742,17900403,3577867,PDP
EI266,,2006,1962,,8401838,1144566163,212061298,,8155134,1129606143,209152668,,246704,14960020,2908630,PDP
EI266,,2007,1962,,8401838,1144589854,212065513,,8269831,1134763086,210184971,,132007,9826768,1880542,PDP
EI266,,2008,1962,,8878942,1167467032,216613289,,8349155,1137887634,210820264,,529787,29579398,5793025,PDP
EI266,,2009,1962,,8925556,1187480030,220220933,,8397198,1162056851,215168878,,528358,25423179,5052051,PDP
EI266,,2010,1962,,8847410,1211744485,224460306,,8473970,1173729921,217322707,,373440,38014564,7137596,PDP
EI266,,2011,1962,,9231025,1243915718,230568341,,8592204,1186428161,219700415,,638821,57487557,10867926,PDP
EI266,,2012,1962,,9231025,1243915718,230568341,,8777786,1201747075,222611785,,453239,42168643,7956557,PDP
EI266,,2013,1962,,9207935,1243257806,230428184,,8910147,1215922551,225266471,,297788,27335255,5161713,PDP
EI266,,2014,1962,,9222630,1247602218,231215906,,9068955,1229295409,227804792,,153675,18306809,3411115,PDP
EI266,,2015,1962,,9298947,1256173184,232817307,,9184985,1238990221,229645877,,113962,17182963,3171427,PDP
EI266,,2016,1962,,9385703,1257876744,233207188,,9260101,1247341671,231207017,,125602,10535073,2000169,PDP
EI266,,2017,1962,,9453478,1266988511,234896273,,9316586,1254662657,232566169,,136892,12325854,2330106,PDP
EI266,,2017,1962,,9453478,1266988511,234896273,,9316586,1254662657,232566169,,136892,12325854,2330106,PDP
EI268,,2000,1997,,4885,2430803,437412,,0,0,0,,4885,2430803,437412,PDN
EI268,,2001,1997,,4965,2480628,446358,,0,0,0,,4965,2480628,446358,PDN
EI268,,2002,1997,,4965,2480628,446358,,0,0,0,,4965,2480628,446358,PDN
EI268,,2003,1997,,4965,2480628,446358,,567,226355,40844,,4398,2254273,405514,PDN
EI268,,2004,1997,,4965,2480628,446358,,982,341009,61660,,3983,2139619,384698,PDN
EI268,,2005,1997,,4211,2054109,369711,,1183,540821,97414,,3028,1513288,272297,PDN
EI268,,2006,1997,,5056,2347553,422770,,2940,1277923,230328,,2116,1069630,192442,PDN
EI268,,2007,1997,,5056,2347553,422770,,3508,1593246,287004,,1548,754307,135766,PDN
EI268,,2008,1997,,5056,2347553,422770,,3591,1642344,295823,,1465,705209,126947,PDN
EI268,,2009,1997,,3591,1641973,295757,,3591,1641973,295757,,0,0,0,PDN
EI268,,2010,1997,,3591,1641973,295757,,3591,1641973,295757,,0,0,0,PDN
EI268,,2011,1997,,3591,1641973,295757,,3591,1641973,295757,,0,0,0,PDN
EI268,,2012,1997,,3591,1641973,295757,,3591,1641973,295757,,0,0,0,PDN
EI268,,2013,1997,,3591,1641973,295757,,3591,1641973,295757,,0,0,0,PDN
EI268,,2014,1997,,3591,1641973,295757,,3591,1641973,295757,,0,0,0,PDN
EI268,,2015,1997,,3591,1641973,295757,,3591,1641973,295757,,0,0,0,PDN
EI268,,2016,1997,,3591,1641973,295757,,3591,1641973,295757,,0,0,0,PDN
EI268,,2017,1997,,3591,1641973,295757,,3591,1641973,295757,,0,0,0,PDN
EI268,,2017,1997,,3591,1641973,295757,,3591,1641973,295757,,0,0,0,PDN
EI273,,1975,1963,,2000000,400000000,73174377,,672980,172853620,31429852,,1327020,227146380,41744525,PDN
EI273,,1976,1963,,2000000,400000000,73174377,,761893,206476111,37501415,,1238107,193523889,35672962,PDN
EI273,,1977,1963,,1680838,456543922,82916411,,665130,232349929,42008534,,1015708,224193993,40907877,PDN
EI273,,1978,1963,,1703087,471581567,85614398,,723411,259240032,46851531,,979676,212341535,38762867,PDN
EI273,,1979,1963,,943855,474452452,85365999,,577066,277211637,49902980,,366789,197240815,35463019,PDN
EI273,,1980,1963,,1098158,491952452,88634181,,590081,292846738,52698041,,508077,199105714,35936140,PDN
EI273,,1981,1963,,1099352,492754994,88778177,,590081,301266738,54196262,,509271,191488256,34581915,PDN
EI273,,1982,1963,,1099352,492752452,88777724,,644435,319320710,57463067,,454917,173431742,31314657,PDN
EI273,,1983,1963,,1869352,515834138,93654786,,797614,332769326,60009238,,1071738,183064812,33645548,PDN
EI273,,1984,1963,,1797535,564009388,102155077,,957608,351036067,63419542,,839927,212973321,38735535,PDN
EI273,,1985,1963,,1962032,577391655,104700761,,1053278,365224767,66039891,,908754,212166888,38660870,PDN
EI273,,1986,1963,,2036099,577534553,104800254,,1121507,377262968,68250149,,914592,200271585,36550105,PDN
EI273,,1987,1963,,2007712,580063462,105221851,,1177529,391636939,70863817,,830183,188426523,34358034,PDN
EI273,,1988,1963,,1950787,514752824,93543816,,1195360,400905287,72530820,,755427,113847537,21012996,PDN
EI273,,1989,1963,,1739708,493701516,89586953,,1233431,416866891,75409034,,506277,76834625,14177919,PDN
EI273,,1990,1963,,1778318,507185918,92024923,,1254129,433158772,78328644,,524189,74027146,13696279,PDN
EI273,,1991,1963,,1839735,516983505,93829683,,1283192,446634969,80755606,,556543,70348536,13074077,PDN
EI273,,1992,1963,,1626124,530301642,95985847,,1353872,461612323,83491296,,272252,68689319,12494551,PDN
EI273,,1993,1963,,1712176,620784982,112172137,,1427054,493851432,89300974,,285122,126933550,22871163,PDN
EI273,,1994,1963,,1854992,653903429,118207915,,1536376,527998862,95486351,,318616,125904567,22721564,PDN
EI273,,1995,1963,,1846804,644573244,116539552,,1626282,551468731,99752391,,220522,93104513,16787161,PDN
EI273,,1996,1963,,2090489,697209006,126149031,,1738791,572958155,103688641,,351698,124250851,22460390,PDN
EI273,,1997,1963,,2106623,700469642,126745349,,1790191,593188835,107339806,,316432,107280807,19405543,PDN
EI273,,1998,1963,,2862000,761991286,138447638,,1997651,615431370,111505012,,864349,146559916,26942626,PDN
EI273,,1999,1963,,2753312,705436086,128275747,,2093315,630787428,114333071,,659997,74648658,13942676,PDN
EI273,,2000,1963,,2397819,662853064,120343204,,2157220,638769089,115817200,,240599,24083975,4526004,PDN
EI273,,2001,1963,,2275648,669236401,121356858,,2197648,643953274,116780081,,78000,25283127,4576777,PDN
EI273,,2002,1963,,2362370,686411400,124499630,,2222529,647341423,117407836,,139841,39069977,7091794,PDN
EI273,,2003,1963,,2397435,688271234,124865626,,2258797,656103568,119003204,,138638,32167666,5862422,PDN
EI273,,2004,1963,,2307168,695868046,126127105,,2270327,663254614,120287162,,36841,32613432,5839943,PDN
EI273,,2005,1963,,2291221,695662193,126074529,,2273460,667912112,121119032,,17761,27750081,4955497,PDN
EI273,,2006,1963,,2288521,695329007,126012543,,2273566,669904659,121473683,,14955,25424348,4538860,PDN
EI273,,2007,1963,,2374115,705870334,127973818,,2310269,679852397,123280446,,63846,26017937,4693372,PDN
EI273,,2008,1963,,2374176,705880519,127975692,,2330227,684649306,124153947,,43949,21231213,3821745,PDN
EI273,,2009,1963,,2381130,744167925,134795352,,2351820,700638652,127020619,,29310,43529273,7774732,PDN
EI273,,2010,1963,,2374462,729525259,132183227,,2359813,704516788,127718670,,14649,25008471,4464554,PDN
EI273,,2011,1963,,2375424,730335727,132328400,,2363724,705992626,127985186,,11700,24343101,4343214,PDN
EI273,,2012,1963,,2375424,722047664,130853656,,2365855,706736281,128119640,,9569,15311383,2734015,PDN
EI273,,2013,1963,,2365855,706736281,128119640,,2365855,706736281,128119640,,0,0,0,PDN
EI273,,2014,1963,,2365855,706736281,128119640,,2365855,706736281,128119640,,0,0,0,PDN
EI273,,2015,1963,,2365855,706736281,128119640,,2365855,706736281,128119640,,0,0,0,PDN
EI273,,2016,1963,,2365855,706736281,128119640,,2365855,706736281,128119640,,0,0,0,PDN
EI273,,2017,1963,,2365855,706736281,128119640,,2365855,706736281,128119640,,0,0,0,PDN
EI273,,2017,1963,,2365855,706736281,128119640,,2365855,706736281,128119640,,0,0,0,PDN
EI276,,1975,1963,,91000000,159978000,119465836,,53330188,124438371,75472247,,37669812,35539629,43993589,PDP
EI276,,1976,1963,,81386311,204391343,117754877,,57668668,136240613,81910770,,23717643,68150730,35844107,PDP
EI276,,1977,1963,,83304586,211688513,120971581,,60905273,149308362,87472597,,22399313,62380151,33498984,PDP
EI276,,1978,1963,,86069356,233019182,127531844,,63157632,160587170,91731862,,22911724,72432012,35799982,PDP
EI276,,1979,1963,,82992637,236411852,125058803,,63774378,173044501,94565214,,19218259,63367351,30493589,PDP
EI276,,1980,1963,,83244410,239211115,125808665,,65948489,181943224,98322728,,17295921,57267891,27485937,PDP
EI276,,1981,1963,,84825529,251671448,129606925,,67794032,189489258,101510982,,17031497,62182190,28095943,PDP
EI276,,1982,1963,,101036694,256865217,146742249,,69438589,196019014,104317417,,31598105,60846203,42424832,PDP
EI276,,1983,1963,,104278546,283114430,154654779,,71012416,201530794,106871988,,33266130,81583636,47782791,PDP
EI276,,1984,1963,,108352445,293661398,160605363,,72346085,207865675,109332860,,36006360,85795723,51272503,PDP
EI276,,1985,1963,,109605494,325031241,167440234,,73436412,212121729,111180492,,36169082,112909512,56259742,PDP
EI276,,1986,1963,,111842816,328422664,170281012,,74616860,215820546,113019092,,37225956,112602118,57261920,PDP
EI276,,1987,1963,,118479490,351233447,180976545,,76200150,221436745,115601706,,42279340,129796702,65374839,PDP
EI276,,1988,1963,,119391881,354902594,182541809,,78058776,228655153,118744746,,41333105,126247441,63797063,PDP
EI276,,1989,1963,,90935704,275242536,139911244,,79646066,234920840,121446927,,11289638,40321696,18464317,PDP
EI276,,1990,1963,,91292275,279096649,140953600,,81072454,242450622,124213134,,10219821,36646027,16740466,PDP
EI276,,1991,1963,,92066239,294531983,144474065,,82221926,246923414,126158477,,9844313,47608569,18315588,PDP
EI276,,1992,1963,,97992844,302508426,151819966,,83980357,251553692,128740800,,14012487,50954734,23079166,PDP
EI276,,1993,1963,,101670245,290486321,153358202,,87212789,256792934,132905482,,14457456,33693387,20452720,PDP
EI276,,1994,1963,,103010073,299974079,156386244,,90037615,262700235,136781429,,12972458,37273844,19604815,PDP
EI276,,1995,1963,,104363639,308423063,159243188,,92609296,276452390,141800113,,11754343,31970673,17443075,PDP
EI276,,1996,1963,,105930567,326626778,164049211,,94959810,286854922,146001611,,10970757,39771856,18047600,PDP
EI276,,1997,1963,,107052494,361302602,171341213,,97247934,297173135,150125716,,9804560,64129467,21215497,PDP
EI276,,1998,1963,,109599645,372941024,175959258,,99916639,315056181,155976458,,9683006,57884843,19982800,PDP
EI276,,1999,1963,,111740181,379846260,179328483,,104531050,339317957,164907911,,7209131,40528303,14420572,PDP
EI276,,2000,1963,,114419298,395085942,184719288,,107175511,356952524,170690195,,7243787,38133418,14029093,PDP
EI276,,2001,1963,,113184613,390999939,182757556,,108971900,366446977,174175988,,4212713,24552962,8581568,PDP
EI276,,2002,1963,,114814200,394355965,184984301,,110096607,372761859,176424340,,4717593,21594106,8559961,PDP
EI276,,2003,1963,,114679459,394966795,184958248,,111390475,377743933,178604698,,3288984,17222862,6353550,PDP
EI276,,2004,1963,,114080574,389914360,183460353,,112447980,381318600,180298265,,1632594,8595760,3162088,PDP
EI276,,2005,1963,,115929859,405149086,188020444,,113112567,383128854,181284961,,2817292,22020232,6735483,PDP
EI276,,2006,1963,,115686451,404904821,187733572,,113481727,385637011,182100412,,2204724,19267810,5633160,PDP
EI276,,2007,1963,,115691497,392996612,185619720,,113909924,389664168,183245185,,1781573,3332444,2374535,PDP
EI276,,2008,1963,,116830535,397857549,187623693,,114187999,391383523,183829195,,2642536,6474026,3794498,PDP
EI276,,2009,1963,,116964610,404725820,188979884,,114553494,398885637,185529590,,2411116,5840183,3450295,PDP
EI276,,2010,1963,,121633314,418904874,196171550,,115500109,400097047,186691756,,6133205,18807827,9479793,PDP
EI276,,2011,1963,,121801883,420578254,196637873,,117191338,402673600,188841448,,4610545,17904654,7796424,PDP
EI276,,2012,1963,,121911892,422449549,197080852,,118251702,409194146,191062051,,3660190,13255403,6018802,PDP
EI276,,2013,1963,,122469645,422806456,197702112,,119071372,412652243,192497041,,3398273,10154213,5205072,PDP
EI276,,2014,1963,,123914146,427353849,199955757,,119906385,415035058,193756040,,4007761,12318791,6199718,PDP
EI276,,2015,1963,,125795706,430641710,202422345,,120783911,417908639,195144877,,5011795,12733071,7277465,PDP
EI276,,2016,1963,,126508926,431600509,203306169,,121728008,420065275,196472720,,4780918,11535234,6833450,PDP
EI276,,2017,1963,,126799010,426518958,202692065,,122530883,421249435,197486299,,4268127,5269523,5205766,PDP
EI276,,2017,1963,,126799010,426518958,202692065,,122530883,421249435,197486299,,4268127,5269523,5205766,PDP
EI280,,2003,2003,,268412,6710288,1462413,,0,0,0,,268412,6710288,1462413,PDN
EI280,,2004,2003,,268412,6710288,1462413,,0,0,0,,268412,6710288,1462413,PDN
EI280,,2005,2003,,654086,6540863,1817941,,287026,2394807,713148,,367060,4146056,1104793,PDN
EI280,,2006,2003,,654086,6540863,1817941,,532576,4581420,1347775,,121510,1959443,470166,PDN
EI280,,2007,2003,,654086,6540863,1817941,,619201,5564724,1609365,,34885,976139,208576,PDN
EI280,,2008,2003,,1080461,13073582,3406721,,735904,7297658,2034420,,344557,5775924,1372301,PDN
EI280,,2009,2003,,1102114,13335577,3474992,,735950,7299028,2034709,,366164,6036549,1440283,PDN
EI280,,2010,2003,,1102114,13335577,3474992,,886748,9459329,2569903,,215366,3876248,905090,PDN
EI280,,2011,2003,,1102114,13335577,3474992,,931679,10296890,2763866,,170435,3038687,711127,PDN
EI280,,2012,2003,,1102114,13335577,3474992,,956058,10893100,2894332,,146056,2442477,580660,PDN
EI280,,2013,2003,,1102114,13335577,3474992,,960290,10990940,2915973,,141824,2344637,559019,PDN
EI280,,2014,2003,,1102114,13335577,3474992,,960290,10990940,2915973,,141824,2344637,559019,PDN
EI280,,2015,2003,,960290,10990940,2915973,,960290,10990940,2915973,,0,0,0,PDN
EI280,,2016,2003,,960290,10990940,2915973,,960290,10990940,2915973,,0,0,0,PDN
EI280,,2017,2003,,960290,10990940,2915973,,960290,10990940,2915973,,0,0,0,PDN
EI280,,2017,2003,,960290,10990940,2915973,,960290,10990940,2915973,,0,0,0,PDN
EI287,,1989,1985,,40225,4022475,755968,,0,0,0,,40225,4022475,755968,PDN
EI287,,1990,1985,,53145,5185296,975796,,188,253461,45288,,52957,4931835,930508,PDN
EI287,,1991,1985,,188,261078,46643,,188,261078,46643,,0,0,0,PDN
EI287,,1992,1985,,188,261078,46643,,188,261078,46643,,0,0,0,PDN
EI287,,1993,1985,,188,261078,46643,,188,261078,46643,,0,0,0,PDN
EI287,,1994,1985,,188,261078,46643,,188,261078,46643,,0,0,0,PDN
EI287,,1995,1985,,57617,11337386,2074945,,1074,750725,134655,,56543,10586661,1940290,PDN
EI287,,1996,1985,,12971,7325800,1316494,,4438,2392530,430155,,8533,4933270,886339,PDN
EI287,,1997,1985,,12971,7325800,1316494,,8049,4226232,760048,,4922,3099568,556446,PDN
EI287,,1998,1985,,12971,7325800,1316494,,10005,5359533,963659,,2966,1966267,352835,PDN
EI287,,1999,1985,,12971,7325800,1316494,,10465,5593761,1005796,,2506,1732039,310698,PDN
EI287,,2000,1985,,12971,7325800,1316494,,10465,5593761,1005796,,2506,1732039,310698,PDN
EI287,,2001,1985,,12971,7325800,1316494,,10465,5593761,1005796,,2506,1732039,310698,PDN
EI287,,2002,1985,,12971,7325800,1316494,,10465,5593761,1005796,,2506,1732039,310698,PDN
EI287,,2003,1985,,12971,7325800,1316494,,10465,5593761,1005796,,2506,1732039,310698,PDN
EI287,,2004,1985,,12971,7325800,1316494,,10465,5593761,1005796,,2506,1732039,310698,PDN
EI287,,2005,1985,,10465,5593761,1005796,,10465,5593761,1005796,,0,0,0,PDN
EI287,,2006,1985,,10465,5593761,1005796,,10465,5593761,1005796,,0,0,0,PDN
EI287,,2007,1985,,10465,5593761,1005796,,10465,5593761,1005796,,0,0,0,PDN
EI287,,2008,1985,,10465,5593761,1005796,,10465,5593761,1005796,,0,0,0,PDN
EI287,,2009,1985,,10465,5697341,1024226,,10465,5697341,1024226,,0,0,0,PDN
EI287,,2010,1985,,10465,5697341,1024226,,10465,5697341,1024226,,0,0,0,PDN
EI287,,2011,1985,,10465,5697341,1024226,,10465,5697341,1024226,,0,0,0,PDN
EI287,,2012,1985,,10465,5697341,1024226,,10465,5697341,1024226,,0,0,0,PDN
EI287,,2013,1985,,10465,5697341,1024226,,10465,5697341,1024226,,0,0,0,PDN
EI287,,2014,1985,,10465,5697341,1024226,,10465,5697341,1024226,,0,0,0,PDN
EI287,,2015,1985,,10465,5697341,1024226,,10465,5697341,1024226,,0,0,0,PDN
EI287,,2016,1985,,10465,5697341,1024226,,10465,5697341,1024226,,0,0,0,PDN
EI287,,2017,1985,,10465,5697341,1024226,,10465,5697341,1024226,,0,0,0,PDN
EI287,,2017,1985,,10465,5697341,1024226,,10465,5697341,1024226,,0,0,0,PDN
EI288,,2000,2000,,25590,3787199,699469,,0,0,0,,25590,3787199,699469,PDN
EI288,,2001,2000,,38590,4343796,811507,,18006,2459137,455575,,20584,1884659,355932,PDN
EI288,,2002,2000,,38590,4343796,811507,,21043,3527872,648778,,17547,815924,162729,PDN
EI288,,2003,2000,,31195,5676059,1041170,,21897,3902700,716328,,9298,1773359,324842,PDN
EI288,,2004,2000,,31195,5676059,1041170,,23186,4509240,825542,,8009,1166819,215628,PDN
EI288,,2005,2000,,31195,5676059,1041170,,23564,4857881,887956,,7631,818178,153214,PDN
EI288,,2006,2000,,31195,5676059,1041170,,23920,5077839,927450,,7275,598220,113720,PDN
EI288,,2007,2000,,31195,5676059,1041170,,24453,5231291,955288,,6742,444768,85882,PDN
EI288,,2008,2000,,31224,5681345,1042139,,24547,5257162,959985,,6677,424183,82154,PDN
EI288,,2009,2000,,24547,5257162,959985,,24547,5257162,959985,,0,0,0,PDN
EI288,,2010,2000,,24547,5257162,959985,,24547,5257162,959985,,0,0,0,PDN
EI288,,2011,2000,,24547,5257162,959985,,24547,5257162,959985,,0,0,0,PDN
EI288,,2012,2000,,24547,5257162,959985,,24547,5257162,959985,,0,0,0,PDN
EI288,,2013,2000,,24547,5257162,959985,,24547,5257162,959985,,0,0,0,PDN
EI288,,2014,2000,,24547,5257162,959985,,24547,5257162,959985,,0,0,0,PDN
EI288,,2015,2000,,24547,5257162,959985,,24547,5257162,959985,,0,0,0,PDN
EI288,,2016,2000,,24547,5257162,959985,,24547,5257162,959985,,0,0,0,PDN
EI288,,2017,2000,,24547,5257162,959985,,24547,5257162,959985,,0,0,0,PDN
EI288,,2017,2000,,24547,5257162,959985,,24547,5257162,959985,,0,0,0,PDN
EI289,,1993,1991,,162454,14620839,2764027,,0,0,0,,162454,14620839,2764027,PDN
EI289,,1994,1991,,162454,14620839,2764027,,0,0,0,,162454,14620839,2764027,PDN
EI289,,1995,1991,,162454,14620839,2764027,,0,0,0,,162454,14620839,2764027,PDN
EI289,,2009,1991,,7547,2308017,418226,,7191,1998022,362711,,356,309995,55515,PDN
EI289,,2010,1991,,7547,2308017,418226,,7547,2308017,418226,,0,0,0,PDN
EI289,,2011,1991,,31240,4653974,859349,,12189,2779757,506808,,19051,1874217,352542,PDN
EI289,,2012,1991,,32628,9698170,1758281,,15048,3582260,652461,,17580,6115910,1105820,PDN
EI289,,2013,1991,,16426,8042113,1447407,,15091,4646306,841836,,1335,3395807,605571,PDN
EI289,,2014,1991,,16426,8042113,1447407,,15091,5791166,1045547,,1335,2250947,401859,PDN
EI289,,2015,1991,,16426,8042113,1447407,,15091,6498561,1171418,,1335,1543552,275988,PDN
EI289,,2016,1991,,15091,6498561,1171418,,15091,6498561,1171418,,0,0,0,PDN
EI289,,2017,1991,,15091,6498561,1171418,,15091,6498561,1171418,,0,0,0,PDN
EI289,,2017,1991,,15091,6498561,1171418,,15091,6498561,1171418,,0,0,0,PDN
EI292,,1975,1964,,879852,1080905320,193211759,,95462,510952891,91012347,,784390,569952429,102199412,PDP
EI292,,1976,1964,,879852,1080905320,193211759,,124598,612414302,109095114,,755254,468491018,84116645,PDP
EI292,,1977,1964,,5895223,1117051792,204658887,,1273977,694185201,124794475,,4621246,422866591,79864412,PDP
EI292,,1978,1964,,5926041,1144764412,209620776,,2095211,764693642,138161695,,3830830,380070770,71459081,PDP
EI292,,1979,1964,,6364566,1152302712,211400636,,2900395,841119511,152565788,,3464171,311183201,58834848,PDP
EI292,,1980,1964,,6373146,1169924712,214544803,,3384728,899610910,163457844,,2988418,270313802,51086959,PDP
EI292,,1981,1964,,6477177,1169982312,214659083,,3829035,946768410,172293165,,2648142,223213902,42365918,PDP
EI292,,1982,1964,,10556399,1216700923,227051225,,4214085,982981399,179121807,,6342314,233719524,47929418,PDP
EI292,,1983,1964,,11719954,1232072909,230950009,,5017279,1014958374,185614854,,6702675,217114535,45335155,PDP
EI292,,1984,1964,,14869965,1241502988,235777970,,5493575,1055418953,193290542,,9376390,186084035,42487428,PDP
EI292,,1985,1964,,17256906,1393744688,265254181,,5878743,1085557063,199038363,,11378163,308187625,66215818,PDP
EI292,,1986,1964,,17270363,1395090419,265507092,,6819878,1114532982,205135355,,10450485,280557437,60371737,PDP
EI292,,1987,1964,,17420613,1412509301,268756788,,7967123,1178364817,217640578,,9453490,234144484,51116210,PDP
EI292,,1988,1964,,17489578,1445026477,274611727,,9000339,1234535666,228668607,,8489239,210490811,45943120,PDP
EI292,,1989,1964,,15989365,1644576122,308618568,,9616355,1285913146,238426523,,6373010,358662976,70192045,PDP
EI292,,1990,1964,,17177524,1646456415,310141299,,10442958,1321969726,245668888,,6734566,324486689,64472411,PDP
EI292,,1991,1964,,18699437,1607036384,304648972,,11504420,1354784726,252569318,,7195017,252251658,52079654,PDP
EI292,,1992,1964,,19826473,1621869716,308415390,,12450231,1387798957,259389547,,7376242,234070759,49025843,PDP
EI292,,1993,1964,,17451319,1621503401,305975056,,13213688,1415293008,265045184,,4237631,206210393,40929872,PDP
EI292,,1994,1964,,17378277,1631750348,307725314,,13816150,1437518825,269602418,,3562127,194231523,38122896,PDP
EI292,,1995,1964,,18515188,1650696149,312233364,,14470310,1462864039,274766402,,4044878,187832110,37466962,PDP
EI292,,1996,1964,,18342858,1669862438,315471406,,14925836,1487742827,279648759,,3417022,182119611,35822647,PDP
EI292,,1997,1964,,18436474,1678481765,317098710,,15335947,1516888914,285245006,,3100527,161592851,31853704,PDP
EI292,,1998,1964,,18259751,1677424551,316733870,,15680934,1531825130,288247683,,2578817,145599421,28486187,PDP
EI292,,1999,1964,,18306894,1605352884,303956873,,16049124,1539628964,290004456,,2257770,65723920,13952417,PDP
EI292,,2000,1964,,18784681,1633156542,309381931,,16610400,1556468335,293562061,,2174281,76688207,15819870,PDP
EI292,,2001,1964,,19068356,1634126425,309838183,,17216005,1577605454,297928719,,1852351,56520971,11909464,PDP
EI292,,2002,1964,,19070333,1631596092,309389923,,17635904,1588874045,300353706,,1434429,42722047,9036217,PDP
EI292,,2003,1964,,19073729,1633436473,309720789,,17889771,1597014998,302056141,,1183958,36421475,7664648,PDP
EI292,,2004,1964,,18981860,1632712835,309500158,,18107791,1603059494,303349694,,874069,29653341,6150464,PDP
EI292,,2005,1964,,19121820,1618122123,307043906,,18236711,1606806040,304145259,,885109,11316083,2898647,PDP
EI292,,2006,1964,,19116976,1618273161,307065937,,18344912,1609444820,304722994,,772064,8828341,2342943,PDP
EI292,,2007,1964,,18982779,1617589613,306810113,,18435455,1611406023,305162505,,547324,6183590,1647608,PDP
EI292,,2008,1964,,19107693,1617505601,306920078,,18484834,1613354125,305558522,,622859,4151476,1361556,PDP
EI292,,2009,1964,,20548209,1649406335,314036881,,18656614,1644039611,311190353,,1891595,5366724,2846528,PDP
EI292,,2010,1964,,20536955,1649316479,314009637,,18973336,1644262175,311546676,,1563619,5054304,2462961,PDP
EI292,,2011,1964,,20536955,1649316479,314009637,,19298129,1644531682,311919424,,1238826,4784797,2090213,PDP
EI292,,2012,1964,,20609036,1649420196,314100173,,19612481,1644758592,312274151,,996555,4661604,1826023,PDP
EI292,,2013,1964,,20572191,1649046593,313996850,,19867008,1644930028,312559183,,705183,4116565,1437667,PDP
EI292,,2014,1964,,23589090,1653257020,317762936,,21063279,1646071128,313958497,,2525811,7185892,3804439,PDP
EI292,,2015,1964,,25247830,1655625758,319843159,,22548929,1648384813,315855833,,2698901,7240945,3987326,PDP
EI292,,2016,1964,,26121806,1657239023,321004194,,23632859,1649770509,317186329,,2488947,7468514,3817862,PDP
EI292,,2017,1964,,26783807,1657869362,321778354,,24392434,1650629655,318098778,,2391373,7239707,3679577,PDP
EI292,,2017,1964,,26783807,1657869362,321778354,,24392434,1650629655,318098778,,2391373,7239707,3679577,PDP
EI294,,1979,1977,,0,10000000,1779359,,0,0,0,,0,10000000,1779359,PDN
EI294,,1980,1977,,10000,10000000,1789359,,0,0,0,,10000,10000000,1789359,PDN
EI294,,1981,1977,,10000,10000000,1789359,,0,655943,116716,,10000,9344057,1672643,PDN
EI294,,1982,1977,,10000,10000000,1789359,,0,5483556,975722,,10000,4516444,813637,PDN
EI294,,1983,1977,,0,99963564,17787111,,0,9827489,1748664,,0,90136075,16038447,PDN
EI294,,1984,1977,,0,102294351,18201842,,0,16762283,2982613,,0,85532068,15219229,PDN
EI294,,1985,1977,,0,104625151,18616575,,0,19085638,3396021,,0,85539513,15220554,PDN
EI294,,1986,1977,,0,104625151,18616575,,0,19873239,3536164,,0,84751912,15080411,PDN
EI294,,1987,1977,,0,104625151,18616575,,0,20686382,3680851,,0,83938769,14935724,PDN
EI294,,1988,1977,,0,106934969,19027575,,0,24613330,4379596,,0,82321639,14647979,PDN
EI294,,1989,1977,,0,106934969,19027575,,0,27164443,4833531,,0,79770526,14194044,PDN
EI294,,1990,1977,,0,33243792,5915265,,0,28439079,5060334,,0,4804713,854931,PDN
EI294,,1991,1977,,25625,35550053,6351257,,0,28829725,5129844,,25625,6720328,1221413,PDN
EI294,,1992,1977,,50598,32601520,5851580,,20461,30456772,5439815,,30137,2144748,411765,PDN
EI294,,1993,1977,,50598,32601520,5851580,,22640,30956065,5530837,,27958,1645455,320743,PDN
EI294,,1994,1977,,50598,32601520,5851580,,22640,31032976,5544522,,27958,1568544,307058,PDN
EI294,,1995,1977,,22640,31521895,5631518,,22640,31086597,5554063,,0,435298,77455,PDN
EI294,,1996,1977,,22640,31521895,5631518,,22640,31122597,5560469,,0,399298,71049,PDN
EI294,,1997,1977,,22640,31521895,5631518,,22640,31213043,5576562,,0,308852,54956,PDN
EI294,,1998,1977,,22640,31521895,5631518,,22640,31270839,5586846,,0,251056,44672,PDN
EI294,,1999,1977,,0,29598085,5266563,,0,29405108,5232226,,0,192977,34337,PDN
EI294,,2000,1977,,0,29598085,5266563,,0,29417791,5234482,,0,180294,32081,PDN
EI294,,2001,1977,,0,29598085,5266563,,0,29441221,5238651,,0,156864,27912,PDN
EI294,,2002,1977,,0,29598085,5266563,,0,29441221,5238651,,0,156864,27912,PDN
EI294,,2003,1977,,876,31684109,5638618,,0,29653735,5276465,,876,2030374,362153,PDN
EI294,,2004,1977,,1017,36306502,6461249,,432,32086270,5709733,,585,4220232,751516,PDN
EI294,,2005,1977,,1012,36067932,6418793,,532,32874871,5850153,,480,3193061,568640,PDN
EI294,,2006,1977,,532,32874871,5850153,,532,32874871,5850153,,0,0,0,PDN
EI294,,2007,1977,,532,32874871,5850153,,532,32874871,5850153,,0,0,0,PDN
EI294,,2008,1977,,532,32874871,5850153,,532,32874871,5850153,,0,0,0,PDN
EI294,,2009,1977,,532,33462276,5954674,,532,33462276,5954674,,0,0,0,PDN
EI294,,2010,1977,,532,33462276,5954674,,532,33462276,5954674,,0,0,0,PDN
EI294,,2011,1977,,532,33462276,5954674,,532,33462276,5954674,,0,0,0,PDN
EI294,,2012,1977,,532,33462276,5954674,,532,33462276,5954674,,0,0,0,PDN
EI294,,2013,1977,,532,33462276,5954674,,532,33462276,5954674,,0,0,0,PDN
EI294,,2014,1977,,532,33462276,5954674,,532,33462276,5954674,,0,0,0,PDN
EI294,,2015,1977,,532,33462276,5954674,,532,33462276,5954674,,0,0,0,PDN
EI294,,2016,1977,,532,33462276,5954674,,532,33462276,5954674,,0,0,0,PDN
EI294,,2017,1977,,532,33462276,5954674,,532,33462276,5954674,,0,0,0,PDN
EI294,,2017,1977,,532,33462276,5954674,,532,33462276,5954674,,0,0,0,PDN
EI296,,1975,1971,,26750028,1475000000,289205544,,6501483,418984153,81053823,,20248545,1056015847,208151721,PDN
EI296,,1976,1971,,26650028,1470000000,288215864,,8503337,582349351,112124218,,18146691,887650649,176091646,PDN
EI296,,1977,1971,,29090230,1320532415,264060411,,17184071,728370814,146787419,,11906159,592161601,117272992,PDN
EI296,,1978,1971,,29090230,1320532415,264060411,,18520812,816220425,163755763,,10569418,504311990,100304648,PDN
EI296,,1979,1971,,20744310,1210381561,236114695,,11420708,865418036,165409682,,9323602,344963525,70705013,PDN
EI296,,1980,1971,,21372174,1226021565,239525477,,13253787,937801918,180122456,,8118387,288219647,59403021,PDN
EI296,,1981,1971,,24776745,1312085628,258243939,,14716473,999561920,192574466,,10060272,312523708,65669473,PDN
EI296,,1982,1971,,24990693,1320727271,259995545,,15885866,1058393225,204212063,,9104827,262334046,55783482,PDN
EI296,,1983,1971,,24968014,1321791115,260162163,,16622296,1105675079,213361634,,8345718,216116036,46800529,PDN
EI296,,1984,1971,,25552415,1333692123,262864181,,17219227,1148672772,221609400,,8333188,185019351,41254781,PDN
EI296,,1985,1971,,28822690,1370934468,272761207,,17590640,1177284397,227071849,,11232050,193650071,45689358,PDN
EI296,,1986,1971,,28841516,1373334415,273207070,,17829065,1193471318,230190509,,11012451,179863097,43016561,PDN
EI296,,1987,1971,,28664606,1390859865,276148568,,18162329,1212708498,233946759,,10502277,178151367,42201809,PDN
EI296,,1988,1971,,30585977,1457621139,289949169,,18502034,1230282458,237413503,,12083943,227338681,52535666,PDN
EI296,,1989,1971,,28648534,1460972289,288608016,,18879830,1252592956,241761139,,9768704,208379333,46846877,PDN
EI296,,1990,1971,,27148317,1437638314,282955846,,19078025,1267187192,244556173,,8070292,170451122,38399673,PDN
EI296,,1991,1971,,20657980,1376733402,265628336,,19291011,1279316060,246927321,,1366969,97417342,18701015,PDN
EI296,,1992,1971,,21014676,1388810680,268134014,,19438615,1287970495,248614860,,1576061,100840185,19519154,PDN
EI296,,1993,1971,,21022477,1466810680,282020819,,19578850,1295035943,250012292,,1443627,171774737,32008527,PDN
EI296,,1994,1971,,21236792,1514735188,290762626,,19678577,1325397125,255514364,,1558215,189338063,35248262,PDN
EI296,,1995,1971,,20834422,1432523991,275731929,,19827842,1345065934,259163417,,1006580,87458057,16568512,PDN
EI296,,1996,1971,,20833039,1429897253,275263155,,19930655,1357675685,261509958,,902384,72221568,13753197,PDN
EI296,,1997,1971,,20824283,1394309192,268922004,,19999169,1363731109,262655950,,825114,30578083,6266054,PDN
EI296,,1998,1971,,20824292,1394582650,268970671,,20045297,1368786669,263601644,,778995,25795981,5369027,PDN
EI296,,1999,1971,,20801917,1397812807,269523057,,20090226,1372626380,264329795,,711691,25186427,5193262,PDN
EI296,,2000,1971,,20239116,1403045607,269891360,,20112360,1379593120,265591563,,126756,23452487,4299797,PDN
EI296,,2001,1971,,20442730,1411620971,271620839,,20122115,1386071544,266754062,,320615,25549427,4866777,PDN
EI296,,2002,1971,,20441516,1416002129,272399191,,20179003,1391540884,267784143,,262513,24461245,4615048,PDN
EI296,,2003,1971,,20441542,1418305904,272809141,,20223827,1400139533,269358975,,217715,18166371,3450166,PDN
EI296,,2004,1971,,20312073,1420228480,273021767,,20257388,1407008329,270614742,,54685,13220151,2407025,PDN
EI296,,2005,1971,,20314297,1420796263,273125020,,20269328,1410339777,271219466,,44969,10456486,1905554,PDN
EI296,,2006,1971,,20318970,1421619428,273276164,,20279418,1413554169,271801512,,39552,8065259,1474652,PDN
EI296,,2007,1971,,20510136,1425713162,274195752,,20296142,1417122856,272453234,,213994,8590306,1742518,PDN
EI296,,2008,1971,,20569015,1433766747,275687654,,20411385,1421196202,273293271,,157630,12570545,2394383,PDN
EI296,,2009,1971,,20676216,1461959615,280811378,,20466666,1451202482,278687747,,209550,10757133,2123629,PDN
EI296,,2010,1971,,20575850,1469995379,282140863,,20512189,1456633189,279699589,,63661,13362190,2441274,PDN
EI296,,2011,1971,,20575850,1469995379,282140863,,20542673,1460416453,280403252,,33177,9578926,1737612,PDN
EI296,,2012,1971,,20575850,1469995379,282140863,,20550383,1463006569,280871836,,25467,6988810,1269028,PDN
EI296,,2013,1971,,20562046,1466172053,281446752,,20553093,1464005716,281052330,,8953,2166337,394422,PDN
EI296,,2014,1971,,20562046,1466172053,281446752,,20553093,1464005716,281052330,,8953,2166337,394422,PDN
EI296,,2015,1971,,20553093,1464005716,281052330,,20553093,1464005716,281052330,,0,0,0,PDN
EI296,,2016,1971,,20553093,1464005716,281052330,,20553093,1464005716,281052330,,0,0,0,PDN
EI296,,2017,1971,,20553093,1464005716,281052330,,20553093,1464005716,281052330,,0,0,0,PDN
EI296,,2017,1971,,20553093,1464005716,281052330,,20553093,1464005716,281052330,,0,0,0,PDN
EI297,,1982,1980,,0,7000000,1245552,,0,0,0,,0,7000000,1245552,PDN
EI297,,1983,1980,,0,7000000,1245552,,0,0,0,,0,7000000,1245552,PDN
EI297,,1984,1980,,725023,61336893,11639061,,0,0,0,,725023,61336893,11639061,PDN
EI297,,1985,1980,,733974,62679616,11886931,,0,0,0,,733974,62679616,11886931,PDN
EI297,,1986,1980,,733974,62679616,11886931,,0,0,0,,733974,62679616,11886931,PDN
EI297,,1987,1980,,733974,62679616,11886931,,0,1382042,245915,,733974,61297574,11641016,PDN
EI297,,1988,1980,,6212,62119915,11059578,,294,9930160,1767226,,5918,52189755,9292352,PDN
EI297,,1989,1980,,262271,70734699,12848516,,7652,22454730,4003156,,254619,48279969,8845360,PDN
EI297,,1990,1980,,286079,95434529,17267312,,93553,40286666,7261999,,192526,55147863,10005313,PDN
EI297,,1991,1980,,1106201,105777104,19927750,,375537,54019700,9987583,,730664,51757404,9940167,PDN
EI297,,1992,1980,,1127248,105171470,19841033,,698339,63993141,12085019,,428909,41178329,7756014,PDN
EI297,,1993,1980,,1557021,107589336,20701031,,1037603,70913343,13655636,,519418,36675993,7045395,PDN
EI297,,1994,1980,,2183743,101360811,20219474,,1404497,77838108,15254694,,779246,23522703,4964780,PDN
EI297,,1995,1980,,2213515,90395884,18298192,,1749934,82206972,16377509,,463581,8188912,1920683,PDN
EI297,,1996,1980,,2769651,91583599,19065665,,2152487,84553244,17197548,,617164,7030355,1868117,PDN
EI297,,1997,1980,,2769665,94682033,19617002,,2560956,86454007,17944231,,208709,8228026,1672771,PDN
EI297,,1998,1980,,4096901,95497761,21089385,,3057231,87873307,18693051,,1039670,7624454,2396334,PDN
EI297,,1999,1980,,4093661,91241067,20328726,,3563175,88596381,19327656,,530486,2644686,1001070,PDN
EI297,,2000,1980,,4725489,103769684,23189846,,4027493,93319390,20632367,,697996,10450294,2557479,PDN
EI297,,2001,1980,,4725519,113887703,24990235,,4398223,100198250,22227093,,327296,13689453,2763142,PDN
EI297,,2002,1980,,5477816,114695229,25886220,,4685828,104074861,23204487,,791988,10620368,2681733,PDN
EI297,,2003,1980,,5478470,118484598,26561139,,4892964,108614456,24219380,,585506,9870142,2341759,PDN
EI297,,2004,1980,,5427960,130509669,28650321,,5011877,113531039,25213129,,416083,16978630,3437192,PDN
EI297,,2005,1980,,5420579,130188050,28585712,,5126025,117463494,26027003,,294554,12724556,2558709,PDN
EI297,,2006,1980,,5509894,129609028,28571999,,5217869,119928528,26557465,,292025,9680500,2014534,PDN
EI297,,2007,1980,,5490146,120795977,26984092,,5309051,120474913,26745868,,181095,321064,238224,PDN
EI297,,2008,1980,,5490146,120795977,26984092,,5378355,120663550,26848738,,111791,132427,135354,PDN
EI297,,2009,1980,,5491062,122814066,27344099,,5378364,122453024,27167159,,112698,361042,176940,PDN
EI297,,2010,1980,,5491062,122814066,27344099,,5465492,122629817,27285745,,25570,184249,58354,PDN
EI297,,2011,1980,,5866538,124697524,28054711,,5528680,122697946,27361055,,337858,1999578,693655,PDN
EI297,,2012,1980,,5866538,124697524,28054711,,5603846,122746897,27444932,,262692,1950627,609779,PDN
EI297,,2013,1980,,5866538,124736652,28061673,,5669487,122828290,27525055,,197051,1908362,536617,PDN
EI297,,2014,1980,,5866538,124736652,28061673,,5733281,122906617,27602786,,133257,1830035,458887,PDN
EI297,,2015,1980,,6004641,123224444,27930699,,5799539,122993496,27684503,,205102,230948,246196,PDN
EI297,,2016,1980,,5800676,123001013,27686977,,5800676,123001013,27686977,,0,0,0,PDN
EI297,,2017,1980,,5800676,123001013,27686977,,5800676,123001013,27686977,,0,0,0,PDN
EI297,,2017,1980,,5800676,123001013,27686977,,5800676,123001013,27686977,,0,0,0,PDN
EI299,,1982,1980,,245041,22053680,4169183,,29957,2743598,518142,,215084,19310082,3651041,PDN
EI299,,1983,1980,,245041,22053680,4169183,,50315,6893184,1276860,,194726,15160496,2892323,PDN
EI299,,1984,1980,,77324,9408211,1751383,,72216,8976062,1669380,,5108,432149,82003,PDN
EI299,,1985,1980,,72216,8976062,1669380,,72216,8976062,1669380,,0,0,0,PDN
EI299,,1986,1980,,72216,8976062,1669380,,72216,8976062,1669380,,0,0,0,PDN
EI299,,1987,1980,,72216,8976062,1669380,,72216,8976062,1669380,,0,0,0,PDN
EI299,,1988,1980,,72216,8976062,1669380,,72216,8976062,1669380,,0,0,0,PDN
EI299,,1989,1980,,72216,8976062,1669380,,72216,8976062,1669380,,0,0,0,PDN
EI299,,1990,1980,,72216,8976062,1669380,,72216,8976062,1669380,,0,0,0,PDN
EI299,,1991,1980,,72216,8976062,1669380,,72216,8976062,1669380,,0,0,0,PDN
EI299,,1992,1980,,72216,8976062,1669380,,72216,8976062,1669380,,0,0,0,PDN
EI299,,1993,1980,,79824,12616876,2324820,,79824,12616876,2324820,,0,0,0,PDN
EI299,,1994,1980,,79824,12616876,2324820,,79824,12616876,2324820,,0,0,0,PDN
EI299,,1995,1980,,79824,12616876,2324820,,79824,12616876,2324820,,0,0,0,PDN
EI299,,1996,1980,,79824,12616876,2324820,,79824,12616876,2324820,,0,0,0,PDN
EI299,,1997,1980,,79824,12616876,2324820,,79824,12616876,2324820,,0,0,0,PDN
EI299,,1998,1980,,79824,12616876,2324820,,79824,12616876,2324820,,0,0,0,PDN
EI299,,1999,1980,,79824,12616876,2324820,,79824,12616876,2324820,,0,0,0,PDN
EI299,,2000,1980,,79824,12616876,2324820,,79824,12616876,2324820,,0,0,0,PDN
EI299,,2001,1980,,79824,12616876,2324820,,79824,12616876,2324820,,0,0,0,PDN
EI299,,2002,1980,,79824,12616876,2324820,,79824,12616876,2324820,,0,0,0,PDN
EI299,,2003,1980,,79824,12616876,2324820,,79824,12616876,2324820,,0,0,0,PDN
EI299,,2004,1980,,79824,12616876,2324820,,79824,12616876,2324820,,0,0,0,PDN
EI299,,2005,1980,,79824,12616876,2324820,,79824,12616876,2324820,,0,0,0,PDN
EI299,,2006,1980,,79824,12616876,2324820,,79824,12616876,2324820,,0,0,0,PDN
EI299,,2007,1980,,79824,12616876,2324820,,79824,12616876,2324820,,0,0,0,PDN
EI299,,2008,1980,,79824,12616876,2324820,,79824,12616876,2324820,,0,0,0,PDN
EI299,,2009,1980,,79824,12869561,2369781,,79824,12869561,2369781,,0,0,0,PDN
EI299,,2010,1980,,79824,12869561,2369781,,79824,12869561,2369781,,0,0,0,PDN
EI299,,2011,1980,,79824,12869561,2369781,,79824,12869561,2369781,,0,0,0,PDN
EI299,,2012,1980,,79824,12869561,2369781,,79824,12869561,2369781,,0,0,0,PDN
EI299,,2013,1980,,79824,12869561,2369781,,79824,12869561,2369781,,0,0,0,PDN
EI299,,2014,1980,,79824,12869561,2369781,,79824,12869561,2369781,,0,0,0,PDN
EI299,,2015,1980,,79824,12869561,2369781,,79824,12869561,2369781,,0,0,0,PDN
EI299,,2016,1980,,79824,12869561,2369781,,79824,12869561,2369781,,0,0,0,PDN
EI299,,2017,1980,,79824,12869561,2369781,,79824,12869561,2369781,,0,0,0,PDN
EI299,,2017,1980,,79824,12869561,2369781,,79824,12869561,2369781,,0,0,0,PDN
EI300,,1988,1979,,16935,17100181,3059672,,15535,15081325,2699045,,1400,2018856,360627,PDN
EI300,,1989,1979,,16272,21386596,3821716,,15730,16492339,2950310,,542,4894257,871406,PDN
EI300,,1990,1979,,17248,33482211,5974937,,16120,20724134,3703688,,1128,12758077,2271249,PDN
EI300,,1991,1979,,17248,33482211,5974937,,16184,23777299,4247020,,1064,9704912,1727917,PDN
EI300,,1992,1979,,17248,33482211,5974937,,16653,25635322,4578098,,595,7846889,1396839,PDN
EI300,,1993,1979,,12746,29841397,5322603,,9638,23316702,4158517,,3108,6524695,1164086,PDN
EI300,,1994,1979,,10544,26974902,4810349,,9965,24302742,4334296,,579,2672160,476053,PDN
EI300,,1995,1979,,10544,26974902,4810349,,9965,24465059,4363178,,579,2509843,447171,PDN
EI300,,1996,1979,,9965,24462252,4362679,,9965,24462252,4362679,,0,0,0,PDN
EI300,,1997,1979,,9965,24462252,4362679,,9965,24462252,4362679,,0,0,0,PDN
EI300,,1998,1979,,9965,24462252,4362679,,9965,24462252,4362679,,0,0,0,PDN
EI300,,1999,1979,,9965,24462252,4362679,,9965,24462252,4362679,,0,0,0,PDN
EI300,,2000,1979,,9965,24462252,4362679,,9965,24462252,4362679,,0,0,0,PDN
EI300,,2001,1979,,11833,41067008,7319130,,9965,24462252,4362679,,1868,16604756,2956451,PDN
EI300,,2002,1979,,16704,45514711,8115407,,11390,28642012,5107833,,5314,16872699,3007574,PDN
EI300,,2003,1979,,16704,45514711,8115407,,13793,34565351,6164211,,2911,10949360,1951196,PDN
EI300,,2004,1979,,16704,45514711,8115407,,14444,37998045,6775662,,2260,7516666,1339745,PDN
EI300,,2005,1979,,16704,45514711,8115407,,14927,40123532,7154346,,1777,5391179,961061,PDN
EI300,,2006,1979,,16704,45514711,8115407,,15222,42879286,7644988,,1482,2635425,470419,PDN
EI300,,2007,1979,,16704,45514711,8115407,,15417,44305553,7898967,,1287,1209158,216440,PDN
EI300,,2008,1979,,16704,45514711,8115407,,15422,44754283,7978818,,1282,760428,136589,PDN
EI300,,2009,1979,,15422,45244193,8065991,,15422,45244193,8065991,,0,0,0,PDN
EI300,,2010,1979,,15422,45244193,8065991,,15422,45244193,8065991,,0,0,0,PDN
EI300,,2011,1979,,15422,45244193,8065991,,15422,45244193,8065991,,0,0,0,PDN
EI300,,2012,1979,,15422,45244193,8065991,,15422,45244193,8065991,,0,0,0,PDN
EI300,,2013,1979,,15422,45244193,8065991,,15422,45244193,8065991,,0,0,0,PDN
EI300,,2014,1979,,15422,45244193,8065991,,15422,45244193,8065991,,0,0,0,PDN
EI300,,2015,1979,,15422,45244193,8065991,,15422,45244193,8065991,,0,0,0,PDN
EI300,,2016,1979,,15422,45244193,8065991,,15422,45244193,8065991,,0,0,0,PDN
EI300,,2017,1979,,15422,45244193,8065991,,15422,45244193,8065991,,0,0,0,PDN
EI300,,2017,1979,,15422,45244193,8065991,,15422,45244193,8065991,,0,0,0,PDN
EI304,,2004,2004,,6671,5870752,1051289,,4750,4644567,831185,,1921,1226185,220104,PDP
EI304,,2005,2004,,6671,5870752,1051289,,6371,5611648,1004885,,300,259104,46404,PDP
EI304,,2006,2004,,38534,8243338,1505320,,8660,6024802,1080689,,29874,2218536,424631,PDP
EI304,,2007,2004,,38501,8155377,1489636,,19499,6844450,1237373,,19002,1310927,252263,PDP
EI304,,2008,2004,,23439,8065988,1458668,,23439,8065988,1458668,,0,0,0,PDP
EI304,,2009,2004,,23439,8066175,1458701,,23439,8066175,1458701,,0,0,0,PDP
EI304,,2010,2004,,23439,8066175,1458701,,23439,8066175,1458701,,0,0,0,PDP
EI304,,2011,2004,,23439,8066175,1458701,,23439,8066175,1458701,,0,0,0,PDP
EI304,,2012,2004,,34608,8412764,1531541,,33927,8369277,1523122,,681,43487,8419,PDP
EI304,,2013,2004,,59052,8750909,1616153,,41870,8728066,1594907,,17182,22843,21247,PDP
EI304,,2014,2004,,140803,9240189,1784965,,58017,8759833,1616706,,82786,480356,168259,PDP
EI304,,2015,2004,,204545,9558897,1905417,,95749,8795448,1660776,,108796,763449,244641,PDP
EI304,,2016,2004,,278468,9558897,1979340,,129620,8821818,1699339,,148848,737079,280001,PDP
EI304,,2017,2004,,135906,8829707,1707029,,135906,8829707,1707029,,0,0,0,PDP
EI304,,2017,2004,,135906,8829707,1707029,,135906,8829707,1707029,,0,0,0,PDP
EI306,,1975,1971,,10739544,343803726,71914584,,1283086,49752177,10135787,,9456458,294051549,61778797,PDP
EI306,,1976,1971,,10739544,343803726,71914584,,2073975,86325515,17434387,,8665569,257478211,54480197,PDP
EI306,,1977,1971,,12679404,384573593,81108869,,3843842,124429928,25984399,,8835562,260143665,55124470,PDP
EI306,,1978,1971,,13331297,463656576,95832467,,4650738,188260985,38149134,,8680559,275395591,57683333,PDP
EI306,,1979,1971,,12285946,487556576,99039785,,4005542,258641352,50027135,,8280404,228915224,49012650,PDP
EI306,,1980,1971,,18129135,552985800,116525185,,4538943,310481187,59784706,,13590192,242504613,56740479,PDP
EI306,,1981,1971,,12339135,593009370,117856816,,4981450,347360377,66789346,,7357685,245648993,51067470,PDP
EI306,,1982,1971,,12462492,620559370,122882309,,5363117,376717993,72394788,,7099375,243841377,50487521,PDP
EI306,,1983,1971,,12759798,629203633,124717740,,5896690,405324309,78018453,,6863108,223879324,46699287,PDP
EI306,,1984,1971,,13544357,667568654,132328815,,6460939,440930504,84918324,,7083418,226638150,47410491,PDP
EI306,,1985,1971,,15311199,705182096,140788440,,6981188,475590326,91605801,,8330011,229591770,49182639,PDP
EI306,,1986,1971,,14970914,716906143,142534285,,7326763,500449430,96374704,,7644151,216456713,46159581,PDP
EI306,,1987,1971,,12091236,644527491,126775843,,7741215,528994583,101868365,,4350021,115532908,24907478,PDP
EI306,,1988,1971,,12136001,669222195,131214683,,8402734,557846567,107663689,,3733267,111375628,23550994,PDP
EI306,,1989,1971,,12293890,685541231,134276315,,8975747,580683541,112300220,,3318143,104857690,21976095,PDP
EI306,,1990,1971,,14465733,715826533,141837002,,9487939,597852903,115867459,,4977794,117973630,25969543,PDP
EI306,,1991,1971,,14803119,719644173,142853684,,9941214,613072121,119028780,,4861905,106572052,23824904,PDP
EI306,,1992,1971,,14774831,722555967,143343508,,10337665,626809660,121869633,,4437166,95746307,21473875,PDP
EI306,,1993,1971,,14767378,724004510,143593803,,10708859,640701607,124712704,,4058519,83302903,18881099,PDP
EI306,,1994,1971,,14914701,764727435,150987198,,11110526,670441494,130406166,,3804175,94285941,20581032,PDP
EI306,,1995,1971,,15304749,771201976,152529300,,11578311,694464986,135148593,,3726438,76736990,17380707,PDP
EI306,,1996,1971,,15321884,772502827,152777903,,12041464,706223107,137703939,,3280420,66279720,15073964,PDP
EI306,,1997,1971,,15350069,781793014,154459146,,12628471,710119756,138984299,,2721598,71673258,15474847,PDP
EI306,,1998,1971,,16303921,895718546,175684445,,13370504,721334485,141721836,,2933417,174384061,33962609,PDP
EI306,,1999,1971,,15995901,749164326,149299162,,13893513,725036476,142903562,,2102388,24127850,6395600,PDP
EI306,,2000,1971,,16577643,748272854,149722279,,14383710,727499400,143832002,,2193933,20773454,5890277,PDP
EI306,,2001,1971,,16797462,749386654,150140283,,14641690,728794597,144320444,,2155772,20592057,5819839,PDP
EI306,,2002,1971,,16996940,745693730,149682657,,14783226,729158137,144526667,,2213714,16535593,5155990,PDP
EI306,,2003,1971,,16945817,745725354,149637161,,14969147,729856763,144836898,,1976670,15868591,4800263,PDP
EI306,,2004,1971,,16949816,745756353,149646676,,15152068,730421256,145120263,,1797748,15335097,4526413,PDP
EI306,,2005,1971,,16558032,742951430,148755795,,15260801,730693198,145277384,,1297231,12258232,3478411,PDP
EI306,,2006,1971,,16617553,743203222,148860119,,15311597,731015513,145385532,,1305956,12187709,3474587,PDP
EI306,,2007,1971,,16632929,739605626,148235354,,15353253,731768315,145561138,,1279676,7837311,2674216,PDP
EI306,,2008,1971,,17672889,744297739,150110209,,15512337,734479173,146202581,,2160552,9818566,3907628,PDP
EI306,,2009,1971,,16946379,756153027,151493181,,15684168,750123128,149158034,,1262211,6029899,2335146,PDP
EI306,,2010,1971,,16946379,756153027,151493181,,16035645,752329580,149902117,,910734,3823447,1591063,PDP
EI306,,2011,1971,,16946379,756153027,151493181,,16173761,752452289,150062068,,772618,3700738,1431112,PDP
EI306,,2012,1971,,16946379,756153027,151493181,,16404323,754219242,150607034,,542056,1933785,886145,PDP
EI306,,2013,1971,,16946379,756153027,151493181,,16589005,755901633,151091073,,357374,251394,402107,PDP
EI306,,2014,1971,,16741671,756716389,151388716,,16637344,756185241,151189877,,104327,531148,198837,PDP
EI306,,2015,1971,,16919287,756684378,151560635,,16646074,756202113,151201609,,273213,482265,359026,PDP
EI306,,2016,1971,,16919275,757092388,151633222,,16780308,756516503,151391784,,138967,575885,241438,PDP
EI306,,2017,1971,,17083370,757684661,151902704,,16891046,756827669,151557890,,192324,856992,344814,PDP
EI306,,2017,1971,,17083370,757684661,151902704,,16891046,756827669,151557890,,192324,856992,344814,PDP
EI311,,1984,1982,,691,5806227,1033827,,0,0,0,,691,5806227,1033827,PDN
EI311,,1985,1982,,151204,5806227,1184340,,8632,256890,54342,,142572,5549337,1129998,PDN
EI311,,1986,1982,,251196,10870584,2185464,,81393,3387596,684168,,169803,7482988,1501296,PDN
EI311,,1987,1982,,94683,4020719,810113,,94683,4020719,810113,,0,0,0,PDN
EI311,,1988,1982,,94683,4020719,810113,,94683,4020719,810113,,0,0,0,PDN
EI311,,1989,1982,,94683,4020719,810113,,94683,4020719,810113,,0,0,0,PDN
EI311,,1990,1982,,94683,4020719,810113,,94683,4020719,810113,,0,0,0,PDN
EI311,,1991,1982,,94683,4020719,810113,,94683,4020719,810113,,0,0,0,PDN
EI311,,1992,1982,,94683,4020719,810113,,94683,4020719,810113,,0,0,0,PDN
EI311,,1993,1982,,94683,4020719,810113,,94683,4020719,810113,,0,0,0,PDN
EI311,,1994,1982,,94683,4020719,810113,,94683,4020719,810113,,0,0,0,PDN
EI311,,1995,1982,,94683,4020719,810113,,94683,4020719,810113,,0,0,0,PDN
EI311,,1996,1982,,94683,4020719,810113,,94683,4020719,810113,,0,0,0,PDN
EI311,,1997,1982,,94683,4020719,810113,,94683,4020719,810113,,0,0,0,PDN
EI311,,1998,1982,,94683,4020719,810113,,94683,4020719,810113,,0,0,0,PDN
EI311,,1999,1982,,94683,4020719,810113,,94683,4020719,810113,,0,0,0,PDN
EI311,,2000,1982,,94683,4020719,810113,,94683,4020719,810113,,0,0,0,PDN
EI311,,2001,1982,,94683,4020719,810113,,94683,4020719,810113,,0,0,0,PDN
EI311,,2002,1982,,94683,4020719,810113,,94683,4020719,810113,,0,0,0,PDN
EI311,,2003,1982,,94683,4020719,810113,,94683,4020719,810113,,0,0,0,PDN
EI311,,2004,1982,,94683,4020719,810113,,94683,4020719,810113,,0,0,0,PDN
EI311,,2005,1982,,94683,4020719,810113,,94683,4020719,810113,,0,0,0,PDN
EI311,,2006,1982,,94683,4020719,810113,,94683,4020719,810113,,0,0,0,PDN
EI311,,2007,1982,,94683,4020719,810113,,94683,4020719,810113,,0,0,0,PDN
EI311,,2008,1982,,94683,4020719,810113,,94683,4020719,810113,,0,0,0,PDN
EI311,,2009,1982,,94683,4101242,824442,,94683,4101242,824442,,0,0,0,PDN
EI311,,2010,1982,,94683,4101242,824442,,94683,4101242,824442,,0,0,0,PDN
EI311,,2011,1982,,94683,4101242,824442,,94683,4101242,824442,,0,0,0,PDN
EI311,,2012,1982,,94683,4101242,824442,,94683,4101242,824442,,0,0,0,PDN
EI311,,2013,1982,,94683,4101242,824442,,94683,4101242,824442,,0,0,0,PDN
EI311,,2014,1982,,94683,4101242,824442,,94683,4101242,824442,,0,0,0,PDN
EI311,,2015,1982,,94683,4101242,824442,,94683,4101242,824442,,0,0,0,PDN
EI311,,2016,1982,,94683,4101242,824442,,94683,4101242,824442,,0,0,0,PDN
EI311,,2017,1982,,94683,4101242,824442,,94683,4101242,824442,,0,0,0,PDN
EI311,,2017,1982,,94683,4101242,824442,,94683,4101242,824442,,0,0,0,PDN
EI321,,1980,1978,,18400,18400000,3292421,,0,0,0,,18400,18400000,3292421,PDN
EI321,,1981,1978,,63448,18400000,3337469,,13850,4737468,856816,,49598,13662532,2480653,PDN
EI321,,1982,1978,,133604,40507600,7341362,,28689,10218538,1846934,,104915,30289062,5494428,PDN
EI321,,1983,1978,,133604,40507600,7341362,,36398,14379593,2595044,,97206,26128007,4746318,PDN
EI321,,1984,1978,,133604,40507600,7341362,,41068,20297939,3652801,,92536,20209661,3688561,PDN
EI321,,1985,1978,,133604,40507600,7341362,,44511,23090423,4153127,,89093,17417177,3188235,PDN
EI321,,1986,1978,,44553,23092765,4153586,,44553,23092765,4153586,,0,0,0,PDN
EI321,,1987,1978,,44553,23092765,4153586,,44553,23092765,4153586,,0,0,0,PDN
EI321,,1988,1978,,44553,23092765,4153586,,44553,23092765,4153586,,0,0,0,PDN
EI321,,1989,1978,,44553,23092765,4153586,,44553,23092765,4153586,,0,0,0,PDN
EI321,,1990,1978,,44553,23092765,4153586,,44553,23092765,4153586,,0,0,0,PDN
EI321,,1991,1978,,44553,23092765,4153586,,44553,23092765,4153586,,0,0,0,PDN
EI321,,1992,1978,,44553,23092765,4153586,,44553,23092765,4153586,,0,0,0,PDN
EI321,,1993,1978,,44553,23092765,4153586,,44553,23092765,4153586,,0,0,0,PDN
EI321,,1994,1978,,44553,23092765,4153586,,44553,23092765,4153586,,0,0,0,PDN
EI321,,1995,1978,,44553,23092765,4153586,,44553,23092765,4153586,,0,0,0,PDN
EI321,,1996,1978,,44553,23092765,4153586,,44553,23092765,4153586,,0,0,0,PDN
EI321,,1997,1978,,44553,23092765,4153586,,44553,23092765,4153586,,0,0,0,PDN
EI321,,1998,1978,,44553,23092765,4153586,,44553,23092765,4153586,,0,0,0,PDN
EI321,,1999,1978,,44553,23092765,4153586,,44553,23092765,4153586,,0,0,0,PDN
EI321,,2000,1978,,44553,23092765,4153586,,44553,23092765,4153586,,0,0,0,PDN
EI321,,2001,1978,,44553,23092765,4153586,,44553,23092765,4153586,,0,0,0,PDN
EI321,,2002,1978,,44553,23092765,4153586,,44553,23092765,4153586,,0,0,0,PDN
EI321,,2003,1978,,44553,23092765,4153586,,44553,23092765,4153586,,0,0,0,PDN
EI321,,2004,1978,,44553,23092765,4153586,,44553,23092765,4153586,,0,0,0,PDN
EI321,,2005,1978,,44553,23092765,4153586,,44553,23092765,4153586,,0,0,0,PDN
EI321,,2006,1978,,44553,23092765,4153586,,44553,23092765,4153586,,0,0,0,PDN
EI321,,2007,1978,,44553,23092765,4153586,,44553,23092765,4153586,,0,0,0,PDN
EI321,,2008,1978,,44553,23092765,4153586,,44553,23092765,4153586,,0,0,0,PDN
EI321,,2009,1978,,44553,23555247,4235878,,44553,23555247,4235878,,0,0,0,PDN
EI321,,2010,1978,,44553,23555247,4235878,,44553,23555247,4235878,,0,0,0,PDN
EI321,,2011,1978,,44553,23555247,4235878,,44553,23555247,4235878,,0,0,0,PDN
EI321,,2012,1978,,44553,23555247,4235878,,44553,23555247,4235878,,0,0,0,PDN
EI321,,2013,1978,,44553,23555247,4235878,,44553,23555247,4235878,,0,0,0,PDN
EI321,,2014,1978,,44553,23555247,4235878,,44553,23555247,4235878,,0,0,0,PDN
EI321,,2015,1978,,44553,23555247,4235878,,44553,23555247,4235878,,0,0,0,PDN
EI321,,2016,1978,,44553,23555247,4235878,,44553,23555247,4235878,,0,0,0,PDN
EI321,,2017,1978,,44553,23555247,4235878,,44553,23555247,4235878,,0,0,0,PDN
EI321,,2017,1978,,44553,23555247,4235878,,44553,23555247,4235878,,0,0,0,PDN
EI322,,1975,1968,,0,86100000,15320285,,0,0,0,,0,86100000,15320285,PDP
EI322,,1976,1968,,0,46032360,8190811,,0,0,0,,0,46032360,8190811,PDP
EI322,,1977,1968,,0,46032360,8190811,,0,0,0,,0,46032360,8190811,PDP
EI322,,1978,1968,,0,46032360,8190811,,0,0,0,,0,46032360,8190811,PDP
EI322,,1979,1968,,194245,78105320,14091989,,10572,2317630,422962,,183673,75787690,13669027,PDP
EI322,,1980,1968,,194245,78115759,14093846,,36151,9131067,1660896,,158094,68984692,12432950,PDP
EI322,,1981,1968,,815927,150453444,27587002,,83998,25053972,4542000,,731929,125399472,23045002,PDP
EI322,,1982,1968,,815927,150453444,27587002,,104543,32985048,5973769,,711384,117468396,21613233,PDP
EI322,,1983,1968,,693937,178430457,32443129,,158248,51907204,9394405,,535689,126523253,23048724,PDP
EI322,,1984,1968,,727060,187728669,34130738,,199935,78257834,14124816,,527125,109470835,20005922,PDP
EI322,,1985,1968,,660801,188663831,34230878,,235250,98720587,17801191,,425551,89943244,16429687,PDP
EI322,,1986,1968,,659185,207363993,37556693,,258016,124098510,22339601,,401169,83265483,15217092,PDP
EI322,,1987,1968,,512571,267920354,48185232,,272592,146344747,26312583,,239979,121575607,21872649,PDP
EI322,,1988,1968,,512994,268375466,48266636,,282994,161208609,28967800,,230000,107166857,19298836,PDP
EI322,,1989,1968,,512994,268375466,48266636,,291784,171270000,30766873,,221210,97105466,17499763,PDP
EI322,,1990,1968,,346230,244022593,43766620,,299042,179928318,32314757,,47188,64094275,11451863,PDP
EI322,,1991,1968,,346651,237666171,42636005,,304561,187042755,33586190,,42090,50623416,9049815,PDP
EI322,,1992,1968,,457866,246366631,44295345,,392565,201017037,36160721,,65301,45349594,8134624,PDP
EI322,,1993,1968,,723247,264627924,47810066,,573372,218146596,39389492,,149875,46481328,8420574,PDP
EI322,,1994,1968,,915217,283613008,51380165,,710656,231351966,41876486,,204561,52261042,9503679,PDP
EI322,,1995,1968,,909041,277255578,50242774,,734221,234571744,42472965,,174820,42683834,7769809,PDP
EI322,,1996,1968,,1218953,305340720,55550042,,771188,245444233,44444539,,447765,59896487,11105503,PDP
EI322,,1997,1968,,1297738,331447558,60274172,,870989,260403341,47206103,,426749,71044217,13068069,PDP
EI322,,1998,1968,,1318019,340034338,61822350,,926484,275566926,49959745,,391535,64467412,11862605,PDP
EI322,,1999,1968,,1260445,310808422,56564434,,938307,282494524,51204237,,322138,28313898,5360197,PDP
EI322,,2000,1968,,3400996,396654316,73980055,,1096361,291986280,53051215,,2304635,104668036,20928840,PDP
EI322,,2001,1968,,4511971,404574065,76500238,,2549932,346750915,64249383,,1962039,57823150,12250855,PDP
EI322,,2002,1968,,4434074,401212018,75824112,,2943864,359014973,66825532,,1490210,42197045,8998580,PDP
EI322,,2003,1968,,4986280,402959727,76687299,,3670169,368069618,69162984,,1316111,34890109,7524315,PDP
EI322,,2004,1968,,5710023,403943931,77586167,,4341107,373091355,70727469,,1368916,30852576,6858698,PDP
EI322,,2005,1968,,6778526,405769279,78979465,,4860918,380183322,72509196,,1917608,25585957,6470269,PDP
EI322,,2006,1968,,6920115,429223120,83294335,,5519371,394999178,75803922,,1400744,34223942,7490413,PDP
EI322,,2007,1968,,6920115,429223120,83294335,,5993173,407026738,78417859,,926942,22196382,4876476,PDP
EI322,,2008,1968,,6921471,429223120,83295691,,6080884,409464480,78939332,,840587,19758640,4356359,PDP
EI322,,2009,1968,,6975791,437372755,84800125,,6094757,417167198,80323796,,881034,20205557,4476328,PDP
EI322,,2010,1968,,6972202,436149323,84578843,,6116665,418617134,80603699,,855537,17532189,3975144,PDP
EI322,,2011,1968,,6972202,436149323,84578843,,6118200,418704992,80620867,,854002,17444331,3957975,PDP
EI322,,2012,1968,,6972202,436149323,84578843,,6187543,418820298,80710727,,784659,17329025,3868114,PDP
EI322,,2013,1968,,6832771,423112937,82119770,,6263208,418930755,80806046,,569563,4182182,1313723,PDP
EI322,,2014,1968,,6832771,423112937,82119770,,6414972,419144795,80995895,,417799,3968142,1123874,PDP
EI322,,2015,1968,,7143747,423517206,82502680,,6625129,419442789,81259076,,518618,4074417,1243603,PDP
EI322,,2016,1968,,7143747,423769874,82547639,,6802353,419700810,81482211,,341394,4069064,1065426,PDP
EI322,,2017,1968,,7594033,423984575,83036127,,6969411,419956915,81694840,,624622,4027660,1341287,PDP
EI322,,2017,1968,,7594033,423984575,83036127,,6969411,419956915,81694840,,624622,4027660,1341287,PDP
EI324,,1990,1976,,4446928,13794160,6901405,,60059,547099,157408,,4386869,13247061,6743997,PDN
EI324,,1991,1976,,4438777,13085112,6767089,,355423,2756683,845936,,4083354,10328429,5921153,PDN
EI324,,1992,1976,,4414595,14023013,6909793,,551638,3838908,1234718,,3862957,10184105,5675075,PDN
EI324,,1993,1976,,4414595,14023013,6909793,,722335,4299928,1487447,,3692260,9723085,5422346,PDN
EI324,,1994,1976,,4441601,14173773,6963625,,901988,4438931,1691833,,3539613,9734842,5271792,PDN
EI324,,1995,1976,,2195960,7124229,3463616,,1057935,4586373,1874016,,1138025,2537856,1589600,PDN
EI324,,1996,1976,,2196066,7110571,3461292,,1110234,4646489,1937011,,1085832,2464082,1524281,PDN
EI324,,1997,1976,,2196066,7282333,3491855,,1153428,4691262,1988172,,1042638,2591071,1503683,PDN
EI324,,1998,1976,,2190827,6849720,3409638,,1319379,4801469,2173733,,871448,2048251,1235905,PDN
EI324,,1999,1976,,2190924,6858644,3411323,,1445335,4900018,2317224,,745589,1958626,1094099,PDN
EI324,,2000,1976,,2190930,6859139,3411417,,1542743,5002310,2432834,,648187,1856829,978583,PDN
EI324,,2001,1976,,1930652,5982867,2995219,,1622657,5179390,2544257,,307995,803477,450962,PDN
EI324,,2002,1976,,1930652,5982867,2995219,,1675011,5233918,2606313,,255641,748949,388906,PDN
EI324,,2003,1976,,1930652,5982867,2995219,,1678773,5233918,2610075,,251879,748949,385144,PDN
EI324,,2004,1976,,1930652,5982867,2995219,,1678773,5233918,2610075,,251879,748949,385144,PDN
EI324,,2005,1976,,1684297,5578584,2676928,,1678773,5233918,2610075,,5524,344666,66853,PDN
EI324,,2006,1976,,1679270,6746944,2879794,,1679013,5671467,2688171,,257,1075477,191623,PDN
EI324,,2007,1976,,1679270,6746944,2879794,,1679024,6000158,2746668,,246,746786,133126,PDN
EI324,,2008,1976,,1679270,6746944,2879794,,1679027,6152606,2773797,,243,594338,105997,PDN
EI324,,2009,1976,,1679357,6335672,2806702,,1679335,6280438,2796852,,22,55234,9850,PDN
EI324,,2010,1976,,1679335,6280438,2796852,,1679335,6280438,2796852,,0,0,0,PDN
EI324,,2011,1976,,1679335,6280438,2796852,,1679335,6280438,2796852,,0,0,0,PDN
EI324,,2012,1976,,1679335,6280438,2796852,,1679335,6280438,2796852,,0,0,0,PDN
EI324,,2013,1976,,1679335,6280438,2796852,,1679335,6280438,2796852,,0,0,0,PDN
EI324,,2014,1976,,1679335,6280438,2796852,,1679335,6280438,2796852,,0,0,0,PDN
EI324,,2015,1976,,1679335,6280438,2796852,,1679335,6280438,2796852,,0,0,0,PDN
EI324,,2016,1976,,1679335,6280438,2796852,,1679335,6280438,2796852,,0,0,0,PDN
EI324,,2017,1976,,1679335,6280438,2796852,,1679335,6280438,2796852,,0,0,0,PDN
EI324,,2017,1976,,1679335,6280438,2796852,,1679335,6280438,2796852,,0,0,0,PDN
EI325,,1976,1974,,0,7000000,1245552,,0,0,0,,0,7000000,1245552,PDN
EI325,,1977,1974,,0,7000000,1245552,,0,0,0,,0,7000000,1245552,PDN
EI325,,1989,1974,,2650778,84425534,17673115,,0,0,0,,2650778,84425534,17673115,PDN
EI325,,1990,1974,,2717423,90423607,18807033,,180925,5096390,1087756,,2536498,85327217,17719277,PDN
EI325,,1991,1974,,2540247,79143239,16622674,,505719,17824021,3677253,,2034528,61319218,12945421,PDN
EI325,,1992,1974,,2586651,88564092,18345386,,676591,26874600,5458548,,1910060,61689492,12886838,PDN
EI325,,1993,1974,,2368439,82027346,16964052,,974143,37282974,7608124,,1394296,44744372,9355928,PDN
EI325,,1994,1974,,2242684,108878421,21616069,,1157342,47110044,9539912,,1085342,61768377,12076157,PDN
EI325,,1995,1974,,2252397,101693332,20347296,,1283348,56616845,11357520,,969049,45076487,8989776,PDN
EI325,,1996,1974,,2230160,105606671,21021383,,1380983,65905156,13107879,,849177,39701515,7913504,PDN
EI325,,1997,1974,,2230103,107116804,21290033,,1453543,72240275,14307684,,776560,34876529,6982349,PDN
EI325,,1998,1974,,2233685,110597990,21913043,,1506391,76031978,15035213,,727294,34566012,6877830,PDN
EI325,,1999,1974,,2041292,101120747,20034307,,1558664,77865040,15413653,,482628,23255707,4620654,PDN
EI325,,2000,1974,,1791273,90958431,17976047,,1600975,79083744,15672816,,190298,11874687,2303231,PDN
EI325,,2001,1974,,1791273,90959531,17976243,,1623231,80148549,15884539,,168042,10810982,2091704,PDN
EI325,,2002,1974,,1791273,90959531,17976243,,1636230,80493017,15958831,,155043,10466514,2017412,PDN
EI325,,2003,1974,,1802723,91824387,18141582,,1645271,82066704,16247887,,157452,9757683,1893695,PDN
EI325,,2004,1974,,1770318,90009464,17786237,,1654924,83425212,16499268,,115394,6584252,1286969,PDN
EI325,,2005,1974,,1824946,89722859,17789868,,1680752,83977081,16623293,,144194,5745778,1166575,PDN
EI325,,2006,1974,,1824946,89722859,17789868,,1716422,85443191,16919837,,108524,4279668,870031,PDN
EI325,,2007,1974,,1783827,89485146,17706451,,1751880,87411819,17305584,,31947,2073327,400867,PDN
EI325,,2008,1974,,1783827,89485146,17706451,,1778153,88984243,17611648,,5674,500903,94803,PDN
EI325,,2009,1974,,1781702,92438221,18229786,,1780235,91585260,18076547,,1467,852961,153239,PDN
EI325,,2010,1974,,1781702,92438221,18229786,,1781643,92199689,18187284,,59,238532,42502,PDN
EI325,,2011,1974,,1781702,92438221,18229786,,1781702,92239452,18194418,,0,198769,35368,PDN
EI325,,2012,1974,,1781702,92438221,18229786,,1781702,92239452,18194418,,0,198769,35368,PDN
EI325,,2013,1974,,1781702,92239452,18194418,,1781702,92239452,18194418,,0,0,0,PDN
EI325,,2014,1974,,1781702,92239452,18194418,,1781702,92239452,18194418,,0,0,0,PDN
EI325,,2015,1974,,1781702,92239452,18194418,,1781702,92239452,18194418,,0,0,0,PDN
EI325,,2016,1974,,1781702,92239452,18194418,,1781702,92239452,18194418,,0,0,0,PDN
EI325,,2017,1974,,1781702,92239452,18194418,,1781702,92239452,18194418,,0,0,0,PDN
EI325,,2017,1974,,1781702,92239452,18194418,,1781702,92239452,18194418,,0,0,0,PDN
EI327,,1976,1975,,2100000,18897900,5462616,,0,0,0,,2100000,18897900,5462616,PDP
EI327,,1977,1975,,1988502,29594344,7254400,,0,0,0,,1988502,29594344,7254400,PDP
EI327,,1978,1975,,1988502,29594344,7254400,,0,0,0,,1988502,29594344,7254400,PDP
EI327,,1979,1975,,1988502,29594344,7254400,,0,0,0,,1988502,29594344,7254400,PDP
EI327,,1980,1975,,1975072,30295714,7365768,,97477,600629,204350,,1877595,29695085,7161418,PDP
EI327,,1981,1975,,1975572,30775714,7451678,,394458,2305352,804663,,1581114,28470362,6647015,PDP
EI327,,1982,1975,,1915533,25815273,6508998,,642195,3814525,1320936,,1273338,22000748,5188062,PDP
EI327,,1983,1975,,1961333,27457302,6846974,,831915,5007817,1722986,,1129418,22449485,5123988,PDP
EI327,,1984,1975,,2095614,32654302,7905988,,1008879,6477989,2161546,,1086735,26176313,5744442,PDP
EI327,,1985,1975,,2095614,32654302,7905988,,1164929,7425148,2486130,,930685,25229154,5419858,PDP
EI327,,1986,1975,,2645615,34040304,8702609,,1328615,8294299,2804469,,1317000,25746005,5898140,PDP
EI327,,1987,1975,,2607140,34090304,8673030,,1479302,10683053,3380201,,1127838,23407251,5292829,PDP
EI327,,1988,1975,,2609163,33990304,8657260,,1581115,11600105,3645191,,1028048,22390199,5012069,PDP
EI327,,1989,1975,,2609163,33990304,8657260,,1655891,12027872,3796082,,953272,21962432,4861178,PDP
EI327,,1990,1975,,2786290,37859954,9522937,,1892434,15066723,4573346,,893856,22793231,4949591,PDP
EI327,,1991,1975,,3323179,39358275,10326431,,2298625,16096630,5162794,,1024554,23261645,5163637,PDP
EI327,,1992,1975,,3529619,20959198,7259014,,2745117,16978510,5766204,,784502,3980688,1492810,PDP
EI327,,1993,1975,,3529619,20959198,7259014,,2900143,17228830,5965771,,629476,3730368,1293243,PDP
EI327,,1994,1975,,3531462,20993715,7266998,,3023334,17453580,6128953,,508128,3540135,1138045,PDP
EI327,,1995,1975,,3531462,20993715,7266998,,3082517,17563398,6207677,,448945,3430317,1059321,PDP
EI327,,1996,1975,,3531343,20964681,7261713,,3221340,17781308,6385274,,310003,3183373,876439,PDP
EI327,,1997,1975,,3526320,21921787,7426994,,3330998,17935412,6522352,,195322,3986375,904642,PDP
EI327,,1998,1975,,3566023,23593982,7764240,,3453161,18924247,6820465,,112862,4669735,943775,PDP
EI327,,1999,1975,,3712492,26187039,8372107,,3550944,19904515,7092673,,161548,6282524,1279434,PDP
EI327,,2000,1975,,4007682,22268730,7970089,,3662722,20538447,7317250,,344960,1730283,652839,PDP
EI327,,2001,1975,,4008010,22594669,8028414,,3789165,21098932,7543423,,218845,1495737,484991,PDP
EI327,,2002,1975,,4412396,24034365,8688973,,3909633,21334623,7705829,,502763,2699742,983144,PDP
EI327,,2003,1975,,4412743,24144268,8708876,,4008847,21552132,7843746,,403896,2592136,865130,PDP
EI327,,2004,1975,,4354508,22945450,8437328,,4113514,21762277,7985805,,240994,1183173,451523,PDP
EI327,,2005,1975,,4924473,23138335,9041614,,4197519,21861373,8087443,,726954,1276962,954171,PDP
EI327,,2006,1975,,4923521,23108341,9035325,,4556160,22239524,8513371,,367361,868817,521954,PDP
EI327,,2007,1975,,5006271,23246224,9142610,,4761337,22524847,8769317,,244934,721377,373293,PDP
EI327,,2008,1975,,5338452,25126165,9809300,,4884047,22710469,8925056,,454405,2415696,884244,PDP
EI327,,2009,1975,,5346276,25546721,9891954,,4954520,23577827,9149861,,391756,1968894,742093,PDP
EI327,,2010,1975,,5346276,25546721,9891954,,5103549,24209847,9411350,,242727,1336874,480606,PDP
EI327,,2011,1975,,5346276,25546721,9891954,,5226601,24655306,9613664,,119675,891415,278289,PDP
EI327,,2012,1975,,5346986,25547357,9892777,,5319899,24920318,9754118,,27087,627039,138660,PDP
EI327,,2013,1975,,5596390,25965111,10216515,,5396193,25130622,9867832,,200197,834489,348682,PDP
EI327,,2014,1975,,5596522,25965111,10216647,,5458283,25299311,9959939,,138239,665800,256708,PDP
EI327,,2015,1975,,5596706,26795977,10364672,,5511472,25463309,10042310,,85234,1332668,322363,PDP
EI327,,2016,1975,,5701422,26862681,10481257,,5572786,25517465,10113260,,128636,1345216,367997,PDP
EI327,,2017,1975,,5791686,25719053,10368030,,5626577,25554419,10173626,,165109,164634,194403,PDP
EI327,,2017,1975,,5791686,25719053,10368030,,5626577,25554419,10173626,,165109,164634,194403,PDP
EI330,,1975,1971,,120000000,300000000,173380783,,62702134,135915826,86886445,,57297866,164084174,86494338,PDP
EI330,,1976,1971,,210000000,525000000,303416370,,96477921,262058151,143107485,,113522079,262941849,160308885,PDP
EI330,,1977,1971,,210000000,525000000,303416370,,148267214,442758028,227049781,,61732786,82241972,76366589,PDP
EI330,,1978,1971,,365182436,1188742712,576702492,,169775315,584000062,273689917,,195407121,604742650,303012575,PDP
EI330,,1979,1971,,386798506,1250211661,609256097,,180656517,736364501,311682229,,206141989,513847160,297573868,PDP
EI330,,1980,1971,,400936490,1315227897,634962806,,198504786,811898810,342970766,,202431704,503329087,291992040,PDP
EI330,,1981,1971,,403132658,1372750671,647394343,,212021726,914799979,374797523,,191110932,457950692,272596820,PDP
EI330,,1982,1971,,423079059,1549607173,698809873,,223622138,994151954,400517503,,199456921,555455219,298292370,PDP
EI330,,1983,1971,,431746857,1617094203,719486039,,235305378,1060693583,424040891,,196441479,556400620,295445148,PDP
EI330,,1984,1971,,448653877,1674564955,746619171,,246906195,1129869878,447950657,,201747682,544695077,298668514,PDP
EI330,,1985,1971,,458864406,1768664652,773573419,,257596677,1190471847,469424408,,201267729,578192805,304149011,PDP
EI330,,1986,1971,,464467504,1781139020,781396155,,267996571,1235948141,487916169,,196470933,545190879,293479986,PDP
EI330,,1987,1971,,462718597,1752918733,774625845,,276994584,1282591889,505213781,,185724013,470326844,269412064,PDP
EI330,,1988,1971,,432804817,1759014169,745796662,,285068030,1331846271,522051352,,147736787,427167898,223745310,PDP
EI330,,1989,1971,,342014526,1606987458,627955355,,292582481,1378506970,537868419,,49432045,228480488,90086936,PDP
EI330,,1990,1971,,345815749,1646233805,638739914,,298703229,1411800281,549913243,,47112520,234433524,88826671,PDP
EI330,,1991,1971,,349936560,1648505661,643264969,,304727756,1443487807,561576120,,45208804,205017854,81688849,PDP
EI330,,1992,1971,,355189215,1661202434,650776837,,311720530,1472560098,573741900,,43468685,188642336,77034937,PDP
EI330,,1993,1971,,367023340,1705660623,670521671,,320249440,1500671937,587272916,,46773900,204988686,83248755,PDP
EI330,,1994,1971,,372744096,1737978332,681992910,,329907926,1533944270,602851746,,42836170,204034062,79141164,PDP
EI330,,1995,1971,,408129235,1821619486,732260816,,341041198,1570650793,620516428,,67088037,250968693,111744388,PDP
EI330,,1996,1971,,412633793,1898275281,750405195,,353076457,1608656406,639314252,,59557336,289618875,111090943,PDP
EI330,,1997,1971,,413225971,1903637411,751951489,,363147853,1642540290,655414809,,50078118,261097121,96536680,PDP
EI330,,1998,1971,,416265258,1929899373,759663723,,372810563,1676169617,671061385,,43454695,253729756,88602338,PDP
EI330,,1999,1971,,414055642,1925341651,756643124,,381000460,1707834738,684885645,,33055182,217506913,71757479,PDP
EI330,,2000,1971,,413456532,1834294695,739843489,,388565526,1732567756,696851604,,24891006,101726939,42991885,PDP
EI330,,2001,1971,,415976951,1805631649,737263722,,395474391,1749283856,706734864,,20502560,56347793,30528858,PDP
EI330,,2002,1971,,426811393,1828408193,752150929,,402124685,1762607931,715755989,,24686708,65800262,36394940,PDP
EI330,,2003,1971,,428150717,1849426029,757230081,,409071963,1776202317,725122197,,19078754,73223712,32107884,PDP
EI330,,2004,1971,,432861957,1837946492,759898699,,415298883,1790011046,733806187,,17563074,47935446,26092512,PDP
EI330,,2005,1971,,427212395,1813016173,749813138,,419375231,1800658557,739777109,,7837164,12357616,10036029,PDP
EI330,,2006,1971,,432743183,1821519521,756856977,,420329205,1801387921,740860864,,12413978,20131600,15996113,PDP
EI330,,2007,1971,,430715596,1818305300,754257464,,423873336,1807011481,745405628,,6842260,11293819,8851836,PDP
EI330,,2008,1971,,430745987,1819724139,754540317,,427349833,1813244856,749991266,,3396154,6479283,4549051,PDP
EI330,,2009,1971,,434631980,1858088182,765252661,,427916869,1847584130,756668501,,6715111,10504052,8584161,PDP
EI330,,2010,1971,,436678250,1866880750,768863444,,429362346,1851760990,758857193,,7315904,15119760,10006253,PDP
EI330,,2011,1971,,440628603,1872185599,773757718,,431598918,1855980031,761844485,,9029685,16205568,11913234,PDP
EI330,,2012,1971,,448460618,1886229394,784088632,,434273328,1860607267,765342248,,14187290,25622127,18746387,PDP
EI330,,2013,1971,,452641250,1892216578,789334601,,438230465,1866215665,770297319,,14410785,26000913,19037281,PDP
EI330,,2014,1971,,455269631,1895392620,792528115,,443245173,1872816029,776486470,,12024458,22576591,16041643,PDP
EI330,,2015,1971,,460154826,1902353997,798651989,,448471980,1879741643,782945591,,11682846,22612354,15706392,PDP
EI330,,2016,1971,,466124208,1903391487,804805976,,452642614,1884966381,788045893,,13481594,18425106,16760083,PDP
EI330,,2017,1971,,466610639,1904427281,805476713,,455877060,1889260231,792044372,,10733579,15167050,13432346,PDP
EI330,,2017,1971,,466160150,1903575723,804874701,,455426571,1888408673,791442360,,10733579,15167050,13432346,PDP
EI333,,1978,1973,,13396667,142653272,38779811,,4015662,46619929,12311023,,9381005,96033343,26468788,PDP
EI333,,1979,1973,,14538305,190379212,48413610,,7905578,121680650,29556939,,6632727,68698562,18856671,PDP
EI333,,1980,1973,,16175161,214766552,54389850,,9144937,134190099,33022179,,7030224,80576453,21367671,PDP
EI333,,1981,1973,,16749073,230619864,57784636,,9920794,140624185,34942891,,6828279,89995679,22841745,PDP
EI333,,1982,1973,,16832548,242736224,60024047,,10515703,146151188,36521252,,6316845,96585036,23502795,PDP
EI333,,1983,1973,,17148479,246030621,60926170,,11041689,149637187,37667523,,6106790,96393434,23258647,PDP
EI333,,1984,1973,,17964120,258383294,63939795,,11496054,155386519,39144901,,6468066,102996775,24794894,PDP
EI333,,1985,1973,,18211145,260731808,64604705,,11954688,159542175,40342975,,6256457,101189633,24261730,PDP
EI333,,1986,1973,,18327812,260809308,64735162,,12339292,164035219,41527053,,5988520,96774089,23208109,PDP
EI333,,1987,1973,,19640147,251186298,64335218,,12594350,167110218,42329264,,7045797,84076080,22005954,PDP
EI333,,1988,1973,,20001051,249978335,64481182,,12898637,169080853,42984198,,7102414,80897482,21496984,PDP
EI333,,1989,1973,,20947023,254191526,66176832,,13313663,172379133,43986107,,7633360,81812393,22190725,PDP
EI333,,1990,1973,,15628352,198759306,50994777,,13728515,176812382,45189793,,1899837,21946924,5804984,PDP
EI333,,1991,1973,,15679607,218350027,54531925,,14065746,184980601,46980444,,1613861,33369426,7551481,PDP
EI333,,1992,1973,,15785521,242237628,58888302,,14497695,210568171,51965341,,1287826,31669457,6922961,PDP
EI333,,1993,1973,,16205743,259897422,62450836,,14869746,223829900,54697130,,1335997,36067522,7753706,PDP
EI333,,1994,1973,,16362137,262605859,63089158,,15163826,233446564,56702361,,1198311,29159295,6386797,PDP
EI333,,1995,1973,,16994303,291655534,68890305,,15405959,245001715,59000570,,1588344,46653819,9889735,PDP
EI333,,1996,1973,,17035018,287071952,68115437,,15664238,253001340,60682270,,1370780,34070612,7433167,PDP
EI333,,1997,1973,,17200399,291060145,68990460,,16018245,262376673,62704486,,1182154,28683472,6285974,PDP
EI333,,1998,1973,,17487171,303393119,71471712,,16327321,273274824,64952735,,1159850,30118295,6518977,PDP
EI333,,1999,1973,,17372485,301869189,71085864,,16432249,278657506,66015435,,940236,23211683,5070429,PDP
EI333,,2000,1973,,17345661,300167078,70756173,,16556439,282168366,66764333,,789222,17998712,3991840,PDP
EI333,,2001,1973,,17139277,292790959,69237312,,16728492,285233818,67481840,,410785,7557141,1755472,PDP
EI333,,2002,1973,,17678582,309444642,72739906,,17135185,292824530,69239194,,543397,16620112,3500712,PDP
EI333,,2003,1973,,17948330,315293881,74050444,,17344206,301583495,71006750,,604124,13710386,3043694,PDP
EI333,,2004,1973,,17753817,312815007,73414850,,17390205,305713837,71787685,,363612,7101170,1627165,PDP
EI333,,2005,1973,,17592299,311480083,73015801,,17398753,306945433,72015378,,193546,4534650,1000423,PDP
EI333,,2006,1973,,17422681,314679211,73415423,,17398536,306917505,72010192,,24145,7761706,1405231,PDP
EI333,,2007,1973,,17448583,317418171,73928685,,17399447,309142193,72406955,,49136,8275978,1521730,PDP
EI333,,2008,1973,,17463905,321779986,74720130,,17417700,312508331,73024165,,46205,9271655,1695965,PDP
EI333,,2009,1973,,17465437,327454615,75731385,,17422391,319749026,74317238,,43046,7705589,1414147,PDP
EI333,,2010,1973,,17435323,326037431,75449103,,17424292,322190616,74753586,,11031,3846815,695517,PDP
EI333,,2011,1973,,17434549,325159565,75292125,,17425956,323167966,74929156,,8593,1991599,362970,PDP
EI333,,2012,1973,,17434549,325159565,75292125,,17426256,323633894,75012361,,8293,1525671,279765,PDP
EI333,,2013,1973,,17434902,325379438,75331601,,17426647,323970613,75072666,,8255,1408825,258935,PDP
EI333,,2014,1973,,17434902,325379438,75331601,,17426659,324169628,75108089,,8243,1209810,223511,PDP
EI333,,2015,1973,,17435754,325753324,75398981,,17426659,324419686,75152584,,9095,1333638,246397,PDP
EI333,,2016,1973,,17435754,325753324,75398981,,17426659,324531984,75172566,,9095,1221340,226415,PDP
EI333,,2017,1973,,17434815,325515064,75355647,,17426659,324576994,75180575,,8156,938070,175072,PDP
EI333,,2017,1973,,17434815,325515064,75355647,,17426659,324576994,75180575,,8156,938070,175072,PDP
EI335,,1998,1972,,4257834,34346229,10369263,,0,0,0,,4257834,34346229,10369263,PDN
EI335,,1999,1972,,1493464,21879673,5386644,,143748,6659177,1328655,,1349716,15220496,4057989,PDN
EI335,,2000,1972,,1425793,23154299,5545775,,241690,11422195,2274109,,1184103,11732104,3271666,PDN
EI335,,2001,1972,,684748,20530390,4337842,,272393,12701868,2532512,,412355,7828522,1805330,PDN
EI335,,2002,1972,,678498,20556129,4336172,,283309,13046433,2604738,,395189,7509696,1731434,PDN
EI335,,2003,1972,,678498,20556129,4336172,,283309,13046433,2604738,,395189,7509696,1731434,PDN
EI335,,2004,1972,,678498,20556129,4336172,,283309,13046433,2604738,,395189,7509696,1731434,PDN
EI335,,2005,1972,,283309,13046433,2604738,,283309,13046433,2604738,,0,0,0,PDN
EI335,,2006,1972,,283309,13046433,2604738,,283309,13046433,2604738,,0,0,0,PDN
EI335,,2007,1972,,283309,13046433,2604738,,283309,13046433,2604738,,0,0,0,PDN
EI335,,2008,1972,,283309,13046433,2604738,,283309,13046433,2604738,,0,0,0,PDN
EI335,,2009,1972,,283309,13046433,2604739,,283309,13046433,2604739,,0,0,0,PDN
EI335,,2010,1972,,283309,13046433,2604739,,283309,13046433,2604739,,0,0,0,PDN
EI335,,2011,1972,,283309,13046433,2604739,,283309,13046433,2604739,,0,0,0,PDN
EI335,,2012,1972,,283309,13046433,2604739,,283309,13046433,2604739,,0,0,0,PDN
EI335,,2013,1972,,283309,13046433,2604739,,283309,13046433,2604739,,0,0,0,PDN
EI335,,2014,1972,,283309,13046433,2604739,,283309,13046433,2604739,,0,0,0,PDN
EI335,,2015,1972,,283309,13046433,2604739,,283309,13046433,2604739,,0,0,0,PDN
EI335,,2016,1972,,283309,13046433,2604739,,283309,13046433,2604739,,0,0,0,PDN
EI335,,2017,1972,,283309,13046433,2604739,,283309,13046433,2604739,,0,0,0,PDN
EI335,,2017,1972,,283309,13046433,2604739,,283309,13046433,2604739,,0,0,0,PDN
EI336,,1988,1984,,223017,18956448,3596050,,98,1517420,270102,,222919,17439028,3325948,PDN
EI336,,1989,1984,,223017,18956448,3596050,,98,4762850,847580,,222919,14193598,2748470,PDN
EI336,,1990,1984,,223017,18956448,3596050,,98,8616023,1533198,,222919,10340425,2062852,PDN
EI336,,1991,1984,,223017,18956448,3596050,,98,10015623,1782237,,222919,8940825,1813813,PDN
EI336,,1992,1984,,1561,15605381,2778319,,98,10480327,1864925,,1463,5125054,913394,PDN
EI336,,1993,1984,,1561,15605381,2778319,,98,10954117,1949229,,1463,4651264,829090,PDN
EI336,,1994,1984,,35858,18692094,3361853,,98,11012443,1959607,,35760,7679651,1402246,PDN
EI336,,1995,1984,,98,11012443,1959607,,98,11012443,1959607,,0,0,0,PDN
EI336,,1996,1984,,98,11012443,1959607,,98,11012443,1959607,,0,0,0,PDN
EI336,,1997,1984,,98,11012443,1959607,,98,11012443,1959607,,0,0,0,PDN
EI336,,1998,1984,,98,11012443,1959607,,98,11012443,1959607,,0,0,0,PDN
EI336,,1999,1984,,98,11012443,1959607,,98,11012443,1959607,,0,0,0,PDN
EI336,,2000,1984,,98,11012443,1959607,,98,11012443,1959607,,0,0,0,PDN
EI336,,2001,1984,,98,11012443,1959607,,98,11012443,1959607,,0,0,0,PDN
EI336,,2002,1984,,98,11012443,1959607,,98,11012443,1959607,,0,0,0,PDN
EI336,,2003,1984,,98,11012443,1959607,,98,11012443,1959607,,0,0,0,PDN
EI336,,2004,1984,,98,11012443,1959607,,98,11012443,1959607,,0,0,0,PDN
EI336,,2005,1984,,98,11012443,1959607,,98,11012443,1959607,,0,0,0,PDN
EI336,,2006,1984,,98,11012443,1959607,,98,11012443,1959607,,0,0,0,PDN
EI336,,2007,1984,,98,11012443,1959607,,98,11012443,1959607,,0,0,0,PDN
EI336,,2008,1984,,98,11012443,1959607,,98,11012443,1959607,,0,0,0,PDN
EI336,,2009,1984,,98,11232986,1998850,,98,11232986,1998850,,0,0,0,PDN
EI336,,2010,1984,,98,11232986,1998850,,98,11232986,1998850,,0,0,0,PDN
EI336,,2011,1984,,98,11232986,1998850,,98,11232986,1998850,,0,0,0,PDN
EI336,,2012,1984,,98,11232986,1998850,,98,11232986,1998850,,0,0,0,PDN
EI336,,2013,1984,,98,11232986,1998850,,98,11232986,1998850,,0,0,0,PDN
EI336,,2014,1984,,98,11232986,1998850,,98,11232986,1998850,,0,0,0,PDN
EI336,,2015,1984,,98,11232986,1998850,,98,11232986,1998850,,0,0,0,PDN
EI336,,2016,1984,,98,11232986,1998850,,98,11232986,1998850,,0,0,0,PDN
EI336,,2017,1984,,98,11232986,1998850,,98,11232986,1998850,,0,0,0,PDN
EI336,,2017,1984,,98,11232986,1998850,,98,11232986,1998850,,0,0,0,PDN
EI337,,1979,1976,,3200000,1600000,3484698,,0,0,0,,3200000,1600000,3484698,PDP
EI337,,1980,1976,,3200000,1600000,3484698,,0,0,0,,3200000,1600000,3484698,PDP
EI337,,1981,1976,,10000000,6670000,11186833,,542290,534671,637427,,9457710,6135329,10549406,PDP
EI337,,1982,1976,,10000000,6670000,11186833,,872417,898694,1032327,,9127583,5771306,10154506,PDP
EI337,,1983,1976,,5885890,9408226,7559952,,1056946,1104347,1253449,,4828944,8303879,6306503,PDP
EI337,,1984,1976,,6300372,9739811,8033434,,1241953,1320707,1476954,,5058419,8419104,6556480,PDP
EI337,,1985,1976,,6389630,10751944,8302787,,1598360,2565077,2054779,,4791270,8186867,6248008,PDP
EI337,,1986,1976,,6389630,11396286,8417439,,2062633,4020724,2778064,,4326997,7375562,5639375,PDP
EI337,,1987,1976,,4354735,27579387,9262099,,2319148,5144027,3234455,,2035587,22435360,6027644,PDP
EI337,,1988,1976,,4131718,8622939,5666049,,2487613,5983784,3552343,,1644105,2639155,2113706,PDP
EI337,,1989,1976,,4123735,9787944,5865362,,2582825,6623767,3761431,,1540910,3164177,2103931,PDP
EI337,,1990,1976,,4144539,10779620,6062621,,2639770,6929441,3872767,,1504769,3850179,2189854,PDP
EI337,,1991,1976,,4088477,10582451,5971475,,2678041,7173557,3954475,,1410436,3408894,2017000,PDP
EI337,,1992,1976,,3709457,11323468,5724309,,2710615,7475911,4040848,,998842,3847557,1683461,PDP
EI337,,1993,1976,,3709457,11323468,5724309,,2726075,7904463,4132563,,983382,3419005,1591746,PDP
EI337,,1994,1976,,3710291,11324444,5725317,,2737156,8205195,4197155,,973135,3119249,1528162,PDP
EI337,,1995,1976,,4781991,12610389,7025832,,2816817,8432342,4317234,,1965174,4178047,2708598,PDP
EI337,,1996,1976,,10941030,18686330,14266000,,4642298,10454930,6502606,,6298732,8231400,7763394,PDP
EI337,,1997,1976,,15157998,31739850,20805658,,7688989,15529935,10452323,,7469009,16209915,10353335,PDP
EI337,,1998,1976,,15037016,32215630,20769335,,9863616,18993962,13243325,,5173400,13221668,7526010,PDP
EI337,,1999,1976,,15517909,33237674,21432086,,10882223,20441049,14519420,,4635686,12796625,6912666,PDP
EI337,,2000,1976,,13885807,27656765,18806940,,11468084,21378718,15272126,,2417723,6278047,3534814,PDP
EI337,,2001,1976,,15640108,27900446,20604600,,12277146,22687421,16314054,,3362962,5213025,4290546,PDP
EI337,,2002,1976,,17963448,37216073,24585525,,13876598,25189344,18358688,,4086850,12026729,6226837,PDP
EI337,,2003,1976,,17963448,37252217,24591956,,14989896,27049452,19802966,,2973552,10202765,4788990,PDP
EI337,,2004,1976,,17816708,37157509,24428364,,15725597,29023805,20889975,,2091111,8133704,3538389,PDP
EI337,,2005,1976,,16605822,31195760,22156669,,16092226,29538237,21348140,,513596,1657523,808529,PDP
EI337,,2006,1976,,16892907,30730183,22360911,,16247055,29583715,21511061,,645852,1146468,849850,PDP
EI337,,2007,1976,,18892492,34184168,24975084,,16618260,30419731,22031024,,2274232,3764437,2944060,PDP
EI337,,2008,1976,,18892492,34184168,24975084,,17153212,31487619,22755991,,1739280,2696549,2219093,PDP
EI337,,2009,1976,,18895232,34523891,25038274,,17402662,32401090,23167982,,1492570,2122801,1870289,PDP
EI337,,2010,1976,,20013055,36501671,26508015,,17720677,33103097,23610911,,2292378,3398574,2897105,PDP
EI337,,2011,1976,,20013055,36501768,26508032,,18127549,33856956,24151920,,1885506,2644812,2356116,PDP
EI337,,2012,1976,,20013057,36501833,26508045,,18483363,34456986,24614502,,1529694,2044847,1893544,PDP
EI337,,2013,1976,,20013057,36501833,26508045,,18781063,34942139,24998526,,1231994,1559694,1509520,PDP
EI337,,2014,1976,,20343777,37146944,26953554,,19054419,35359236,25346100,,1289358,1787708,1607456,PDP
EI337,,2015,1976,,20819033,37854607,27554731,,19304478,35729645,25662067,,1514555,2124962,1892664,PDP
EI337,,2016,1976,,21170505,38575761,28034521,,19747425,36352663,26215872,,1423080,2223098,1818649,PDP
EI337,,2017,1976,,21643279,39320786,28639862,,20234573,37016530,26821145,,1408706,2304256,1818712,PDP
EI337,,2017,1976,,21643279,39320786,28639862,,20234573,37016530,26821145,,1408706,2304256,1818712,PDP
EI341,,1978,1976,,15000000,15000000,17669039,,0,0,0,,15000000,15000000,17669039,PDP
EI341,,1979,1976,,2679337,90586069,18797855,,0,0,0,,2679337,90586069,18797855,PDP
EI341,,1980,1976,,2679337,90586069,18797855,,0,0,0,,2679337,90586069,18797855,PDP
EI341,,1981,1976,,2679337,90586069,18797855,,0,0,0,,2679337,90586069,18797855,PDP
EI341,,1982,1976,,28980753,67307913,40957250,,1595086,3123741,2150912,,27385667,64184172,38806338,PDP
EI341,,1983,1976,,28981618,68351155,41143745,,3629069,6973611,4869925,,25352549,61377544,36273820,PDP
EI341,,1984,1976,,28981618,68351155,41143745,,5455375,10388494,7303861,,23526243,57962661,33839884,PDP
EI341,,1985,1976,,28981618,68351155,41143745,,7005115,12986559,9315891,,21976503,55364596,31827854,PDP
EI341,,1986,1976,,28977455,68351155,41139582,,8381361,15229098,11091165,,20596094,53122057,30048417,PDP
EI341,,1987,1976,,28936470,68329898,41094815,,9716492,17496264,12829706,,19219978,50833634,28265109,PDP
EI341,,1988,1976,,28936470,68329898,41094815,,10901079,19337082,14341841,,18035391,48992816,26752974,PDP
EI341,,1989,1976,,28936470,68329898,41094815,,11988692,21061096,15736218,,16947778,47268802,25358597,PDP
EI341,,1990,1976,,24898232,41770656,32330733,,13014691,22481255,17014914,,11883541,19289401,15315819,PDP
EI341,,1991,1976,,24898232,41770656,32330733,,13960282,23551978,18151025,,10937950,18218678,14179708,PDP
EI341,,1992,1976,,24771081,40654210,32004926,,14982474,25205914,19467512,,9788607,15448296,12537414,PDP
EI341,,1993,1976,,24921032,83012476,39691935,,16071238,28450639,21133629,,8849794,54561837,18558306,PDP
EI341,,1994,1976,,24924676,86169832,40257386,,16963175,32343485,22718244,,7961501,53826347,17539142,PDP
EI341,,1995,1976,,25163854,46630766,33461143,,17946443,34017152,23999317,,7217411,12613614,9461826,PDP
EI341,,1996,1976,,25554275,47476679,34002083,,19021306,35691339,25372078,,6532969,11785340,8630005,PDP
EI341,,1997,1976,,25554275,48152195,34122281,,19662899,36663595,26186670,,5891376,11488600,7935611,PDP
EI341,,1998,1976,,25591166,53417063,35095981,,20285014,39323420,27282064,,5306152,14093643,7813917,PDP
EI341,,1999,1976,,25721307,53351993,35214544,,20797332,41124895,28114929,,4923975,12227098,7099615,PDP
EI341,,2000,1976,,24336414,48797105,33019173,,21497239,42030230,28975928,,2839175,6766875,4043245,PDP
EI341,,2001,1976,,24324967,47228817,32728671,,21874286,42625070,29458818,,2450681,4603747,3269853,PDP
EI341,,2002,1976,,24554310,48601095,33202192,,22248439,43623457,30010620,,2305871,4977638,3191572,PDP
EI341,,2003,1976,,24554779,48658906,33212947,,22780654,44974783,30783284,,1774125,3684123,2429663,PDP
EI341,,2004,1976,,24486229,49177566,33236686,,23092662,45548587,31197393,,1393567,3628979,2039293,PDP
EI341,,2005,1976,,23619108,47068688,31994319,,23251458,45769362,31395473,,367650,1299326,598846,PDP
EI341,,2006,1976,,23619108,47131490,32005494,,23412665,45958886,31590403,,206443,1172604,415091,PDP
EI341,,2007,1976,,23959441,47287774,32373636,,23568118,46157329,31781166,,391323,1130445,592470,PDP
EI341,,2008,1976,,23959441,47287774,32373636,,23673218,46279767,31908052,,286223,1008007,465584,PDP
EI341,,2009,1976,,24058529,48160023,32627927,,23713715,47066137,32088472,,344814,1093886,539455,PDP
EI341,,2010,1976,,24058639,48161102,32628229,,23824825,47139076,32212560,,233814,1022026,415669,PDP
EI341,,2011,1976,,24058639,48161102,32628229,,23915207,47194356,32312778,,143432,966746,315451,PDP
EI341,,2012,1976,,24212800,51181332,33319797,,23967488,47322576,32387875,,245312,3858756,931924,PDP
EI341,,2013,1976,,24212800,51181332,33319797,,24052812,48403135,32665469,,159988,2778197,654329,PDP
EI341,,2014,1976,,24212800,51181332,33319797,,24118540,49470566,32921131,,94260,1710766,398667,PDP
EI341,,2015,1976,,24328451,51453971,33483960,,24168827,49549510,32985465,,159624,1904461,498495,PDP
EI341,,2016,1976,,25825984,53244511,35300094,,24610353,50147550,33533403,,1215631,3096961,1766691,PDP
EI341,,2017,1976,,28799168,58152576,39146599,,25568427,51684103,34764884,,3230741,6468473,4381714,PDP
EI341,,2017,1976,,28799168,58152576,39146599,,25568427,51684103,34764884,,3230741,6468473,4381714,PDP
EI342,,1975,1973,,5947865,206277957,42652128,,0,14397472,2561828,,5947865,191880485,40090300,PDP
EI342,,1976,1973,,5947865,224968047,45977767,,0,104487754,18592127,,5947865,120480293,27385640,PDP
EI342,,1977,1973,,8027789,437203244,85821961,,131316,213063559,38042981,,7896473,224139685,47778980,PDP
EI342,,1978,1973,,7887789,653593344,124185537,,738496,330694608,59580953,,7149293,322898736,64604584,PDP
EI342,,1979,1973,,8128154,526798574,101864555,,1451878,410654623,74522096,,6676276,116143951,27342459,PDP
EI342,,1980,1973,,9564519,516960563,101550384,,2378231,455232321,83380423,,7186288,61728242,18169961,PDP
EI342,,1981,1973,,12697472,586672345,117087569,,3838084,488977827,90844815,,8859388,97694518,26242754,PDP
EI342,,1982,1973,,13757572,587357270,118269542,,5302055,495008402,93381842,,8455517,92348868,24887700,PDP
EI342,,1983,1973,,18541323,607992080,126724967,,7525750,501595951,96777699,,11015573,106396129,29947268,PDP
EI342,,1984,1973,,20290503,612886185,129344984,,9859157,507202400,100108694,,10431346,105683785,29236290,PDP
EI342,,1985,1973,,19029364,554793013,117746982,,12191859,510322281,102996535,,6837505,44470732,14750447,PDP
EI342,,1986,1973,,26721029,570407367,128217002,,14299148,513061560,105591241,,12421881,57345807,22625761,PDP
EI342,,1987,1973,,32548261,580103409,135769508,,17238125,520990011,109940974,,15310136,59113398,25828534,PDP
EI342,,1988,1973,,32913700,588204076,137576347,,19982345,526037955,113583405,,12931355,62166121,23992942,PDP
EI342,,1989,1973,,43135043,584844101,147199830,,22733957,531550982,117315982,,20401086,53293119,29883848,PDP
EI342,,1990,1973,,42936176,584712211,146977495,,25293974,536990650,120843912,,17642202,47721561,26133583,PDP
EI342,,1991,1973,,43459663,586125293,147752420,,27469188,544484611,124352571,,15990475,41640682,23399849,PDP
EI342,,1992,1973,,43291655,585892409,147542973,,29175539,549726586,126991658,,14116116,36165823,20551315,PDP
EI342,,1993,1973,,39517769,581316170,142954810,,30714903,553186080,129146590,,8802866,28130090,13808220,PDP
EI342,,1994,1973,,39807519,583454277,143625006,,32124684,555817117,131024527,,7682835,27637160,12600479,PDP
EI342,,1995,1973,,39851291,584908004,143927448,,33556663,557424530,132742522,,6294628,27483474,11184926,PDP
EI342,,1996,1973,,41980850,579234967,145047570,,35218776,559673983,134804894,,6762074,19560984,10242676,PDP
EI342,,1997,1973,,41801300,580309605,145059237,,36637117,560823437,136427764,,5164183,19486168,8631473,PDP
EI342,,1998,1973,,42283695,580327288,145544778,,37626683,561527972,137542692,,4657012,18799316,8002086,PDP
EI342,,1999,1973,,42121387,568646201,143303985,,38542311,562110385,138561952,,3579076,6535816,4742033,PDP
EI342,,2000,1973,,41941151,565712519,142601742,,39295829,562709789,139422126,,2645322,3002730,3179616,PDP
EI342,,2001,1973,,41940920,565706203,142600387,,40028141,563657803,140323124,,1912779,2048400,2277263,PDP
EI342,,2002,1973,,42598261,566022687,143314042,,40533105,564261732,140935548,,2065156,1760955,2378494,PDP
EI342,,2003,1973,,42816979,566255829,143574244,,41068850,564679020,141545544,,1748129,1576809,2028700,PDP
EI342,,2004,1973,,43148197,569093641,144410411,,41754275,567176357,142675335,,1393922,1917284,1735076,PDP
EI342,,2005,1973,,44181820,569683111,145548922,,42073363,567676334,143083387,,2108457,2006777,2465535,PDP
EI342,,2006,1973,,44181820,569683111,145548922,,42923711,568383428,144059552,,1258109,1299683,1489370,PDP
EI342,,2007,1973,,43857004,568944617,145092701,,43462853,568677248,144650975,,394151,267369,441726,PDP
EI342,,2008,1973,,44503494,573693745,146584232,,43794998,570287067,145269565,,708496,3406678,1314667,PDP
EI342,,2009,1973,,44690764,585601021,148890238,,44084641,583245392,147864964,,606123,2355629,1025274,PDP
EI342,,2010,1973,,44891853,585428438,149060618,,44412551,584699751,148451656,,479302,728687,608961,PDP
EI342,,2011,1973,,44993123,585596234,149191744,,44416785,584760692,148466733,,576338,835542,725011,PDP
EI342,,2012,1973,,44993123,585596234,149191744,,44538218,584945308,148621016,,454905,650926,570728,PDP
EI342,,2013,1973,,45084043,586206214,149391201,,44799014,585548987,148989229,,285029,657227,401972,PDP
EI342,,2014,1973,,45375598,586329795,149704747,,45013700,585915549,149269140,,361898,414246,435608,PDP
EI342,,2015,1973,,45694064,586741908,150096542,,45186261,586099896,149474503,,507803,642012,622040,PDP
EI342,,2016,1973,,45694064,586741908,150096542,,45334650,586264866,149652247,,359414,477042,444298,PDP
EI342,,2017,1973,,45675729,586656652,150063038,,45360637,586311591,149686548,,315092,345061,376492,PDP
EI342,,2017,1973,,45675729,586656652,150063038,,45360637,586311591,149686548,,315092,345061,376492,PDP
EI346,,1978,1977,,90000,9000000,1691423,,0,0,0,,90000,9000000,1691423,PDP
EI346,,1979,1977,,0,22000000,3914591,,0,0,0,,0,22000000,3914591,PDP
EI346,,1980,1977,,9418,9417080,1685055,,0,0,0,,9418,9417080,1685055,PDP
EI346,,1981,1977,,9418,9417080,1685055,,0,0,0,,9418,9417080,1685055,PDP
EI346,,1982,1977,,8918,7809080,1398434,,1846,3922131,699734,,7072,3886949,698700,PDP
EI346,,1983,1977,,32280,33643630,6018691,,3110,6881501,1227576,,29170,26762129,4791115,PDP
EI346,,1984,1977,,32280,33643630,6018691,,3222,7036079,1255193,,29058,26607551,4763498,PDP
EI346,,1985,1977,,3339,7185466,1281892,,3339,7185466,1281892,,0,0,0,PDP
EI346,,1986,1977,,3339,7185466,1281892,,3339,7185466,1281892,,0,0,0,PDP
EI346,,1987,1977,,3339,7185466,1281892,,3339,7185466,1281892,,0,0,0,PDP
EI346,,1988,1977,,3339,7185466,1281892,,3339,7185466,1281892,,0,0,0,PDP
EI346,,1989,1977,,3339,7185466,1281892,,3339,7185466,1281892,,0,0,0,PDP
EI346,,1990,1977,,3339,7185466,1281892,,3339,7185466,1281892,,0,0,0,PDP
EI346,,1991,1977,,3339,7185466,1281892,,3339,7185466,1281892,,0,0,0,PDP
EI346,,1992,1977,,3339,7185466,1281892,,3339,7185466,1281892,,0,0,0,PDP
EI346,,1993,1977,,3339,7185466,1281892,,3339,7185466,1281892,,0,0,0,PDP
EI346,,1994,1977,,3339,7185466,1281892,,3339,7185466,1281892,,0,0,0,PDP
EI346,,1995,1977,,3339,7185466,1281892,,3339,7185466,1281892,,0,0,0,PDP
EI346,,1996,1977,,3339,7185466,1281892,,3339,7185466,1281892,,0,0,0,PDP
EI346,,1997,1977,,3339,7185466,1281892,,3339,7185466,1281892,,0,0,0,PDP
EI346,,1998,1977,,3339,7185466,1281892,,3339,7185466,1281892,,0,0,0,PDP
EI346,,1999,1977,,9576839,94342790,26363812,,3339,7185466,1281892,,9573500,87157324,25081920,PDP
EI346,,2000,1977,,9576839,94342789,26363812,,19736,7212387,1303079,,9557103,87130402,25060733,PDP
EI346,,2001,1977,,8745520,63298012,20008511,,4515968,33900606,10548104,,4229552,29397406,9460407,PDP
EI346,,2002,1977,,9640073,64302467,21081793,,6058176,46171256,14273702,,3581897,18131211,6808091,PDP
EI346,,2003,1977,,9804164,66916726,21711055,,7731511,57608426,17982121,,2072653,9308300,3728934,PDP
EI346,,2004,1977,,9904213,65189831,21503827,,8579178,61290312,19484927,,1325035,3899519,2018900,PDP
EI346,,2005,1977,,10595041,70179619,23082518,,9116318,63491473,20413733,,1478723,6688146,2668785,PDP
EI346,,2006,1977,,10595041,70179619,23082518,,9624059,65329825,21248583,,970982,4849794,1833935,PDP
EI346,,2007,1977,,11005931,71928642,23804622,,10030506,70009808,22487767,,975425,1918834,1316855,PDP
EI346,,2008,1977,,11736089,80066642,25982822,,10334195,72203130,23181727,,1401894,7863512,2801095,PDP
EI346,,2009,1977,,11913934,82855249,26656861,,10708188,75436558,24131063,,1205746,7418691,2525798,PDP
EI346,,2010,1977,,11913171,81218387,26364842,,11155542,79813713,25357271,,757629,1404674,1007570,PDP
EI346,,2011,1977,,12201441,82016923,26795200,,11391486,80982981,25801270,,809955,1033942,993929,PDP
EI346,,2012,1977,,12201441,82016923,26795200,,11588590,81251674,26046185,,612851,765249,749016,PDP
EI346,,2013,1977,,12201309,82130339,26815249,,11771344,81509207,26274762,,429965,621132,540487,PDP
EI346,,2014,1977,,12201309,82130339,26815249,,11943173,81723317,26484689,,258136,407022,330561,PDP
EI346,,2015,1977,,12421582,82332656,27071521,,12087647,81851729,26652012,,333935,480927,419510,PDP
EI346,,2016,1977,,12670783,82381377,27329392,,12240617,82003139,26831924,,430166,378238,497468,PDP
EI346,,2017,1977,,12693381,82684132,27405861,,12373509,82157613,26992302,,319872,526519,413559,PDP
EI346,,2017,1977,,12693381,82684132,27405861,,12373509,82157613,26992302,,319872,526519,413559,PDP
EI348,,1977,1976,,3800000,152000000,30846263,,0,0,0,,3800000,152000000,30846263,PDN
EI348,,1978,1976,,5016,5016000,897543,,0,0,0,,5016,5016000,897543,PDN
EI348,,1979,1976,,365000,5016000,1257527,,72633,1000876,250725,,292367,4015124,1006802,PDN
EI348,,1980,1976,,989659,15600000,3765460,,265323,4613061,1086152,,724336,10986939,2679308,PDN
EI348,,1981,1976,,1317800,24375000,5654989,,435783,8017226,1862336,,882017,16357774,3792653,PDN
EI348,,1982,1976,,2797800,25125000,7268441,,563451,10899856,2502927,,2234349,14225144,4765514,PDN
EI348,,1983,1976,,2797800,25125000,7268441,,732607,14123228,3245637,,2065193,11001772,4022804,PDN
EI348,,1984,1976,,2797800,25125000,7268441,,914757,17941257,4107151,,1883043,7183743,3161290,PDN
EI348,,1985,1976,,1476019,30096000,6831179,,1085049,22183038,5032209,,390970,7912962,1798970,PDN
EI348,,1986,1976,,1959931,39962976,9070781,,1188677,24839580,5608531,,771254,15123396,3462250,PDN
EI348,,1987,1976,,1959931,39962976,9070781,,1351288,29654548,6627898,,608643,10308428,2442883,PDN
EI348,,1988,1976,,1959931,39962976,9070781,,1442783,32226535,7177042,,517148,7736441,1893739,PDN
EI348,,1989,1976,,1959931,39962976,9070781,,1522175,34590439,7677057,,437756,5372537,1393724,PDN
EI348,,1990,1976,,2028081,49282370,10797186,,1600577,36831018,8154139,,427504,12451352,2643047,PDN
EI348,,1991,1976,,2028081,49282370,10797186,,1654439,38562378,8516072,,373642,10719992,2281114,PDN
EI348,,1992,1976,,2028081,49282370,10797186,,1708111,40158676,8853783,,319970,9123694,1943403,PDN
EI348,,1993,1976,,2862474,50200202,11794894,,1792421,42115300,9286247,,1070053,8084902,2508647,PDN
EI348,,1994,1976,,3412106,60972840,14261366,,1909297,44573713,9840563,,1502809,16399127,4420803,PDN
EI348,,1995,1976,,2678368,60359566,13418504,,2062793,47154296,10453237,,615575,13205270,2965267,PDN
EI348,,1996,1976,,2524767,68661343,14742088,,2128531,51066857,11215160,,396236,17594486,3526928,PDN
EI348,,1997,1976,,2407604,66643874,14265945,,2190917,55968355,12149699,,216687,10675519,2116246,PDN
EI348,,1998,1976,,2361730,67187524,14316805,,2225992,58573484,12648320,,135738,8614040,1668485,PDN
EI348,,1999,1976,,2361730,67187524,14316805,,2257119,60749748,13066683,,104611,6437776,1250122,PDN
EI348,,2000,1976,,2358308,67150884,14306864,,2279685,62017507,13314829,,78623,5133377,992035,PDN
EI348,,2001,1976,,2372454,67725255,14423211,,2300618,63150558,13537372,,71836,4574697,885839,PDN
EI348,,2002,1976,,2372454,67725255,14423211,,2317339,64130239,13728414,,55115,3595016,694797,PDN
EI348,,2003,1976,,2373005,69144369,14676274,,2326795,65571955,13994403,,46210,3572414,681871,PDN
EI348,,2004,1976,,2989271,69859792,15419839,,2406072,66377157,14216954,,583199,3482635,1202885,PDN
EI348,,2005,1976,,3394028,71811935,16171952,,2775650,68601607,14982342,,618378,3210328,1189610,PDN
EI348,,2006,1976,,3443044,72297401,16307350,,3060566,70103703,15534535,,382478,2193698,772815,PDN
EI348,,2007,1976,,3716429,73105102,16724454,,3291557,70968026,15919320,,424872,2137076,805134,PDN
EI348,,2008,1976,,3716429,73120248,16727149,,3474493,71820312,16253908,,241936,1299936,473241,PDN
EI348,,2009,1976,,3786568,75033197,17137670,,3539107,73400258,16599650,,247461,1632939,538019,PDN
EI348,,2010,1976,,3786568,75033197,17137670,,3678955,74566145,16946952,,107613,467052,190718,PDN
EI348,,2011,1976,,3872308,76880473,17552107,,3755232,75112911,17120518,,117076,1767562,431590,PDN
EI348,,2012,1976,,3963765,77249928,17709303,,3862724,76479743,17471219,,101041,770185,238085,PDN
EI348,,2013,1976,,4085668,77499762,17875661,,3935863,76822034,17605264,,149805,677728,270398,PDN
EI348,,2014,1976,,4092011,77582218,17896676,,3960316,76956147,17653580,,131695,626071,243095,PDN
EI348,,2015,1976,,4092011,77582218,17896676,,3967314,76973853,17663728,,124697,608365,232947,PDN
EI348,,2016,1976,,4092011,77582218,17896676,,3968009,76976251,17664850,,124002,605967,231826,PDN
EI348,,2017,1976,,3968022,76976285,17664869,,3968022,76976285,17664869,,0,0,0,PDN
EI348,,2017,1976,,3968022,76976285,17664869,,3968022,76976285,17664869,,0,0,0,PDN
EI351,,1979,1977,,0,2600000,462633,,0,0,0,,0,2600000,462633,PDP
EI351,,1980,1977,,2600,2600000,465233,,0,0,0,,2600,2600000,465233,PDP
EI351,,1981,1977,,2600,2600000,465233,,0,0,0,,2600,2600000,465233,PDP
EI351,,1982,1977,,2600,2600000,465233,,0,0,0,,2600,2600000,465233,PDP
EI351,,1983,1977,,2600,2600000,465233,,0,0,0,,2600,2600000,465233,PDP
EI351,,1984,1977,,2600,2600000,465233,,0,0,0,,2600,2600000,465233,PDP
EI351,,2006,1977,,142,1425475,253785,,0,0,0,,142,1425475,253785,PDP
EI351,,2007,1977,,142,1425475,253785,,0,0,0,,142,1425475,253785,PDP
EI351,,2008,1977,,341136,11699545,2422906,,68036,1922946,410197,,273100,9776599,2012709,PDP
EI351,,2009,1977,,348050,11936613,2472003,,90248,2440190,524445,,257802,9496423,1947557,PDP
EI351,,2010,1977,,348050,11936613,2472003,,213518,5998150,1280804,,134532,5938463,1191198,PDP
EI351,,2011,1977,,348050,11936613,2472003,,265308,9032937,1872592,,82742,2903676,599411,PDP
EI351,,2012,1977,,348050,11936613,2472003,,275161,10211694,2092188,,72889,1724919,379815,PDP
EI351,,2013,1977,,348050,11936613,2472003,,276745,10795696,2197687,,71305,1140917,274316,PDP
EI351,,2014,1977,,348050,11936613,2472003,,277422,10992381,2233362,,70628,944232,238641,PDP
EI351,,2015,1977,,564961,11517183,2614282,,387353,11187919,2378086,,177608,329264,236196,PDP
EI351,,2016,1977,,565040,11535308,2617586,,433197,11276399,2439673,,131843,258909,177912,PDP
EI351,,2017,1977,,585584,11559653,2642461,,475724,11353685,2495952,,109860,205968,146509,PDP
EI351,,2017,1977,,585584,11559653,2642461,,475724,11353685,2495952,,109860,205968,146509,PDP
EI355,,2002,2002,,403539,4228425,1155928,,0,0,0,,403539,4228425,1155928,PDN
EI355,,2003,2002,,403539,4228425,1155928,,0,0,0,,403539,4228425,1155928,PDN
EI355,,2004,2002,,433601,1717533,739212,,211907,801446,354513,,221694,916087,384699,PDN
EI355,,2005,2002,,432846,1700669,735456,,321843,1246521,543644,,111003,454148,191812,PDN
EI355,,2006,2002,,456011,1818810,779643,,321843,1246521,543644,,134168,572289,235999,PDN
EI355,,2007,2002,,456011,1818810,779643,,356724,1329431,593278,,99287,489379,186365,PDN
EI355,,2008,2002,,456011,1818810,779643,,419244,1599131,703787,,36767,219679,75856,PDN
EI355,,2009,2002,,493096,1933370,837111,,452685,1754018,764787,,40411,179352,72324,PDN
EI355,,2010,2002,,594950,2286478,1001797,,493992,1927137,836899,,100958,359341,164898,PDN
EI355,,2011,2002,,594950,2286478,1001797,,546396,2054745,912009,,48554,231733,89788,PDN
EI355,,2012,2002,,594950,2286478,1001797,,574674,2151473,957498,,20276,135005,44298,PDN
EI355,,2013,2002,,594950,2286478,1001797,,588880,2220281,983947,,6070,66197,17848,PDN
EI355,,2014,2002,,597969,2282761,1004154,,596464,2268854,1000174,,1505,13907,3980,PDN
EI355,,2015,2002,,604969,2326151,1018874,,600455,2301398,1009956,,4514,24753,8918,PDN
EI355,,2016,2002,,600589,2302384,1010265,,600589,2302384,1010265,,0,0,0,PDN
EI355,,2017,2002,,600589,2302384,1010265,,600589,2302384,1010265,,0,0,0,PDN
EI355,,2017,2002,,600589,2302384,1010265,,600589,2302384,1010265,,0,0,0,PDN
EI361,,1975,1973,,0,10000000,1779359,,0,0,0,,0,10000000,1779359,PDP
EI361,,1976,1973,,0,15000000,2669039,,0,0,0,,0,15000000,2669039,PDP
EI361,,1977,1973,,0,15000000,2669039,,0,0,0,,0,15000000,2669039,PDP
EI361,,1978,1973,,1373349,113050000,21489007,,0,0,0,,1373349,113050000,21489007,PDP
EI361,,1979,1973,,1373349,113050000,21489007,,0,0,0,,1373349,113050000,21489007,PDP
EI361,,1980,1973,,1373349,113050000,21489007,,0,0,0,,1373349,113050000,21489007,PDP
EI361,,1981,1973,,3371449,120898860,24883702,,0,0,0,,3371449,120898860,24883702,PDP
EI361,,1982,1973,,3371449,120898860,24883702,,0,0,0,,3371449,120898860,24883702,PDP
EI361,,1983,1973,,8708116,36052220,15123102,,0,0,0,,8708116,36052220,15123102,PDP
EI361,,1984,1973,,11297931,40690631,18538257,,0,0,0,,11297931,40690631,18538257,PDP
EI361,,1985,1973,,63941756,101362046,81977707,,937148,764704,1073216,,63004608,100597342,80904491,PDP
EI361,,1986,1973,,65015196,102271758,83213018,,5847394,8728596,7400525,,59167802,93543162,75812493,PDP
EI361,,1987,1973,,61676465,109838309,81220648,,10597741,18956496,13970783,,51078724,90881813,67249865,PDP
EI361,,1988,1973,,62518158,123007450,84405605,,14855894,28051940,19847342,,47662264,94955510,64558263,PDP
EI361,,1989,1973,,70288624,144549698,96009211,,19018348,35440589,25324503,,51270276,109109109,70684708,PDP
EI361,,1990,1973,,61394823,122916517,83266089,,23307509,41851723,30754435,,38087314,81064794,52511654,PDP
EI361,,1991,1973,,61173679,122511597,82972896,,28504986,48563106,37146108,,32668693,73948491,45826788,PDP
EI361,,1992,1973,,65778935,134600545,89729210,,33179648,56303980,43198150,,32599287,78296565,46531060,PDP
EI361,,1993,1973,,66549422,150426223,93315654,,37518940,65422590,49159970,,29030482,85003633,44155684,PDP
EI361,,1994,1973,,70633979,190321404,104498998,,40717500,77585635,54522773,,29916479,112735769,49976225,PDP
EI361,,1995,1973,,70460906,175310646,101654971,,43210792,85566267,58436106,,27250114,89744379,43218865,PDP
EI361,,1996,1973,,72314832,183136338,104901369,,45801933,91043567,62001856,,26512899,92092771,42899513,PDP
EI361,,1997,1973,,72317986,188407520,105842456,,49198471,96759332,66415434,,23119515,91648188,39427022,PDP
EI361,,1998,1973,,72602331,177035193,104103255,,52419401,102545539,70665938,,20182930,74489654,33437317,PDP
EI361,,1999,1973,,75925709,177879620,107576887,,55016249,107830474,74203166,,20909460,70049146,33373721,PDP
EI361,,2000,1973,,65496762,144328007,91177902,,56927054,111929291,76843298,,8569708,32398716,14334604,PDP
EI361,,2001,1973,,66501107,141692199,91713242,,58899001,117323532,79775074,,7602106,24368667,11938168,PDP
EI361,,2002,1973,,67582275,141982758,92846111,,60869968,121414719,82474011,,6712307,20568039,10372100,PDP
EI361,,2003,1973,,68460109,142662492,93844894,,62826138,124912329,85052531,,5633971,17750163,8792363,PDP
EI361,,2004,1973,,69197003,137506040,93664270,,64120877,126761517,86676307,,5076126,10744523,6987963,PDP
EI361,,2005,1973,,69172823,137486826,93636671,,64899357,127384454,87565630,,4273466,10102372,6071041,PDP
EI361,,2006,1973,,70610585,139175056,95374830,,65529461,127831209,88275228,,5081124,11343847,7099602,PDP
EI361,,2007,1973,,70213814,139343529,95008036,,66510439,129242926,89507401,,3703375,10100603,5500635,PDP
EI361,,2008,1973,,72640133,141763124,97864888,,67012226,130032925,90149757,,5627907,11730199,7715131,PDP
EI361,,2009,1973,,72650782,143358624,98159429,,67137113,132147638,90650925,,5513669,11210986,7508507,PDP
EI361,,2010,1973,,73270948,144986565,99069265,,68187590,133346928,91914797,,5083358,11639637,7154469,PDP
EI361,,2011,1973,,73875145,149819905,100533488,,68986811,136853556,93337975,,4888334,12966349,7195514,PDP
EI361,,2012,1973,,76448283,152316922,103550936,,70008286,139955999,94911487,,6439997,12360923,8639450,PDP
EI361,,2013,1973,,76878657,156051986,104645913,,71036816,141889424,96284043,,5841841,14162562,8361871,PDP
EI361,,2014,1973,,78081750,160073111,106564510,,71907093,143506800,97442112,,6174657,16566311,9122399,PDP
EI361,,2015,1973,,79008204,160863757,107631648,,72661644,145656206,98579115,,6346560,15207551,9052529,PDP
EI361,,2016,1973,,79368511,161568676,108117386,,73245063,147201625,99437521,,6123448,14367051,8679861,PDP
EI361,,2017,1973,,78292858,161543097,107037179,,73829501,148243236,100207297,,4463357,13299861,6829880,PDP
EI361,,2017,1973,,78292858,161543097,107037179,,73829501,148243236,100207297,,4463357,13299861,6829880,PDP
EI366,,1989,1987,,198122,25755817,4781008,,0,0,0,,198122,25755817,4781008,PDN
EI366,,1990,1987,,198277,27306340,5057056,,0,10244354,1822839,,198277,17061986,3234217,PDN
EI366,,1991,1987,,198277,27306340,5057056,,0,11946173,2125654,,198277,15360167,2931402,PDN
EI366,,1992,1987,,155,12339601,2195814,,0,11957292,2127632,,155,382309,68182,PDN
EI366,,1993,1987,,0,11957292,2127632,,0,11957292,2127632,,0,0,0,PDN
EI366,,1994,1987,,0,11957292,2127632,,0,11957292,2127632,,0,0,0,PDN
EI366,,1995,1987,,0,11957292,2127632,,0,11957292,2127632,,0,0,0,PDN
EI366,,1996,1987,,0,11957292,2127632,,0,11957292,2127632,,0,0,0,PDN
EI366,,1997,1987,,0,11957292,2127632,,0,11957292,2127632,,0,0,0,PDN
EI366,,1998,1987,,0,11957292,2127632,,0,11957292,2127632,,0,0,0,PDN
EI366,,1999,1987,,0,11957292,2127632,,0,11957292,2127632,,0,0,0,PDN
EI366,,2000,1987,,0,11957292,2127632,,0,11957292,2127632,,0,0,0,PDN
EI366,,2001,1987,,0,11957292,2127632,,0,11957292,2127632,,0,0,0,PDN
EI366,,2002,1987,,0,11957292,2127632,,0,11957292,2127632,,0,0,0,PDN
EI366,,2003,1987,,0,11957292,2127632,,0,11957292,2127632,,0,0,0,PDN
EI366,,2004,1987,,0,11957292,2127632,,0,11957292,2127632,,0,0,0,PDN
EI366,,2005,1987,,0,11957292,2127632,,0,11957292,2127632,,0,0,0,PDN
EI366,,2006,1987,,0,11957292,2127632,,0,11957292,2127632,,0,0,0,PDN
EI366,,2007,1987,,0,11957292,2127632,,0,11957292,2127632,,0,0,0,PDN
EI366,,2008,1987,,0,11957292,2127632,,0,11957292,2127632,,0,0,0,PDN
EI366,,2009,1987,,0,12196761,2170243,,0,12196761,2170243,,0,0,0,PDN
EI366,,2010,1987,,0,12196761,2170243,,0,12196761,2170243,,0,0,0,PDN
EI366,,2011,1987,,0,12196761,2170243,,0,12196761,2170243,,0,0,0,PDN
EI366,,2012,1987,,0,12196761,2170243,,0,12196761,2170243,,0,0,0,PDN
EI366,,2013,1987,,0,12196761,2170243,,0,12196761,2170243,,0,0,0,PDN
EI366,,2014,1987,,0,12196761,2170243,,0,12196761,2170243,,0,0,0,PDN
EI366,,2015,1987,,0,12196761,2170243,,0,12196761,2170243,,0,0,0,PDN
EI366,,2016,1987,,0,12196761,2170243,,0,12196761,2170243,,0,0,0,PDN
EI366,,2017,1987,,0,12196761,2170243,,0,12196761,2170243,,0,0,0,PDN
EI366,,2017,1987,,0,12196761,2170243,,0,12196761,2170243,,0,0,0,PDN
EI380,,1976,1974,,41402,41401044,7408136,,0,0,0,,41402,41401044,7408136,PDN
EI380,,1977,1974,,41402,41401044,7408136,,0,0,0,,41402,41401044,7408136,PDN
EI380,,1978,1974,,111643,78693034,14113962,,17019,14040475,2515324,,94624,64652559,11598638,PDN
EI380,,1979,1974,,114330,122000000,21822515,,27215,39325342,7024607,,87115,82674658,14797908,PDN
EI380,,1980,1974,,121500,125700000,22488048,,39330,62236103,11113370,,82170,63463897,11374678,PDN
EI380,,1981,1974,,216101,210985000,37757916,,55098,92213934,16463271,,161003,118771066,21294645,PDN
EI380,,1982,1974,,211465,216129655,38668699,,84870,128138487,22885313,,126595,87991168,15783386,PDN
EI380,,1983,1974,,207329,222218691,39748021,,93369,137690469,24593452,,113960,84528222,15154569,PDN
EI380,,1984,1974,,220484,232224416,41541554,,102871,151496985,27059630,,117613,80727431,14481924,PDN
EI380,,1985,1974,,227410,235493456,42130160,,110016,160779549,28718477,,117394,74713907,13411683,PDN
EI380,,1986,1974,,5403596,252084185,50258433,,109854,169113521,30201228,,5293742,82970664,20057205,PDN
EI380,,1987,1974,,5399620,235512415,47305744,,116928,175485617,31342127,,5282692,60026798,15963617,PDN
EI380,,1988,1974,,149948,227765558,40677627,,120659,187827160,33541862,,29289,39938398,7135765,PDN
EI380,,1989,1974,,151457,239034463,42684280,,122440,199548629,35629313,,29017,39485834,7054967,PDN
EI380,,1990,1974,,154880,243369251,43459017,,125286,208918625,37299419,,29594,34450626,6159598,PDN
EI380,,1991,1974,,165371,258751811,46206619,,130043,217976637,38915921,,35328,40775174,7290698,PDN
EI380,,1992,1974,,165789,280715369,50115143,,135614,227087986,40542729,,30175,53627383,9572414,PDN
EI380,,1993,1974,,166680,280715369,50116034,,142236,236404942,42207172,,24444,44310427,7908862,PDN
EI380,,1994,1974,,165205,280715369,50114559,,148722,245380579,43810747,,16483,35334790,6303812,PDN
EI380,,1995,1974,,170106,279557323,49913402,,153610,252617517,45103346,,16496,26939806,4810056,PDN
EI380,,1996,1974,,177424,289124595,51623081,,160936,259072000,46259157,,16488,30052595,5363924,PDN
EI380,,1997,1974,,184241,289124595,51629898,,171263,264819288,47292133,,12978,24305307,4337765,PDN
EI380,,1998,1974,,188780,291251253,52012846,,178081,270249979,48265266,,10699,21001274,3747580,PDN
EI380,,1999,1974,,193526,304840917,54435682,,179311,275510112,49202463,,14215,29330805,5233219,PDN
EI380,,2000,1974,,5229734,315778720,61418118,,179986,278222936,49685846,,5049748,37555784,11732272,PDN
EI380,,2001,1974,,5229734,315778720,61418118,,180390,280348629,50064488,,5049344,35430091,11353630,PDN
EI380,,2002,1974,,3241976,316106688,59488718,,600385,282001965,50778671,,2641591,34104723,8710047,PDN
EI380,,2003,1974,,3883718,319337618,60705358,,1529065,286576396,52521306,,2354653,32761222,8184052,PDN
EI380,,2004,1974,,4030369,320032549,60975663,,2473728,290766679,54211571,,1556641,29265870,6764092,PDN
EI380,,2005,1974,,3936774,299605148,57247299,,2863710,291732499,54773407,,1073064,7872649,2473892,PDN
EI380,,2006,1974,,4318468,303804977,58376293,,3309061,292246396,55310199,,1009407,11558581,3066094,PDN
EI380,,2007,1974,,4255216,304349347,58409904,,3609827,296514704,56370450,,645389,7834643,2039454,PDN
EI380,,2008,1974,,4255216,304349347,58409904,,3904773,298887972,57087686,,350443,5461375,1322218,PDN
EI380,,2009,1974,,3904773,305048061,58183789,,3904773,304255659,58042792,,0,792402,140997,PDN
EI380,,2010,1974,,3904773,304255659,58042792,,3904773,304255659,58042792,,0,0,0,PDN
EI380,,2011,1974,,3904773,304255659,58042792,,3904773,304255659,58042792,,0,0,0,PDN
EI380,,2012,1974,,3904773,304255659,58042792,,3904773,304255659,58042792,,0,0,0,PDN
EI380,,2013,1974,,3904773,304255659,58042792,,3904773,304255659,58042792,,0,0,0,PDN
EI380,,2014,1974,,3904773,304255659,58042792,,3904773,304255659,58042792,,0,0,0,PDN
EI380,,2015,1974,,3904773,304255659,58042792,,3904773,304255659,58042792,,0,0,0,PDN
EI380,,2016,1974,,3904773,304255659,58042792,,3904773,304255659,58042792,,0,0,0,PDN
EI380,,2017,1974,,3904773,304255659,58042792,,3904773,304255659,58042792,,0,0,0,PDN
EI380,,2017,1974,,3904773,304255659,58042792,,3904773,304255659,58042792,,0,0,0,PDN
EI385,,1978,1975,,43286,43285950,7745412,,0,0,0,,43286,43285950,7745412,PDN
EI385,,1979,1975,,43286,43285950,7745412,,0,0,0,,43286,43285950,7745412,PDN
EI385,,1980,1975,,50286,50285950,8997964,,0,0,0,,50286,50285950,8997964,PDN
EI385,,1981,1975,,424732,107265950,19511200,,145463,17522610,3263365,,279269,89743340,16247835,PDN
EI385,,1982,1975,,424732,107265950,19511200,,273091,34497596,6411453,,151641,72768354,13099747,PDN
EI385,,1983,1975,,796815,110299767,20423108,,347635,46588854,8637467,,449180,63710913,11785641,PDN
EI385,,1984,1975,,796815,110299767,20423108,,411190,58391016,10801050,,385625,51908751,9622058,PDN
EI385,,1985,1975,,1758794,117205727,22613906,,450388,68785112,12689732,,1308406,48420615,9924174,PDN
EI385,,1986,1975,,6783038,164252792,36009513,,527055,84047114,15482057,,6255983,80205678,20527456,PDN
EI385,,1987,1975,,5737142,168377042,35697470,,613663,99745646,18361999,,5123479,68631396,17335471,PDN
EI385,,1988,1975,,5255625,169649644,35442394,,750413,118208521,21783958,,4505212,51441123,13658436,PDN
EI385,,1989,1975,,4619029,208866408,41783870,,945652,159427610,29313554,,3673377,49438798,12470316,PDN
EI385,,1990,1975,,2000468,415862196,75997300,,1077498,194447689,35676731,,922970,221414507,40320569,PDN
EI385,,1991,1975,,2437036,425602946,78167098,,1352827,226095113,41583274,,1084209,199507833,36583824,PDN
EI385,,1992,1975,,4363421,358848269,68215426,,1869780,240490675,44661715,,2493641,118357594,23553711,PDN
EI385,,1993,1975,,6617240,386528705,75394590,,2947078,252151310,47813859,,3670162,134377395,27580731,PDN
EI385,,1994,1975,,8073036,322101953,65386551,,3786492,260337230,50109843,,4286544,61764723,15276708,PDN
EI385,,1995,1975,,7882015,319821992,64789843,,4333983,264942020,51476691,,3548032,54879972,13313152,PDN
EI385,,1996,1975,,8111439,327872056,66451662,,4781196,267826632,52437180,,3330243,60045424,14014482,PDN
EI385,,1997,1975,,8112413,332926969,67352087,,5099706,269437449,53042313,,3012707,63489520,14309774,PDN
EI385,,1998,1975,,8115006,332926969,67354680,,5359417,272599486,53864664,,2755589,60327483,13490016,PDN
EI385,,1999,1975,,7374834,282704253,57678082,,5562962,274003875,54318100,,1811872,8700378,3359982,PDN
EI385,,2000,1975,,6434084,280507226,56346402,,5655242,274396536,54480248,,778842,6110690,1866154,PDN
EI385,,2001,1975,,6505601,278700040,56096356,,5788786,274827236,54690429,,716815,3872804,1405927,PDN
EI385,,2002,1975,,6597899,283466957,57036860,,5950903,275640665,54997285,,646996,7826292,2039575,PDN
EI385,,2003,1975,,6597899,283466957,57036860,,6115511,277744252,55536196,,482388,5722705,1500664,PDN
EI385,,2004,1975,,6677547,288916876,58086244,,6387133,280786326,56349113,,290414,8130550,1737131,PDN
EI385,,2005,1975,,7668395,288575622,59016370,,6617986,282989753,56972035,,1050409,5585869,2044335,PDN
EI385,,2006,1975,,7639990,288336173,58945359,,6898996,284724049,57561638,,740994,3612124,1383721,PDN
EI385,,2007,1975,,7378038,288590129,58728595,,7192197,285676070,58024238,,185841,2914059,704357,PDN
EI385,,2008,1975,,7378038,288569598,58724941,,7280902,286066156,58182353,,97136,2503442,542588,PDN
EI385,,2009,1975,,7280902,291529701,59154515,,7280902,291529701,59154515,,0,0,0,PDN
EI385,,2010,1975,,7280902,291529701,59154515,,7280902,291529701,59154515,,0,0,0,PDN
EI385,,2011,1975,,7280902,291529701,59154515,,7280902,291529701,59154515,,0,0,0,PDN
EI385,,2012,1975,,7280902,291529701,59154515,,7280902,291529701,59154515,,0,0,0,PDN
EI385,,2013,1975,,7280902,291529701,59154515,,7280902,291529701,59154515,,0,0,0,PDN
EI385,,2014,1975,,7280902,291529701,59154515,,7280902,291529701,59154515,,0,0,0,PDN
EI385,,2015,1975,,7280902,291529701,59154515,,7280902,291529701,59154515,,0,0,0,PDN
EI385,,2016,1975,,7280902,291529701,59154515,,7280902,291529701,59154515,,0,0,0,PDN
EI385,,2017,1975,,7280902,291529701,59154515,,7280902,291529701,59154515,,0,0,0,PDN
EI385,,2017,1975,,7280902,291529701,59154515,,7280902,291529701,59154515,,0,0,0,PDN
EI395,,2004,2004,,6487,6487137,1160782,,0,84402,15018,,6487,6402735,1145764,PDN
EI395,,2005,2004,,6487,6487137,1160782,,4333,3122973,560022,,2154,3364164,600760,PDN
EI395,,2006,2004,,9186,7139044,1279479,,8324,6294969,1128425,,862,844075,151054,PDN
EI395,,2007,2004,,9186,7139044,1279479,,9186,7139044,1279479,,0,0,0,PDN
EI395,,2008,2004,,9186,7139044,1279479,,9186,7139044,1279479,,0,0,0,PDN
EI395,,2009,2004,,9186,7139044,1279479,,9186,7139044,1279479,,0,0,0,PDN
EI395,,2010,2004,,9186,7139044,1279479,,9186,7139044,1279479,,0,0,0,PDN
EI395,,2011,2004,,9186,7139044,1279479,,9186,7139044,1279479,,0,0,0,PDN
EI395,,2012,2004,,9186,7139044,1279479,,9186,7139044,1279479,,0,0,0,PDN
EI395,,2013,2004,,9186,7139044,1279479,,9186,7139044,1279479,,0,0,0,PDN
EI395,,2014,2004,,9186,7139044,1279479,,9186,7139044,1279479,,0,0,0,PDN
EI395,,2015,2004,,9186,7139044,1279479,,9186,7139044,1279479,,0,0,0,PDN
EI395,,2016,2004,,9186,7139044,1279479,,9186,7139044,1279479,,0,0,0,PDN
EI395,,2017,2004,,9186,7139044,1279479,,9186,7139044,1279479,,0,0,0,PDN
EI395,,2017,2004,,9186,7139044,1279479,,9186,7139044,1279479,,0,0,0,PDN
EW1006,,1997,1988,,138087,69043141,12423343,,0,0,0,,138087,69043141,12423343,PDP
EW1006,,1998,1988,,6396989,90299439,22464505,,0,0,0,,6396989,90299439,22464505,PDP
EW1006,,1999,1988,,7046108,6278083,8163205,,904947,726593,1034234,,6141161,5551490,7128971,PDP
EW1006,,2000,1988,,17076187,23319225,21225516,,1914046,1710642,2218431,,15162141,21608583,19007085,PDP
EW1006,,2001,1988,,13171697,20216072,16768863,,2867540,2435929,3300979,,10304157,17780143,13467884,PDP
EW1006,,2002,1988,,13135296,20216072,16732462,,3105217,3174930,3670151,,10030079,17041142,13062311,PDP
EW1006,,2003,1988,,13895564,81274753,28357264,,3103453,3174930,3668387,,10792111,78099823,24688877,PDP
EW1006,,2004,1988,,16926556,42040125,24407005,,3116783,3554888,3749325,,13809773,38485237,20657680,PDP
EW1006,,2005,1988,,18031899,33599769,24010506,,3258372,7701052,4628666,,14773527,25898717,19381840,PDP
EW1006,,2006,1988,,18031899,28796687,23155865,,3300452,8173193,4754757,,14731447,20623494,18401108,PDP
EW1006,,2007,1988,,19302937,30096861,24658251,,3300452,10028997,5084971,,16002485,20067864,19573280,PDP
EW1006,,2008,1988,,19302865,30106769,24659941,,3300031,10044201,5087255,,16002834,20062568,19572686,PDP
EW1006,,2009,1988,,4571490,11344453,6590076,,3457144,11010417,5416293,,1114346,334036,1173783,PDP
EW1006,,2010,1988,,4798590,12547712,7031279,,3746098,11685989,5825455,,1052492,861723,1205823,PDP
EW1006,,2011,1988,,4798590,12547712,7031279,,3982090,11909952,6101299,,816500,637760,929980,PDP
EW1006,,2012,1988,,4798590,12547712,7031279,,4142692,12039986,6285038,,655898,507726,746240,PDP
EW1006,,2013,1988,,4798590,12547712,7031279,,4288292,12120017,6444879,,510298,427695,586400,PDP
EW1006,,2014,1988,,4798590,12547712,7031279,,4458605,12196569,6628813,,339985,351143,402466,PDP
EW1006,,2015,1988,,4798590,12547712,7031279,,4557450,12244623,6736209,,241140,303089,295070,PDP
EW1006,,2016,1988,,4798590,12547712,7031279,,4662065,12315632,6853458,,136525,232080,177820,PDP
EW1006,,2017,1988,,4798590,12547712,7031279,,4758799,12408912,6966791,,39791,138800,64488,PDP
EW1006,,2017,1988,,4798590,12547712,7031279,,4758799,12408912,6966791,,39791,138800,64488,PDP
EW305,,1980,1980,,423500,23900000,4676169,,0,0,0,,423500,23900000,4676169,PDP
EW305,,1981,1980,,534800,43781880,8325170,,0,0,0,,534800,43781880,8325170,PDP
EW305,,1982,1980,,534800,43781880,8325170,,0,0,0,,534800,43781880,8325170,PDP
EW305,,1983,1980,,534800,40632380,7764761,,0,0,0,,534800,40632380,7764761,PDP
EW305,,1984,1980,,534800,40632380,7764761,,0,0,0,,534800,40632380,7764761,PDP
EW305,,1985,1980,,1901592,53389432,11401491,,0,0,0,,1901592,53389432,11401491,PDP
EW305,,1986,1980,,2004770,66359097,13812439,,2129,12899,4424,,2002641,66346198,13808015,PDP
EW305,,1987,1980,,2786145,80045274,17029076,,428972,6966792,1668615,,2357173,73078482,15360461,PDP
EW305,,1988,1980,,2786145,80045274,17029076,,526946,11407292,2556713,,2259199,68637982,14472363,PDP
EW305,,1989,1980,,2831001,81868954,17398431,,881119,17814636,4050983,,1949882,64054318,13347448,PDP
EW305,,1990,1980,,5904689,111376493,25722570,,2220684,34352335,8333199,,3684005,77024158,17389371,PDP
EW305,,1991,1980,,7559045,129964896,30684471,,4061846,53574695,13594710,,3497199,76390201,17089761,PDP
EW305,,1992,1980,,13205187,132757295,36827481,,6381119,66517471,18216968,,6824068,66239824,18610513,PDP
EW305,,1993,1980,,13901890,128252930,36722696,,7581837,68639351,19795245,,6320053,59613579,16927451,PDP
EW305,,1994,1980,,16609232,157413234,44618704,,8754877,81407790,23240249,,7854355,76005444,21378455,PDP
EW305,,1995,1980,,12813087,134824785,36803262,,8917180,89246309,24797306,,3895907,45578476,12005956,PDP
EW305,,1996,1980,,20892966,150929103,47748678,,10271795,95255660,27221201,,10621171,55673443,20527477,PDP
EW305,,1997,1980,,20571198,150027738,47266525,,13240930,103008594,31569861,,7330268,47019144,15696664,PDP
EW305,,1998,1980,,21227669,151825494,48242881,,15209105,106509631,34160997,,6018564,45315863,14081884,PDP
EW305,,1999,1980,,24805268,153883971,52186758,,17255457,121316856,38842086,,7549811,32567115,13344672,PDP
EW305,,2000,1980,,30797593,200109702,66404302,,20139569,134236156,44025006,,10658024,65873546,22379296,PDP
EW305,,2001,1980,,30060536,188060464,63523252,,21974894,140797841,47027891,,8085642,47262623,16495361,PDP
EW305,,2002,1980,,30064150,164933573,59411761,,23283565,143914234,48891080,,6780585,21019339,10520681,PDP
EW305,,2003,1980,,27949127,159461942,56323138,,24214802,146263440,50240325,,3734325,13198502,6082813,PDP
EW305,,2004,1980,,27361822,161282740,56059819,,25026174,149703845,51663869,,2335648,11578895,4395950,PDP
EW305,,2005,1980,,28717569,176924737,60198839,,25555445,154031416,52963170,,3162124,22893321,7235669,PDP
EW305,,2006,1980,,29413552,177140493,60933213,,26072182,158300267,54239489,,3341370,18840226,6693724,PDP
EW305,,2007,1980,,30433681,184824683,63320636,,26724386,161322625,55429479,,3709295,23502058,7891157,PDP
EW305,,2008,1980,,32339330,196667862,67333611,,28046584,164995895,57405284,,4292746,31671967,9928327,PDP
EW305,,2009,1980,,32409361,188539627,65957335,,29292089,172378366,59964393,,3117272,16161261,5992941,PDP
EW305,,2010,1980,,32600290,189370073,66296029,,30015286,175751158,61287730,,2585004,13618915,5008300,PDP
EW305,,2011,1980,,32584650,185996981,65680195,,30609915,177510237,62195361,,1974735,8486744,3484833,PDP
EW305,,2012,1980,,32584650,185996981,65680195,,31079581,178526398,62845840,,1505069,7470583,2834355,PDP
EW305,,2013,1980,,32584650,185996981,65680195,,31438285,179160039,63317292,,1146365,6836942,2362902,PDP
EW305,,2014,1980,,32478173,185826787,65543434,,31712991,179553491,63662008,,765182,6273296,1881426,PDP
EW305,,2015,1980,,32587512,186540858,65779830,,31949644,180439324,64056280,,637868,6101534,1723548,PDP
EW305,,2016,1980,,33376043,194851422,68047109,,32173952,182533018,64653131,,1202091,12318404,3393977,PDP
EW305,,2017,1980,,34149385,202648861,70207895,,32544642,184832301,65432946,,1604743,17816560,4774949,PDP
EW305,,2017,1980,,34149385,202648861,70207895,,32544642,184832301,65432946,,1604743,17816560,4774949,PDP
EW826,,1987,1985,,10538174,123139780,32449167,,0,0,0,,10538174,123139780,32449167,PDP
EW826,,1988,1985,,10538174,123139780,32449167,,0,0,0,,10538174,123139780,32449167,PDP
EW826,,1989,1985,,14729038,34001935,20779204,,647802,1278354,875267,,14081236,32723581,19903937,PDP
EW826,,1990,1985,,15685820,35554948,22012323,,3178868,7646023,4539370,,12506952,27908925,17472953,PDP
EW826,,1991,1985,,16253301,36897235,22818645,,5519192,13585707,7936578,,10734109,23311528,14882067,PDP
EW826,,1992,1985,,18466608,45739520,26605313,,7186085,17660579,10328537,,11280523,28078941,16276776,PDP
EW826,,1993,1985,,19057332,46484113,27328526,,8642334,22033428,12562873,,10414998,24450685,14765653,PDP
EW826,,1994,1985,,21030187,71987257,33839307,,10628466,30323763,16024153,,10401721,41663494,17815154,PDP
EW826,,1995,1985,,20877769,75437444,34300802,,12108665,37225453,18732411,,8769104,38211991,15568391,PDP
EW826,,1996,1985,,21469101,87932064,37115376,,13223261,39889484,20321034,,8245840,48042580,16794342,PDP
EW826,,1997,1985,,18639547,68117210,30760047,,14146138,42324872,21677254,,4493409,25792338,9082793,PDP
EW826,,1998,1985,,19113932,66122602,30879520,,14846780,44254069,22721170,,4267152,21868533,8158350,PDP
EW826,,1999,1985,,19215011,61476959,30153972,,15424005,45676605,23551515,,3791006,15800354,6602457,PDP
EW826,,2000,1985,,19457076,62711598,30615723,,15896561,46801064,24224152,,3560515,15910534,6391571,PDP
EW826,,2001,1985,,19502916,61443077,30435848,,16192827,47342820,24616816,,3310089,14100257,5819032,PDP
EW826,,2002,1985,,19445540,61599381,30406284,,16504625,47887503,25025533,,2940915,13711878,5380751,PDP
EW826,,2003,1985,,20904335,67252262,32870930,,16960387,48692824,25624591,,3943948,18559438,7246339,PDP
EW826,,2004,1985,,20421630,65819676,32133316,,17363985,50183277,26293394,,3057645,15636399,5839922,PDP
EW826,,2005,1985,,21068654,66959484,32983153,,17625111,51167615,26729669,,3443543,15791869,6253484,PDP
EW826,,2006,1985,,24139002,73908376,37289958,,17885131,52151612,27164777,,6253871,21756764,10125181,PDP
EW826,,2007,1985,,24800454,76290843,38375337,,18276988,53367448,27772975,,6523466,22923395,10602362,PDP
EW826,,2008,1985,,29609262,87502853,45179165,,19559917,56024429,29528677,,10049345,31478424,15650488,PDP
EW826,,2009,1985,,29549650,94846749,46426299,,21208030,63168600,32447995,,8341620,31678149,13978301,PDP
EW826,,2010,1985,,29972706,98048666,47419090,,22955487,70099833,35428767,,7017219,27948833,11990323,PDP
EW826,,2011,1985,,30061794,98262306,47546192,,24373534,75231368,37759901,,5688260,23030938,9786294,PDP
EW826,,2012,1985,,30061794,98262306,47546192,,25379353,78061183,39269245,,4682441,20201123,8276949,PDP
EW826,,2013,1985,,30385870,98248539,47867819,,26162479,80426625,40473269,,4223391,17821914,7394551,PDP
EW826,,2014,1985,,30945518,99797503,48703084,,26922061,82538490,41608625,,4023457,17259013,7094458,PDP
EW826,,2015,1985,,31896712,104330608,50460878,,27757874,84939012,42871577,,4138838,19391596,7589302,PDP
EW826,,2016,1985,,32423572,107173912,51493665,,28321795,86833228,43772548,,4101777,20340684,7721116,PDP
EW826,,2017,1985,,32730364,107610604,51878162,,28861694,88526631,44613764,,3868670,19083973,7264397,PDP
EW826,,2017,1985,,32730364,107610604,51878162,,28861694,88526631,44613764,,3868670,19083973,7264397,PDP
EW868,,2001,1986,,668148,53092762,10115259,,0,0,0,,668148,53092762,10115259,PDN
EW868,,2002,1986,,328501,35170292,6586561,,0,0,0,,328501,35170292,6586561,PDN
EW868,,2003,1986,,1114183,61956319,12138439,,77300,2197759,468360,,1036883,59758560,11670079,PDN
EW868,,2004,1986,,1114287,61968791,12140763,,143440,4340566,915783,,970847,57628225,11224980,PDN
EW868,,2005,1986,,1114287,61968791,12140763,,189398,5857546,1231666,,924889,56111245,10909097,PDN
EW868,,2006,1986,,855234,53296272,10338557,,287721,9101648,1907231,,567513,44194624,8431326,PDN
EW868,,2007,1986,,855234,53296272,10338557,,374399,12267766,2557276,,480835,41028506,7781281,PDN
EW868,,2008,1986,,855234,53296272,10338557,,395472,12914891,2693495,,459762,40381381,7645062,PDN
EW868,,2009,1986,,485042,14266960,3023647,,421302,13547270,2831849,,63740,719690,191799,PDN
EW868,,2010,1986,,485042,14266960,3023647,,440004,13900309,2913369,,45038,366651,110279,PDN
EW868,,2011,1986,,485042,14266960,3023647,,456206,14052526,2956656,,28836,214434,66991,PDN
EW868,,2012,1986,,514961,14961232,3177102,,471130,14168913,2992289,,43831,792319,184813,PDN
EW868,,2013,1986,,514961,14961232,3177102,,484167,14369540,3041024,,30794,591692,136077,PDN
EW868,,2014,1986,,514961,14961232,3177102,,492553,14526914,3077413,,22408,434318,99689,PDN
EW868,,2015,1986,,514961,14961232,3177102,,503711,14661423,3112505,,11250,299809,64597,PDN
EW868,,2016,1986,,514961,14961232,3177102,,509633,14720350,3128912,,5328,240882,48190,PDN
EW868,,2017,1986,,509633,14720350,3128912,,509633,14720350,3128912,,0,0,0,PDN
EW868,,2017,1986,,509633,14720350,3128912,,509633,14720350,3128912,,0,0,0,PDN
EW873,,1987,1985,,1663112,8315561,3142749,,0,0,0,,1663112,8315561,3142749,PDP
EW873,,1992,1985,,51485951,25742975,56066552,,0,0,0,,51485951,25742975,56066552,PDP
EW873,,1993,1985,,51485951,25742975,56066552,,0,0,0,,51485951,25742975,56066552,PDP
EW873,,1994,1985,,46730667,23365334,50888200,,1998875,1507002,2267025,,44731792,21858332,48621175,PDP
EW873,,1995,1985,,47108349,23629711,51312924,,17111191,12424823,19322014,,29997158,11204888,31990910,PDP
EW873,,1996,1985,,64880585,48812163,73566023,,30681839,22215392,34634756,,34198746,26596771,38931267,PDP
EW873,,1997,1985,,80752736,59123529,91272937,,43154757,31342672,48731745,,37597979,27780857,42541192,PDP
EW873,,1998,1985,,107190805,87080023,122685471,,60915243,45698188,69046593,,46275562,41381835,53638878,PDP
EW873,,1999,1985,,116293285,91733937,132616050,,79201495,61075267,90068980,,37091790,30658670,42547070,PDP
EW873,,2000,1985,,114853737,90662848,130985916,,90843823,71006840,103478492,,24009914,19656008,27507424,PDP
EW873,,2001,1985,,134331600,115192541,154828493,,101106791,80824979,115488460,,33224809,34367562,39340033,PDP
EW873,,2002,1985,,132373946,112830308,152450513,,110096827,89671533,126052616,,22277119,23158775,26397897,PDP
EW873,,2003,1985,,139552248,117135624,160394886,,118063000,97286611,135373785,,21489248,19849013,25021101,PDP
EW873,,2004,1985,,174184317,166014753,203724308,,124707670,102646596,142972189,,49476647,63368157,60752119,PDP
EW873,,2005,1985,,196095143,187619200,229479342,,132826589,112300900,152808956,,63268554,75318300,76670386,PDP
EW873,,2006,1985,,179494980,165731616,208984591,,140152697,121288977,161734366,,39342283,44442639,47250225,PDP
EW873,,2007,1985,,179151752,164570084,208434685,,145430337,127696351,168152108,,33721415,36873733,40282577,PDP
EW873,,2008,1985,,184127163,170739724,214507897,,148595950,130882369,171884628,,35531213,39857355,42623269,PDP
EW873,,2009,1985,,169154124,153561814,196478289,,152321378,135487906,176429548,,16832746,18073908,20048744,PDP
EW873,,2010,1985,,169154124,153561814,196478289,,155399128,138801150,180096841,,13754996,14760664,16381449,PDP
EW873,,2011,1985,,169154124,153561814,196478289,,158190931,141992286,183456461,,10963193,11569528,13021829,PDP
EW873,,2012,1985,,170924236,156845601,198832707,,160863184,144884611,186643365,,10061052,11960990,12189341,PDP
EW873,,2013,1985,,170924236,156845601,198832707,,163489216,147886661,189803569,,7435020,8958940,9029136,PDP
EW873,,2014,1985,,170924236,156845601,198832707,,165883876,150882991,192731385,,5040360,5962610,6101322,PDP
EW873,,2015,1985,,171258049,157222418,199233569,,168240362,153599645,195571260,,3017687,3622773,3662307,PDP
EW873,,2016,1985,,180044358,165921558,209567767,,170453178,155972311,198206259,,9591180,9949247,11361509,PDP
EW873,,2017,1985,,180069004,165946450,209596842,,172518756,158294232,200684989,,7550248,7652218,8911852,PDP
EW873,,2017,1985,,180069004,165946450,209596842,,172518756,158294232,200684989,,7550248,7652218,8911852,PDP
EW878,,2000,2000,,15396297,42346409,22931245,,0,0,0,,15396297,42346409,22931245,PDP
EW878,,2001,2000,,13579256,31533524,19190204,,41471,491319,128894,,13537785,31042205,19061310,PDP
EW878,,2002,2000,,13579256,31533524,19190204,,438807,3377387,1039766,,13140449,28156137,18150438,PDP
EW878,,2003,2000,,4577048,20434988,8213167,,509699,5054229,1409028,,4067349,15380759,6804139,PDP
EW878,,2004,2000,,4770870,13940960,7251467,,733617,6610110,1909793,,4037253,7330850,5341674,PDP
EW878,,2005,2000,,4321399,20190162,7913955,,946546,7682675,2313570,,3374853,12507487,5600385,PDP
EW878,,2006,2000,,13808286,35174137,20067030,,1047521,9974759,2822389,,12760765,25199378,17244641,PDP
EW878,,2007,2000,,13808286,35174137,20067030,,1047924,10025635,2831845,,12760362,25148502,17235185,PDP
EW878,,2008,2000,,13808324,35175410,20067294,,1047924,9999858,2827258,,12760400,25175552,17240036,PDP
EW878,,2009,2000,,6726959,15757587,9530800,,1670165,10591230,3554725,,5056794,5166357,5976075,PDP
EW878,,2010,2000,,8300179,17597438,11431396,,2308906,11135032,4290228,,5991273,6462406,7141168,PDP
EW878,,2011,2000,,8300179,17597438,11431396,,2801753,11513210,4850367,,5498426,6084228,6581029,PDP
EW878,,2012,2000,,8300179,17597438,11431396,,2901141,11608596,4966727,,5399038,5988842,6464669,PDP
EW878,,2013,2000,,8300179,17597438,11431396,,3528607,12277695,5713250,,4771572,5319743,5718146,PDP
EW878,,2014,2000,,8300179,17597438,11431396,,3827939,12538117,6058921,,4472240,5059321,5372475,PDP
EW878,,2015,2000,,8300179,17597438,11431396,,3924969,12619533,6170438,,4375210,4977905,5260958,PDP
EW878,,2016,2000,,13888608,21098616,17642810,,4898718,13321098,7269020,,8989890,7777518,10373790,PDP
EW878,,2017,2000,,41502309,42171298,49006099,,9570598,16874659,12573207,,31931711,25296639,36432892,PDP
EW878,,2017,2000,,41502309,42171298,49006099,,9570598,16874659,12573207,,31931711,25296639,36432892,PDP
EW910,,1997,1996,,26326212,72091299,39153845,,0,0,0,,26326212,72091299,39153845,PDP
EW910,,1998,1996,,20588015,33491920,26547431,,20010,24884,24438,,20568005,33467036,26522993,PDP
EW910,,1999,1996,,19554398,26233429,24222268,,3857864,5397241,4818227,,15696534,20836188,19404041,PDP
EW910,,2000,1996,,20814632,30571859,26254465,,7284833,10734605,9194905,,13529799,19837254,17059560,PDP
EW910,,2001,1996,,17490913,29666652,22769677,,8515170,13392441,10898167,,8975743,16274211,11871510,PDP
EW910,,2002,1996,,16487439,31747610,22136480,,9437901,15486759,12193552,,7049538,16260851,9942928,PDP
EW910,,2003,1996,,15171723,24744146,19574596,,9945856,16313305,12848579,,5225867,8430841,6726017,PDP
EW910,,2004,1996,,15079872,24101052,19368315,,10298830,16791067,13286564,,4781042,7309985,6081751,PDP
EW910,,2005,1996,,15503475,24573014,19875897,,10552644,17100519,13595441,,4950831,7472495,6280456,PDP
EW910,,2006,1996,,14686326,23579030,18881883,,10757967,17325487,13840794,,3928359,6253543,5041089,PDP
EW910,,2007,1996,,14686326,23579030,18881883,,10948306,17573066,14075186,,3738020,6005964,4806697,PDP
EW910,,2008,1996,,14835682,24043871,19113951,,11061400,17729221,14216066,,3774282,6314650,4897885,PDP
EW910,,2009,1996,,14836953,24099166,19125062,,11320645,18059376,14534059,,3516308,6039790,4591003,PDP
EW910,,2010,1996,,14836953,24099166,19125062,,11513459,18338156,14776476,,3323494,5761010,4348584,PDP
EW910,,2011,1996,,14836953,24099166,19125062,,11643272,18542557,14942660,,3193681,5556609,4182401,PDP
EW910,,2012,1996,,14924934,23896127,19176914,,11723790,18628529,15038475,,3201144,5267598,4138438,PDP
EW910,,2013,1996,,14924934,23896127,19176914,,11796245,18711455,15125687,,3128689,5184672,4051229,PDP
EW910,,2014,1996,,14924934,23896127,19176914,,11838846,18780680,15180605,,3086088,5115447,3996310,PDP
EW910,,2015,1996,,15973464,26098040,20617243,,11954146,19080044,15349172,,4019318,7017996,5268072,PDP
EW910,,2016,1996,,27452554,106975143,46487277,,12608827,21937428,16512285,,14843727,85037715,29974992,PDP
EW910,,2017,1996,,18410098,40666163,25646071,,13478729,25981840,18101833,,4931369,14684323,7544238,PDP
EW910,,2017,1996,,18410098,40666163,25646071,,13478729,25981840,18101833,,4931369,14684323,7544238,PDP
EW914,,1986,1984,,1756567,2459194,2194146,,0,0,0,,1756567,2459194,2194146,PDP
EW914,,1987,1984,,1756567,2459194,2194146,,0,0,0,,1756567,2459194,2194146,PDP
EW914,,1993,1984,,12362419,59581278,22964070,,224921,1540721,499071,,12137498,58040557,22464999,PDP
EW914,,1994,1984,,12361516,59575921,22962214,,585009,2701791,1065755,,11776507,56874130,21896459,PDP
EW914,,1995,1984,,12361516,59575921,22962214,,1236447,3910641,1932291,,11125069,55665280,21029923,PDP
EW914,,1996,1984,,7247191,17816310,10417353,,1630409,4781412,2481194,,5616782,13034898,7936159,PDP
EW914,,1997,1984,,1685148,4911660,2559109,,1685148,4911660,2559109,,0,0,0,PDP
EW914,,1998,1984,,1685148,4911660,2559109,,1685148,4911660,2559109,,0,0,0,PDP
EW914,,1999,1984,,1685148,4911660,2559109,,1685148,4911660,2559109,,0,0,0,PDP
EW914,,2000,1984,,1685148,4911660,2559109,,1685148,4911660,2559109,,0,0,0,PDP
EW914,,2001,1984,,19405473,19087920,22801900,,1685148,4911660,2559109,,17720325,14176260,20242791,PDP
EW914,,2002,1984,,14997964,15419604,17741666,,3227826,6200018,4331032,,11770138,9219586,13410634,PDP
EW914,,2003,1984,,9227490,11035762,11191149,,4821191,7429326,6143135,,4406299,3606436,5048014,PDP
EW914,,2004,1984,,9227490,11266737,11232248,,5706746,8182133,7162642,,3520744,3084604,4069606,PDP
EW914,,2005,1984,,12412654,13980003,14900199,,6464806,8869914,8043083,,5947848,5110089,6857116,PDP
EW914,,2006,1984,,10680924,12360133,12880236,,7131907,9459922,8815167,,3549017,2900211,4065069,PDP
EW914,,2007,1984,,10680924,12360133,12880236,,7545673,9776667,9285293,,3135251,2583466,3594943,PDP
EW914,,2008,1984,,13019004,15867253,15842359,,7863755,10054618,9652833,,5155249,5812635,6189526,PDP
EW914,,2009,1984,,11754815,14935301,14412342,,8245057,10444800,10103563,,3509758,4490501,4308780,PDP
EW914,,2010,1984,,11754815,14935301,14412342,,8851109,11114747,10828822,,2903706,3820554,3583520,PDP
EW914,,2011,1984,,11754815,14935301,14412342,,10294195,13016089,12610225,,1460620,1919212,1802117,PDP
EW914,,2012,1984,,13713115,17012819,16740307,,11560827,14702488,14176928,,2152288,2310331,2563379,PDP
EW914,,2013,1984,,13713115,17012819,16740307,,12168633,15449363,14917629,,1544482,1563456,1822677,PDP
EW914,,2014,1984,,13713115,17012819,16740307,,12638108,15989113,15483146,,1075007,1023706,1257161,PDP
EW914,,2015,1984,,13713115,17012819,16740307,,12968571,16422079,15890649,,744544,590740,849658,PDP
EW914,,2016,1984,,14165505,17944735,17358518,,13198653,16755941,16180137,,966852,1188794,1178381,PDP
EW914,,2017,1984,,14165505,17944735,17358518,,13399549,16983143,16421460,,765956,961592,937058,PDP
EW914,,2017,1984,,14165505,17944735,17358518,,13399549,16983143,16421460,,765956,961592,937058,PDP
EW921,,1993,1989,,46171354,60022780,56851564,,0,0,0,,46171354,60022780,56851564,PDP
EW921,,1994,1989,,31887679,41453983,39263833,,0,0,0,,31887679,41453983,39263833,PDP
EW921,,1995,1989,,31887679,41453983,39263833,,0,0,0,,31887679,41453983,39263833,PDP
EW921,,1996,1989,,22714834,29529285,27969155,,0,0,0,,22714834,29529285,27969155,PDP
EW921,,1997,1989,,59359638,60131312,70059160,,0,0,0,,59359638,60131312,70059160,PDP
EW921,,1998,1989,,59471130,59200577,70005041,,1035628,1075313,1226965,,58435502,58125264,68778076,PDP
EW921,,1999,1989,,59485645,59214657,70022061,,8840594,8448038,10343804,,50645051,50766619,59678257,PDP
EW921,,2000,1989,,65172421,60822950,75995010,,12850971,12365452,15051229,,52321450,48457498,60943781,PDP
EW921,,2001,1989,,52422853,53269555,61901421,,16564673,15625907,19345083,,35858180,37643648,42556338,PDP
EW921,,2002,1989,,45780133,48037855,54327794,,20435398,19010762,23818096,,25344735,29027093,30509698,PDP
EW921,,2003,1989,,45780133,48037855,54327794,,24604396,23245840,28740666,,21175737,24792015,25587128,PDP
EW921,,2004,1989,,42078320,42828404,49699032,,27525128,26188960,32185085,,14553192,16639444,17513947,PDP
EW921,,2005,1989,,53821476,51090637,62912337,,29171871,27750981,34109768,,24649605,23339656,28802569,PDP
EW921,,2006,1989,,53821476,50119021,62739451,,31022371,29340530,36243106,,22799105,20778491,26496345,PDP
EW921,,2007,1989,,53821476,50119021,62739451,,33569640,31175030,39116798,,20251836,18943991,23622653,PDP
EW921,,2008,1989,,60180569,58061832,70511856,,35609777,32532659,41398506,,24570792,25529173,29113350,PDP
EW921,,2009,1989,,58829338,56612860,68902801,,37475435,33981793,43522016,,21353903,22631067,25380783,PDP
EW921,,2010,1989,,58829338,56612860,68902801,,39048916,35223633,45316467,,19780422,21389227,23586335,PDP
EW921,,2011,1989,,58829338,56612860,68902801,,40366352,36189945,46805843,,18462986,20422915,22096957,PDP
EW921,,2012,1989,,58829338,56612860,68902801,,41311818,36931858,47883323,,17517520,19681002,21019477,PDP
EW921,,2013,1989,,58829338,56612860,68902801,,42131636,37514260,48806772,,16697702,19098600,20096030,PDP
EW921,,2014,1989,,58829338,56612860,68902801,,43006975,38174377,49799568,,15822363,18438483,19103233,PDP
EW921,,2015,1989,,61225808,58200625,71581790,,43845163,38828651,50754174,,17380645,19371974,20827615,PDP
EW921,,2016,1989,,61225808,58200625,71581790,,44541325,39363971,51545589,,16684483,18836654,20036201,PDP
EW921,,2017,1989,,61225808,58200625,71581790,,45226410,39932230,52331789,,15999398,18268395,19250003,PDP
EW921,,2017,1989,,61225808,58200625,71581790,,45226410,39932230,52331789,,15999398,18268395,19250003,PDP
EW947,,1986,1984,,236573,331202,295506,,0,0,0,,236573,331202,295506,PDN
EW947,,1987,1984,,236573,331202,295506,,0,0,0,,236573,331202,295506,PDN
EW947,,1990,1984,,10232650,16381592,13147524,,0,0,0,,10232650,16381592,13147524,PDN
EW947,,1991,1984,,7621676,17899893,10806710,,287408,4275185,1048117,,7334268,13624708,9758593,PDN
EW947,,1992,1984,,7449006,17692936,10597215,,614310,13196807,2962496,,6834696,4496129,7634719,PDN
EW947,,1993,1984,,7450508,91762538,23778362,,968160,25402935,5488255,,6482348,66359603,18290107,PDN
EW947,,1994,1984,,7451125,91767677,23779893,,1227463,36403218,7704904,,6223662,55364459,16074989,PDN
EW947,,1995,1984,,2607639,78246767,16530551,,1373332,42786708,8986625,,1234307,35460059,7543926,PDN
EW947,,1996,1984,,2594005,77037222,16301696,,1565679,50108527,10481787,,1028326,26928695,5819909,PDN
EW947,,1997,1984,,2594005,77037222,16301696,,2174028,63276040,13433110,,419977,13761182,2868586,PDN
EW947,,1998,1984,,2728703,77037222,16436394,,2593554,71686531,15349164,,135149,5350691,1087230,PDN
EW947,,1999,1984,,3411679,84996825,18535669,,2916826,76279234,16489643,,494853,8717591,2046026,PDN
EW947,,2000,1984,,3567680,83245213,18379995,,3107402,79037418,17171000,,460278,4207795,1208995,PDN
EW947,,2001,1984,,3814450,88866738,19627037,,3277966,81950604,17859924,,536484,6916134,1767113,PDN
EW947,,2002,1984,,3814450,88866738,19627037,,3416439,83829454,18332712,,398011,5037284,1294325,PDN
EW947,,2003,1984,,3753167,87444884,19312755,,3535323,85172608,18690591,,217844,2272276,622164,PDN
EW947,,2004,1984,,4009545,88859224,19820795,,3637062,86109585,18959052,,372483,2749639,861743,PDN
EW947,,2005,1984,,4090833,89620343,20037513,,3719177,86868172,19176147,,371656,2752171,861366,PDN
EW947,,2006,1984,,5040088,97796681,22441633,,3777227,87395053,19327948,,1262861,10401628,3113685,PDN
EW947,,2007,1984,,5040088,97796681,22441633,,4027215,89653390,19979775,,1012873,8143291,2461858,PDN
EW947,,2008,1984,,5040088,97796681,22441633,,4220237,91385861,20481066,,819851,6410820,1960567,PDN
EW947,,2009,1984,,4220237,92778750,20728912,,4220237,92778750,20728912,,0,0,0,PDN
EW947,,2010,1984,,4220237,92778750,20728912,,4220237,92778750,20728912,,0,0,0,PDN
EW947,,2011,1984,,4220237,92778750,20728912,,4220237,92778750,20728912,,0,0,0,PDN
EW947,,2012,1984,,4220237,92778750,20728912,,4220237,92778750,20728912,,0,0,0,PDN
EW947,,2013,1984,,4220237,92778750,20728912,,4220237,92778750,20728912,,0,0,0,PDN
EW947,,2014,1984,,4220237,92778750,20728912,,4220237,92778750,20728912,,0,0,0,PDN
EW947,,2015,1984,,4220237,92778750,20728912,,4220237,92778750,20728912,,0,0,0,PDN
EW947,,2016,1984,,4220237,92778750,20728912,,4220237,92778750,20728912,,0,0,0,PDN
EW947,,2017,1984,,4220237,92778750,20728912,,4220237,92778750,20728912,,0,0,0,PDN
EW947,,2017,1984,,4220237,92778750,20728912,,4220237,92778750,20728912,,0,0,0,PDN
EW949,,2004,2004,,2209414,7541443,3551308,,0,0,0,,2209414,7541443,3551308,PDN
EW949,,2005,2004,,2209414,7541443,3551308,,0,0,0,,2209414,7541443,3551308,PDN
EW949,,2006,2004,,2211616,7482733,3543063,,0,0,0,,2211616,7482733,3543063,PDN
EW949,,2007,2004,,2211616,7482733,3543063,,331874,351349,394392,,1879742,7131384,3148671,PDN
EW949,,2008,2004,,2211616,7482733,3543063,,432645,476701,517467,,1778971,7006032,3025596,PDN
EW949,,2009,2004,,432645,476701,517467,,432645,476701,517467,,0,0,0,PDN
EW949,,2010,2004,,432645,476701,517467,,432645,476701,517467,,0,0,0,PDN
EW949,,2011,2004,,432645,476701,517467,,432645,476701,517467,,0,0,0,PDN
EW949,,2012,2004,,432645,476701,517467,,432645,476701,517467,,0,0,0,PDN
EW949,,2013,2004,,432645,476701,517467,,432645,476701,517467,,0,0,0,PDN
EW949,,2014,2004,,432645,476701,517467,,432645,476701,517467,,0,0,0,PDN
EW949,,2015,2004,,432645,476701,517467,,432645,476701,517467,,0,0,0,PDN
EW949,,2016,2004,,432645,476701,517467,,432645,476701,517467,,0,0,0,PDN
EW949,,2017,2004,,432645,476701,517467,,432645,476701,517467,,0,0,0,PDN
EW949,,2017,2004,,432645,476701,517467,,432645,476701,517467,,0,0,0,PDN
EW958,,1995,1994,,15509710,17060682,18545419,,0,0,0,,15509710,17060682,18545419,PDP
EW958,,1996,1994,,12591046,10223930,14410251,,0,0,0,,12591046,10223930,14410251,PDP
EW958,,1997,1994,,12554478,10194237,14368399,,0,0,0,,12554478,10194237,14368399,PDP
EW958,,1998,1994,,12546448,10187717,14359209,,0,0,0,,12546448,10187717,14359209,PDP
EW958,,1999,1994,,12546448,10187717,14359209,,0,0,0,,12546448,10187717,14359209,PDP
EW958,,2000,1994,,17918441,14549774,20507369,,0,0,0,,17918441,14549774,20507369,PDP
EW958,,2001,1994,,18745399,15847897,21565310,,424302,419082,498872,,18321097,15428815,21066438,PDP
EW958,,2002,1994,,11225422,10124517,13026938,,2116810,2132176,2496201,,9108612,7992341,10530737,PDP
EW958,,2003,1994,,13771377,14636735,16375779,,2531485,2535004,2982553,,11239892,12101731,13393226,PDP
EW958,,2004,1994,,16397822,17132735,19446352,,3169309,3259942,3749370,,13228513,13872793,15696982,PDP
EW958,,2005,1994,,17006304,17583368,20135018,,4121028,4220773,4872055,,12885276,13362595,15262963,PDP
EW958,,2006,1994,,17006035,17645105,20145734,,5020262,5150891,5936791,,11985773,12494214,14208943,PDP
EW958,,2007,1994,,17006035,17645105,20145734,,5834344,5987616,6899756,,11171691,11657489,13245978,PDP
EW958,,2008,1994,,17006035,17645105,20145734,,6425200,6562382,7592884,,10580835,11082723,12552850,PDP
EW958,,2009,1994,,10596125,11032222,12559155,,6894922,7022691,8144511,,3701203,4009531,4414644,PDP
EW958,,2010,1994,,10596125,11032222,12559155,,7317671,7457693,8644664,,3278454,3574529,3914491,PDP
EW958,,2011,1994,,9279145,9451846,10960969,,7641650,7787420,9027312,,1637495,1664426,1933657,PDP
EW958,,2012,1994,,9279145,9451846,10960969,,7958943,8133125,9406119,,1320202,1318721,1554849,PDP
EW958,,2013,1994,,9279145,9451846,10960969,,8290762,8556166,9813212,,988383,895680,1147757,PDP
EW958,,2014,1994,,10111065,10894268,12049548,,8659579,9017932,10264193,,1451486,1876336,1785354,PDP
EW958,,2015,1994,,10344505,11254256,12347043,,9359406,10070583,11151326,,985099,1183673,1195717,PDP
EW958,,2016,1994,,12670055,15606322,15446982,,10056498,11231206,12054934,,2613557,4375116,3392047,PDP
EW958,,2017,1994,,12670055,15606322,15446982,,10570770,11989491,12704132,,2099285,3616831,2742850,PDP
EW958,,2017,1994,,12670055,15606322,15446982,,10570770,11989491,12704132,,2099285,3616831,2742850,PDP
EW963,,1997,1996,,26431233,23746363,30656564,,0,0,0,,26431233,23746363,30656564,PDP
EW963,,1998,1996,,31700186,28277872,36731836,,3375191,2908465,3892711,,28324995,25369407,32839125,PDP
EW963,,1999,1996,,31700186,28277872,36731836,,8306380,7242771,9595129,,23393806,21035101,27136707,PDP
EW963,,2000,1996,,19483270,16806189,22473695,,11633586,10270299,13461041,,7849684,6535890,9012654,PDP
EW963,,2001,1996,,22768296,21814626,26649902,,14144438,12264169,16326674,,8623858,9550457,10323228,PDP
EW963,,2002,1996,,22768296,21814626,26649902,,15611333,13563482,18024764,,7156963,8251144,8625138,PDP
EW963,,2003,1996,,19523306,19399942,22975253,,16343902,14174988,18866142,,3179404,5224954,4109111,PDP
EW963,,2004,1996,,18733836,18839972,22086144,,17002279,14810644,19637625,,1731557,4029328,2448519,PDP
EW963,,2005,1996,,19909056,19510062,23380597,,17436208,15254362,20150507,,2472848,4255700,3230090,PDP
EW963,,2006,1996,,19909056,18935851,23278425,,17884954,15619412,20664209,,2024102,3316439,2614216,PDP
EW963,,2007,1996,,22368656,24596291,26745220,,18224830,15794119,21035171,,4143826,8802172,5710049,PDP
EW963,,2008,1996,,22368656,24596291,26745220,,19053763,17076035,22092203,,3314893,7520256,4653017,PDP
EW963,,2009,1996,,22346360,22366703,26326201,,19752624,17873053,22932883,,2593736,4493650,3393318,PDP
EW963,,2010,1996,,22346360,22366703,26326201,,20271846,18313370,23530454,,2074514,4053333,2795747,PDP
EW963,,2011,1996,,23246610,20195227,26840066,,20799346,18707954,24128163,,2447264,1487273,2711903,PDP
EW963,,2012,1996,,23246610,20195227,26840066,,21231269,18978424,24608214,,2015341,1216803,2231854,PDP
EW963,,2013,1996,,23246610,20195227,26840066,,21566871,19191612,24981748,,1679739,1003615,1858318,PDP
EW963,,2014,1996,,23246610,20195227,26840066,,21925620,19425015,25382028,,1320990,770212,1458038,PDP
EW963,,2015,1996,,23246610,20195227,26840066,,22287598,19701035,25793120,,959012,494192,1046947,PDP
EW963,,2016,1996,,23246610,20195227,26840066,,22556685,19909727,26099341,,689925,285500,740726,PDP
EW963,,2017,1996,,23246610,20195227,26840066,,22761692,20041130,26327730,,484918,154097,512337,PDP
EW963,,2017,1996,,23246610,20195227,26840066,,22761692,20041130,26327730,,484918,154097,512337,PDP
EW977,,1996,1996,,1529,6726183,1198359,,0,0,0,,1529,6726183,1198359,PDN
EW977,,1997,1996,,1529,6726183,1198359,,500,2415263,430262,,1029,4310920,768097,PDN
EW977,,1998,1996,,1011,6726183,1197841,,527,3486947,620980,,484,3239236,576861,PDN
EW977,,1999,1996,,595,4185226,745297,,581,4039479,719350,,14,145747,25947,PDN
EW977,,2000,1996,,595,4185226,745297,,595,4185226,745297,,0,0,0,PDN
EW977,,2001,1996,,595,4185226,745297,,595,4185226,745297,,0,0,0,PDN
EW977,,2002,1996,,15663,109657932,19527750,,595,4185226,745297,,15068,105472706,18782453,PDN
EW977,,2003,1996,,15663,109657932,19527750,,595,4185226,745297,,15068,105472706,18782453,PDN
EW977,,2004,1996,,595,5808876,1034203,,595,4185226,745297,,0,1623650,288906,PDN
EW977,,2005,1996,,595,6692176,1191374,,595,5043443,898005,,0,1648733,293369,PDN
EW977,,2006,1996,,595,6692176,1191374,,595,5336618,950171,,0,1355558,241203,PDN
EW977,,2007,1996,,595,6692176,1191374,,595,5525343,983752,,0,1166833,207622,PDN
EW977,,2008,1996,,595,6692176,1191374,,595,5626186,1001696,,0,1065990,189678,PDN
EW977,,2009,1996,,595,5673750,1010159,,595,5673750,1010159,,0,0,0,PDN
EW977,,2010,1996,,595,5673750,1010159,,595,5673750,1010159,,0,0,0,PDN
EW977,,2011,1996,,595,5673750,1010159,,595,5673750,1010159,,0,0,0,PDN
EW977,,2012,1996,,595,5673750,1010159,,595,5673750,1010159,,0,0,0,PDN
EW977,,2013,1996,,595,5673750,1010159,,595,5673750,1010159,,0,0,0,PDN
EW977,,2014,1996,,595,5673750,1010159,,595,5673750,1010159,,0,0,0,PDN
EW977,,2015,1996,,595,5673750,1010159,,595,5673750,1010159,,0,0,0,PDN
EW977,,2016,1996,,595,5673750,1010159,,595,5673750,1010159,,0,0,0,PDN
EW977,,2017,1996,,595,5673750,1010159,,595,5673750,1010159,,0,0,0,PDN
EW977,,2017,1996,,595,5673750,1010159,,595,5673750,1010159,,0,0,0,PDN
EW988,,1987,1985,,1282253,6411265,2423047,,0,0,0,,1282253,6411265,2423047,PDN
EW988,,1988,1985,,865543,1038651,1050356,,0,0,0,,865543,1038651,1050356,PDN
EW988,,1993,1985,,2610104,2349092,3028092,,0,0,0,,2610104,2349092,3028092,PDN
EW988,,1994,1985,,2566115,2309503,2977059,,0,0,0,,2566115,2309503,2977059,PDN
EW988,,1995,1985,,13011810,17852881,16188479,,0,0,0,,13011810,17852881,16188479,PDN
EW988,,1996,1985,,13011810,17852881,16188479,,0,0,0,,13011810,17852881,16188479,PDN
EW988,,1997,1985,,7588759,9202408,9226198,,0,0,0,,7588759,9202408,9226198,PDN
EW988,,1998,1985,,7588759,9202408,9226198,,0,0,0,,7588759,9202408,9226198,PDN
EW988,,1999,1985,,7588759,9202408,9226198,,0,0,0,,7588759,9202408,9226198,PDN
EW988,,2000,1985,,10538394,12447008,12753164,,0,0,0,,10538394,12447008,12753164,PDN
EW988,,2001,1985,,10538394,12447008,12753164,,0,0,0,,10538394,12447008,12753164,PDN
EW988,,2002,1985,,10538394,12447008,12753164,,0,0,0,,10538394,12447008,12753164,PDN
EW988,,2003,1985,,12300646,18001199,15503706,,0,0,0,,12300646,18001199,15503706,PDN
EW988,,2004,1985,,16656665,30074078,22007925,,364091,2857006,872455,,16292574,27217072,21135470,PDN
EW988,,2005,1985,,16346745,31954271,22032559,,965471,6446420,2112521,,15381274,25507851,19920038,PDN
EW988,,2006,1985,,14614291,26233946,19282253,,1335447,8214519,2797105,,13278844,18019427,16485148,PDN
EW988,,2007,1985,,14479666,27346533,19345597,,1480909,10314743,3316273,,12998757,17031790,16029324,PDN
EW988,,2008,1985,,14718809,26939953,19512395,,1546058,11043309,3511060,,13172751,15896644,16001335,PDN
EW988,,2009,1985,,1820246,11992188,3954088,,1572818,11313974,3585981,,247428,678214,368108,PDN
EW988,,2010,1985,,1820246,11990575,3953801,,1657383,11470661,3698427,,162863,519914,255375,PDN
EW988,,2011,1985,,1820246,11992188,3954088,,1696767,11570480,3755572,,123479,421708,198516,PDN
EW988,,2012,1985,,1901301,12133382,4060266,,1727105,11682686,3805875,,174196,450696,254392,PDN
EW988,,2013,1985,,1901301,12133382,4060266,,1756772,11767158,3850573,,144529,366224,209693,PDN
EW988,,2014,1985,,1912405,12089238,4063515,,1789532,11833764,3895184,,122873,255474,168331,PDN
EW988,,2015,1985,,1935992,12183460,4103868,,1819832,11900402,3937342,,116160,283058,166526,PDN
EW988,,2016,1985,,1935992,12183460,4103868,,1830246,11932118,3953399,,105746,251342,150469,PDN
EW988,,2017,1985,,1830246,11932118,3953399,,1830246,11932118,3953399,,0,0,0,PDN
EW988,,2017,1985,,1830246,11932118,3953399,,1830246,11932118,3953399,,0,0,0,PDN
EW989,,1994,1992,,77756,6998057,1322962,,0,0,0,,77756,6998057,1322962,PDP
EW989,,1995,1992,,1287571,1854048,1617473,,613345,1115186,811777,,674226,738862,805696,PDP
EW989,,1996,1992,,814875,1413096,1066316,,810188,1398164,1058972,,4687,14932,7344,PDP
EW989,,1997,1992,,812578,1413096,1064019,,812578,1413096,1064019,,0,0,0,PDP
EW989,,1998,1992,,812578,1413096,1064019,,812578,1413096,1064019,,0,0,0,PDP
EW989,,1999,1992,,812578,1413096,1064019,,812578,1413096,1064019,,0,0,0,PDP
EW989,,2000,1992,,812578,1413096,1064019,,812578,1413096,1064019,,0,0,0,PDP
EW989,,2001,1992,,812578,1413096,1064019,,812578,1413096,1064019,,0,0,0,PDP
EW989,,2002,1992,,812578,1413096,1064019,,812578,1413096,1064019,,0,0,0,PDP
EW989,,2003,1992,,812578,1413096,1064019,,812578,1413096,1064019,,0,0,0,PDP
EW989,,2004,1992,,812578,1413096,1064019,,812578,1413096,1064019,,0,0,0,PDP
EW989,,2005,1992,,1092436,1732986,1400796,,812578,1413096,1064019,,279858,319890,336777,PDP
EW989,,2006,1992,,906098,1513366,1175380,,812578,1413096,1064019,,93520,100270,111361,PDP
EW989,,2007,1992,,1705580,2695800,2185260,,906098,1513366,1175380,,799482,1182434,1009880,PDP
EW989,,2008,1992,,1705580,2696594,2185401,,1368231,2182451,1756567,,337349,514143,428834,PDP
EW989,,2009,1992,,1705580,2724893,2190437,,1622621,2643795,2093047,,82959,81098,97389,PDP
EW989,,2010,1992,,2060147,3432135,2670847,,1776609,2938688,2299507,,283538,493447,371340,PDP
EW989,,2011,1992,,2060147,3432135,2670847,,1855258,3095000,2405970,,204889,337135,264877,PDP
EW989,,2012,1992,,2060147,3432135,2670847,,1883011,3193967,2451333,,177136,238168,219515,PDP
EW989,,2013,1992,,2060147,3432135,2670847,,1908233,3235360,2483920,,151914,196775,186927,PDP
EW989,,2014,1992,,2052147,3432135,2662847,,1915591,3245882,2493150,,136556,186253,169697,PDP
EW989,,2015,1992,,2052147,3432135,2662847,,1921205,3266127,2502366,,130942,166008,160481,PDP
EW989,,2016,1992,,2052147,3432135,2662847,,1922852,3272842,2505208,,129295,159293,157639,PDP
EW989,,2017,1992,,2052147,3432135,2662847,,1928685,3310381,2517721,,123462,121754,145126,PDP
EW989,,2017,1992,,2052147,3432135,2662847,,1928685,3310381,2517721,,123462,121754,145126,PDP
EW991,,1996,1988,,564684,5703308,1579507,,0,0,0,,564684,5703308,1579507,PDN
EW991,,1997,1988,,2397730,3035526,2937859,,315330,831112,463215,,2082400,2204414,2474644,PDN
EW991,,1998,1988,,2397730,3035526,2937859,,518521,1031892,702132,,1879209,2003634,2235727,PDN
EW991,,1999,1988,,2397730,3035526,2937859,,647686,1161259,854316,,1750044,1874267,2083543,PDN
EW991,,2000,1988,,1081253,1695404,1382927,,775883,1310297,1009032,,305370,385107,373895,PDN
EW991,,2001,1988,,1081253,1695404,1382927,,861308,1417071,1113456,,219945,278333,269471,PDN
EW991,,2002,1988,,1081253,1695404,1382927,,916563,1478962,1179723,,164690,216442,203204,PDN
EW991,,2003,1988,,1400145,2058929,1766503,,968977,1551761,1245091,,431168,507168,521412,PDN
EW991,,2004,1988,,1406133,2068318,1774161,,1034408,1618980,1322483,,371725,449338,451678,PDN
EW991,,2005,1988,,1406133,1942422,1751759,,1067094,1650241,1360731,,339039,292181,391028,PDN
EW991,,2006,1988,,1406133,1935796,1750580,,1115489,1680356,1414485,,290644,255440,336095,PDN
EW991,,2007,1988,,1406133,1935796,1750580,,1172225,1714699,1477332,,233908,221097,273248,PDN
EW991,,2008,1988,,1406133,1935796,1750580,,1208096,1736054,1517002,,198037,199742,233578,PDN
EW991,,2009,1988,,1208096,1755820,1520519,,1208096,1755820,1520519,,0,0,0,PDN
EW991,,2010,1988,,1208096,1755820,1520519,,1208096,1755820,1520519,,0,0,0,PDN
EW991,,2011,1988,,1208096,1755820,1520519,,1208096,1755820,1520519,,0,0,0,PDN
EW991,,2012,1988,,1208096,1755820,1520519,,1208096,1755820,1520519,,0,0,0,PDN
EW991,,2013,1988,,1208096,1755820,1520519,,1208096,1755820,1520519,,0,0,0,PDN
EW991,,2014,1988,,1208096,1755820,1520519,,1208096,1755820,1520519,,0,0,0,PDN
EW991,,2015,1988,,1208096,1755820,1520519,,1208096,1755820,1520519,,0,0,0,PDN
EW991,,2016,1988,,1208096,1755820,1520519,,1208096,1755820,1520519,,0,0,0,PDN
EW991,,2017,1988,,1208096,1755820,1520519,,1208096,1755820,1520519,,0,0,0,PDN
EW991,,2017,1988,,1208096,1755820,1520519,,1208096,1755820,1520519,,0,0,0,PDN
EW998,,2009,2009,,2191787,3506859,2815783,,0,0,0,,2191787,3506859,2815783,PDP
EW998,,2010,2009,,2191787,3506859,2815783,,0,0,0,,2191787,3506859,2815783,PDP
EW998,,2011,2009,,2191787,3506859,2815783,,1078211,1427446,1332205,,1113576,2079413,1483578,PDP
EW998,,2012,2009,,6498800,8318464,7978954,,2457438,3271539,3039562,,4041362,5046925,4939391,PDP
EW998,,2013,2009,,6498800,8318464,7978954,,3569259,4675569,4401211,,2929541,3642895,3577743,PDP
EW998,,2014,2009,,6498800,8318464,7978954,,4052777,5269008,4990323,,2446023,3049456,2988631,PDP
EW998,,2015,2009,,6498800,8318464,7978954,,4418065,5789487,5448223,,2080735,2528977,2530731,PDP
EW998,,2016,2009,,6498800,8318464,7978954,,4856516,6386016,5992818,,1642284,1932448,1986136,PDP
EW998,,2017,2009,,6498800,8318464,7978954,,5161237,6794343,6370195,,1337563,1524121,1608759,PDP
EW998,,2017,2009,,6498800,8318464,7978954,,5161237,6794343,6370195,,1337563,1524121,1608759,PDP
GA034A,,1995,1995,,161,1606140,285951,,0,0,0,,161,1606140,285951,PDN
GA034A,,1996,1995,,92959,9072988,1707370,,36339,2498380,480891,,56620,6574608,1226479,PDN
GA034A,,1997,1995,,92959,9072988,1707370,,66784,6171329,1164885,,26175,2901659,542485,PDN
GA034A,,1998,1995,,92959,9073912,1707534,,72439,7063168,1329230,,20520,2010744,378304,PDN
GA034A,,1999,1995,,72439,7063168,1329230,,72439,7063168,1329230,,0,0,0,PDN
GA034A,,2000,1995,,72439,7063168,1329230,,72439,7063168,1329230,,0,0,0,PDN
GA034A,,2001,1995,,72439,7063168,1329230,,72439,7063168,1329230,,0,0,0,PDN
GA034A,,2002,1995,,72439,7063168,1329230,,72439,7063168,1329230,,0,0,0,PDN
GA034A,,2003,1995,,72439,7063168,1329230,,72439,7063168,1329230,,0,0,0,PDN
GA034A,,2004,1995,,72439,7063168,1329230,,72439,7063168,1329230,,0,0,0,PDN
GA034A,,2005,1995,,72439,7063168,1329230,,72439,7063168,1329230,,0,0,0,PDN
GA034A,,2006,1995,,72439,7063168,1329230,,72439,7063168,1329230,,0,0,0,PDN
GA034A,,2007,1995,,72439,7063168,1329230,,72439,7063168,1329230,,0,0,0,PDN
GA034A,,2008,1995,,72439,7063168,1329230,,72439,7063168,1329230,,0,0,0,PDN
GA034A,,2009,1995,,72438,7204585,1354393,,72438,7204585,1354393,,0,0,0,PDN
GA034A,,2010,1995,,72438,7204585,1354393,,72438,7204585,1354393,,0,0,0,PDN
GA034A,,2011,1995,,72438,7204585,1354393,,72438,7204585,1354393,,0,0,0,PDN
GA034A,,2012,1995,,72438,7204585,1354393,,72438,7204585,1354393,,0,0,0,PDN
GA034A,,2013,1995,,72438,7204585,1354393,,72438,7204585,1354393,,0,0,0,PDN
GA034A,,2014,1995,,72438,7204585,1354393,,72438,7204585,1354393,,0,0,0,PDN
GA034A,,2015,1995,,72438,7204585,1354393,,72438,7204585,1354393,,0,0,0,PDN
GA034A,,2016,1995,,72438,7204585,1354393,,72438,7204585,1354393,,0,0,0,PDN
GA034A,,2017,1995,,72438,7204585,1354393,,72438,7204585,1354393,,0,0,0,PDN
GA034A,,2017,1995,,72438,7204585,1354393,,72438,7204585,1354393,,0,0,0,PDN
GA039A,,2006,2006,,188,1876347,334058,,0,0,0,,188,1876347,334058,PDN
GA039A,,2007,2006,,188,1876347,334058,,0,650167,115688,,188,1226180,218370,PDN
GA039A,,2008,2006,,0,7061199,1256441,,0,1344303,239200,,0,5716896,1017241,PDN
GA039A,,2009,2006,,0,7004558,1246363,,0,1888714,336070,,0,5115844,910293,PDN
GA039A,,2010,2006,,0,4305985,766190,,0,2955271,525849,,0,1350714,240340,PDN
GA039A,,2011,2006,,0,4305985,766190,,0,3832980,682025,,0,473005,84165,PDN
GA039A,,2012,2006,,0,4305985,766190,,0,4305985,766190,,0,0,0,PDN
GA039A,,2013,2006,,0,4305985,766190,,0,4305985,766190,,0,0,0,PDN
GA039A,,2014,2006,,0,4305985,766190,,0,4305985,766190,,0,0,0,PDN
GA039A,,2015,2006,,0,4305985,766190,,0,4305985,766190,,0,0,0,PDN
GA039A,,2016,2006,,0,4305985,766190,,0,4305985,766190,,0,0,0,PDN
GA039A,,2017,2006,,0,4305985,766190,,0,4305985,766190,,0,0,0,PDN
GA039A,,2017,2006,,0,4305985,766190,,0,4305985,766190,,0,0,0,PDN
GA050A,,1993,1992,,0,9736062,1732395,,0,1314729,233938,,0,8421333,1498457,PDN
GA050A,,1994,1992,,0,10898629,1939258,,0,4461114,793793,,0,6437515,1145465,PDN
GA050A,,1995,1992,,0,10898629,1939258,,0,7236349,1287607,,0,3662280,651651,PDN
GA050A,,1996,1992,,0,13235181,2355014,,0,9853678,1753323,,0,3381503,601691,PDN
GA050A,,1997,1992,,0,13235181,2355014,,0,11542047,2053745,,0,1693134,301269,PDN
GA050A,,1998,1992,,0,16841006,2996620,,0,12508074,2225636,,0,4332932,770984,PDN
GA050A,,1999,1992,,0,15793821,2810288,,0,13138053,2337732,,0,2655768,472556,PDN
GA050A,,2000,1992,,0,14954640,2660968,,0,13578313,2416070,,0,1376327,244898,PDN
GA050A,,2001,1992,,1049,16627430,2959666,,0,13854144,2465150,,1049,2773286,494516,PDN
GA050A,,2002,1992,,1049,16627430,2959666,,0,14125337,2513405,,1049,2502093,446261,PDN
GA050A,,2003,1992,,1049,16627430,2959666,,0,14347184,2552880,,1049,2280246,406786,PDN
GA050A,,2004,1992,,0,15292888,2721154,,0,14550147,2588994,,0,742741,132160,PDN
GA050A,,2005,1992,,0,15292888,2721154,,0,14779152,2629742,,0,513736,91412,PDN
GA050A,,2006,1992,,0,14892920,2649986,,0,14892920,2649986,,0,0,0,PDN
GA050A,,2007,1992,,0,14892920,2649986,,0,14892920,2649986,,0,0,0,PDN
GA050A,,2008,1992,,0,14892920,2649986,,0,14892920,2649986,,0,0,0,PDN
GA050A,,2009,1992,,0,15137619,2693527,,0,15137619,2693527,,0,0,0,PDN
GA050A,,2010,1992,,0,15137619,2693527,,0,15137619,2693527,,0,0,0,PDN
GA050A,,2011,1992,,0,15137619,2693527,,0,15137619,2693527,,0,0,0,PDN
GA050A,,2012,1992,,0,15137619,2693527,,0,15137619,2693527,,0,0,0,PDN
GA050A,,2013,1992,,0,15137619,2693527,,0,15137619,2693527,,0,0,0,PDN
GA050A,,2014,1992,,0,15137619,2693527,,0,15137619,2693527,,0,0,0,PDN
GA050A,,2015,1992,,0,15137619,2693527,,0,15137619,2693527,,0,0,0,PDN
GA050A,,2016,1992,,0,15137619,2693527,,0,15137619,2693527,,0,0,0,PDN
GA050A,,2017,1992,,0,15137619,2693527,,0,15137619,2693527,,0,0,0,PDN
GA050A,,2017,1992,,0,15137619,2693527,,0,15137619,2693527,,0,0,0,PDN
GA096A,,1987,1987,,33884,6607423,1209582,,0,167252,29760,,33884,6440171,1179822,PDN
GA096A,,1988,1987,,33884,6607423,1209582,,138,2178253,387728,,33746,4429170,821854,PDN
GA096A,,1989,1987,,259,8654793,1540258,,173,4497421,800426,,86,4157372,739832,PDN
GA096A,,1990,1987,,259,8654793,1540258,,173,4726862,841252,,86,3927931,699006,PDN
GA096A,,1991,1987,,173,4726862,841252,,173,4726862,841252,,0,0,0,PDN
GA096A,,1992,1987,,173,4726862,841252,,173,4726862,841252,,0,0,0,PDN
GA096A,,1993,1987,,173,4726862,841252,,173,4726862,841252,,0,0,0,PDN
GA096A,,1994,1987,,173,4726862,841252,,173,4726862,841252,,0,0,0,PDN
GA096A,,1995,1987,,173,4726862,841252,,173,4726862,841252,,0,0,0,PDN
GA096A,,1996,1987,,173,4726862,841252,,173,4726862,841252,,0,0,0,PDN
GA096A,,1997,1987,,173,4726862,841252,,173,4726862,841252,,0,0,0,PDN
GA096A,,1998,1987,,173,4726862,841252,,173,4726862,841252,,0,0,0,PDN
GA096A,,1999,1987,,173,4726862,841252,,173,4726862,841252,,0,0,0,PDN
GA096A,,2000,1987,,173,4726862,841252,,173,4726862,841252,,0,0,0,PDN
GA096A,,2001,1987,,173,4726862,841252,,173,4726862,841252,,0,0,0,PDN
GA096A,,2002,1987,,173,4726862,841252,,173,4726862,841252,,0,0,0,PDN
GA096A,,2003,1987,,173,4726862,841252,,173,4726862,841252,,0,0,0,PDN
GA096A,,2004,1987,,173,4726862,841252,,173,4726862,841252,,0,0,0,PDN
GA096A,,2005,1987,,173,4726862,841252,,173,4726862,841252,,0,0,0,PDN
GA096A,,2006,1987,,173,4726862,841252,,173,4726862,841252,,0,0,0,PDN
GA096A,,2007,1987,,173,4726862,841252,,173,4726862,841252,,0,0,0,PDN
GA096A,,2008,1987,,173,4726862,841252,,173,4726862,841252,,0,0,0,PDN
GA096A,,2009,1987,,173,4821526,858096,,173,4821526,858096,,0,0,0,PDN
GA096A,,2010,1987,,173,4821526,858096,,173,4821526,858096,,0,0,0,PDN
GA096A,,2011,1987,,173,4821526,858096,,173,4821526,858096,,0,0,0,PDN
GA096A,,2012,1987,,173,4821526,858096,,173,4821526,858096,,0,0,0,PDN
GA096A,,2013,1987,,173,4821526,858096,,173,4821526,858096,,0,0,0,PDN
GA096A,,2014,1987,,173,4821526,858096,,173,4821526,858096,,0,0,0,PDN
GA096A,,2015,1987,,173,4821526,858096,,173,4821526,858096,,0,0,0,PDN
GA096A,,2016,1987,,173,4821526,858096,,173,4821526,858096,,0,0,0,PDN
GA096A,,2017,1987,,173,4821526,858096,,173,4821526,858096,,0,0,0,PDN
GA096A,,2017,1987,,173,4821526,858096,,173,4821526,858096,,0,0,0,PDN
GA097A,,1987,1987,,25772,3195719,594405,,10411,1354731,251466,,15361,1840988,342939,PDN
GA097A,,1988,1987,,56312,2534041,507209,,12871,1691051,313770,,43441,842990,193439,PDN
GA097A,,1989,1987,,18825,2534041,469722,,12999,1749821,324355,,5826,784220,145367,PDN
GA097A,,1990,1987,,12999,1749821,324355,,12999,1749821,324355,,0,0,0,PDN
GA097A,,1991,1987,,12999,1749821,324355,,12999,1749821,324355,,0,0,0,PDN
GA097A,,1992,1987,,12999,1749821,324355,,12999,1749821,324355,,0,0,0,PDN
GA097A,,1993,1987,,12999,1749821,324355,,12999,1749821,324355,,0,0,0,PDN
GA097A,,1994,1987,,12999,1749821,324355,,12999,1749821,324355,,0,0,0,PDN
GA097A,,1995,1987,,12999,1749821,324355,,12999,1749821,324355,,0,0,0,PDN
GA097A,,1996,1987,,12999,1749821,324355,,12999,1749821,324355,,0,0,0,PDN
GA097A,,1997,1987,,12999,1749821,324355,,12999,1749821,324355,,0,0,0,PDN
GA097A,,1998,1987,,12999,1749821,324355,,12999,1749821,324355,,0,0,0,PDN
GA097A,,1999,1987,,12999,1749821,324355,,12999,1749821,324355,,0,0,0,PDN
GA097A,,2000,1987,,12999,1749821,324355,,12999,1749821,324355,,0,0,0,PDN
GA097A,,2001,1987,,12999,1749821,324355,,12999,1749821,324355,,0,0,0,PDN
GA097A,,2002,1987,,12999,1749821,324355,,12999,1749821,324355,,0,0,0,PDN
GA097A,,2003,1987,,12999,1749821,324355,,12999,1749821,324355,,0,0,0,PDN
GA097A,,2004,1987,,12999,1749821,324355,,12999,1749821,324355,,0,0,0,PDN
GA097A,,2005,1987,,12999,1749821,324355,,12999,1749821,324355,,0,0,0,PDN
GA097A,,2006,1987,,12999,1749821,324355,,12999,1749821,324355,,0,0,0,PDN
GA097A,,2007,1987,,12999,1749821,324355,,12999,1749821,324355,,0,0,0,PDN
GA097A,,2008,1987,,12999,1749821,324355,,12999,1749821,324355,,0,0,0,PDN
GA097A,,2009,1987,,12999,1784864,330590,,12999,1784864,330590,,0,0,0,PDN
GA097A,,2010,1987,,12999,1784864,330590,,12999,1784864,330590,,0,0,0,PDN
GA097A,,2011,1987,,12999,1784864,330590,,12999,1784864,330590,,0,0,0,PDN
GA097A,,2012,1987,,12999,1784864,330590,,12999,1784864,330590,,0,0,0,PDN
GA097A,,2013,1987,,12999,1784864,330590,,12999,1784864,330590,,0,0,0,PDN
GA097A,,2014,1987,,12999,1784864,330590,,12999,1784864,330590,,0,0,0,PDN
GA097A,,2015,1987,,12999,1784864,330590,,12999,1784864,330590,,0,0,0,PDN
GA097A,,2016,1987,,12999,1784864,330590,,12999,1784864,330590,,0,0,0,PDN
GA097A,,2017,1987,,12999,1784864,330590,,12999,1784864,330590,,0,0,0,PDN
GA097A,,2017,1987,,12999,1784864,330590,,12999,1784864,330590,,0,0,0,PDN
GA101A,,1987,1986,,3964,15659394,2790333,,445,1785034,318067,,3519,13874360,2472266,PDN
GA101A,,1988,1986,,3964,15659394,2790333,,1120,2275901,406085,,2844,13383493,2384248,PDN
GA101A,,1989,1986,,6636,7917896,1415514,,1226,2745749,489793,,5410,5172147,925721,PDN
GA101A,,1990,1986,,6636,6831173,1222147,,1230,2894956,516347,,5406,3936217,705800,PDN
GA101A,,1991,1986,,6636,6831173,1222147,,1250,3162158,563912,,5386,3669015,658235,PDN
GA101A,,1992,1986,,1250,3162158,563912,,1250,3162158,563912,,0,0,0,PDN
GA101A,,1993,1986,,1250,3162158,563912,,1250,3162158,563912,,0,0,0,PDN
GA101A,,1994,1986,,1250,3162158,563912,,1250,3162158,563912,,0,0,0,PDN
GA101A,,1995,1986,,1250,3162158,563912,,1250,3162158,563912,,0,0,0,PDN
GA101A,,1996,1986,,1250,3162158,563912,,1250,3162158,563912,,0,0,0,PDN
GA101A,,1997,1986,,1250,3162158,563912,,1250,3162158,563912,,0,0,0,PDN
GA101A,,1998,1986,,1250,3162158,563912,,1250,3162158,563912,,0,0,0,PDN
GA101A,,1999,1986,,1250,3162158,563912,,1250,3162158,563912,,0,0,0,PDN
GA101A,,2000,1986,,1250,3162158,563912,,1250,3162158,563912,,0,0,0,PDN
GA101A,,2001,1986,,1250,3162158,563912,,1250,3162158,563912,,0,0,0,PDN
GA101A,,2002,1986,,1250,3162158,563912,,1250,3162158,563912,,0,0,0,PDN
GA101A,,2003,1986,,1250,3162158,563912,,1250,3162158,563912,,0,0,0,PDN
GA101A,,2004,1986,,1250,3162158,563912,,1250,3162158,563912,,0,0,0,PDN
GA101A,,2005,1986,,1250,3162158,563912,,1250,3162158,563912,,0,0,0,PDN
GA101A,,2006,1986,,1250,3162158,563912,,1250,3162158,563912,,0,0,0,PDN
GA101A,,2007,1986,,1250,3162158,563912,,1250,3162158,563912,,0,0,0,PDN
GA101A,,2008,1986,,1250,3162158,563912,,1250,3162158,563912,,0,0,0,PDN
GA101A,,2009,1986,,1250,3225485,575180,,1250,3225485,575180,,0,0,0,PDN
GA101A,,2010,1986,,1250,3225485,575180,,1250,3225485,575180,,0,0,0,PDN
GA101A,,2011,1986,,1250,3225485,575180,,1250,3225485,575180,,0,0,0,PDN
GA101A,,2012,1986,,1250,3225485,575180,,1250,3225485,575180,,0,0,0,PDN
GA101A,,2013,1986,,1250,3225485,575180,,1250,3225485,575180,,0,0,0,PDN
GA101A,,2014,1986,,1250,3225485,575180,,1250,3225485,575180,,0,0,0,PDN
GA101A,,2015,1986,,1250,3225485,575180,,1250,3225485,575180,,0,0,0,PDN
GA101A,,2016,1986,,1250,3225485,575180,,1250,3225485,575180,,0,0,0,PDN
GA101A,,2017,1986,,1250,3225485,575180,,1250,3225485,575180,,0,0,0,PDN
GA101A,,2017,1986,,1250,3225485,575180,,1250,3225485,575180,,0,0,0,PDN
GA127A,,1985,1983,,190325,8126859,1636385,,0,0,0,,190325,8126859,1636385,PDN
GA127A,,1986,1983,,190325,8126859,1636385,,0,0,0,,190325,8126859,1636385,PDN
GA127A,,1987,1983,,190325,8126859,1636385,,2822,2300349,412137,,187503,5826510,1224248,PDN
GA127A,,1988,1983,,21289,12771892,2293868,,5590,5064053,906667,,15699,7707839,1387201,PDN
GA127A,,1989,1983,,7560,8914038,1593688,,6147,6155934,1101509,,1413,2758104,492179,PDN
GA127A,,1990,1983,,14582,15863213,2837218,,7608,7933353,1419237,,6974,7929860,1417981,PDN
GA127A,,1991,1983,,14582,15863213,2837218,,7826,8623148,1542194,,6756,7240065,1295024,PDN
GA127A,,1992,1983,,7830,8638475,1544925,,7830,8638475,1544925,,0,0,0,PDN
GA127A,,1993,1983,,7830,8638475,1544925,,7830,8638475,1544925,,0,0,0,PDN
GA127A,,1994,1983,,7830,8638475,1544925,,7830,8638475,1544925,,0,0,0,PDN
GA127A,,1995,1983,,7830,8638475,1544925,,7830,8638475,1544925,,0,0,0,PDN
GA127A,,1996,1983,,7830,8638475,1544925,,7830,8638475,1544925,,0,0,0,PDN
GA127A,,1997,1983,,7830,8638475,1544925,,7830,8638475,1544925,,0,0,0,PDN
GA127A,,1998,1983,,7830,8638475,1544925,,7830,8638475,1544925,,0,0,0,PDN
GA127A,,1999,1983,,7830,8638475,1544925,,7830,8638475,1544925,,0,0,0,PDN
GA127A,,2000,1983,,7830,8638475,1544925,,7830,8638475,1544925,,0,0,0,PDN
GA127A,,2001,1983,,7830,8638475,1544925,,7830,8638475,1544925,,0,0,0,PDN
GA127A,,2002,1983,,7830,8638475,1544925,,7830,8638475,1544925,,0,0,0,PDN
GA127A,,2003,1983,,7830,8638475,1544925,,7830,8638475,1544925,,0,0,0,PDN
GA127A,,2004,1983,,7830,8638475,1544925,,7830,8638475,1544925,,0,0,0,PDN
GA127A,,2005,1983,,7830,8638475,1544925,,7830,8638475,1544925,,0,0,0,PDN
GA127A,,2006,1983,,7830,8638475,1544925,,7830,8638475,1544925,,0,0,0,PDN
GA127A,,2007,1983,,7830,8638475,1544925,,7830,8638475,1544925,,0,0,0,PDN
GA127A,,2008,1983,,7830,8638475,1544925,,7830,8638475,1544925,,0,0,0,PDN
GA127A,,2009,1983,,7830,8811477,1575709,,7830,8811477,1575709,,0,0,0,PDN
GA127A,,2010,1983,,7830,8811477,1575709,,7830,8811477,1575709,,0,0,0,PDN
GA127A,,2011,1983,,7830,8811477,1575709,,7830,8811477,1575709,,0,0,0,PDN
GA127A,,2012,1983,,7830,8811477,1575709,,7830,8811477,1575709,,0,0,0,PDN
GA127A,,2013,1983,,7830,8811477,1575709,,7830,8811477,1575709,,0,0,0,PDN
GA127A,,2014,1983,,7830,8811477,1575709,,7830,8811477,1575709,,0,0,0,PDN
GA127A,,2015,1983,,7830,8811477,1575709,,7830,8811477,1575709,,0,0,0,PDN
GA127A,,2016,1983,,7830,8811477,1575709,,7830,8811477,1575709,,0,0,0,PDN
GA127A,,2017,1983,,7830,8811477,1575709,,7830,8811477,1575709,,0,0,0,PDN
GA127A,,2017,1983,,7830,8811477,1575709,,7830,8811477,1575709,,0,0,0,PDN
GA131A,,1979,1977,,0,20000000,3558719,,0,0,0,,0,20000000,3558719,PDN
GA131A,,1980,1977,,20000,20000000,3578719,,0,0,0,,20000,20000000,3578719,PDN
GA131A,,1981,1977,,30,31078400,5529994,,16,8854239,1575503,,14,22224161,3954491,PDN
GA131A,,1982,1977,,16,37683284,6705227,,8,12099127,2152878,,8,25584157,4552349,PDN
GA131A,,1983,1977,,16,48452513,8621460,,8,17238781,3067407,,8,31213732,5554053,PDN
GA131A,,1984,1977,,16,48452513,8621460,,8,20787970,3698935,,8,27664543,4922525,PDN
GA131A,,1985,1977,,16,48452513,8621460,,8,23234445,4134251,,8,25218068,4487209,PDN
GA131A,,1986,1977,,16,48452513,8621460,,8,25092089,4464793,,8,23360424,4156667,PDN
GA131A,,1987,1977,,16,51695419,9198489,,8,26223810,4666166,,8,25471609,4532323,PDN
GA131A,,1988,1977,,16,39081682,6954052,,8,27763655,4940160,,8,11318027,2013892,PDN
GA131A,,1989,1977,,16,39081682,6954052,,8,28519680,5074684,,8,10562002,1879368,PDN
GA131A,,1990,1977,,21,35782355,6366988,,8,29262807,5206913,,13,6519548,1160075,PDN
GA131A,,1991,1977,,13,33705082,5997359,,8,30032544,5343877,,5,3672538,653482,PDN
GA131A,,1992,1977,,8,30032544,5343877,,8,30032544,5343877,,0,0,0,PDN
GA131A,,1993,1977,,8,30032544,5343877,,8,30032544,5343877,,0,0,0,PDN
GA131A,,1994,1977,,8,30032544,5343877,,8,30032544,5343877,,0,0,0,PDN
GA131A,,1995,1977,,8,30032544,5343877,,8,30032544,5343877,,0,0,0,PDN
GA131A,,1996,1977,,8,30032544,5343877,,8,30032544,5343877,,0,0,0,PDN
GA131A,,1997,1977,,8,30032544,5343877,,8,30032544,5343877,,0,0,0,PDN
GA131A,,1998,1977,,8,30032544,5343877,,8,30032544,5343877,,0,0,0,PDN
GA131A,,1999,1977,,8,30032544,5343877,,8,30032544,5343877,,0,0,0,PDN
GA131A,,2000,1977,,8,30032544,5343877,,8,30032544,5343877,,0,0,0,PDN
GA131A,,2001,1977,,8,30032544,5343877,,8,30032544,5343877,,0,0,0,PDN
GA131A,,2002,1977,,8,30032544,5343877,,8,30032544,5343877,,0,0,0,PDN
GA131A,,2003,1977,,8,30032544,5343877,,8,30032544,5343877,,0,0,0,PDN
GA131A,,2004,1977,,8,30032544,5343877,,8,30032544,5343877,,0,0,0,PDN
GA131A,,2005,1977,,8,30032544,5343877,,8,30032544,5343877,,0,0,0,PDN
GA131A,,2006,1977,,8,30032544,5343877,,8,30032544,5343877,,0,0,0,PDN
GA131A,,2007,1977,,8,30032544,5343877,,8,30032544,5343877,,0,0,0,PDN
GA131A,,2008,1977,,8,30032544,5343877,,8,30032544,5343877,,0,0,0,PDN
GA131A,,2009,1977,,8,30634015,5450900,,8,30634015,5450900,,0,0,0,PDN
GA131A,,2010,1977,,8,30634015,5450900,,8,30634015,5450900,,0,0,0,PDN
GA131A,,2011,1977,,8,30634015,5450900,,8,30634015,5450900,,0,0,0,PDN
GA131A,,2012,1977,,8,30634015,5450900,,8,30634015,5450900,,0,0,0,PDN
GA131A,,2013,1977,,8,30634015,5450900,,8,30634015,5450900,,0,0,0,PDN
GA131A,,2014,1977,,8,30634015,5450900,,8,30634015,5450900,,0,0,0,PDN
GA131A,,2015,1977,,8,30634015,5450900,,8,30634015,5450900,,0,0,0,PDN
GA131A,,2016,1977,,8,30634015,5450900,,8,30634015,5450900,,0,0,0,PDN
GA131A,,2017,1977,,8,30634015,5450900,,8,30634015,5450900,,0,0,0,PDN
GA131A,,2017,1977,,8,30634015,5450900,,8,30634015,5450900,,0,0,0,PDN
GA133A,,2009,1978,,3432,11880459,2117393,,0,0,0,,3432,11880459,2117393,PDN
GA133A,,2010,1978,,3432,11880459,2117393,,0,0,0,,3432,11880459,2117393,PDN
GA133A,,2011,1978,,3432,11880459,2117393,,307,1460299,260147,,3125,10420160,1857246,PDN
GA133A,,2012,1978,,3432,11880459,2117393,,886,4308395,767504,,2546,7572064,1349888,PDN
GA133A,,2013,1978,,3432,11880459,2117393,,1479,6539295,1165055,,1953,5341164,952338,PDN
GA133A,,2014,1978,,3432,11880459,2117393,,1970,8761922,1561031,,1462,3118537,556362,PDN
GA133A,,2015,1978,,2461,9009747,1605619,,2034,8801299,1568101,,427,208448,37517,PDN
GA133A,,2016,1978,,2034,8808320,1569351,,2034,8808320,1569351,,0,0,0,PDN
GA133A,,2017,1978,,2034,8808320,1569351,,2034,8808320,1569351,,0,0,0,PDN
GA133A,,2017,1978,,2034,8808320,1569351,,2034,8808320,1569351,,0,0,0,PDN
GA144,,1979,1977,,1312282,17126980,4359787,,0,0,0,,1312282,17126980,4359787,PDN
GA144,,1980,1977,,1297829,15681640,4088156,,150561,161898,179368,,1147268,15519742,3908788,PDN
GA144,,1981,1977,,1347829,15924040,4181288,,258091,1363565,500718,,1089738,14560475,3680570,PDN
GA144,,1982,1977,,1320349,16035067,4173564,,389944,4010799,1103609,,930405,12024268,3069955,PDN
GA144,,1983,1977,,1148177,16035067,4001392,,450956,4772088,1300082,,697221,11262979,2701310,PDN
GA144,,1984,1977,,1148177,16035067,4001392,,501173,5435262,1468301,,647004,10599805,2533091,PDN
GA144,,1985,1977,,1148177,16035067,4001392,,558012,6021585,1629468,,590165,10013482,2371924,PDN
GA144,,1986,1977,,1148177,16035067,4001392,,616190,6202824,1719895,,531987,9832243,2281497,PDN
GA144,,1987,1977,,1331752,16127176,4201356,,679399,6379553,1814551,,652353,9747623,2386805,PDN
GA144,,1988,1977,,1024140,8671576,2567125,,733743,6499334,1890208,,290397,2172242,676917,PDN
GA144,,1989,1977,,738041,6499694,1894570,,738041,6499694,1894570,,0,0,0,PDN
GA144,,1990,1977,,732649,6499694,1889178,,732649,6499694,1889178,,0,0,0,PDN
GA144,,1991,1977,,732649,6499694,1889178,,732649,6499694,1889178,,0,0,0,PDN
GA144,,1992,1977,,732649,6499694,1889178,,732649,6499694,1889178,,0,0,0,PDN
GA144,,1993,1977,,732649,6499694,1889178,,732649,6499694,1889178,,0,0,0,PDN
GA144,,1994,1977,,732649,6499694,1889178,,732649,6499694,1889178,,0,0,0,PDN
GA144,,1995,1977,,732649,6499694,1889178,,732649,6499694,1889178,,0,0,0,PDN
GA144,,1996,1977,,732649,6499694,1889178,,732649,6499694,1889178,,0,0,0,PDN
GA144,,1997,1977,,732649,6499694,1889178,,732649,6499694,1889178,,0,0,0,PDN
GA144,,1998,1977,,732649,6499694,1889178,,732649,6499694,1889178,,0,0,0,PDN
GA144,,1999,1977,,786940,11928799,2909502,,733092,6499694,1889621,,53848,5429105,1019881,PDN
GA144,,2000,1977,,786957,11930498,2909821,,733092,6499694,1889621,,53865,5430804,1020200,PDN
GA144,,2001,1977,,750878,7477209,2081342,,750878,7477209,2081342,,0,0,0,PDN
GA144,,2002,1977,,750878,7477209,2081342,,750878,7477209,2081342,,0,0,0,PDN
GA144,,2003,1977,,750878,7477209,2081342,,750878,7477209,2081342,,0,0,0,PDN
GA144,,2004,1977,,750878,7477209,2081342,,750878,7477209,2081342,,0,0,0,PDN
GA144,,2005,1977,,750878,7477209,2081342,,750878,7477209,2081342,,0,0,0,PDN
GA144,,2006,1977,,750878,7477209,2081342,,750878,7477209,2081342,,0,0,0,PDN
GA144,,2007,1977,,750878,7477209,2081342,,750878,7477209,2081342,,0,0,0,PDN
GA144,,2008,1977,,750878,7477209,2081342,,750878,7477209,2081342,,0,0,0,PDN
GA144,,2009,1977,,750878,7607380,2104504,,750878,7607380,2104504,,0,0,0,PDN
GA144,,2010,1977,,750878,7607380,2104504,,750878,7607380,2104504,,0,0,0,PDN
GA144,,2011,1977,,750878,7607380,2104504,,750878,7607380,2104504,,0,0,0,PDN
GA144,,2012,1977,,750878,7607380,2104504,,750878,7607380,2104504,,0,0,0,PDN
GA144,,2013,1977,,750878,7607380,2104504,,750878,7607380,2104504,,0,0,0,PDN
GA144,,2014,1977,,750878,7607380,2104504,,750878,7607380,2104504,,0,0,0,PDN
GA144,,2015,1977,,750878,7607380,2104504,,750878,7607380,2104504,,0,0,0,PDN
GA144,,2016,1977,,750878,7607380,2104504,,750878,7607380,2104504,,0,0,0,PDN
GA144,,2017,1977,,750878,7607380,2104504,,750878,7607380,2104504,,0,0,0,PDN
GA144,,2017,1977,,750878,7607380,2104504,,750878,7607380,2104504,,0,0,0,PDN
GA151,,1997,1987,,1265012,23406516,5429872,,59561,983848,234623,,1205451,22422668,5195249,PDN
GA151,,1998,1987,,3938434,67748774,15993376,,363447,6013800,1433518,,3574987,61734974,14559858,PDN
GA151,,1999,1987,,3938390,67747959,15993187,,1036853,18162108,4268545,,2901537,49585851,11724642,PDN
GA151,,2000,1987,,2623818,52523806,11969691,,1299962,25228694,5789053,,1323856,27295112,6180638,PDN
GA151,,2001,1987,,2249976,57999820,12570229,,1591804,28853312,6725845,,658172,29146508,5844384,PDN
GA151,,2002,1987,,2384567,57999820,12704820,,1879971,33116725,7772627,,504596,24883095,4932193,PDN
GA151,,2003,1987,,3913866,66371695,15723776,,1953980,34978864,8177977,,1959886,31392831,7545799,PDN
GA151,,2004,1987,,3913866,66371695,15723776,,2299454,37467334,8966239,,1614412,28904361,6757537,PDN
GA151,,2005,1987,,2828380,54474685,12521384,,2428824,38487149,9277071,,399556,15987536,3244313,PDN
GA151,,2006,1987,,3297219,54501124,12994928,,2527114,39132806,9490247,,770105,15368318,3504681,PDN
GA151,,2007,1987,,3260722,54518482,12961520,,2596911,39776514,9674583,,663811,14741968,3286937,PDN
GA151,,2008,1987,,3561676,65972728,15300596,,2624659,40104268,9760650,,937017,25868460,5539946,PDN
GA151,,2009,1987,,2926043,50135740,11846993,,2633894,40589944,9856304,,292149,9545796,1990690,PDN
GA151,,2010,1987,,2981613,50817933,12023950,,2719366,44064049,10559944,,262247,6753884,1464006,PDN
GA151,,2011,1987,,2981613,50817933,12023950,,2787683,46468704,11056137,,193930,4349229,967814,PDN
GA151,,2012,1987,,2981613,50817933,12023950,,2791416,46612582,11085471,,190197,4205351,938480,PDN
GA151,,2013,1987,,2981613,50817933,12023950,,2815320,47416886,11252489,,166293,3401047,771462,PDN
GA151,,2014,1987,,2982297,52061006,12245822,,2834843,48219167,11414767,,147454,3841839,831055,PDN
GA151,,2015,1987,,2840111,48581239,11484461,,2840111,48581239,11484461,,0,0,0,PDN
GA151,,2016,1987,,2840111,48581239,11484461,,2840111,48581239,11484461,,0,0,0,PDN
GA151,,2017,1987,,2840111,48581239,11484461,,2840111,48581239,11484461,,0,0,0,PDN
GA151,,2017,1987,,2840111,48581239,11484461,,2840111,48581239,11484461,,0,0,0,PDN
GA155A,,1988,1980,,0,12613737,2244437,,0,0,0,,0,12613737,2244437,PDP
GA155A,,1989,1980,,0,12613737,2244437,,0,0,0,,0,12613737,2244437,PDP
GA155A,,2007,1980,,2207,22064952,3928355,,0,0,0,,2207,22064952,3928355,PDP
GA155A,,2008,1980,,29659,21773547,3903956,,0,0,0,,29659,21773547,3903956,PDP
GA155A,,2009,1980,,29794,17653036,3170904,,942,605298,108646,,28852,17047738,3062257,PDP
GA155A,,2010,1980,,29794,17653036,3170904,,6291,3436162,617708,,23503,14216874,2553196,PDP
GA155A,,2011,1980,,29794,17653036,3170904,,10354,6243005,1121209,,19440,11410031,2049695,PDP
GA155A,,2012,1980,,29794,17653036,3170904,,14299,8912759,1600199,,15495,8740277,1570704,PDP
GA155A,,2013,1980,,29794,17653036,3170904,,17539,11462949,2057210,,12255,6190087,1113694,PDP
GA155A,,2014,1980,,29794,17653036,3170904,,20300,13815865,2478639,,9494,3837171,692265,PDP
GA155A,,2015,1980,,25463,20334817,3643758,,22021,15984051,2866158,,3442,4350766,777600,PDP
GA155A,,2016,1980,,25463,20334817,3643758,,22421,16661701,2987136,,3042,3673116,656621,PDP
GA155A,,2017,1980,,25463,20334817,3643758,,22422,16693474,2992791,,3041,3641343,650967,PDP
GA155A,,2017,1980,,25463,20334817,3643758,,22422,16693474,2992791,,3041,3641343,650967,PDP
GA157A,,1978,1978,,863018,8110891,2306237,,0,0,0,,863018,8110891,2306237,PDN
GA157A,,1979,1978,,863018,8110891,2306237,,0,0,0,,863018,8110891,2306237,PDN
GA157A,,1980,1978,,902282,8110891,2345501,,14020,2131685,393323,,888262,5979206,1952178,PDN
GA157A,,1981,1978,,84022,16976000,3104663,,28707,6291786,1148242,,55315,10684214,1956421,PDN
GA157A,,1982,1978,,84022,16976000,3104663,,32553,7404190,1350025,,51469,9571810,1754638,PDN
GA157A,,1983,1978,,84022,16976000,3104663,,33180,7514740,1370322,,50842,9461260,1734341,PDN
GA157A,,1984,1978,,84022,16976000,3104663,,33180,7514740,1370322,,50842,9461260,1734341,PDN
GA157A,,1985,1978,,33180,7514740,1370322,,33180,7514740,1370322,,0,0,0,PDN
GA157A,,1986,1978,,33180,7514740,1370322,,33180,7514740,1370322,,0,0,0,PDN
GA157A,,1987,1978,,33180,7514740,1370322,,33180,7514740,1370322,,0,0,0,PDN
GA157A,,1988,1978,,33180,7514740,1370322,,33180,7514740,1370322,,0,0,0,PDN
GA157A,,1989,1978,,33180,7514740,1370322,,33180,7514740,1370322,,0,0,0,PDN
GA157A,,1990,1978,,33180,7514740,1370322,,33180,7514740,1370322,,0,0,0,PDN
GA157A,,1991,1978,,33180,7514740,1370322,,33180,7514740,1370322,,0,0,0,PDN
GA157A,,1992,1978,,33180,7514740,1370322,,33180,7514740,1370322,,0,0,0,PDN
GA157A,,1993,1978,,33180,7514740,1370322,,33180,7514740,1370322,,0,0,0,PDN
GA157A,,1994,1978,,33180,7514740,1370322,,33180,7514740,1370322,,0,0,0,PDN
GA157A,,1995,1978,,33180,7514740,1370322,,33180,7514740,1370322,,0,0,0,PDN
GA157A,,1996,1978,,33180,7514740,1370322,,33180,7514740,1370322,,0,0,0,PDN
GA157A,,1997,1978,,33180,7514740,1370322,,33180,7514740,1370322,,0,0,0,PDN
GA157A,,1998,1978,,33180,7514740,1370322,,33180,7514740,1370322,,0,0,0,PDN
GA157A,,1999,1978,,33180,7514740,1370322,,33180,7514740,1370322,,0,0,0,PDN
GA157A,,2000,1978,,33180,7514740,1370322,,33180,7514740,1370322,,0,0,0,PDN
GA157A,,2001,1978,,33180,7514740,1370322,,33180,7514740,1370322,,0,0,0,PDN
GA157A,,2002,1978,,33180,7514740,1370322,,33180,7514740,1370322,,0,0,0,PDN
GA157A,,2003,1978,,33180,7514740,1370322,,33180,7514740,1370322,,0,0,0,PDN
GA157A,,2004,1978,,33180,7514740,1370322,,33180,7514740,1370322,,0,0,0,PDN
GA157A,,2005,1978,,33180,7514740,1370322,,33180,7514740,1370322,,0,0,0,PDN
GA157A,,2006,1978,,33180,7514740,1370322,,33180,7514740,1370322,,0,0,0,PDN
GA157A,,2007,1978,,33180,7514740,1370322,,33180,7514740,1370322,,0,0,0,PDN
GA157A,,2008,1978,,33180,7514740,1370322,,33180,7514740,1370322,,0,0,0,PDN
GA157A,,2009,1978,,33180,7665239,1397101,,33180,7665239,1397101,,0,0,0,PDN
GA157A,,2010,1978,,33180,7665239,1397101,,33180,7665239,1397101,,0,0,0,PDN
GA157A,,2011,1978,,33180,7665239,1397101,,33180,7665239,1397101,,0,0,0,PDN
GA157A,,2012,1978,,33180,7665239,1397101,,33180,7665239,1397101,,0,0,0,PDN
GA157A,,2013,1978,,33180,7665239,1397101,,33180,7665239,1397101,,0,0,0,PDN
GA157A,,2014,1978,,33180,7665239,1397101,,33180,7665239,1397101,,0,0,0,PDN
GA157A,,2015,1978,,33180,7665239,1397101,,33180,7665239,1397101,,0,0,0,PDN
GA157A,,2016,1978,,33180,7665239,1397101,,33180,7665239,1397101,,0,0,0,PDN
GA157A,,2017,1978,,33180,7665239,1397101,,33180,7665239,1397101,,0,0,0,PDN
GA157A,,2017,1978,,33180,7665239,1397101,,33180,7665239,1397101,,0,0,0,PDN
GA189,,1975,1955,,2125850,4954740,3007476,,571419,380145,639060,,1554431,4574595,2368416,PDN
GA189,,1976,1955,,2125850,4954740,3007476,,679086,403585,750898,,1446764,4551155,2256578,PDN
GA189,,1977,1955,,2125850,4954740,3007476,,691032,405900,763256,,1434818,4548840,2244220,PDN
GA189,,1978,1955,,2125850,4954740,3007476,,729943,407912,802525,,1395907,4546828,2204951,PDN
GA189,,1979,1955,,2125850,4954740,3007476,,879342,697961,1003534,,1246508,4256779,2003942,PDN
GA189,,1980,1955,,2125850,4954740,3007476,,849858,654573,966330,,1275992,4300167,2041146,PDN
GA189,,1981,1955,,4426724,5171060,5346841,,2940738,727029,3070103,,1485986,4444031,2276738,PDN
GA189,,1982,1955,,4547225,5171060,5467342,,3035676,823265,3182164,,1511549,4347795,2285178,PDN
GA189,,1983,1955,,4547225,5671020,5556303,,3147530,912248,3309852,,1399695,4758772,2246451,PDN
GA189,,1984,1955,,4566806,7629107,5924298,,1891922,1044207,2077724,,2674884,6584900,3846574,PDN
GA189,,1985,1955,,4733730,11724068,6819863,,2030535,1448607,2288294,,2703195,10275461,4531569,PDN
GA189,,1986,1955,,4760025,13692336,7196384,,1858691,3502448,2481902,,2901334,10189888,4714482,PDN
GA189,,1987,1955,,4672548,17095684,7714485,,1738874,5723741,2757333,,2933674,11371943,4957152,PDN
GA189,,1988,1955,,4270443,20810896,7973449,,1803427,6728141,3000605,,2467016,14082755,4972844,PDN
GA189,,1989,1955,,2802739,15147227,5497975,,1847230,8599953,3377471,,955509,6547274,2120504,PDN
GA189,,1990,1955,,2238794,15136506,4932122,,1881325,10141069,3685786,,357469,4995437,1246336,PDN
GA189,,1991,1955,,2104557,18700010,5431961,,1909804,11849443,4018246,,194753,6850567,1413715,PDN
GA189,,1992,1955,,2170553,19668207,5670234,,2034894,13593059,4453588,,135659,6075148,1216646,PDN
GA189,,1993,1955,,2189658,20762741,5884096,,2104878,15483247,4859904,,84780,5279494,1024192,PDN
GA189,,1994,1955,,2694520,21058470,6441579,,2223936,17210492,5286301,,470584,3847978,1155278,PDN
GA189,,1995,1955,,2841353,22512559,6847146,,2310477,18899186,5673321,,530876,3613373,1173825,PDN
GA189,,1996,1955,,3067079,34031565,9122518,,2356935,20096048,5932744,,710144,13935517,3189774,PDN
GA189,,1997,1955,,2465724,33507911,8427986,,2357582,20389177,5985549,,108142,13118734,2442437,PDN
GA189,,1998,1955,,2465724,33507911,8427986,,2358302,20566777,6017871,,107422,12941134,2410115,PDN
GA189,,1999,1955,,2459757,31646559,8090817,,2358366,20617574,6026973,,101391,11028985,2063844,PDN
GA189,,2000,1955,,2358793,20956221,6087658,,2358759,20724160,6046332,,34,232061,41326,PDN
GA189,,2001,1955,,3162727,26635793,7902192,,2455268,22172807,6400607,,707459,4462986,1501585,PDN
GA189,,2002,1955,,3283206,23572212,7477550,,2564195,22383868,6547090,,719011,1188344,930460,PDN
GA189,,2003,1955,,3283206,23572212,7477550,,2657232,22542497,6668352,,625974,1029715,809198,PDN
GA189,,2004,1955,,3333036,23604884,7533193,,2728508,22679593,6764023,,604528,925291,769170,PDN
GA189,,2005,1955,,3343008,23281797,7485677,,2789415,22822794,6850410,,553593,459003,635267,PDN
GA189,,2006,1955,,3343008,26184097,8002100,,2847895,22916953,6925645,,495113,3267144,1076455,PDN
GA189,,2007,1955,,3383425,26136815,8034104,,2902469,23014325,6997545,,480956,3122490,1036559,PDN
GA189,,2008,1955,,3260172,23661942,7470482,,2946590,23054633,7048838,,313582,607309,421644,PDN
GA189,,2009,1955,,3260539,24078456,7544962,,2988934,23502050,7170794,,271605,576406,374169,PDN
GA189,,2010,1955,,3260539,24078456,7544962,,3034177,23579851,7229880,,226362,498605,315082,PDN
GA189,,2011,1955,,3260539,24078456,7544962,,3055967,23627835,7260208,,204572,450621,284753,PDN
GA189,,2012,1955,,3260539,24078456,7544962,,3086856,23685603,7301376,,173683,392853,243586,PDN
GA189,,2013,1955,,3100006,23728651,7322186,,3099642,23728567,7321807,,364,84,379,PDN
GA189,,2014,1955,,3100006,23728651,7322186,,3100006,23728651,7322186,,0,0,0,PDN
GA189,,2015,1955,,3100006,23728651,7322186,,3100006,23728651,7322186,,0,0,0,PDN
GA189,,2016,1955,,3100006,23728651,7322186,,3100006,23728651,7322186,,0,0,0,PDN
GA189,,2017,1955,,3100006,23728651,7322186,,3100006,23728651,7322186,,0,0,0,PDN
GA189,,2017,1955,,3100006,23728651,7322186,,3100006,23728651,7322186,,0,0,0,PDN
GA192A,,2002,1989,,17561,5905310,1068328,,0,0,0,,17561,5905310,1068328,PDN
GA192A,,2003,1989,,17561,5905310,1068328,,445,149891,27116,,17116,5755419,1041212,PDN
GA192A,,2004,1989,,17561,5905310,1068328,,11203,2394093,437198,,6358,3511217,631130,PDN
GA192A,,2005,1989,,17294,5612493,1015958,,15237,4645882,841906,,2057,966611,174052,PDN
GA192A,,2006,1989,,15725,5124985,927644,,15725,5124985,927644,,0,0,0,PDN
GA192A,,2007,1989,,15725,5124985,927644,,15725,5124985,927644,,0,0,0,PDN
GA192A,,2008,1989,,15725,5124985,927644,,15725,5124985,927644,,0,0,0,PDN
GA192A,,2009,1989,,15725,5124985,927644,,15725,5124985,927644,,0,0,0,PDN
GA192A,,2010,1989,,15725,5124985,927644,,15725,5124985,927644,,0,0,0,PDN
GA192A,,2011,1989,,15725,5124985,927644,,15725,5124985,927644,,0,0,0,PDN
GA192A,,2012,1989,,15725,5124985,927644,,15725,5124985,927644,,0,0,0,PDN
GA192A,,2013,1989,,15725,5124985,927644,,15725,5124985,927644,,0,0,0,PDN
GA192A,,2014,1989,,15725,5124985,927644,,15725,5124985,927644,,0,0,0,PDN
GA192A,,2015,1989,,15725,5124985,927644,,15725,5124985,927644,,0,0,0,PDN
GA192A,,2016,1989,,15725,5124985,927644,,15725,5124985,927644,,0,0,0,PDN
GA192A,,2017,1989,,15725,5124985,927644,,15725,5124985,927644,,0,0,0,PDN
GA192A,,2017,1989,,15725,5124985,927644,,15725,5124985,927644,,0,0,0,PDN
GA209,,1987,1983,,726134,34128283,6798782,,0,0,0,,726134,34128283,6798782,PDP
GA209,,1990,1983,,457230,57882501,10756607,,20733,1644314,313316,,436497,56238187,10443291,PDP
GA209,,1991,1983,,1817753,66729259,13691287,,168791,6216573,1274943,,1648962,60512686,12416344,PDP
GA209,,1992,1983,,1749238,57180935,11923782,,496684,12935132,2798309,,1252554,44245803,9125473,PDP
GA209,,1993,1983,,2210472,93488219,18845386,,937569,24576992,5310699,,1272903,68911227,13534687,PDP
GA209,,1994,1983,,2419605,142920990,27850386,,1356288,37796201,8081591,,1063317,105124789,19768795,PDP
GA209,,1995,1983,,7009919,112694029,27062237,,1758343,48433272,10376363,,5251576,64260757,16685874,PDP
GA209,,1996,1983,,6977350,96071233,24071875,,2084122,59796354,12724043,,4893228,36274879,11347832,PDP
GA209,,1997,1983,,11015679,149405642,37600313,,3383131,76322717,16963686,,7632548,73082925,20636627,PDP
GA209,,1998,1983,,11135554,166262898,40719700,,5879603,96264439,23008507,,5255951,69998459,17711193,PDP
GA209,,1999,1983,,11734759,230967909,52832252,,7760570,120928652,29278124,,3974189,110039257,23554128,PDP
GA209,,2000,1983,,15383215,291091190,67178801,,9264009,156221856,37061492,,6119206,134869334,30117309,PDP
GA209,,2001,1983,,16600218,304394410,70762925,,10380899,180548877,42507034,,6219319,123845533,28255891,PDP
GA209,,2002,1983,,16347863,288974810,67766869,,11581560,202584189,47628569,,4766303,86390621,20138300,PDP
GA209,,2003,1983,,20093507,321993534,77387730,,12989739,226581602,53306750,,7103768,95411932,24080980,PDP
GA209,,2004,1983,,20066164,339849248,80537561,,14610002,246795760,58523838,,5456162,93053488,22013723,PDP
GA209,,2005,1983,,23206377,346703588,84897407,,15793965,261538518,62331068,,7412412,85165070,22566339,PDP
GA209,,2006,1983,,26062215,363339783,90713422,,16727671,275644912,65774808,,9334544,87694871,24938614,PDP
GA209,,2007,1983,,25944866,352353341,88641190,,17525157,286424243,68490325,,8419709,65929098,20150865,PDP
GA209,,2008,1983,,24284448,370761448,90256236,,18203670,292941802,70328546,,6080778,77819646,19927690,PDP
GA209,,2009,1983,,24169004,346798676,85876952,,18899390,302026781,72640810,,5269614,44771895,13236144,PDP
GA209,,2010,1983,,24302323,335999737,84088752,,19917079,308363981,74786114,,4385244,27635756,9302640,PDP
GA209,,2011,1983,,24302323,335999737,84088752,,20800472,311854199,76290542,,3501851,24145538,7798211,PDP
GA209,,2012,1983,,24277637,332354662,83415476,,21667961,314611012,77648567,,2609676,17743650,5766909,PDP
GA209,,2013,1983,,24905377,324051262,82565743,,22627759,317123152,79055364,,2277618,6928110,3510378,PDP
GA209,,2014,1983,,26934790,328765179,85433931,,23813949,320094636,80770291,,3120841,8670543,4663642,PDP
GA209,,2015,1983,,27031696,333412856,86357826,,25085155,324058140,82746747,,1946541,9354716,3611082,PDP
GA209,,2016,1983,,27728372,336546831,87612151,,25951584,326869548,84113426,,1776788,9677283,3498723,PDP
GA209,,2017,1983,,27998516,336704691,87910384,,26718067,328202513,85117091,,1280449,8502178,2793291,PDP
GA209,,2017,1983,,27998516,336704691,87910384,,26718067,328202513,85117091,,1280449,8502178,2793291,PDP
GA210,,1991,1989,,157067,20914106,3878438,,0,0,0,,157067,20914106,3878438,PDP
GA210,,1992,1989,,157067,20914106,3878438,,17564,2173404,404291,,139503,18740702,3474147,PDP
GA210,,1993,1989,,166678,22706611,4207000,,76383,11636185,2146879,,90295,11070426,2060121,PDP
GA210,,1994,1989,,166434,22674101,4200972,,106578,19585622,3591564,,59856,3088479,609408,PDP
GA210,,1995,1989,,196802,34675959,6366901,,119072,22144422,4059361,,77730,12531537,2307540,PDP
GA210,,1996,1989,,217025,37965407,6972435,,126792,23823713,4365887,,90233,14141694,2606548,PDP
GA210,,1997,1989,,217025,37965407,6972435,,130615,24689504,4523765,,86410,13275903,2448670,PDP
GA210,,1998,1989,,217025,37965407,6972435,,133803,25530458,4676589,,83222,12434949,2295846,PDP
GA210,,1999,1989,,193125,37005106,6777663,,140279,26616722,4876351,,52846,10388384,1901312,PDP
GA210,,2000,1989,,398519,59704810,11022151,,179349,31327788,5753689,,219170,28377022,5268462,PDP
GA210,,2001,1989,,185783,32169777,5909943,,185783,32169777,5909943,,0,0,0,PDP
GA210,,2002,1989,,185785,32170281,5910034,,185785,32170281,5910034,,0,0,0,PDP
GA210,,2003,1989,,185785,32170281,5910034,,185785,32170281,5910034,,0,0,0,PDP
GA210,,2004,1989,,185785,32170281,5910034,,185785,32170281,5910034,,0,0,0,PDP
GA210,,2005,1989,,4340319,107673218,23499255,,230114,34980890,6454472,,4110205,72692328,17044783,PDP
GA210,,2006,1989,,4340319,107673218,23499255,,473760,42030048,7952416,,3866559,65643170,15546839,PDP
GA210,,2007,1989,,2852825,108444909,22149072,,695739,50129499,9615579,,2157086,58315410,12533493,PDP
GA210,,2008,1989,,2852825,108444909,22149072,,779729,54799182,10530473,,2073096,53645727,11618599,PDP
GA210,,2009,1989,,1018207,79286623,15126146,,821341,58374660,11208290,,196866,20911963,3917856,PDP
GA210,,2010,1989,,1018207,79286623,15126146,,839643,60547911,11613292,,178564,18738712,3512855,PDP
GA210,,2011,1989,,1018207,79286623,15126146,,864189,63535613,12169457,,154018,15751010,2956689,PDP
GA210,,2012,1989,,1018207,79286623,15126146,,895834,66137571,12664084,,122373,13149052,2462062,PDP
GA210,,2013,1989,,1018207,79286623,15126146,,906702,67506498,12918533,,111505,11780125,2207613,PDP
GA210,,2014,1989,,955073,73985412,14119736,,914498,68580863,13117498,,40575,5404549,1002239,PDP
GA210,,2015,1989,,955073,73985412,14119736,,920597,69322184,13255504,,34476,4663228,864232,PDP
GA210,,2016,1989,,956368,74254808,14168966,,923641,69809739,13345302,,32727,4445069,823665,PDP
GA210,,2017,1989,,956368,74254808,14168966,,930203,70881738,13542610,,26165,3373070,626356,PDP
GA210,,2017,1989,,956368,74254808,14168966,,930203,70881738,13542610,,26165,3373070,626356,PDP
GA213,,1988,1982,,90751,4644850,917237,,20854,1157359,226790,,69897,3487491,690447,PDN
GA213,,1989,1982,,24810,1319903,259668,,24810,1319903,259668,,0,0,0,PDN
GA213,,1990,1982,,24810,1319903,259668,,24810,1319903,259668,,0,0,0,PDN
GA213,,1991,1982,,24810,1319903,259668,,24810,1319903,259668,,0,0,0,PDN
GA213,,1992,1982,,24810,1319903,259668,,24810,1319903,259668,,0,0,0,PDN
GA213,,1993,1982,,24810,1319903,259668,,24810,1319903,259668,,0,0,0,PDN
GA213,,1994,1982,,24810,1319903,259668,,24810,1319903,259668,,0,0,0,PDN
GA213,,1995,1982,,24810,1319903,259668,,24810,1319903,259668,,0,0,0,PDN
GA213,,1996,1982,,24810,1319903,259668,,24810,1319903,259668,,0,0,0,PDN
GA213,,1997,1982,,259091,12363402,2458985,,24810,1319903,259668,,234281,11043499,2199317,PDN
GA213,,1998,1982,,259091,12363402,2458985,,62579,4077576,788126,,196512,8285826,1670859,PDN
GA213,,1999,1982,,259091,12363402,2458985,,70140,5354557,1022908,,188951,7008845,1436077,PDN
GA213,,2000,1982,,70210,5366176,1025046,,70210,5366176,1025046,,0,0,0,PDN
GA213,,2001,1982,,111506,7628417,1468876,,96771,6851820,1315956,,14735,776597,152920,PDN
GA213,,2002,1982,,185876,11518131,2235366,,118835,8002691,1542801,,67041,3515440,692565,PDN
GA213,,2003,1982,,185876,11518131,2235366,,129920,8546683,1650682,,55956,2971448,584684,PDN
GA213,,2004,1982,,189244,11752357,2280411,,136691,8813594,1704946,,52553,2938763,575465,PDN
GA213,,2005,1982,,147107,9573020,1850491,,147107,9573020,1850491,,0,0,0,PDN
GA213,,2006,1982,,147872,9589703,1854225,,147833,9582329,1852874,,39,7374,1351,PDN
GA213,,2007,1982,,147833,9582329,1852874,,147833,9582329,1852874,,0,0,0,PDN
GA213,,2008,1982,,147833,9582329,1852874,,147833,9582329,1852874,,0,0,0,PDN
GA213,,2009,1982,,147833,9634603,1862176,,147833,9634603,1862176,,0,0,0,PDN
GA213,,2010,1982,,147833,9634603,1862176,,147833,9634603,1862176,,0,0,0,PDN
GA213,,2011,1982,,147833,9634603,1862176,,147833,9634603,1862176,,0,0,0,PDN
GA213,,2012,1982,,147833,9634603,1862176,,147833,9634603,1862176,,0,0,0,PDN
GA213,,2013,1982,,147833,9634603,1862176,,147833,9634603,1862176,,0,0,0,PDN
GA213,,2014,1982,,147833,9634603,1862176,,147833,9634603,1862176,,0,0,0,PDN
GA213,,2015,1982,,147833,9634603,1862176,,147833,9634603,1862176,,0,0,0,PDN
GA213,,2016,1982,,147833,9634603,1862176,,147833,9634603,1862176,,0,0,0,PDN
GA213,,2017,1982,,147833,9634603,1862176,,147833,9634603,1862176,,0,0,0,PDN
GA213,,2017,1982,,147833,9634603,1862176,,147833,9634603,1862176,,0,0,0,PDN
GA218A,,1978,1976,,1500,1500000,268404,,0,0,0,,1500,1500000,268404,PDN
GA218A,,1979,1976,,0,3000000,533808,,0,0,0,,0,3000000,533808,PDN
GA218A,,1980,1976,,3000,3000000,536808,,0,0,0,,3000,3000000,536808,PDN
GA218A,,1995,1976,,1347027,15667342,4134810,,358467,1956441,706588,,988560,13710901,3428222,PDN
GA218A,,1996,1976,,1291961,15595026,4066877,,760612,5552343,1748573,,531349,10042683,2318304,PDN
GA218A,,1997,1976,,1445560,15799160,4256798,,1016860,7778054,2400855,,428700,8021106,1855943,PDN
GA218A,,1998,1976,,1445560,15799160,4256798,,1095674,8427543,2595237,,349886,7371617,1661561,PDN
GA218A,,1999,1976,,1374221,10109490,3173063,,1167979,8513606,2682856,,206242,1595884,490207,PDN
GA218A,,2000,1976,,2181280,16870073,5183072,,1234380,8631828,2770292,,946900,8238245,2412780,PDN
GA218A,,2001,1976,,2088334,15424410,4832890,,1260844,8678948,2805141,,827490,6745462,2027749,PDN
GA218A,,2002,1976,,2088334,15424410,4832890,,1270463,8693970,2817433,,817871,6730440,2015457,PDN
GA218A,,2003,1976,,1270463,8693970,2817433,,1270463,8693970,2817433,,0,0,0,PDN
GA218A,,2004,1976,,1270463,8693970,2817433,,1270463,8693970,2817433,,0,0,0,PDN
GA218A,,2005,1976,,1270463,8693970,2817433,,1270463,8693970,2817433,,0,0,0,PDN
GA218A,,2006,1976,,1270463,8693970,2817433,,1270463,8693970,2817433,,0,0,0,PDN
GA218A,,2007,1976,,1270463,8693970,2817433,,1270463,8693970,2817433,,0,0,0,PDN
GA218A,,2008,1976,,1270463,8693970,2817433,,1270463,8693970,2817433,,0,0,0,PDN
GA218A,,2009,1976,,1270463,8862450,2847411,,1270463,8862450,2847411,,0,0,0,PDN
GA218A,,2010,1976,,1270463,8862450,2847411,,1270463,8862450,2847411,,0,0,0,PDN
GA218A,,2011,1976,,1270463,8862450,2847411,,1270463,8862450,2847411,,0,0,0,PDN
GA218A,,2012,1976,,1270463,8862450,2847411,,1270463,8862450,2847411,,0,0,0,PDN
GA218A,,2013,1976,,1270463,8862450,2847411,,1270463,8862450,2847411,,0,0,0,PDN
GA218A,,2014,1976,,1270463,8862450,2847411,,1270463,8862450,2847411,,0,0,0,PDN
GA218A,,2015,1976,,1270463,8862450,2847411,,1270463,8862450,2847411,,0,0,0,PDN
GA218A,,2016,1976,,1270463,8862450,2847411,,1270463,8862450,2847411,,0,0,0,PDN
GA218A,,2017,1976,,1270463,8862450,2847411,,1270463,8862450,2847411,,0,0,0,PDN
GA218A,,2017,1976,,1270463,8862450,2847411,,1270463,8862450,2847411,,0,0,0,PDN
GA227,,2004,2004,,88038,2982265,618690,,0,0,0,,88038,2982265,618690,PDN
GA227,,2005,2004,,54717,2552462,508892,,10714,291538,62589,,44003,2260924,446303,PDN
GA227,,2006,2004,,54717,2552462,508892,,41575,1627180,331109,,13142,925282,177783,PDN
GA227,,2007,2004,,54717,2552462,508892,,46307,2073436,415246,,8410,479026,93646,PDN
GA227,,2008,2004,,46316,2078969,416239,,46316,2078969,416239,,0,0,0,PDN
GA227,,2009,2004,,46316,2078969,416239,,46316,2078969,416239,,0,0,0,PDN
GA227,,2010,2004,,46316,2078969,416239,,46316,2078969,416239,,0,0,0,PDN
GA227,,2011,2004,,46316,2078969,416239,,46316,2078969,416239,,0,0,0,PDN
GA227,,2012,2004,,46316,2078969,416239,,46316,2078969,416239,,0,0,0,PDN
GA227,,2013,2004,,46316,2078969,416239,,46316,2078969,416239,,0,0,0,PDN
GA227,,2014,2004,,46316,2078969,416239,,46316,2078969,416239,,0,0,0,PDN
GA227,,2015,2004,,46316,2078969,416239,,46316,2078969,416239,,0,0,0,PDN
GA227,,2016,2004,,46316,2078969,416239,,46316,2078969,416239,,0,0,0,PDN
GA227,,2017,2004,,46316,2078969,416239,,46316,2078969,416239,,0,0,0,PDN
GA227,,2017,2004,,46316,2078969,416239,,46316,2078969,416239,,0,0,0,PDN
GA239,,1991,1990,,448740,10263660,2275014,,0,0,0,,448740,10263660,2275014,PDN
GA239,,1992,1990,,456552,12327559,2650068,,47240,1407216,297634,,409312,10920343,2352434,PDN
GA239,,1993,1990,,255480,11660786,2330353,,77186,3596142,717069,,178294,8064644,1613284,PDN
GA239,,1994,1990,,256714,12210909,2429474,,83534,4479505,880599,,173180,7731404,1548875,PDN
GA239,,1995,1990,,126861,14668477,2736910,,88848,5843230,1128569,,38013,8825247,1608341,PDN
GA239,,1996,1990,,126861,14668477,2736910,,97115,7954837,1512566,,29746,6713640,1224344,PDN
GA239,,1997,1990,,126861,14668477,2736910,,103322,9794445,1846106,,23539,4874032,890804,PDN
GA239,,1998,1990,,300278,19889016,3839249,,104861,10434758,1961580,,195417,9454258,1877669,PDN
GA239,,1999,1990,,513416,35146317,6767209,,224433,14931253,2881240,,288983,20215064,3885969,PDN
GA239,,2000,1990,,266433,19793353,3788382,,259283,18315898,3518340,,7150,1477455,270042,PDN
GA239,,2001,1990,,362270,28943667,5512389,,313803,22328013,4286759,,48467,6615654,1225630,PDN
GA239,,2002,1990,,758410,37073647,7355144,,424184,25704923,4998014,,334226,11368724,2357130,PDN
GA239,,2003,1990,,758410,37073647,7355144,,496791,28624823,5590176,,261619,8448824,1764968,PDN
GA239,,2004,1990,,1234255,44978469,9237541,,620649,32272395,6363068,,613606,12706074,2874473,PDN
GA239,,2005,1990,,988953,39808616,8072337,,735247,34420514,6859894,,253706,5388102,1212443,PDN
GA239,,2006,1990,,994386,43994942,8822667,,820365,36599534,7332738,,174021,7395408,1489929,PDN
GA239,,2007,1990,,993378,42801303,8609268,,902634,38794106,7805500,,90744,4007197,803768,PDN
GA239,,2008,1990,,1001447,44638581,8944255,,942285,40170240,8090015,,59162,4468341,854240,PDN
GA239,,2009,1990,,950010,44239454,8821799,,944206,41054239,8249230,,5804,3185215,572568,PDN
GA239,,2010,1990,,951029,46354992,9199248,,947828,42356130,8484505,,3201,3998862,714743,PDN
GA239,,2011,1990,,951029,46354992,9199248,,949433,42900476,8582969,,1596,3454516,616279,PDN
GA239,,2012,1990,,952274,46354992,9200493,,949876,43913104,8763595,,2398,2441888,436898,PDN
GA239,,2013,1990,,951219,45315737,9014517,,950748,44927052,8944885,,471,388685,69632,PDN
GA239,,2014,1990,,951219,45315737,9014517,,951219,45315737,9014517,,0,0,0,PDN
GA239,,2015,1990,,951219,45315737,9014517,,951219,45315737,9014517,,0,0,0,PDN
GA239,,2016,1990,,951219,45315737,9014517,,951219,45315737,9014517,,0,0,0,PDN
GA239,,2017,1990,,951219,45315737,9014517,,951219,45315737,9014517,,0,0,0,PDN
GA239,,2017,1990,,951219,45315737,9014517,,951219,45315737,9014517,,0,0,0,PDN
GA252,,1993,1990,,74371,19929097,3620474,,137,46213,8360,,74234,19882884,3612114,PDN
GA252,,1994,1990,,81236,21953776,3987602,,22153,5776121,1049933,,59083,16177655,2937669,PDN
GA252,,1995,1990,,84055,23460652,4258548,,35276,9666993,1755382,,48779,13793659,2503166,PDN
GA252,,1996,1990,,90969,25792611,4680402,,43162,12752216,2312240,,47807,13040395,2368162,PDN
GA252,,1997,1990,,107225,33639370,6092878,,50864,15711140,2846441,,56361,17928230,3246437,PDN
GA252,,1998,1990,,111936,35319542,6396552,,57061,18926536,3424772,,54875,16393006,2971780,PDN
GA252,,1999,1990,,116091,37514531,6791274,,60679,20917330,3782624,,55412,16597201,3008650,PDN
GA252,,2000,1990,,108736,34928853,6323834,,66266,23113079,4178914,,42470,11815774,2144920,PDN
GA252,,2001,1990,,107839,36083281,6528352,,79090,28108038,5080520,,28749,7975243,1447832,PDN
GA252,,2002,1990,,111406,39874196,7206459,,82946,30105912,5439870,,28460,9768284,1766589,PDN
GA252,,2003,1990,,111374,39864637,7204726,,85312,31153960,5628721,,26062,8710677,1576005,PDN
GA252,,2004,1990,,95738,35780566,6462387,,86439,31749100,5735745,,9299,4031466,726642,PDN
GA252,,2005,1990,,95738,35780566,6462387,,87225,32176643,5812606,,8513,3603923,649781,PDN
GA252,,2006,1990,,97444,36402049,6574677,,89842,32918201,5947173,,7602,3483848,627504,PDN
GA252,,2007,1990,,97330,35417515,6399379,,91911,33379621,6031345,,5419,2037894,368034,PDN
GA252,,2008,1990,,94836,35168651,6352603,,92045,33640161,6077839,,2791,1528490,274764,PDN
GA252,,2009,1990,,92466,34422100,6217395,,92083,34212780,6179766,,383,209320,37629,PDN
GA252,,2010,1990,,92466,34422100,6217395,,92358,34322616,6199585,,108,99484,17810,PDN
GA252,,2011,1990,,92466,34422100,6217395,,92466,34401251,6213685,,0,20849,3710,PDN
GA252,,2012,1990,,92466,34422100,6217395,,92466,34422100,6217395,,0,0,0,PDN
GA252,,2013,1990,,92466,34422100,6217395,,92466,34422100,6217395,,0,0,0,PDN
GA252,,2014,1990,,92466,34422100,6217395,,92466,34422100,6217395,,0,0,0,PDN
GA252,,2015,1990,,92466,34422100,6217395,,92466,34422100,6217395,,0,0,0,PDN
GA252,,2016,1990,,92466,34422100,6217395,,92466,34422100,6217395,,0,0,0,PDN
GA252,,2017,1990,,92466,34422100,6217395,,92466,34422100,6217395,,0,0,0,PDN
GA252,,2017,1990,,92466,34422100,6217395,,92466,34422100,6217395,,0,0,0,PDN
GA255,,1975,1969,,2251693,76659610,15892193,,0,0,0,,2251693,76659610,15892193,PDN
GA255,,1976,1969,,2251693,76659610,15892193,,0,0,0,,2251693,76659610,15892193,PDN
GA255,,1977,1969,,2619532,81372435,17098613,,215261,3242836,792278,,2404271,78129599,16306335,PDN
GA255,,1978,1969,,2902433,87988740,18558792,,707542,8225280,2171115,,2194891,79763460,16387677,PDN
GA255,,1979,1969,,2803625,86502386,18195509,,1101496,11482441,3144635,,1702129,75019945,15050874,PDN
GA255,,1980,1969,,3203625,98756386,20775936,,1421501,13397776,3805447,,1782124,85358610,16970489,PDN
GA255,,1981,1969,,3358032,65734523,15054566,,1693145,14877199,4340333,,1664887,50857324,10714233,PDN
GA255,,1982,1969,,3591241,72575446,16505021,,1930864,17289582,5007302,,1660377,55285864,11497719,PDN
GA255,,1983,1969,,4089294,78594508,18074082,,2204102,19905137,5745941,,1885192,58689371,12328141,PDN
GA255,,1984,1969,,4106542,81129317,18542364,,2389163,22685348,6425702,,1717379,58443969,12116662,PDN
GA255,,1985,1969,,4233722,82539336,18920437,,2581760,26354871,7271239,,1651962,56184465,11649198,PDN
GA255,,1986,1969,,4227095,85598076,19458069,,2776092,30314725,8170171,,1451003,55283351,11287898,PDN
GA255,,1987,1969,,4658612,90352193,20735515,,2944668,31769640,8597629,,1713944,58582553,12137886,PDN
GA255,,1988,1969,,4642184,86858487,20097431,,3055792,32780004,8888533,,1586392,54078483,11208898,PDN
GA255,,1989,1969,,3716091,45980701,11897710,,3149030,33684317,9142681,,567061,12296384,2755029,PDN
GA255,,1990,1969,,3717839,49178468,12468456,,3242971,35284906,9521424,,474868,13893562,2947032,PDN
GA255,,1991,1969,,3717924,50701216,12739493,,3336966,37696090,10044455,,380958,13005126,2695038,PDN
GA255,,1992,1969,,3964910,52789320,13358027,,3459831,39432018,10476204,,505079,13357302,2881823,PDN
GA255,,1993,1969,,4384429,53480598,13900550,,3643182,41168707,10968575,,741247,12311891,2931975,PDN
GA255,,1994,1969,,4740750,53793267,14312506,,4040677,43051140,11701022,,700073,10742127,2611484,PDN
GA255,,1995,1969,,5761224,59164986,16288802,,4617981,45175541,12656333,,1143243,13989445,3632469,PDN
GA255,,1996,1969,,7570471,63973796,18953709,,5581661,48238257,14164981,,1988810,15735539,4788728,PDN
GA255,,1997,1969,,8142650,64135705,19554697,,6616317,50431623,15589915,,1526333,13704082,3964782,PDN
GA255,,1998,1969,,9225019,67228400,21187368,,7384615,52231438,16678465,,1840404,14996962,4508903,PDN
GA255,,1999,1969,,9270994,66982880,21189656,,7583433,52975192,17009624,,1687561,14007688,4180032,PDN
GA255,,2000,1969,,8733179,86878495,24191986,,7758836,53747885,17322517,,974343,33130610,6869469,PDN
GA255,,2001,1969,,9776083,92593847,26251856,,8005695,55877186,17948255,,1770388,36716661,8303601,PDN
GA255,,2002,1969,,9663468,92213689,26071597,,8101470,56767519,18202452,,1561998,35446170,7869145,PDN
GA255,,2003,1969,,9659657,93331545,26266693,,8199876,58157217,18548135,,1459781,35174328,7718558,PDN
GA255,,2004,1969,,9813169,98823958,27397503,,8318360,60003461,18995132,,1494809,38820497,8402371,PDN
GA255,,2005,1969,,9858890,99061384,27485470,,8419800,61829058,19421412,,1439090,37232326,8064058,PDN
GA255,,2006,1969,,9859065,97657359,27235819,,8490550,62788902,19662952,,1368515,34868457,7572867,PDN
GA255,,2007,1969,,9830258,97854265,27242048,,8550895,63363050,19825459,,1279363,34491215,7416589,PDN
GA255,,2008,1969,,9095087,76664761,22736504,,8607528,63862579,19970976,,487559,12802182,2765528,PDN
GA255,,2009,1969,,9103162,76873714,22781758,,8659932,65803246,20368695,,443230,11070468,2413064,PDN
GA255,,2010,1969,,9053069,75114927,22418713,,8709221,66429696,20529450,,343848,8685231,1889263,PDN
GA255,,2011,1969,,9053069,75114927,22418713,,8758031,67049438,20688536,,295038,8065489,1730178,PDN
GA255,,2012,1969,,9053069,75114927,22418713,,8802667,67184116,20757134,,250402,7930811,1661578,PDN
GA255,,2013,1969,,8844644,67295739,20818974,,8840783,67284693,20813147,,3861,11046,5827,PDN
GA255,,2014,1969,,8844644,67295739,20818974,,8844644,67295739,20818974,,0,0,0,PDN
GA255,,2015,1969,,8844644,67295739,20818974,,8844644,67295739,20818974,,0,0,0,PDN
GA255,,2016,1969,,8844644,67295739,20818974,,8844644,67295739,20818974,,0,0,0,PDN
GA255,,2017,1969,,8844644,67295739,20818974,,8844644,67295739,20818974,,0,0,0,PDN
GA255,,2017,1969,,8844644,67295739,20818974,,8844644,67295739,20818974,,0,0,0,PDN
GA273,,1991,1990,,62091,10487986,1928281,,0,0,0,,62091,10487986,1928281,PDN
GA273,,1992,1990,,62091,10487986,1928281,,0,0,0,,62091,10487986,1928281,PDN
GA273,,1993,1990,,62907,18647222,3380918,,13180,3180841,579166,,49727,15466381,2801752,PDN
GA273,,1994,1990,,84558,40127398,7224664,,37258,17280614,3112100,,47300,22846784,4112564,PDN
GA273,,1995,1990,,183650,40609607,7409559,,43213,22120183,3979189,,140437,18489424,3430370,PDN
GA273,,1996,1990,,81017,40578369,7301367,,44846,24069958,4327757,,36171,16508411,2973610,PDN
GA273,,1997,1990,,81463,40554446,7297557,,45748,25524689,4587508,,35715,15029757,2710049,PDN
GA273,,1998,1990,,81946,41943282,7545163,,46487,27067400,4862750,,35459,14875882,2682413,PDN
GA273,,1999,1990,,70431,43171944,7752272,,46697,28150870,5055749,,23734,15021074,2696523,PDN
GA273,,2000,1990,,50766,32876626,5900699,,47214,28544660,5126335,,3552,4331966,774364,PDN
GA273,,2001,1990,,52161,31817056,5713559,,48061,28804946,5173496,,4100,3012110,540063,PDN
GA273,,2002,1990,,52161,31817056,5713559,,48236,28966262,5202375,,3925,2850794,511184,PDN
GA273,,2003,1990,,52161,31817056,5713559,,48325,29178117,5240161,,3836,2638939,473398,PDN
GA273,,2004,1990,,49461,31053940,5575073,,48509,29294126,5260987,,952,1759814,314086,PDN
GA273,,2005,1990,,49400,30979928,5561843,,48578,29360750,5272911,,822,1619178,288932,PDN
GA273,,2006,1990,,49400,30979928,5561843,,48669,29433029,5285863,,731,1546899,275980,PDN
GA273,,2007,1990,,48669,29433029,5285863,,48669,29433029,5285863,,0,0,0,PDN
GA273,,2008,1990,,48669,29433029,5285863,,48669,29433029,5285863,,0,0,0,PDN
GA273,,2009,1990,,48669,29965993,5380697,,48669,29965993,5380697,,0,0,0,PDN
GA273,,2010,1990,,48669,29965993,5380697,,48669,29965993,5380697,,0,0,0,PDN
GA273,,2011,1990,,48669,29965993,5380697,,48669,29965993,5380697,,0,0,0,PDN
GA273,,2012,1990,,48669,29965993,5380697,,48669,29965993,5380697,,0,0,0,PDN
GA273,,2013,1990,,48669,29965993,5380697,,48669,29965993,5380697,,0,0,0,PDN
GA273,,2014,1990,,48669,29965993,5380697,,48669,29965993,5380697,,0,0,0,PDN
GA273,,2015,1990,,48669,29965993,5380697,,48669,29965993,5380697,,0,0,0,PDN
GA273,,2016,1990,,48669,29965993,5380697,,48669,29965993,5380697,,0,0,0,PDN
GA273,,2017,1990,,48669,29965993,5380697,,48669,29965993,5380697,,0,0,0,PDN
GA273,,2017,1990,,48669,29965993,5380697,,48669,29965993,5380697,,0,0,0,PDN
GA288,,1975,1960,,33700000,822414800,180037153,,20655116,477342093,105591431,,13044884,345072707,74445722,PDN
GA288,,1976,1960,,26903298,676849378,147339130,,22901214,595640707,128887105,,4002084,81208671,18452025,PDN
GA288,,1977,1960,,27381492,681315075,148611932,,23075884,609029533,131444128,,4305608,72285542,17167804,PDN
GA288,,1978,1960,,27502701,682142976,148880455,,23170071,617040515,132963757,,4332630,65102461,15916698,PDN
GA288,,1979,1960,,19798776,714392595,146914896,,14759505,618886845,124881719,,5039271,95505750,22033177,PDN
GA288,,1980,1960,,19160262,678280372,139850720,,14883360,622961943,125730681,,4276902,55318429,14120039,PDN
GA288,,1981,1960,,15280308,638629856,128915514,,14982554,626774268,126508224,,297754,11855588,2407290,PDN
GA288,,1982,1960,,15412975,638706601,129061836,,15118143,628434200,126939175,,294832,10272401,2122661,PDN
GA288,,1983,1960,,16395079,639189308,130129831,,15230490,630125322,127352433,,1164589,9063986,2777398,PDN
GA288,,1984,1960,,16579202,641474321,130720540,,15356571,631747282,127767119,,1222631,9727039,2953421,PDN
GA288,,1985,1960,,16616940,647807578,131885192,,15421261,632958649,128047355,,1195679,14848929,3837837,PDN
GA288,,1986,1960,,16925674,648137553,132252641,,15302448,634005137,128114750,,1623226,14132416,4137891,PDN
GA288,,1987,1960,,16805850,648397003,132178982,,15293402,635093427,128299350,,1512448,13303576,3879632,PDN
GA288,,1988,1960,,16275476,645043378,131051878,,15349702,636225393,128557067,,925774,8817985,2494811,PDN
GA288,,1989,1960,,16276925,645323006,131103083,,15397868,637176470,128774464,,879057,8146536,2328619,PDN
GA288,,1990,1960,,15724144,645270168,130540900,,15427263,637978871,128946635,,296881,7291297,1594265,PDN
GA288,,1991,1960,,15585883,645211147,130392137,,15443855,638695685,129090774,,142028,6515462,1301363,PDN
GA288,,1992,1960,,15651131,655618499,132309227,,15450741,639535669,129247123,,200390,16082830,3062104,PDN
GA288,,1993,1960,,16037620,668767325,135035365,,15566600,644672173,130276951,,471020,24095152,4758414,PDN
GA288,,1994,1960,,15987176,668559084,134947867,,15654234,650445814,131391923,,332942,18113270,3555944,PDN
GA288,,1995,1960,,16144787,678020405,136788987,,15717256,656225534,132483365,,427531,21794871,4305622,PDN
GA288,,1996,1960,,16033776,681021896,137212049,,15769786,660813810,133352314,,263990,20208086,3859735,PDN
GA288,,1997,1960,,16098953,683578264,137732096,,15810273,663593672,133887439,,288680,19984592,3844657,PDN
GA288,,1998,1960,,16116437,684625156,137935860,,15845647,665381407,134240915,,270790,19243749,3694945,PDN
GA288,,1999,1960,,16201246,687234941,138485043,,15874915,666444159,134459285,,326331,20790782,4025758,PDN
GA288,,2000,1960,,16188176,682668339,137659411,,15888896,666941410,134561745,,299280,15726929,3097666,PDN
GA288,,2001,1960,,15888896,666941410,134561745,,15888896,666941410,134561745,,0,0,0,PDN
GA288,,2002,1960,,15888896,666941856,134561824,,15888896,666941856,134561824,,0,0,0,PDN
GA288,,2003,1960,,15888896,666941856,134561824,,15888896,666941856,134561824,,0,0,0,PDN
GA288,,2004,1960,,15888896,666941856,134561824,,15888896,666941856,134561824,,0,0,0,PDN
GA288,,2005,1960,,15888896,666941856,134561824,,15888896,666941856,134561824,,0,0,0,PDN
GA288,,2006,1960,,15888896,666941856,134561824,,15888896,666941856,134561824,,0,0,0,PDN
GA288,,2007,1960,,15888896,666941856,134561824,,15888896,666941856,134561824,,0,0,0,PDN
GA288,,2008,1960,,16099083,672972334,135845050,,15888896,666941856,134561824,,210187,6030478,1283226,PDN
GA288,,2009,1960,,15999647,683325475,137587806,,15923020,681187518,137130760,,76627,2137957,457047,PDN
GA288,,2010,1960,,15999647,683153525,137557210,,15967220,682480199,137404974,,32427,673326,152236,PDN
GA288,,2011,1960,,15999647,683153525,137557210,,15999647,682906482,137513252,,0,247043,43958,PDN
GA288,,2012,1960,,15999647,683072247,137542748,,15999647,683072247,137542748,,0,0,0,PDN
GA288,,2013,1960,,15999647,683153525,137557210,,15999647,683153525,137557210,,0,0,0,PDN
GA288,,2014,1960,,15999647,683153525,137557210,,15999647,683153525,137557210,,0,0,0,PDN
GA288,,2015,1960,,15999647,683153525,137557210,,15999647,683153525,137557210,,0,0,0,PDN
GA288,,2016,1960,,15999647,683153525,137557210,,15999647,683153525,137557210,,0,0,0,PDN
GA288,,2017,1960,,15999647,683153525,137557210,,15999647,683153525,137557210,,0,0,0,PDN
GA288,,2017,1960,,15999647,683153525,137557210,,15999647,683153525,137557210,,0,0,0,PDN
GA291,,1990,1990,,59599,10802184,1981696,,263,49143,9007,,59336,10753041,1972689,PDN
GA291,,1991,1990,,49677,9113460,1671289,,11400,1233857,230948,,38277,7879603,1440341,PDN
GA291,,1992,1990,,57265,9425002,1734312,,18828,2049463,383501,,38437,7375539,1350811,PDN
GA291,,1993,1990,,43539,3096202,594465,,34551,2717429,518079,,8988,378773,76386,PDN
GA291,,1994,1990,,35551,2754966,525758,,35551,2754966,525758,,0,0,0,PDN
GA291,,1995,1990,,35551,2754966,525758,,35551,2754966,525758,,0,0,0,PDN
GA291,,1996,1990,,35551,2754966,525758,,35551,2754966,525758,,0,0,0,PDN
GA291,,1997,1990,,35551,2754966,525758,,35551,2754966,525758,,0,0,0,PDN
GA291,,1998,1990,,35551,2754966,525758,,35551,2754966,525758,,0,0,0,PDN
GA291,,1999,1990,,35551,2754966,525758,,35551,2754966,525758,,0,0,0,PDN
GA291,,2000,1990,,35551,2754966,525758,,35551,2754966,525758,,0,0,0,PDN
GA291,,2001,1990,,35551,2754966,525758,,35551,2754966,525758,,0,0,0,PDN
GA291,,2002,1990,,35551,2754966,525758,,35551,2754966,525758,,0,0,0,PDN
GA291,,2003,1990,,35551,2754966,525758,,35551,2754966,525758,,0,0,0,PDN
GA291,,2004,1990,,35551,2754966,525758,,35551,2754966,525758,,0,0,0,PDN
GA291,,2005,1990,,39817,3883988,730918,,35551,2754966,525758,,4266,1129022,205160,PDN
GA291,,2006,1990,,39817,3883988,730918,,37346,3149085,597681,,2471,734903,133237,PDN
GA291,,2007,1990,,38716,4675243,870610,,38716,4675243,870610,,0,0,0,PDN
GA291,,2008,1990,,38716,5087790,944017,,38716,5058643,938830,,0,29147,5187,PDN
GA291,,2009,1990,,38716,5141086,953501,,38716,5141086,953501,,0,0,0,PDN
GA291,,2010,1990,,38716,5141086,953501,,38716,5141086,953501,,0,0,0,PDN
GA291,,2011,1990,,38716,5141086,953501,,38716,5141086,953501,,0,0,0,PDN
GA291,,2012,1990,,38716,5141086,953501,,38716,5141086,953501,,0,0,0,PDN
GA291,,2013,1990,,38716,5141086,953501,,38716,5141086,953501,,0,0,0,PDN
GA291,,2014,1990,,38716,5141086,953501,,38716,5141086,953501,,0,0,0,PDN
GA291,,2015,1990,,38716,5141086,953501,,38716,5141086,953501,,0,0,0,PDN
GA291,,2016,1990,,38716,5141086,953501,,38716,5141086,953501,,0,0,0,PDN
GA291,,2017,1990,,38716,5141086,953501,,38716,5141086,953501,,0,0,0,PDN
GA291,,2017,1990,,38716,5141086,953501,,38716,5141086,953501,,0,0,0,PDN
GA301,,1996,1995,,433490,19986873,3989873,,43952,2018032,403032,,389538,17968841,3586841,PDN
GA301,,1997,1995,,616726,30510001,6045552,,261696,12749108,2530221,,355030,17760893,3515331,PDN
GA301,,1998,1995,,644634,32146142,6364588,,495914,24989369,4942421,,148720,7156773,1422167,PDN
GA301,,1999,1995,,837800,43908363,8650676,,626059,32040082,6327141,,211741,11868281,2323535,PDN
GA301,,2000,1995,,1237729,66303877,13035572,,729992,37873510,7469051,,507737,28430367,5566521,PDN
GA301,,2001,1995,,1248356,66303877,13046199,,771101,40196612,7923523,,477255,26107265,5122676,PDN
GA301,,2002,1995,,1248356,66303877,13046199,,802190,41967100,8269646,,446166,24336777,4776553,PDN
GA301,,2003,1995,,1248356,66303877,13046199,,824777,43312132,8531562,,423579,22991745,4514637,PDN
GA301,,2004,1995,,1267574,66303877,13065417,,844342,44382023,8741499,,423232,21921854,4323918,PDN
GA301,,2005,1995,,1267574,66303877,13065417,,853960,44949340,8852063,,413614,21354537,4213354,PDN
GA301,,2006,1995,,1267574,66303877,13065417,,861384,45384882,8936986,,406190,20918995,4128431,PDN
GA301,,2007,1995,,1267574,66303877,13065417,,864348,45545794,8968582,,403226,20758083,4096835,PDN
GA301,,2008,1995,,1267574,66303877,13065417,,868191,45904304,9036217,,399383,20399573,4029200,PDN
GA301,,2009,1995,,956387,50863657,10006859,,872855,46677528,9178464,,83532,4186129,828395,PDN
GA301,,2010,1995,,879563,47212480,9280360,,876544,46995953,9238813,,3019,216527,41547,PDN
GA301,,2011,1995,,879563,47212480,9280360,,879563,47189860,9276335,,0,22620,4024,PDN
GA301,,2012,1995,,879563,47212480,9280360,,879563,47212480,9280360,,0,0,0,PDN
GA301,,2013,1995,,879563,47212480,9280360,,879563,47212480,9280360,,0,0,0,PDN
GA301,,2014,1995,,879563,47212480,9280360,,879563,47212480,9280360,,0,0,0,PDN
GA301,,2015,1995,,879563,47212480,9280360,,879563,47212480,9280360,,0,0,0,PDN
GA301,,2016,1995,,879563,47212480,9280360,,879563,47212480,9280360,,0,0,0,PDN
GA301,,2017,1995,,879563,47212480,9280360,,879563,47212480,9280360,,0,0,0,PDN
GA301,,2017,1995,,879563,47212480,9280360,,879563,47212480,9280360,,0,0,0,PDN
GA303,,1987,1985,,30171,6637547,1211229,,5527,1337707,243553,,24644,5299840,967676,PDN
GA303,,1988,1985,,86565,22796740,4142924,,25514,7567003,1371956,,61051,15229737,2770968,PDN
GA303,,1989,1985,,45652,16328269,2951038,,31020,9943106,1800256,,14632,6385163,1150782,PDN
GA303,,1990,1985,,47362,19438416,3506155,,37010,13373793,2416688,,10352,6064623,1089467,PDN
GA303,,1991,1985,,47362,19438416,3506155,,41499,16259658,2934677,,5863,3178758,571478,PDN
GA303,,1992,1985,,50386,22279667,4014740,,44201,18450004,3327120,,6185,3829663,687620,PDN
GA303,,1993,1985,,50386,22279667,4014740,,45811,19940374,3593920,,4575,2339293,420820,PDN
GA303,,1994,1985,,50386,22279667,4014740,,47321,21659617,3901345,,3065,620050,113395,PDN
GA303,,1995,1985,,53203,27931500,5023221,,48355,22887996,4120952,,4848,5043504,902269,PDN
GA303,,1996,1985,,243568,179640722,32208109,,48934,23587936,4246076,,194634,156052786,27962033,PDN
GA303,,1997,1985,,194097,100682539,18109140,,74326,30554178,5511012,,119771,70128361,12598128,PDN
GA303,,1998,1985,,194121,97260273,17500219,,86294,35241983,6357109,,107827,62018290,11143110,PDN
GA303,,1999,1985,,99497,55311553,9941410,,89851,36233575,6537106,,9646,19077978,3404304,PDN
GA303,,2000,1985,,96945,57081435,10253784,,90648,36891167,6654913,,6297,20190268,3598871,PDN
GA303,,2001,1985,,107423,61273893,11010251,,92425,38374046,6920547,,14998,22899847,4089704,PDN
GA303,,2002,1985,,107410,61270264,11009592,,94127,40121038,7233102,,13283,21149226,3776490,PDN
GA303,,2003,1985,,106799,63483945,11402875,,95588,41275730,7440024,,11211,22208215,3962851,PDN
GA303,,2004,1985,,104007,61033026,10963976,,96359,42054107,7579296,,7648,18978919,3384680,PDN
GA303,,2005,1985,,104007,61033026,10963976,,98087,42902080,7731909,,5920,18130946,3232067,PDN
GA303,,2006,1985,,105454,62869577,11292211,,101424,43620046,7862998,,4030,19249531,3429213,PDN
GA303,,2007,1985,,116594,63068499,11338747,,107672,45057657,8125049,,8922,18010842,3213698,PDN
GA303,,2008,1985,,123370,53975359,9727526,,109725,46328907,8353303,,13645,7646452,1374223,PDN
GA303,,2009,1985,,120797,49859619,8992616,,114980,47901427,8638366,,5817,1958192,354249,PDN
GA303,,2010,1985,,120797,49859619,8992616,,119096,49369529,8903710,,1701,490090,88906,PDN
GA303,,2011,1985,,120797,49859619,8992616,,120797,49859619,8992616,,0,0,0,PDN
GA303,,2012,1985,,120797,49859619,8992616,,120797,49859619,8992616,,0,0,0,PDN
GA303,,2013,1985,,120797,49859619,8992616,,120797,49859619,8992616,,0,0,0,PDN
GA303,,2014,1985,,120797,49859619,8992616,,120797,49859619,8992616,,0,0,0,PDN
GA303,,2015,1985,,120797,49859619,8992616,,120797,49859619,8992616,,0,0,0,PDN
GA303,,2016,1985,,120797,49859619,8992616,,120797,49859619,8992616,,0,0,0,PDN
GA303,,2017,1985,,120797,49859619,8992616,,120797,49859619,8992616,,0,0,0,PDN
GA303,,2017,1985,,120797,49859619,8992616,,120797,49859619,8992616,,0,0,0,PDN
GA313,,1986,1984,,13416,2455085,450264,,0,0,0,,13416,2455085,450264,PDN
GA313,,1987,1984,,13416,2455085,450264,,0,0,0,,13416,2455085,450264,PDN
GA313,,1988,1984,,305454,14356353,2859965,,0,0,0,,305454,14356353,2859965,PDN
GA313,,1991,1984,,201624,11683501,2280539,,7960,461262,90035,,193664,11222239,2190504,PDN
GA313,,1992,1984,,201624,11683501,2280539,,103482,4499710,904142,,98142,7183791,1376397,PDN
GA313,,1993,1984,,267253,11683501,2346168,,249676,11086363,2222338,,17577,597138,123830,PDN
GA313,,1994,1984,,372098,16701230,3343847,,328797,14682309,2941307,,43301,2018921,402540,PDN
GA313,,1995,1984,,628379,28905414,5771691,,437099,20346688,4057506,,191280,8558726,1714185,PDN
GA313,,1996,1984,,627239,28852986,5761222,,468598,22062195,4394255,,158641,6790791,1366967,PDN
GA313,,1997,1984,,627239,28852986,5761222,,480381,22645601,4509847,,146858,6207385,1251375,PDN
GA313,,1998,1984,,484706,22833092,4547534,,484706,22833092,4547534,,0,0,0,PDN
GA313,,1999,1984,,484706,22833092,4547534,,484706,22833092,4547534,,0,0,0,PDN
GA313,,2000,1984,,484706,22833092,4547534,,484706,22833092,4547534,,0,0,0,PDN
GA313,,2001,1984,,484706,22833092,4547534,,484706,22833092,4547534,,0,0,0,PDN
GA313,,2002,1984,,484706,22833092,4547534,,484706,22833092,4547534,,0,0,0,PDN
GA313,,2003,1984,,484706,22833092,4547534,,484706,22833092,4547534,,0,0,0,PDN
GA313,,2004,1984,,484706,22833092,4547534,,484706,22833092,4547534,,0,0,0,PDN
GA313,,2005,1984,,484706,22833092,4547534,,484706,22833092,4547534,,0,0,0,PDN
GA313,,2006,1984,,484706,22833092,4547534,,484706,22833092,4547534,,0,0,0,PDN
GA313,,2007,1984,,484706,22833092,4547534,,484706,22833092,4547534,,0,0,0,PDN
GA313,,2008,1984,,484706,22833092,4547534,,484706,22833092,4547534,,0,0,0,PDN
GA313,,2009,1984,,484706,23290375,4628901,,484706,23290375,4628901,,0,0,0,PDN
GA313,,2010,1984,,484706,23290375,4628901,,484706,23290375,4628901,,0,0,0,PDN
GA313,,2011,1984,,484706,23290375,4628901,,484706,23290375,4628901,,0,0,0,PDN
GA313,,2012,1984,,484706,23290375,4628901,,484706,23290375,4628901,,0,0,0,PDN
GA313,,2013,1984,,484706,23290375,4628901,,484706,23290375,4628901,,0,0,0,PDN
GA313,,2014,1984,,484706,23290375,4628901,,484706,23290375,4628901,,0,0,0,PDN
GA313,,2015,1984,,484706,23290375,4628901,,484706,23290375,4628901,,0,0,0,PDN
GA313,,2016,1984,,484706,23290375,4628901,,484706,23290375,4628901,,0,0,0,PDN
GA313,,2017,1984,,484706,23290375,4628901,,484706,23290375,4628901,,0,0,0,PDN
GA313,,2017,1984,,484706,23290375,4628901,,484706,23290375,4628901,,0,0,0,PDN
GA319,,1990,1990,,261150,11576204,2320973,,5226,202492,41257,,255924,11373712,2279716,PDN
GA319,,1991,1990,,261150,11576204,2320973,,28670,1307301,261286,,232480,10268903,2059687,PDN
GA319,,1992,1990,,348525,11936929,2472534,,55696,2364339,476397,,292829,9572590,1996137,PDN
GA319,,1993,1990,,303949,8944004,1895409,,77751,3389346,680837,,226198,5554658,1214572,PDN
GA319,,1994,1990,,303949,8944004,1895409,,77751,3389346,680837,,226198,5554658,1214572,PDN
GA319,,1995,1990,,1061260,16364933,3973170,,102266,3900110,796236,,958994,12464823,3176934,PDN
GA319,,1996,1990,,1730848,16455289,4658835,,201578,7805921,1590532,,1529270,8649368,3068303,PDN
GA319,,1997,1990,,1748215,18229737,4991940,,229085,9459025,1912186,,1519130,8770712,3079754,PDN
GA319,,1998,1990,,1748215,18229737,4991940,,242356,10559477,2121266,,1505859,7670260,2870674,PDN
GA319,,1999,1990,,255653,12310614,2446154,,243307,10638731,2136320,,12346,1671883,309834,PDN
GA319,,2000,1990,,209354,8091568,1649135,,203534,7644268,1563724,,5820,447300,85411,PDN
GA319,,2001,1990,,203534,7644268,1563724,,203534,7644268,1563724,,0,0,0,PDN
GA319,,2002,1990,,203534,7644268,1563724,,203534,7644268,1563724,,0,0,0,PDN
GA319,,2003,1990,,203534,7644268,1563724,,203534,7644268,1563724,,0,0,0,PDN
GA319,,2004,1990,,203534,7644268,1563724,,203534,7644268,1563724,,0,0,0,PDN
GA319,,2005,1990,,208940,8667714,1751238,,203534,7644268,1563724,,5406,1023446,187514,PDN
GA319,,2006,1990,,261540,18625849,3575748,,210625,9111718,1831927,,50915,9514131,1743821,PDN
GA319,,2007,1990,,261540,18625849,3575748,,219168,11252669,2221422,,42372,7373180,1354326,PDN
GA319,,2008,1990,,261540,18625849,3575748,,229942,13473224,2627313,,31598,5152625,948435,PDN
GA319,,2009,1990,,245683,17103673,3289042,,241669,15836449,3059544,,4014,1267224,229499,PDN
GA319,,2010,1990,,245683,17103673,3289042,,245683,17087128,3286098,,0,16545,2944,PDN
GA319,,2011,1990,,245683,17103673,3289042,,245683,17103673,3289042,,0,0,0,PDN
GA319,,2012,1990,,245683,17103673,3289042,,245683,17103673,3289042,,0,0,0,PDN
GA319,,2013,1990,,245683,17103673,3289042,,245683,17103673,3289042,,0,0,0,PDN
GA319,,2014,1990,,245683,17103673,3289042,,245683,17103673,3289042,,0,0,0,PDN
GA319,,2015,1990,,245683,17103673,3289042,,245683,17103673,3289042,,0,0,0,PDN
GA319,,2016,1990,,245683,17103673,3289042,,245683,17103673,3289042,,0,0,0,PDN
GA319,,2017,1990,,245683,17103673,3289042,,245683,17103673,3289042,,0,0,0,PDN
GA319,,2017,1990,,245683,17103673,3289042,,245683,17103673,3289042,,0,0,0,PDN
GA320,,1987,1985,,2178628,124345224,24304113,,156395,8502018,1669210,,2022233,115843206,22634903,PDN
GA320,,1988,1985,,2178628,124345224,24304113,,271484,15657124,3057449,,1907144,108688100,21246664,PDN
GA320,,1989,1985,,1817392,109318235,21269035,,326961,20211017,3923227,,1490431,89107218,17345808,PDN
GA320,,1990,1985,,619078,44778421,8586769,,352668,22780771,4406186,,266410,21997650,4180583,PDN
GA320,,1991,1985,,387827,27170815,5222492,,361048,23741372,4585491,,26779,3429443,637001,PDN
GA320,,1992,1985,,387997,27248930,5236561,,364070,24105846,4653366,,23927,3143084,583195,PDN
GA320,,1993,1985,,372192,24892966,4801545,,365247,24251355,4680435,,6945,641611,121110,PDN
GA320,,1994,1985,,373329,24953662,4813482,,366227,24354432,4699756,,7102,599230,113726,PDN
GA320,,1995,1985,,375759,25201254,4859968,,367078,24459409,4719286,,8681,741845,140682,PDN
GA320,,1996,1985,,367310,24482169,4723568,,367310,24482169,4723568,,0,0,0,PDN
GA320,,1997,1985,,367310,24482169,4723568,,367310,24482169,4723568,,0,0,0,PDN
GA320,,1998,1985,,367310,24482169,4723568,,367310,24482169,4723568,,0,0,0,PDN
GA320,,1999,1985,,391662,27133059,5219609,,367310,24482169,4723568,,24352,2650890,496041,PDN
GA320,,2000,1985,,391662,27133059,5219609,,367310,24482169,4723568,,24352,2650890,496041,PDN
GA320,,2001,1985,,367310,24482169,4723568,,367310,24482169,4723568,,0,0,0,PDN
GA320,,2002,1985,,367310,24482169,4723568,,367310,24482169,4723568,,0,0,0,PDN
GA320,,2003,1985,,367310,24482169,4723568,,367310,24482169,4723568,,0,0,0,PDN
GA320,,2004,1985,,367310,24482169,4723568,,367310,24482169,4723568,,0,0,0,PDN
GA320,,2005,1985,,367310,24482169,4723568,,367310,24482169,4723568,,0,0,0,PDN
GA320,,2006,1985,,367310,24482169,4723568,,367310,24482169,4723568,,0,0,0,PDN
GA320,,2007,1985,,367310,24482169,4723568,,367310,24482169,4723568,,0,0,0,PDN
GA320,,2008,1985,,367310,24482169,4723568,,367310,24482169,4723568,,0,0,0,PDN
GA320,,2009,1985,,367310,24972479,4810811,,367310,24972479,4810811,,0,0,0,PDN
GA320,,2010,1985,,367310,24972479,4810811,,367310,24972479,4810811,,0,0,0,PDN
GA320,,2011,1985,,367310,24972479,4810811,,367310,24972479,4810811,,0,0,0,PDN
GA320,,2012,1985,,367310,24972479,4810811,,367310,24972479,4810811,,0,0,0,PDN
GA320,,2013,1985,,367310,24972479,4810811,,367310,24972479,4810811,,0,0,0,PDN
GA320,,2014,1985,,367310,24972479,4810811,,367310,24972479,4810811,,0,0,0,PDN
GA320,,2015,1985,,367310,24972479,4810811,,367310,24972479,4810811,,0,0,0,PDN
GA320,,2016,1985,,367310,24972479,4810811,,367310,24972479,4810811,,0,0,0,PDN
GA320,,2017,1985,,367310,24972479,4810811,,367310,24972479,4810811,,0,0,0,PDN
GA320,,2017,1985,,367310,24972479,4810811,,367310,24972479,4810811,,0,0,0,PDN
GA325,,2000,1994,,39967,3009373,575443,,39967,3009373,575443,,0,0,0,PDN
GA325,,2001,1994,,86699,6514354,1245837,,41232,3094700,591890,,45467,3419654,653947,PDN
GA325,,2002,1994,,86699,6514354,1245837,,48903,3865076,736639,,37796,2649278,509198,PDN
GA325,,2003,1994,,86699,6514354,1245837,,55416,4524368,860464,,31283,1989986,385373,PDN
GA325,,2004,1994,,86699,6514354,1245837,,59578,5251515,994011,,27121,1262839,251826,PDN
GA325,,2005,1994,,86699,6514354,1245837,,62259,5814781,1096918,,24440,699573,148919,PDN
GA325,,2006,1994,,86699,6514354,1245837,,63798,6251035,1176082,,22901,263319,69755,PDN
GA325,,2007,1994,,70680,7020072,1319803,,65550,6593798,1238824,,5130,426274,80979,PDN
GA325,,2008,1994,,73247,7749779,1452211,,67259,6778676,1273429,,5988,971103,178782,PDN
GA325,,2009,1994,,69823,7270750,1363551,,68740,7065771,1325995,,1083,204979,37556,PDN
GA325,,2010,1994,,69823,7270830,1363565,,69720,7250949,1359925,,103,19881,3641,PDN
GA325,,2011,1994,,69823,7270830,1363565,,69823,7270830,1363565,,0,0,0,PDN
GA325,,2012,1994,,69823,7270830,1363565,,69823,7270830,1363565,,0,0,0,PDN
GA325,,2013,1994,,69823,7270830,1363565,,69823,7270830,1363565,,0,0,0,PDN
GA325,,2014,1994,,69823,7270830,1363565,,69823,7270830,1363565,,0,0,0,PDN
GA325,,2015,1994,,69823,7270830,1363565,,69823,7270830,1363565,,0,0,0,PDN
GA325,,2016,1994,,69823,7270830,1363565,,69823,7270830,1363565,,0,0,0,PDN
GA325,,2017,1994,,69823,7270830,1363565,,69823,7270830,1363565,,0,0,0,PDN
GA325,,2017,1994,,69823,7270830,1363565,,69823,7270830,1363565,,0,0,0,PDN
GA330,,1993,1992,,274978,8769039,1835305,,8998,271341,57279,,265980,8497698,1778026,PDN
GA330,,1994,1992,,274978,8769039,1835305,,97979,2865496,607854,,176999,5903543,1227451,PDN
GA330,,1995,1992,,274296,8747291,1830753,,100611,3017323,637501,,173685,5729968,1193252,PDN
GA330,,1996,1992,,100611,3017323,637501,,100611,3017323,637501,,0,0,0,PDN
GA330,,1997,1992,,100611,3017323,637501,,100611,3017323,637501,,0,0,0,PDN
GA330,,1998,1992,,100611,3017323,637501,,100611,3017323,637501,,0,0,0,PDN
GA330,,1999,1992,,100611,3017323,637501,,100611,3017323,637501,,0,0,0,PDN
GA330,,2000,1992,,100611,3017323,637501,,100611,3017323,637501,,0,0,0,PDN
GA330,,2001,1992,,100611,3017323,637501,,100611,3017323,637501,,0,0,0,PDN
GA330,,2002,1992,,100611,3017323,637501,,100611,3017323,637501,,0,0,0,PDN
GA330,,2003,1992,,100611,3017323,637501,,100611,3017323,637501,,0,0,0,PDN
GA330,,2004,1992,,100611,3017323,637501,,100611,3017323,637501,,0,0,0,PDN
GA330,,2005,1992,,100611,3017323,637501,,100611,3017323,637501,,0,0,0,PDN
GA330,,2006,1992,,100611,3017323,637501,,100611,3017323,637501,,0,0,0,PDN
GA330,,2007,1992,,100611,3017323,637501,,100611,3017323,637501,,0,0,0,PDN
GA330,,2008,1992,,100611,3017323,637501,,100611,3017323,637501,,0,0,0,PDN
GA330,,2009,1992,,100611,3077752,648254,,100611,3077752,648254,,0,0,0,PDN
GA330,,2010,1992,,100611,3077752,648254,,100611,3077752,648254,,0,0,0,PDN
GA330,,2011,1992,,100611,3077752,648254,,100611,3077752,648254,,0,0,0,PDN
GA330,,2012,1992,,100611,3077752,648254,,100611,3077752,648254,,0,0,0,PDN
GA330,,2013,1992,,100611,3077752,648254,,100611,3077752,648254,,0,0,0,PDN
GA330,,2014,1992,,100611,3077752,648254,,100611,3077752,648254,,0,0,0,PDN
GA330,,2015,1992,,100611,3077752,648254,,100611,3077752,648254,,0,0,0,PDN
GA330,,2016,1992,,100611,3077752,648254,,100611,3077752,648254,,0,0,0,PDN
GA330,,2017,1992,,100611,3077752,648254,,100611,3077752,648254,,0,0,0,PDN
GA330,,2017,1992,,100611,3077752,648254,,100611,3077752,648254,,0,0,0,PDN
GA333,,1988,1988,,84784,3984819,793827,,0,0,0,,84784,3984819,793827,PDN
GA333,,1989,1988,,84784,3984819,793827,,0,0,0,,84784,3984819,793827,PDN
GA333,,1990,1988,,84784,3984819,793827,,0,0,0,,84784,3984819,793827,PDN
GA333,,1991,1988,,169785,15446766,2918320,,7360,667065,126055,,162425,14779701,2792265,PDN
GA333,,1992,1988,,164947,17448291,3269625,,18104,2491794,461484,,146843,14956497,2808141,PDN
GA333,,1993,1988,,164947,17448291,3269625,,24863,3816608,703975,,140084,13631683,2565650,PDN
GA333,,1994,1988,,164947,17448291,3269625,,47886,8282003,1521552,,117061,9166288,1748073,PDN
GA333,,1995,1988,,162212,16472496,3093261,,66549,10247199,1889894,,95663,6225297,1203367,PDN
GA333,,1996,1988,,184102,21499051,4009556,,85912,14369694,2642797,,98190,7129357,1366759,PDN
GA333,,1997,1988,,269555,28082383,5266420,,107693,16366867,3019947,,161862,11715516,2246473,PDN
GA333,,1998,1988,,269501,28078491,5265674,,118623,17616509,3253233,,150878,10461982,2012441,PDN
GA333,,1999,1988,,313879,34063768,6375048,,126723,18951780,3498926,,187156,15111988,2876122,PDN
GA333,,2000,1988,,219656,27326361,5081998,,127503,19786564,3648244,,92153,7539797,1433754,PDN
GA333,,2001,1988,,246915,29646949,5522173,,136510,21078085,3887059,,110405,8568864,1635114,PDN
GA333,,2002,1988,,249354,34382218,6367186,,141520,22504757,4145925,,107834,11877461,2221261,PDN
GA333,,2003,1988,,249354,34382218,6367186,,144408,23832006,4384978,,104946,10550212,1982208,PDN
GA333,,2004,1988,,196914,29496446,5445392,,145500,24299124,4469188,,51414,5197322,976204,PDN
GA333,,2005,1988,,196914,29496446,5445392,,146014,24503951,4506148,,50900,4992495,939244,PDN
GA333,,2006,1988,,203912,32043881,5905671,,148295,25183713,4629383,,55617,6860168,1276288,PDN
GA333,,2007,1988,,202757,31575745,5821217,,149672,25826847,4745196,,53085,5748898,1076021,PDN
GA333,,2008,1988,,151058,26564431,4877825,,150336,26227736,4817193,,722,336695,60632,PDN
GA333,,2009,1988,,151058,26904300,4938300,,150888,26819575,4923055,,170,84725,15246,PDN
GA333,,2010,1988,,151058,26904300,4938300,,151058,26904300,4938300,,0,0,0,PDN
GA333,,2011,1988,,151058,26904300,4938300,,151058,26904300,4938300,,0,0,0,PDN
GA333,,2012,1988,,151058,26904300,4938300,,151058,26904300,4938300,,0,0,0,PDN
GA333,,2013,1988,,151058,26904300,4938300,,151058,26904300,4938300,,0,0,0,PDN
GA333,,2014,1988,,151058,26904300,4938300,,151058,26904300,4938300,,0,0,0,PDN
GA333,,2015,1988,,151058,26904300,4938300,,151058,26904300,4938300,,0,0,0,PDN
GA333,,2016,1988,,151058,26904300,4938300,,151058,26904300,4938300,,0,0,0,PDN
GA333,,2017,1988,,151058,26904300,4938300,,151058,26904300,4938300,,0,0,0,PDN
GA333,,2017,1988,,151058,26904300,4938300,,151058,26904300,4938300,,0,0,0,PDN
GA343,,1988,1988,,748678,35936587,7143088,,0,0,0,,748678,35936587,7143088,PDN
GA343,,1989,1988,,291598,48022575,8836540,,198,30072,5549,,291400,47992503,8830991,PDN
GA343,,1990,1988,,538638,75035644,13890176,,172511,24261765,4489551,,366127,50773879,9400625,PDN
GA343,,1991,1988,,571782,79842214,14778582,,318478,50392002,9285026,,253304,29450212,5493556,PDN
GA343,,1992,1988,,774551,146910579,26915223,,423921,74730823,13721220,,350630,72179756,13194003,PDN
GA343,,1993,1988,,795170,149453813,27388375,,516358,95403947,17492149,,278812,54049866,9896226,PDN
GA343,,1994,1988,,804598,150948674,27663793,,592570,114382582,20945343,,212028,36566092,6718450,PDN
GA343,,1995,1988,,806875,151994943,27852239,,635626,127659869,23350905,,171249,24335074,4501334,PDN
GA343,,1996,1988,,804944,174269453,31813743,,679832,138946985,25403495,,125112,35322468,6410248,PDN
GA343,,1997,1988,,830048,176039101,32153731,,717041,148153912,27078947,,113007,27885189,5074784,PDN
GA343,,1998,1988,,887766,190080268,34709878,,751558,155887910,28489620,,136208,34192358,6220258,PDN
GA343,,1999,1988,,896012,191186833,34915021,,771064,161932099,29584605,,124948,29254734,5330416,PDN
GA343,,2000,1988,,891648,190952736,34869003,,782165,166213880,30357588,,109483,24738856,4511415,PDN
GA343,,2001,1988,,891649,190952736,34869004,,788415,169429409,30935997,,103234,21523327,3933007,PDN
GA343,,2002,1988,,837093,191506627,34913005,,791915,171773675,31356626,,45178,19732952,3556379,PDN
GA343,,2003,1988,,837093,191506627,34913005,,795439,173842428,31728255,,41654,17664199,3184750,PDN
GA343,,2004,1988,,836956,191469695,34906297,,798331,175578372,32040034,,38625,15891323,2866263,PDN
GA343,,2005,1988,,837353,191560882,34922919,,800193,176773000,32254463,,37160,14787882,2668456,PDN
GA343,,2006,1988,,837402,191562614,34923276,,801973,178009042,32476180,,35429,13553572,2447096,PDN
GA343,,2007,1988,,831762,188752108,34417546,,803870,179256419,32700030,,27892,9495689,1717516,PDN
GA343,,2008,1988,,831587,187855320,34257801,,805404,180143936,32859485,,26183,7711384,1398316,PDN
GA343,,2009,1988,,816049,187084526,34105112,,806538,183947720,33537450,,9511,3136806,567662,PDN
GA343,,2010,1988,,819268,187084526,34108331,,807222,184342651,33608407,,12046,2741875,499924,PDN
GA343,,2011,1988,,809030,184828967,33696748,,807614,184585348,33651983,,1416,243619,44765,PDN
GA343,,2012,1988,,809030,184828967,33696748,,808004,184812989,33692878,,1026,15978,3869,PDN
GA343,,2013,1988,,809030,184828967,33696748,,809030,184828967,33696748,,0,0,0,PDN
GA343,,2014,1988,,809030,184828967,33696748,,809030,184828967,33696748,,0,0,0,PDN
GA343,,2015,1988,,809030,184828967,33696748,,809030,184828967,33696748,,0,0,0,PDN
GA343,,2016,1988,,809030,184828967,33696748,,809030,184828967,33696748,,0,0,0,PDN
GA343,,2017,1988,,809030,184830475,33697016,,809030,184830475,33697016,,0,0,0,PDN
GA343,,2017,1988,,809030,184830475,33697016,,809030,184830475,33697016,,0,0,0,PDN
GA350,,1984,1969,,47149,4714938,886106,,0,0,0,,47149,4714938,886106,PDN
GA350,,1985,1969,,47149,4714938,886106,,0,0,0,,47149,4714938,886106,PDN
GA350,,1986,1969,,47149,4714938,886106,,0,0,0,,47149,4714938,886106,PDN
GA350,,1987,1969,,47149,4714938,886106,,0,0,0,,47149,4714938,886106,PDN
GA350,,1988,1969,,335246,19072828,3728988,,5072,565412,105679,,330174,18507416,3623309,PDN
GA350,,1989,1969,,294703,24171828,4595740,,27136,5000409,916888,,267567,19171419,3678852,PDN
GA350,,1990,1969,,150772,39516874,7182244,,52951,11993810,2187081,,97821,27523064,4995163,PDN
GA350,,1991,1969,,158503,44650615,8103452,,66211,18366079,3334197,,92292,26284536,4769255,PDN
GA350,,1992,1969,,142584,40571382,7361691,,76953,23364797,4234390,,65631,17206585,3127301,PDN
GA350,,1993,1969,,102175,33940574,6141423,,80350,25699811,4653270,,21825,8240763,1488153,PDN
GA350,,1994,1969,,109270,35429824,6413509,,88691,27628383,5004773,,20579,7801441,1408736,PDN
GA350,,1995,1969,,113116,35695971,6464712,,94534,29332349,5313813,,18582,6363622,1150899,PDN
GA350,,1996,1969,,116701,36501696,6611665,,99815,31470274,5699508,,16886,5031422,912157,PDN
GA350,,1997,1969,,105827,34372544,6221938,,101547,32285250,5846253,,4280,2087294,375685,PDN
GA350,,1998,1969,,101547,32285250,5846253,,101547,32285250,5846253,,0,0,0,PDN
GA350,,1999,1969,,101547,32285250,5846253,,101547,32285250,5846253,,0,0,0,PDN
GA350,,2000,1969,,101547,32285250,5846253,,101547,32285250,5846253,,0,0,0,PDN
GA350,,2001,1969,,101547,32285250,5846253,,101547,32285250,5846253,,0,0,0,PDN
GA350,,2002,1969,,101547,32285250,5846253,,101547,32285250,5846253,,0,0,0,PDN
GA350,,2003,1969,,101547,32285250,5846253,,101547,32285250,5846253,,0,0,0,PDN
GA350,,2004,1969,,101547,32285250,5846253,,101547,32285250,5846253,,0,0,0,PDN
GA350,,2005,1969,,101547,32285250,5846253,,101547,32285250,5846253,,0,0,0,PDN
GA350,,2006,1969,,114658,36052521,6529697,,101547,32285250,5846253,,13111,3767271,683444,PDN
GA350,,2007,1969,,114658,36052521,6529697,,105547,33613762,6086643,,9111,2438759,443054,PDN
GA350,,2008,1969,,177286,54231502,9827019,,116955,37417961,6774955,,60331,16813541,3052064,PDN
GA350,,2009,1969,,178810,55319682,10022170,,132202,42314212,7661421,,46608,13005470,2360749,PDN
GA350,,2010,1969,,202228,69090701,12495947,,146513,46215506,8369913,,55715,22875195,4126034,PDN
GA350,,2011,1969,,202228,69090701,12495947,,155603,49824777,9021222,,46625,19265924,3474725,PDN
GA350,,2012,1969,,202228,69090701,12495947,,169556,54138759,9802787,,32672,14951942,2693160,PDN
GA350,,2013,1969,,202228,69090701,12495947,,179452,58174784,10530837,,22776,10915917,1965110,PDN
GA350,,2014,1969,,202228,69090701,12495947,,190282,61305216,11098684,,11946,7785485,1397264,PDN
GA350,,2015,1969,,202228,69090701,12495947,,194816,63080672,11419135,,7412,6010029,1076812,PDN
GA350,,2016,1969,,196085,64048097,11592544,,196085,64048097,11592544,,0,0,0,PDN
GA350,,2017,1969,,196085,64048097,11592544,,196085,64048097,11592544,,0,0,0,PDN
GA350,,2017,1969,,196085,64048097,11592544,,196085,64048097,11592544,,0,0,0,PDN
GA351,,1988,1988,,844021,40513008,8052741,,679,178958,32522,,843342,40334050,8020219,PDN
GA351,,1989,1988,,844021,40513008,8052741,,8712,1753322,320691,,835309,38759686,7732050,PDN
GA351,,1990,1988,,844021,40513008,8052741,,13940,3086642,563165,,830081,37426366,7489576,PDN
GA351,,1991,1988,,58477,17586197,3187694,,14759,3447398,628175,,43718,14138799,2559519,PDN
GA351,,1992,1988,,58477,17586197,3187694,,17191,3890572,709464,,41286,13695625,2478230,PDN
GA351,,1993,1988,,65188,18256609,3313695,,17756,4232429,770857,,47432,14024180,2542838,PDN
GA351,,1994,1988,,19081,4876206,886733,,19081,4876206,886733,,0,0,0,PDN
GA351,,1995,1988,,19084,4876711,886826,,19084,4876711,886826,,0,0,0,PDN
GA351,,1996,1988,,19084,4876711,886826,,19084,4876711,886826,,0,0,0,PDN
GA351,,1997,1988,,19084,4876711,886826,,19084,4876711,886826,,0,0,0,PDN
GA351,,1998,1988,,19084,4876711,886826,,19084,4876711,886826,,0,0,0,PDN
GA351,,1999,1988,,19084,4876711,886826,,19084,4876711,886826,,0,0,0,PDN
GA351,,2000,1988,,19084,4876711,886826,,19084,4876711,886826,,0,0,0,PDN
GA351,,2001,1988,,19084,4876711,886826,,19084,4876711,886826,,0,0,0,PDN
GA351,,2002,1988,,19084,4876711,886826,,19084,4876711,886826,,0,0,0,PDN
GA351,,2003,1988,,19084,4876711,886826,,19084,4876711,886826,,0,0,0,PDN
GA351,,2004,1988,,19084,4876711,886826,,19084,4876711,886826,,0,0,0,PDN
GA351,,2005,1988,,19084,4876711,886826,,19084,4876711,886826,,0,0,0,PDN
GA351,,2006,1988,,19084,4876711,886826,,19084,4876711,886826,,0,0,0,PDN
GA351,,2007,1988,,19084,4876711,886826,,19084,4876711,886826,,0,0,0,PDN
GA351,,2008,1988,,19084,4876711,886826,,19084,4876711,886826,,0,0,0,PDN
GA351,,2009,1988,,19084,4974373,904204,,19084,4974373,904204,,0,0,0,PDN
GA351,,2010,1988,,19084,4974373,904204,,19084,4974373,904204,,0,0,0,PDN
GA351,,2011,1988,,19084,4974373,904204,,19084,4974373,904204,,0,0,0,PDN
GA351,,2012,1988,,19084,4974373,904204,,19084,4974373,904204,,0,0,0,PDN
GA351,,2013,1988,,19084,4974373,904204,,19084,4974373,904204,,0,0,0,PDN
GA351,,2014,1988,,19084,4974373,904204,,19084,4974373,904204,,0,0,0,PDN
GA351,,2015,1988,,19084,4974373,904204,,19084,4974373,904204,,0,0,0,PDN
GA351,,2016,1988,,19084,4974373,904204,,19084,4974373,904204,,0,0,0,PDN
GA351,,2017,1988,,19084,4974373,904204,,19084,4974373,904204,,0,0,0,PDN
GA351,,2017,1988,,19084,4974373,904204,,19084,4974373,904204,,0,0,0,PDN
GA352,,2001,2002,,113091,11309076,2125382,,0,0,0,,113091,11309076,2125382,PDN
GA352,,2002,2002,,113091,11309076,2125382,,4368,562065,104380,,108723,10747011,2021002,PDN
GA352,,2003,2002,,111576,11819862,2214754,,16881,2580188,475989,,94695,9239674,1738765,PDN
GA352,,2004,2002,,103697,11031811,2066653,,30952,5933418,1086720,,72745,5098393,979933,PDN
GA352,,2005,2002,,89547,10594126,1974623,,37635,8862525,1614597,,51912,1731601,360026,PDN
GA352,,2006,2002,,146592,16298539,3046688,,43258,11067020,2012479,,103334,5231519,1034209,PDN
GA352,,2007,2002,,134763,15531493,2898374,,48214,13131923,2384855,,86549,2399570,513519,PDN
GA352,,2008,2002,,61409,18773761,3401936,,50925,14515541,2633761,,10484,4258220,768175,PDN
GA352,,2009,2002,,56599,16013447,2905967,,52566,15187793,2755020,,4033,825654,150947,PDN
GA352,,2010,2002,,56599,16013447,2905967,,54240,15801059,2865816,,2359,212388,40150,PDN
GA352,,2011,2002,,56599,16013447,2905967,,56599,16013447,2905967,,0,0,0,PDN
GA352,,2012,2002,,56599,16013447,2905967,,56599,16013447,2905967,,0,0,0,PDN
GA352,,2013,2002,,56599,16013447,2905967,,56599,16013447,2905967,,0,0,0,PDN
GA352,,2014,2002,,56599,16013447,2905967,,56599,16013447,2905967,,0,0,0,PDN
GA352,,2015,2002,,56599,16013447,2905967,,56599,16013447,2905967,,0,0,0,PDN
GA352,,2016,2002,,56599,16013447,2905967,,56599,16013447,2905967,,0,0,0,PDN
GA352,,2017,2002,,56599,16013447,2905967,,56599,16013447,2905967,,0,0,0,PDN
GA352,,2017,2002,,56599,16013447,2905967,,56599,16013447,2905967,,0,0,0,PDN
GA355,,2006,2006,,30082,10462086,1891663,,1400,380927,69181,,28682,10081159,1822482,PDN
GA355,,2007,2006,,30082,10462086,1891663,,12062,4195034,758509,,18020,6267052,1133154,PDN
GA355,,2008,2006,,22109,11716797,2106948,,16125,6751667,1217489,,5984,4965130,889459,PDN
GA355,,2009,2006,,22109,11716797,2106948,,17748,8045429,1449319,,4361,3671368,657629,PDN
GA355,,2010,2006,,22109,11716797,2106948,,18469,8733432,1572460,,3640,2983365,534488,PDN
GA355,,2011,2006,,23683,12358168,2222645,,18778,9086837,1635653,,4905,3271331,586992,PDN
GA355,,2012,2006,,22360,10756046,1936247,,21876,10273985,1849987,,484,482061,86260,PDN
GA355,,2013,2006,,22360,10756046,1936247,,22356,10753171,1935732,,4,2875,516,PDN
GA355,,2014,2006,,22360,10753611,1935814,,22360,10753611,1935814,,0,0,0,PDN
GA355,,2015,2006,,22360,10753611,1935814,,22360,10753611,1935814,,0,0,0,PDN
GA355,,2016,2006,,22360,10753611,1935814,,22360,10753611,1935814,,0,0,0,PDN
GA355,,2017,2006,,22360,10754114,1935903,,22360,10754114,1935903,,0,0,0,PDN
GA355,,2017,2006,,22360,10754114,1935903,,22360,10754114,1935903,,0,0,0,PDN
GA357,,1995,1995,,3968,2940642,527214,,16,453863,80775,,3952,2486779,446439,PDN
GA357,,1996,1995,,1428,4025281,717670,,295,3085454,549308,,1133,939827,168362,PDN
GA357,,1997,1995,,820,3928315,699808,,309,3698971,658489,,511,229344,41319,PDN
GA357,,1998,1995,,323,3750173,667614,,323,3750173,667614,,0,0,0,PDN
GA357,,1999,1995,,323,3750173,667614,,323,3750173,667614,,0,0,0,PDN
GA357,,2000,1995,,323,3750173,667614,,323,3750173,667614,,0,0,0,PDN
GA357,,2001,1995,,323,3750173,667614,,323,3750173,667614,,0,0,0,PDN
GA357,,2002,1995,,323,3750173,667614,,323,3750173,667614,,0,0,0,PDN
GA357,,2003,1995,,323,3750173,667614,,323,3750173,667614,,0,0,0,PDN
GA357,,2004,1995,,323,3750173,667614,,323,3750173,667614,,0,0,0,PDN
GA357,,2005,1995,,323,3750173,667614,,323,3750173,667614,,0,0,0,PDN
GA357,,2006,1995,,323,3750173,667614,,323,3750173,667614,,0,0,0,PDN
GA357,,2007,1995,,323,3750173,667614,,323,3750173,667614,,0,0,0,PDN
GA357,,2008,1995,,323,3750173,667614,,323,3750173,667614,,0,0,0,PDN
GA357,,2009,1995,,323,3825278,680978,,323,3825278,680978,,0,0,0,PDN
GA357,,2010,1995,,323,3825278,680978,,323,3825278,680978,,0,0,0,PDN
GA357,,2011,1995,,323,3825278,680978,,323,3825278,680978,,0,0,0,PDN
GA357,,2012,1995,,323,3825278,680978,,323,3825278,680978,,0,0,0,PDN
GA357,,2013,1995,,323,3825278,680978,,323,3825278,680978,,0,0,0,PDN
GA357,,2014,1995,,323,3825278,680978,,323,3825278,680978,,0,0,0,PDN
GA357,,2015,1995,,323,3825278,680978,,323,3825278,680978,,0,0,0,PDN
GA357,,2016,1995,,323,3825278,680978,,323,3825278,680978,,0,0,0,PDN
GA357,,2017,1995,,323,3825278,680978,,323,3825278,680978,,0,0,0,PDN
GA357,,2017,1995,,323,3825278,680978,,323,3825278,680978,,0,0,0,PDN
GA379,,1990,1990,,350172,23255398,4488143,,32005,2220521,427115,,318167,21034877,4061028,PDN
GA379,,1991,1990,,475960,41596729,7877513,,144921,13533911,2553090,,331039,28062818,5324423,PDN
GA379,,1992,1990,,250658,36260257,6702661,,188874,23476048,4366107,,61784,12784209,2336554,PDN
GA379,,1993,1990,,234693,35376621,6529465,,196580,25530716,4739412,,38113,9845905,1790053,PDN
GA379,,1994,1990,,234693,35376621,6529465,,197071,25622408,4756218,,37622,9754213,1773247,PDN
GA379,,1995,1990,,203894,30794784,5683393,,201309,25921802,4813729,,2585,4872982,869664,PDN
GA379,,1996,1990,,231104,30794784,5710603,,215646,28088027,5213516,,15458,2706757,497087,PDN
GA379,,1997,1990,,231104,30794784,5710603,,216891,28767918,5335738,,14213,2026866,374865,PDN
GA379,,1998,1990,,231056,30787409,5709243,,217753,29059237,5388436,,13303,1728172,320807,PDN
GA379,,1999,1990,,219842,29754409,5514221,,218085,29172152,5408859,,1757,582257,105362,PDN
GA379,,2000,1990,,219823,29478942,5465186,,218463,29237765,5420912,,1360,241177,44274,PDN
GA379,,2001,1990,,219845,29482613,5465862,,218770,29304666,5433123,,1075,177947,32739,PDN
GA379,,2002,1990,,219845,29482613,5465862,,218980,29338926,5439429,,865,143687,26433,PDN
GA379,,2003,1990,,219845,29482613,5465862,,219014,29349365,5441321,,831,133248,24541,PDN
GA379,,2004,1990,,219845,29482613,5465862,,219094,29365232,5444224,,751,117381,21638,PDN
GA379,,2005,1990,,219094,29365232,5444224,,219094,29365232,5444224,,0,0,0,PDN
GA379,,2006,1990,,219094,29365232,5444224,,219094,29365232,5444224,,0,0,0,PDN
GA379,,2007,1990,,219094,29365232,5444224,,219094,29365232,5444224,,0,0,0,PDN
GA379,,2008,1990,,219094,29365232,5444224,,219094,29365232,5444224,,0,0,0,PDN
GA379,,2009,1990,,219094,29945705,5547512,,219094,29945705,5547512,,0,0,0,PDN
GA379,,2010,1990,,219094,29945705,5547512,,219094,29945705,5547512,,0,0,0,PDN
GA379,,2011,1990,,219094,29945705,5547512,,219094,29945705,5547512,,0,0,0,PDN
GA379,,2012,1990,,219094,29945705,5547512,,219094,29945705,5547512,,0,0,0,PDN
GA379,,2013,1990,,219094,29945705,5547512,,219094,29945705,5547512,,0,0,0,PDN
GA379,,2014,1990,,219094,29945705,5547512,,219094,29945705,5547512,,0,0,0,PDN
GA379,,2015,1990,,219094,29945705,5547512,,219094,29945705,5547512,,0,0,0,PDN
GA379,,2016,1990,,219094,29945705,5547512,,219094,29945705,5547512,,0,0,0,PDN
GA379,,2017,1990,,219094,29945705,5547512,,219094,29945705,5547512,,0,0,0,PDN
GA379,,2017,1990,,219094,29945705,5547512,,219094,29945705,5547512,,0,0,0,PDN
GA384,,1985,1982,,160,1601771,285173,,0,0,0,,160,1601771,285173,PDN
GA384,,1986,1982,,160,1601771,285173,,0,0,0,,160,1601771,285173,PDN
GA384,,1987,1982,,2617,4569926,815771,,1037,1415250,252861,,1580,3154676,562910,PDN
GA384,,1988,1982,,7404,16817978,2999927,,1592,3986071,710857,,5812,12831907,2289070,PDN
GA384,,1989,1982,,4794,12985414,2315366,,2493,5970447,1064850,,2301,7014967,1250516,PDN
GA384,,1990,1982,,4794,21538448,3837258,,2914,7647989,1363766,,1880,13890459,2473492,PDN
GA384,,1991,1982,,29106,23099386,4139317,,8013,10990592,1963634,,21093,12108794,2175683,PDN
GA384,,1992,1982,,29534,21304091,3820298,,12586,13813203,2470451,,16948,7490888,1349847,PDN
GA384,,1993,1982,,29534,21304091,3820298,,13039,14543212,2600799,,16495,6760879,1219499,PDN
GA384,,1994,1982,,29882,23330582,4181231,,13039,14831375,2652074,,16843,8499207,1529157,PDN
GA384,,1995,1982,,13039,14832565,2652285,,13039,14832565,2652285,,0,0,0,PDN
GA384,,1996,1982,,13039,14832565,2652285,,13039,14832565,2652285,,0,0,0,PDN
GA384,,1997,1982,,13039,14832565,2652285,,13039,14832565,2652285,,0,0,0,PDN
GA384,,1998,1982,,13039,14832565,2652285,,13039,14832565,2652285,,0,0,0,PDN
GA384,,1999,1982,,13039,14832565,2652285,,13039,14832565,2652285,,0,0,0,PDN
GA384,,2000,1982,,4655,11099252,1979611,,4655,11099252,1979611,,0,0,0,PDN
GA384,,2001,1982,,4655,11099559,1979665,,4655,11099559,1979665,,0,0,0,PDN
GA384,,2002,1982,,4655,11099559,1979665,,4655,11099559,1979665,,0,0,0,PDN
GA384,,2003,1982,,4655,11099559,1979665,,4655,11099559,1979665,,0,0,0,PDN
GA384,,2004,1982,,4655,11099559,1979665,,4655,11099559,1979665,,0,0,0,PDN
GA384,,2005,1982,,4655,11099559,1979665,,4655,11099559,1979665,,0,0,0,PDN
GA384,,2006,1982,,4655,11099559,1979665,,4655,11099559,1979665,,0,0,0,PDN
GA384,,2007,1982,,4655,11099559,1979665,,4655,11099559,1979665,,0,0,0,PDN
GA384,,2008,1982,,4655,11099559,1979665,,4655,11099559,1979665,,0,0,0,PDN
GA384,,2009,1982,,4655,11321859,2019221,,4655,11321859,2019221,,0,0,0,PDN
GA384,,2010,1982,,4655,11321859,2019221,,4655,11321859,2019221,,0,0,0,PDN
GA384,,2011,1982,,4655,11321859,2019221,,4655,11321859,2019221,,0,0,0,PDN
GA384,,2012,1982,,4655,11321859,2019221,,4655,11321859,2019221,,0,0,0,PDN
GA384,,2013,1982,,4655,11321859,2019221,,4655,11321859,2019221,,0,0,0,PDN
GA384,,2014,1982,,4655,11321859,2019221,,4655,11321859,2019221,,0,0,0,PDN
GA384,,2015,1982,,4655,11321859,2019221,,4655,11321859,2019221,,0,0,0,PDN
GA384,,2016,1982,,4655,11321859,2019221,,4655,11321859,2019221,,0,0,0,PDN
GA384,,2017,1982,,4655,11321859,2019221,,4655,11321859,2019221,,0,0,0,PDN
GA384,,2017,1982,,4655,11321859,2019221,,4655,11321859,2019221,,0,0,0,PDN
GA385,,1988,1987,,26175,2745657,514726,,31,20876,3746,,26144,2724781,510980,PDN
GA385,,1989,1987,,26175,2745657,514726,,2692,163143,31721,,23483,2582514,483005,PDN
GA385,,1990,1987,,2692,163143,31721,,2692,163143,31721,,0,0,0,PDN
GA385,,1991,1987,,2692,163143,31721,,2692,163143,31721,,0,0,0,PDN
GA385,,1992,1987,,2692,163143,31721,,2692,163143,31721,,0,0,0,PDN
GA385,,1993,1987,,2692,163143,31721,,2692,163143,31721,,0,0,0,PDN
GA385,,1994,1987,,2692,163143,31721,,2692,163143,31721,,0,0,0,PDN
GA385,,1995,1987,,2692,163143,31721,,2692,163143,31721,,0,0,0,PDN
GA385,,1996,1987,,2692,163143,31721,,2692,163143,31721,,0,0,0,PDN
GA385,,1997,1987,,2692,163143,31721,,2692,163143,31721,,0,0,0,PDN
GA385,,1998,1987,,2692,163143,31721,,2692,163143,31721,,0,0,0,PDN
GA385,,1999,1987,,2692,163143,31721,,2692,163143,31721,,0,0,0,PDN
GA385,,2000,1987,,2692,163143,31721,,2692,163143,31721,,0,0,0,PDN
GA385,,2001,1987,,2692,163143,31721,,2692,163143,31721,,0,0,0,PDN
GA385,,2002,1987,,2692,163143,31721,,2692,163143,31721,,0,0,0,PDN
GA385,,2003,1987,,2692,163143,31721,,2692,163143,31721,,0,0,0,PDN
GA385,,2004,1987,,2692,163143,31721,,2692,163143,31721,,0,0,0,PDN
GA385,,2005,1987,,2692,163143,31721,,2692,163143,31721,,0,0,0,PDN
GA385,,2006,1987,,2692,163143,31721,,2692,163143,31721,,0,0,0,PDN
GA385,,2007,1987,,2692,163143,31721,,2692,163143,31721,,0,0,0,PDN
GA385,,2008,1987,,2692,163143,31721,,2692,163143,31721,,0,0,0,PDN
GA385,,2009,1987,,2692,166410,32302,,2692,166410,32302,,0,0,0,PDN
GA385,,2010,1987,,2692,166410,32302,,2692,166410,32302,,0,0,0,PDN
GA385,,2011,1987,,2692,166410,32302,,2692,166410,32302,,0,0,0,PDN
GA385,,2012,1987,,2692,166410,32302,,2692,166410,32302,,0,0,0,PDN
GA385,,2013,1987,,2692,166410,32302,,2692,166410,32302,,0,0,0,PDN
GA385,,2014,1987,,2692,166410,32302,,2692,166410,32302,,0,0,0,PDN
GA385,,2015,1987,,2692,166410,32302,,2692,166410,32302,,0,0,0,PDN
GA385,,2016,1987,,2692,166410,32302,,2692,166410,32302,,0,0,0,PDN
GA385,,2017,1987,,2692,166410,32302,,2692,166410,32302,,0,0,0,PDN
GA385,,2017,1987,,2692,166410,32302,,2692,166410,32302,,0,0,0,PDN
GA389,,1985,1961,,257882,7950788,1672613,,7673,193753,42149,,250209,7757035,1630464,PDN
GA389,,1986,1961,,250785,8109890,1693826,,13147,886246,170842,,237638,7223644,1522984,PDN
GA389,,1987,1961,,188267,15711186,2983852,,46770,4951229,927772,,141497,10759957,2056080,PDN
GA389,,1988,1961,,206013,22778890,4259196,,76478,9526359,1771560,,129535,13252531,2487636,PDN
GA389,,1989,1961,,191701,23183522,4316883,,93700,12817296,2374358,,98001,10366226,1942525,PDN
GA389,,1990,1961,,176330,29961798,5507611,,107759,15281504,2826888,,68571,14680294,2680723,PDN
GA389,,1991,1961,,198680,30409479,5609619,,128219,18925778,3495795,,70461,11483701,2113824,PDN
GA389,,1992,1961,,137315,21804666,4017149,,133397,20402202,3763682,,3918,1402464,253467,PDN
GA389,,1993,1961,,136325,21143458,3898506,,133397,20402713,3763773,,2928,740745,134733,PDN
GA389,,1994,1961,,133397,20402713,3763773,,133397,20402713,3763773,,0,0,0,PDN
GA389,,1995,1961,,133397,20402713,3763773,,133397,20402713,3763773,,0,0,0,PDN
GA389,,1996,1961,,133397,20402713,3763773,,133397,20402713,3763773,,0,0,0,PDN
GA389,,1997,1961,,133397,20402713,3763773,,133397,20402713,3763773,,0,0,0,PDN
GA389,,1998,1961,,133397,20402713,3763773,,133397,20402713,3763773,,0,0,0,PDN
GA389,,1999,1961,,133397,20402713,3763773,,133397,20402713,3763773,,0,0,0,PDN
GA389,,2000,1961,,176597,24594878,4552910,,140127,20721360,3827202,,36470,3873518,725708,PDN
GA389,,2001,1961,,149469,22105257,4082789,,144840,21642274,3995778,,4629,462983,87011,PDN
GA389,,2002,1961,,178465,25440421,4705230,,152082,22460279,4148573,,26383,2980142,556657,PDN
GA389,,2003,1961,,3086269,35597840,9420404,,158240,23463431,4333228,,2928029,12134409,5087176,PDN
GA389,,2004,1961,,210646,44081860,8054393,,177395,33567634,6150284,,33251,10514226,1904109,PDN
GA389,,2005,1961,,210329,43814150,8006441,,184702,36909300,6752193,,25627,6904850,1254248,PDN
GA389,,2006,1961,,216205,44877005,8201437,,191147,39587040,7235104,,25058,5289965,966333,PDN
GA389,,2007,1961,,220293,46192321,8439567,,201020,42530290,7768687,,19273,3662031,670880,PDN
GA389,,2008,1961,,236222,53243907,9710227,,203197,43219468,7893494,,33025,10024439,1816733,PDN
GA389,,2009,1961,,257491,59374663,10822376,,212366,46192705,8431707,,45125,13181958,2390669,PDN
GA389,,2010,1961,,252215,57761248,10530016,,214176,47174677,8608246,,38039,10586571,1921770,PDN
GA389,,2011,1961,,252215,57761248,10530016,,219316,48702899,8885311,,32899,9058349,1644704,PDN
GA389,,2012,1961,,252215,57761248,10530016,,230251,51290235,9356626,,21964,6471013,1173389,PDN
GA389,,2013,1961,,252215,57761248,10530016,,236126,53261842,9713321,,16089,4499406,816695,PDN
GA389,,2014,1961,,253092,59075120,10764678,,241267,54880949,10006560,,11825,4194171,758118,PDN
GA389,,2015,1961,,241992,55194354,10063051,,241992,55194354,10063051,,0,0,0,PDN
GA389,,2016,1961,,241992,55194354,10063051,,241992,55194354,10063051,,0,0,0,PDN
GA389,,2017,1961,,241992,55194354,10063051,,241992,55194354,10063051,,0,0,0,PDN
GA389,,2017,1961,,241992,55194354,10063051,,241992,55194354,10063051,,0,0,0,PDN
GA391,,1981,1979,,0,47565600,8463630,,0,0,0,,0,47565600,8463630,PDN
GA391,,1982,1979,,0,47565600,8463630,,0,0,0,,0,47565600,8463630,PDN
GA391,,1983,1979,,331469,94077307,17071203,,34224,11435385,2068990,,297245,82641922,15002213,PDN
GA391,,1984,1979,,349010,73777911,13476752,,61602,27436593,4943558,,287408,46341318,8533194,PDN
GA391,,1985,1979,,353590,67213600,12313305,,69645,33257211,5987298,,283945,33956389,6326007,PDN
GA391,,1986,1979,,353687,81320983,14823613,,78487,41480624,7459381,,275200,39840359,7364232,PDN
GA391,,1987,1979,,356162,83687768,15247224,,84038,46860419,8422191,,272124,36827349,6825033,PDN
GA391,,1988,1979,,239778,85558085,15463637,,96378,52981217,9523641,,143400,32576868,5939996,PDN
GA391,,1989,1979,,174877,88314860,15889265,,102858,57087681,10260808,,72019,31227179,5628457,PDN
GA391,,1990,1979,,167334,90883932,16338852,,106378,60791779,10923421,,60956,30092153,5415431,PDN
GA391,,1991,1979,,151077,84248806,15141968,,111469,64240778,11542212,,39608,20008028,3599756,PDN
GA391,,1992,1979,,122954,75183013,13500714,,114974,66031210,11864300,,7980,9151803,1636414,PDN
GA391,,1993,1979,,138528,77119066,13860782,,117063,67555057,12137536,,21465,9564009,1723246,PDN
GA391,,1994,1979,,167352,77099733,13886166,,119351,68619793,12329279,,48001,8479940,1556887,PDN
GA391,,1995,1979,,151153,75451689,13576720,,122305,69596385,12506003,,28848,5855304,1070717,PDN
GA391,,1996,1979,,201197,84484275,15233986,,145725,74738118,13444323,,55472,9746157,1789663,PDN
GA391,,1997,1979,,202339,88647616,15975936,,163124,79959800,14390846,,39215,8687816,1585090,PDN
GA391,,1998,1979,,202296,89398067,16109425,,174417,83455511,15024152,,27879,5942556,1085273,PDN
GA391,,1999,1979,,223444,94845486,17099865,,179378,85179444,15335863,,44066,9666042,1764002,PDN
GA391,,2000,1979,,219486,95963426,17294829,,194210,90549752,16306266,,25276,5413674,988563,PDN
GA391,,2001,1979,,199046,91915729,16554158,,196946,91370840,16455103,,2100,544889,99055,PDN
GA391,,2002,1979,,199046,91915729,16554158,,199013,91902754,16551816,,33,12975,2342,PDN
GA391,,2003,1979,,199046,91915729,16554158,,199046,91915729,16554158,,0,0,0,PDN
GA391,,2004,1979,,199046,91915729,16554158,,199046,91915729,16554158,,0,0,0,PDN
GA391,,2005,1979,,199046,91915729,16554158,,199046,91915729,16554158,,0,0,0,PDN
GA391,,2006,1979,,199046,91915729,16554158,,199046,91915729,16554158,,0,0,0,PDN
GA391,,2007,1979,,199046,91915729,16554158,,199046,91915729,16554158,,0,0,0,PDN
GA391,,2008,1979,,199046,91915729,16554158,,199046,91915729,16554158,,0,0,0,PDN
GA391,,2009,1979,,199046,93641149,16861175,,199046,93641149,16861175,,0,0,0,PDN
GA391,,2010,1979,,199046,93641149,16861175,,199046,93641149,16861175,,0,0,0,PDN
GA391,,2011,1979,,199046,93641149,16861175,,199046,93641149,16861175,,0,0,0,PDN
GA391,,2012,1979,,199046,93641149,16861175,,199046,93641149,16861175,,0,0,0,PDN
GA391,,2013,1979,,199046,93641149,16861175,,199046,93641149,16861175,,0,0,0,PDN
GA391,,2014,1979,,199046,93641149,16861175,,199046,93641149,16861175,,0,0,0,PDN
GA391,,2015,1979,,199046,93641149,16861175,,199046,93641149,16861175,,0,0,0,PDN
GA391,,2016,1979,,199046,93641149,16861175,,199046,93641149,16861175,,0,0,0,PDN
GA391,,2017,1979,,199046,93641149,16861175,,199046,93641149,16861175,,0,0,0,PDN
GA391,,2017,1979,,199046,93641149,16861175,,199046,93641149,16861175,,0,0,0,PDN
GA395,,1995,1995,,103811,22012527,4020631,,0,0,0,,103811,22012527,4020631,PDN
GA395,,1996,1995,,7250,36048975,6421658,,1458,7880225,1403633,,5792,28168750,5018025,PDN
GA395,,1997,1995,,7158,36048975,6421566,,3119,20161077,3590499,,4039,15887898,2831067,PDN
GA395,,1998,1995,,7158,36048975,6421566,,4001,25884581,4609798,,3157,10164394,1811768,PDN
GA395,,1999,1995,,7158,36864800,6566731,,4495,29766763,5301072,,2663,7098037,1265659,PDN
GA395,,2000,1995,,7034,36864800,6566607,,4693,31660029,5638150,,2341,5204771,928457,PDN
GA395,,2001,1995,,4893,32175698,5730106,,4893,32175698,5730106,,0,0,0,PDN
GA395,,2002,1995,,4893,32175698,5730106,,4893,32175698,5730106,,0,0,0,PDN
GA395,,2003,1995,,4893,32175698,5730106,,4893,32175698,5730106,,0,0,0,PDN
GA395,,2004,1995,,4791,32175698,5730004,,4791,32175698,5730004,,0,0,0,PDN
GA395,,2005,1995,,4791,32175698,5730004,,4791,32175698,5730004,,0,0,0,PDN
GA395,,2006,1995,,4791,32175698,5730004,,4791,32175698,5730004,,0,0,0,PDN
GA395,,2007,1995,,4791,32175698,5730004,,4791,32175698,5730004,,0,0,0,PDN
GA395,,2008,1995,,4791,32175698,5730004,,4791,32175698,5730004,,0,0,0,PDN
GA395,,2009,1995,,4791,32663425,5816788,,4791,32663425,5816788,,0,0,0,PDN
GA395,,2010,1995,,4791,32663425,5816788,,4791,32663425,5816788,,0,0,0,PDN
GA395,,2011,1995,,4791,32663425,5816788,,4791,32663425,5816788,,0,0,0,PDN
GA395,,2012,1995,,4791,32663425,5816788,,4791,32663425,5816788,,0,0,0,PDN
GA395,,2013,1995,,4791,32663425,5816788,,4791,32663425,5816788,,0,0,0,PDN
GA395,,2014,1995,,4791,32663425,5816788,,4791,32663425,5816788,,0,0,0,PDN
GA395,,2015,1995,,4791,32663425,5816788,,4791,32663425,5816788,,0,0,0,PDN
GA395,,2016,1995,,4791,32663425,5816788,,4791,32663425,5816788,,0,0,0,PDN
GA395,,2017,1995,,4791,32663425,5816788,,4791,32663425,5816788,,0,0,0,PDN
GA395,,2017,1995,,4791,32663425,5816788,,4791,32663425,5816788,,0,0,0,PDN
GA418,,1991,1990,,6762,13973790,2493202,,405,1019706,181847,,6357,12954084,2311355,PDN
GA418,,1992,1990,,6762,13973790,2493202,,891,4540623,808831,,5871,9433167,1684371,PDN
GA418,,1993,1990,,6762,13973790,2493202,,4488,8651356,1543875,,2274,5322434,949327,PDN
GA418,,1994,1990,,6882,14406109,2570247,,4893,10293043,1836395,,1989,4113066,733852,PDN
GA418,,1995,1990,,6510,11529757,2058068,,5402,11197862,1997904,,1108,331895,60164,PDN
GA418,,1996,1990,,5648,11290627,2014656,,5648,11290627,2014656,,0,0,0,PDN
GA418,,1997,1990,,5648,11290627,2014656,,5648,11290627,2014656,,0,0,0,PDN
GA418,,1998,1990,,5648,11290627,2014656,,5648,11290627,2014656,,0,0,0,PDN
GA418,,1999,1990,,5648,11290627,2014656,,5648,11290627,2014656,,0,0,0,PDN
GA418,,2000,1990,,5648,11290627,2014656,,5648,11290627,2014656,,0,0,0,PDN
GA418,,2001,1990,,62986,17024453,3092248,,5732,12233571,2182524,,57254,4790882,909724,PDN
GA418,,2002,1990,,8141,17024453,3037403,,6298,14094255,2514173,,1843,2930198,523230,PDN
GA418,,2003,1990,,8141,17024453,3037403,,7119,15291979,2728112,,1022,1732474,309291,PDN
GA418,,2004,1990,,8141,17024453,3037403,,7119,15734621,2806874,,1022,1289832,230529,PDN
GA418,,2005,1990,,8141,17024453,3037403,,7119,15821989,2822420,,1022,1202464,214983,PDN
GA418,,2006,1990,,8141,17024453,3037403,,7119,15893685,2835177,,1022,1130768,202226,PDN
GA418,,2007,1990,,7130,16246314,2897933,,7130,16246314,2897933,,0,0,0,PDN
GA418,,2008,1990,,7164,16293554,2906373,,7164,16293554,2906373,,0,0,0,PDN
GA418,,2009,1990,,7164,16519670,2946608,,7164,16519670,2946608,,0,0,0,PDN
GA418,,2010,1990,,7164,16519670,2946608,,7164,16519670,2946608,,0,0,0,PDN
GA418,,2011,1990,,7164,16519670,2946608,,7164,16519670,2946608,,0,0,0,PDN
GA418,,2012,1990,,7164,16519670,2946608,,7164,16519670,2946608,,0,0,0,PDN
GA418,,2013,1990,,7164,16519670,2946608,,7164,16519670,2946608,,0,0,0,PDN
GA418,,2014,1990,,7164,16519670,2946608,,7164,16519670,2946608,,0,0,0,PDN
GA418,,2015,1990,,7164,16519670,2946608,,7164,16519670,2946608,,0,0,0,PDN
GA418,,2016,1990,,7164,16519670,2946608,,7164,16519670,2946608,,0,0,0,PDN
GA418,,2017,1990,,7164,16519670,2946608,,7164,16519670,2946608,,0,0,0,PDN
GA418,,2017,1990,,7164,16519670,2946608,,7164,16519670,2946608,,0,0,0,PDN
GA427,,1988,1988,,93943,4697138,929733,,0,0,0,,93943,4697138,929733,PDN
GA427,,1989,1988,,31791,6593991,1205099,,1200,588171,105857,,30591,6005820,1099242,PDN
GA427,,1990,1988,,15982,6593991,1189290,,2510,1370157,246310,,13472,5223834,942980,PDN
GA427,,1991,1988,,16124,6593991,1189432,,2899,1695978,304674,,13225,4898013,884758,PDN
GA427,,1992,1988,,7310,3809354,685131,,3178,1941833,348700,,4132,1867521,336431,PDN
GA427,,1993,1988,,3434,2316325,415591,,3434,2316325,415591,,0,0,0,PDN
GA427,,1994,1988,,3434,2316325,415591,,3434,2316325,415591,,0,0,0,PDN
GA427,,1995,1988,,3434,2316325,415591,,3434,2316325,415591,,0,0,0,PDN
GA427,,1996,1988,,3434,2316325,415591,,3434,2316325,415591,,0,0,0,PDN
GA427,,1997,1988,,3434,2316325,415591,,3434,2316325,415591,,0,0,0,PDN
GA427,,1998,1988,,3434,2316325,415591,,3434,2316325,415591,,0,0,0,PDN
GA427,,1999,1988,,3434,2316325,415591,,3434,2316325,415591,,0,0,0,PDN
GA427,,2000,1988,,3434,2316325,415591,,3434,2316325,415591,,0,0,0,PDN
GA427,,2001,1988,,3434,2316325,415591,,3434,2316325,415591,,0,0,0,PDN
GA427,,2002,1988,,3434,2316325,415591,,3434,2316325,415591,,0,0,0,PDN
GA427,,2003,1988,,3434,2316325,415591,,3434,2316325,415591,,0,0,0,PDN
GA427,,2004,1988,,3434,2316325,415591,,3434,2316325,415591,,0,0,0,PDN
GA427,,2005,1988,,3434,2316325,415591,,3434,2316325,415591,,0,0,0,PDN
GA427,,2006,1988,,3434,2316325,415591,,3434,2316325,415591,,0,0,0,PDN
GA427,,2007,1988,,3434,2316325,415591,,3434,2316325,415591,,0,0,0,PDN
GA427,,2008,1988,,3434,2316325,415591,,3434,2316325,415591,,0,0,0,PDN
GA427,,2009,1988,,3434,2362713,423846,,3434,2362713,423846,,0,0,0,PDN
GA427,,2010,1988,,3434,2362713,423846,,3434,2362713,423846,,0,0,0,PDN
GA427,,2011,1988,,3434,2362713,423846,,3434,2362713,423846,,0,0,0,PDN
GA427,,2012,1988,,3434,2362713,423846,,3434,2362713,423846,,0,0,0,PDN
GA427,,2013,1988,,3434,2362713,423846,,3434,2362713,423846,,0,0,0,PDN
GA427,,2014,1988,,3434,2362713,423846,,3434,2362713,423846,,0,0,0,PDN
GA427,,2015,1988,,3434,2362713,423846,,3434,2362713,423846,,0,0,0,PDN
GA427,,2016,1988,,3434,2362713,423846,,3434,2362713,423846,,0,0,0,PDN
GA427,,2017,1988,,3434,2362713,423846,,3434,2362713,423846,,0,0,0,PDN
GA427,,2017,1988,,3434,2362713,423846,,3434,2362713,423846,,0,0,0,PDN
GA460,,1990,1987,,29284,4571213,842667,,0,0,0,,29284,4571213,842667,PDN
GA460,,1991,1987,,24852,4880250,893224,,1683,463657,84184,,23169,4416593,809040,PDN
GA460,,1992,1987,,39511,7349742,1347294,,8416,1833870,334727,,31095,5515872,1012567,PDN
GA460,,1993,1987,,33301,7366194,1344012,,13135,2990512,545255,,20166,4375682,798757,PDN
GA460,,1994,1987,,15286,3642790,663469,,15286,3642790,663469,,0,0,0,PDN
GA460,,1995,1987,,15286,3642790,663469,,15286,3642790,663469,,0,0,0,PDN
GA460,,1996,1987,,15286,3642790,663469,,15286,3642790,663469,,0,0,0,PDN
GA460,,1997,1987,,15286,3642790,663469,,15286,3642790,663469,,0,0,0,PDN
GA460,,1998,1987,,15286,3642790,663469,,15286,3642790,663469,,0,0,0,PDN
GA460,,1999,1987,,15286,3642790,663469,,15286,3642790,663469,,0,0,0,PDN
GA460,,2000,1987,,15286,3642790,663469,,15286,3642790,663469,,0,0,0,PDN
GA460,,2001,1987,,15286,3642790,663469,,15286,3642790,663469,,0,0,0,PDN
GA460,,2002,1987,,15286,3642790,663469,,15286,3642790,663469,,0,0,0,PDN
GA460,,2003,1987,,15286,3642790,663469,,15286,3642790,663469,,0,0,0,PDN
GA460,,2004,1987,,15286,3642790,663469,,15286,3642790,663469,,0,0,0,PDN
GA460,,2005,1987,,15286,3642790,663469,,15286,3642790,663469,,0,0,0,PDN
GA460,,2006,1987,,15286,3642790,663469,,15286,3642790,663469,,0,0,0,PDN
GA460,,2007,1987,,15286,3642790,663469,,15286,3642790,663469,,0,0,0,PDN
GA460,,2008,1987,,15286,3642790,663469,,15286,3642790,663469,,0,0,0,PDN
GA460,,2009,1987,,15286,3715743,676451,,15286,3715743,676451,,0,0,0,PDN
GA460,,2010,1987,,15286,3715743,676451,,15286,3715743,676451,,0,0,0,PDN
GA460,,2011,1987,,15286,3715743,676451,,15286,3715743,676451,,0,0,0,PDN
GA460,,2012,1987,,15286,3715743,676451,,15286,3715743,676451,,0,0,0,PDN
GA460,,2013,1987,,15286,3715743,676451,,15286,3715743,676451,,0,0,0,PDN
GA460,,2014,1987,,15286,3715743,676451,,15286,3715743,676451,,0,0,0,PDN
GA460,,2015,1987,,15286,3715743,676451,,15286,3715743,676451,,0,0,0,PDN
GA460,,2016,1987,,15286,3715743,676451,,15286,3715743,676451,,0,0,0,PDN
GA460,,2017,1987,,15286,3715743,676451,,15286,3715743,676451,,0,0,0,PDN
GA460,,2017,1987,,15286,3715743,676451,,15286,3715743,676451,,0,0,0,PDN
GA465,,1987,1984,,1543,15425543,2746302,,56,1443174,256849,,1487,13982369,2489453,PDN
GA465,,1988,1984,,1543,15425543,2746302,,86,1905836,339203,,1457,13519707,2407099,PDN
GA465,,1989,1984,,621,3823550,680968,,275,2869293,510825,,346,954257,170143,PDN
GA465,,1990,1984,,413,5860220,1043157,,294,3743475,666393,,119,2116745,376764,PDN
GA465,,1991,1984,,413,6293549,1120262,,294,3984705,709316,,119,2308844,410946,PDN
GA465,,1992,1984,,610,5672845,1010013,,294,4246825,755957,,316,1426020,254056,PDN
GA465,,1993,1984,,294,4395689,782445,,294,4395689,782445,,0,0,0,PDN
GA465,,1994,1984,,294,4395689,782445,,294,4395689,782445,,0,0,0,PDN
GA465,,1995,1984,,294,4395689,782445,,294,4395689,782445,,0,0,0,PDN
GA465,,1996,1984,,294,4395689,782445,,294,4395689,782445,,0,0,0,PDN
GA465,,1997,1984,,294,4395689,782445,,294,4395689,782445,,0,0,0,PDN
GA465,,1998,1984,,294,4395689,782445,,294,4395689,782445,,0,0,0,PDN
GA465,,1999,1984,,294,4395689,782445,,294,4395689,782445,,0,0,0,PDN
GA465,,2000,1984,,294,4395689,782445,,294,4395689,782445,,0,0,0,PDN
GA465,,2001,1984,,294,4395689,782445,,294,4395689,782445,,0,0,0,PDN
GA465,,2002,1984,,294,4395689,782445,,294,4395689,782445,,0,0,0,PDN
GA465,,2003,1984,,294,4395689,782445,,294,4395689,782445,,0,0,0,PDN
GA465,,2004,1984,,294,4395689,782445,,294,4395689,782445,,0,0,0,PDN
GA465,,2005,1984,,294,4395689,782445,,294,4395689,782445,,0,0,0,PDN
GA465,,2006,1984,,294,4395689,782445,,294,4395689,782445,,0,0,0,PDN
GA465,,2007,1984,,294,4395689,782445,,294,4395689,782445,,0,0,0,PDN
GA465,,2008,1984,,294,4395689,782445,,294,4395689,782445,,0,0,0,PDN
GA465,,2009,1984,,294,4483727,798111,,294,4483727,798111,,0,0,0,PDN
GA465,,2010,1984,,294,4483727,798111,,294,4483727,798111,,0,0,0,PDN
GA465,,2011,1984,,294,4483727,798111,,294,4483727,798111,,0,0,0,PDN
GA465,,2012,1984,,294,4483727,798111,,294,4483727,798111,,0,0,0,PDN
GA465,,2013,1984,,294,4483727,798111,,294,4483727,798111,,0,0,0,PDN
GA465,,2014,1984,,294,4483727,798111,,294,4483727,798111,,0,0,0,PDN
GA465,,2015,1984,,294,4483727,798111,,294,4483727,798111,,0,0,0,PDN
GA465,,2016,1984,,294,4483727,798111,,294,4483727,798111,,0,0,0,PDN
GA465,,2017,1984,,294,4483727,798111,,294,4483727,798111,,0,0,0,PDN
GA465,,2017,1984,,294,4483727,798111,,294,4483727,798111,,0,0,0,PDN
GB065,,1995,1974,,65874,122298622,21827195,,0,0,0,,65874,122298622,21827195,PDN
GB065,,1996,1974,,65838,122229810,21814915,,0,0,0,,65838,122229810,21814915,PDN
GB065,,1997,1974,,159874,99149913,17802207,,0,0,0,,159874,99149913,17802207,PDN
GB065,,1998,1974,,164480,101781955,18275148,,32235,18680146,3356104,,132245,83101809,14919044,PDN
GB065,,1999,1974,,146532,119680721,21442034,,77042,52559620,9429288,,69490,67121101,12012746,PDN
GB065,,2000,1974,,174562,162127242,29022825,,106092,80700546,14465620,,68470,81426696,14557205,PDN
GB065,,2001,1974,,168815,183727817,32860597,,122573,103111515,18469818,,46242,80616302,14390779,PDN
GB065,,2002,1974,,168663,183578037,32833794,,136500,122778707,21983245,,32163,60799330,10850549,PDN
GB065,,2003,1974,,170972,198986132,35577757,,141528,135754107,24297063,,29444,63232025,11280694,PDN
GB065,,2004,1974,,174218,210153907,37568151,,146372,153055388,27380427,,27846,57098519,10187724,PDN
GB065,,2005,1974,,174218,210153907,37568151,,148504,160605812,28726051,,25714,49548095,8842100,PDN
GB065,,2006,1974,,174101,206489639,36916030,,149163,163897527,29312424,,24938,42592112,7603606,PDN
GB065,,2007,1974,,155588,179699610,32130608,,150857,168371733,30110240,,4731,11327877,2020368,PDN
GB065,,2008,1974,,156337,177871006,31805982,,153121,173454915,31016985,,3216,4416091,788997,PDN
GB065,,2009,1974,,154253,175619244,31403228,,154253,175165515,31322494,,0,453729,80735,PDN
GB065,,2010,1974,,154253,175619244,31403228,,154253,175549074,31390743,,0,70170,12486,PDN
GB065,,2011,1974,,154253,175619244,31403228,,154253,175619244,31403228,,0,0,0,PDN
GB065,,2012,1974,,154253,175619244,31403228,,154253,175619244,31403228,,0,0,0,PDN
GB065,,2013,1974,,154253,175619244,31403228,,154253,175619244,31403228,,0,0,0,PDN
GB065,,2014,1974,,154253,175619244,31403228,,154253,175619244,31403228,,0,0,0,PDN
GB065,,2015,1974,,154253,175619244,31403228,,154253,175619244,31403228,,0,0,0,PDN
GB065,,2016,1974,,154253,175619244,31403228,,154253,175619244,31403228,,0,0,0,PDN
GB065,,2017,1974,,154253,175619244,31403228,,154253,175619244,31403228,,0,0,0,PDN
GB065,,2017,1974,,154253,175619244,31403228,,154253,175619244,31403228,,0,0,0,PDN
GB070,,1993,1990,,4600,46004970,8190538,,0,0,0,,4600,46004970,8190538,PDN
GB070,,1994,1990,,4600,46004970,8190538,,0,0,0,,4600,46004970,8190538,PDN
GB070,,1995,1990,,78876,186233357,33216484,,6311,7168368,1281821,,72565,179064989,31934663,PDN
GB070,,1996,1990,,172121,186100845,33286150,,27004,24373295,4363889,,145117,161727550,28922261,PDN
GB070,,1997,1990,,206662,67492838,12216064,,32747,31003460,5549377,,173915,36489378,6666687,PDN
GB070,,1998,1990,,214408,68979316,12488308,,42614,36573864,6550419,,171794,32405452,5937889,PDN
GB070,,1999,1990,,158276,62279789,11240089,,42653,38767703,6940821,,115623,23512086,4299268,PDN
GB070,,2000,1990,,42869,39673153,7102149,,42743,39145634,7008158,,126,527519,93991,PDN
GB070,,2001,1990,,42743,39245092,7025855,,42743,39245092,7025855,,0,0,0,PDN
GB070,,2002,1990,,42743,39245092,7025855,,42743,39245092,7025855,,0,0,0,PDN
GB070,,2003,1990,,42743,39245092,7025855,,42743,39245092,7025855,,0,0,0,PDN
GB070,,2004,1990,,42743,39245092,7025855,,42743,39245092,7025855,,0,0,0,PDN
GB070,,2005,1990,,42743,39245092,7025855,,42743,39245092,7025855,,0,0,0,PDN
GB070,,2006,1990,,42743,39245092,7025855,,42743,39245092,7025855,,0,0,0,PDN
GB070,,2007,1990,,42743,39245092,7025855,,42743,39245092,7025855,,0,0,0,PDN
GB070,,2008,1990,,42743,39245092,7025855,,42743,39245092,7025855,,0,0,0,PDN
GB070,,2009,1990,,42743,39956117,7152373,,42743,39956117,7152373,,0,0,0,PDN
GB070,,2010,1990,,42743,39956117,7152373,,42743,39956117,7152373,,0,0,0,PDN
GB070,,2011,1990,,42743,39956117,7152373,,42743,39956117,7152373,,0,0,0,PDN
GB070,,2012,1990,,42743,39956117,7152373,,42743,39956117,7152373,,0,0,0,PDN
GB070,,2013,1990,,42743,39956117,7152373,,42743,39956117,7152373,,0,0,0,PDN
GB070,,2014,1990,,42743,39956117,7152373,,42743,39956117,7152373,,0,0,0,PDN
GB070,,2015,1990,,42743,39956117,7152373,,42743,39956117,7152373,,0,0,0,PDN
GB070,,2016,1990,,42743,39956117,7152373,,42743,39956117,7152373,,0,0,0,PDN
GB070,,2017,1990,,42743,39956117,7152373,,42743,39956117,7152373,,0,0,0,PDN
GB070,,2017,1990,,42743,39956117,7152373,,42743,39956117,7152373,,0,0,0,PDN
GB072,,1996,1986,,7160197,29909404,12482155,,621022,1629294,910932,,6539175,28280110,11571223,PDP
GB072,,1997,1986,,4537775,27470688,9425798,,1566662,5478578,2541498,,2971113,21992110,6884300,PDP
GB072,,1998,1986,,4537775,27470688,9425798,,2245854,8011939,3671466,,2291921,19458749,5754332,PDP
GB072,,1999,1986,,5142600,20019448,8704779,,2739306,9461792,4422899,,2403294,10557656,4281880,PDP
GB072,,2000,1986,,5703952,35430179,12008254,,3091764,17492614,6204329,,2612188,17937565,5803925,PDP
GB072,,2001,1986,,9887352,36795383,16434574,,3456800,21720916,7321732,,6430552,15074467,9112842,PDP
GB072,,2002,1986,,9887352,36795383,16434574,,5200567,26377886,9894141,,4686785,10417497,6540433,PDP
GB072,,2003,1986,,9894275,36993539,16476756,,6824474,29790322,12125243,,3069801,7203217,4351513,PDP
GB072,,2004,1986,,12453111,39258628,19438632,,8140563,32111415,13854338,,4312548,7147213,5584294,PDP
GB072,,2005,1986,,12532873,39471212,19556221,,9069791,33687737,15064050,,3463082,5783475,4492171,PDP
GB072,,2006,1986,,13451970,41855812,20899624,,9739251,34664485,15907309,,3712719,7191327,4992315,PDP
GB072,,2007,1986,,12121482,38802689,19025875,,10561158,36532019,17061517,,1560324,2270670,1964358,PDP
GB072,,2008,1986,,12985640,40784382,20242647,,11023003,37244105,17650068,,1962637,3540277,2592579,PDP
GB072,,2009,1986,,12988452,41090906,20300001,,11152534,37676075,17856462,,1835918,3414831,2443538,PDP
GB072,,2010,1986,,12988452,41090906,20300001,,11333191,38006363,18095890,,1655261,3084543,2204112,PDP
GB072,,2011,1986,,12988452,41090906,20300001,,11597979,38393547,18429569,,1390473,2697359,1870431,PDP
GB072,,2012,1986,,13173937,40380492,20359079,,11891473,38764887,18789142,,1282464,1615605,1569938,PDP
GB072,,2013,1986,,13173937,40380492,20359079,,12230413,39148825,19196397,,943524,1231667,1162682,PDP
GB072,,2014,1986,,13173937,40380492,20359079,,12530576,39421219,19545028,,643361,959273,814050,PDP
GB072,,2015,1986,,13424274,40504195,20631427,,12890562,39620902,19940545,,533712,883293,690881,PDP
GB072,,2016,1986,,13554673,40362687,20736647,,13266043,39833800,20353910,,288630,528887,382738,PDP
GB072,,2017,1986,,14152281,40487638,21356489,,13609696,40008138,20728582,,542585,479500,627905,PDP
GB072,,2017,1986,,14152281,40487638,21356489,,13609696,40008138,20728582,,542585,479500,627905,PDP
GB083,,1994,1988,,15932829,30819800,21416779,,0,0,0,,15932829,30819800,21416779,PDP
GB083,,1995,1988,,24606744,219276925,63623990,,0,0,0,,24606744,219276925,63623990,PDP
GB083,,1996,1988,,23955533,218335615,62805287,,0,0,0,,23955533,218335615,62805287,PDP
GB083,,1997,1988,,23956152,202476950,59984079,,67383,48761,76059,,23888769,202428189,59908020,PDP
GB083,,1998,1988,,27719520,203942636,64008245,,714288,7045902,1968007,,27005232,196896734,62040238,PDP
GB083,,1999,1988,,16662135,195950452,51528763,,2198902,34049177,8257474,,14463233,161901275,43271289,PDP
GB083,,2000,1988,,16864416,210008815,54232533,,3125594,51753889,12334471,,13738822,158254926,41898062,PDP
GB083,,2001,1988,,14378642,198589707,49714889,,3785061,66417784,15603172,,10593581,132171923,34111717,PDP
GB083,,2002,1988,,14378203,198567820,49710555,,4436718,80477079,18756483,,9941485,118090741,30954072,PDP
GB083,,2003,1988,,14378203,198567820,49710555,,5144296,94032720,21876097,,9233907,104535100,27834458,PDP
GB083,,2004,1988,,14495993,200286383,50134140,,5723738,105452271,24487487,,8772255,94834112,25646653,PDP
GB083,,2005,1988,,15078082,210133040,52468302,,6180638,113306741,26341980,,8897444,96826299,26126322,PDP
GB083,,2006,1988,,15078082,210133040,52468302,,6594349,120616913,28056433,,8483733,89516127,24411869,PDP
GB083,,2007,1988,,7368156,133443232,31112503,,6962083,126855955,29534317,,406073,6587277,1578186,PDP
GB083,,2008,1988,,7676768,136966015,32047945,,7080299,128787017,29996138,,596469,8178998,2051807,PDP
GB083,,2009,1988,,7734877,136261876,31980763,,7152386,130147251,30310259,,582491,6114625,1670503,PDP
GB083,,2010,1988,,7734877,136261876,31980763,,7233791,131062411,30554505,,501086,5199465,1426257,PDP
GB083,,2011,1988,,7734877,136261876,31980763,,7366991,132198895,30889927,,367886,4062981,1090836,PDP
GB083,,2012,1988,,7734877,136261876,31980763,,7464411,133190769,31163836,,270466,3071107,816926,PDP
GB083,,2013,1988,,7734877,136261876,31980763,,7542333,133711699,31334450,,192544,2550177,646312,PDP
GB083,,2014,1988,,7885667,136383427,32153181,,7660290,134340413,31564278,,225377,2043014,588902,PDP
GB083,,2015,1988,,7996646,136383427,32264160,,7763463,134889524,31765157,,233183,1493903,499002,PDP
GB083,,2016,1988,,7976948,136641007,32290295,,7815672,135424193,31912503,,161276,1216814,377791,PDP
GB083,,2017,1988,,7978077,137072126,32368134,,7839928,135647186,31976437,,138149,1424940,391698,PDP
GB083,,2017,1988,,7978077,137072126,32368134,,7839928,135647186,31976437,,138149,1424940,391698,PDP
GB108,,1999,1999,,239767,23976620,4506069,,0,417578,74302,,239767,23559042,4431767,PDN
GB108,,2000,1999,,0,29212716,5197992,,0,10309688,1834464,,0,18903028,3363528,PDN
GB108,,2001,1999,,0,21702224,3861606,,0,16660900,2964573,,0,5041324,897033,PDN
GB108,,2002,1999,,0,21693132,3859988,,0,19339360,3441167,,0,2353772,418821,PDN
GB108,,2003,1999,,0,24669908,4389663,,0,20847346,3709492,,0,3822562,680171,PDN
GB108,,2004,1999,,0,22985106,4089877,,0,22009015,3916195,,0,976091,173682,PDN
GB108,,2005,1999,,0,22985106,4089877,,0,22985106,4089877,,0,0,0,PDN
GB108,,2006,1999,,0,22985106,4089877,,0,22985106,4089877,,0,0,0,PDN
GB108,,2007,1999,,0,22985106,4089877,,0,22985106,4089877,,0,0,0,PDN
GB108,,2008,1999,,0,22985106,4089877,,0,22985106,4089877,,0,0,0,PDN
GB108,,2009,1999,,0,22985106,4089877,,0,22985106,4089877,,0,0,0,PDN
GB108,,2010,1999,,0,22985106,4089877,,0,22985106,4089877,,0,0,0,PDN
GB108,,2011,1999,,0,22985106,4089877,,0,22985106,4089877,,0,0,0,PDN
GB108,,2012,1999,,0,22985106,4089877,,0,22985106,4089877,,0,0,0,PDN
GB108,,2013,1999,,0,22985106,4089877,,0,22985106,4089877,,0,0,0,PDN
GB108,,2014,1999,,0,22985106,4089877,,0,22985106,4089877,,0,0,0,PDN
GB108,,2015,1999,,0,22985106,4089877,,0,22985106,4089877,,0,0,0,PDN
GB108,,2016,1999,,0,22985106,4089877,,0,22985106,4089877,,0,0,0,PDN
GB108,,2017,1999,,0,22985106,4089877,,0,22985106,4089877,,0,0,0,PDN
GB108,,2017,1999,,0,22985106,4089877,,0,22985106,4089877,,0,0,0,PDN
GB139,,2000,1998,,0,7325574,1303483,,0,0,0,,0,7325574,1303483,PDN
GB139,,2001,1998,,0,7346282,1307168,,0,0,0,,0,7346282,1307168,PDN
GB139,,2002,1998,,0,11067607,1969325,,0,0,0,,0,11067607,1969325,PDN
GB139,,2003,1998,,0,11067607,1969325,,0,0,0,,0,11067607,1969325,PDN
GB139,,2004,1998,,0,10873439,1934776,,0,3425012,609433,,0,7448427,1325343,PDN
GB139,,2005,1998,,0,10873439,1934776,,0,6152177,1094693,,0,4721262,840083,PDN
GB139,,2006,1998,,0,10873439,1934776,,0,8390416,1492957,,0,2483023,441819,PDN
GB139,,2007,1998,,0,10873439,1934776,,0,10249146,1823691,,0,624293,111085,PDN
GB139,,2008,1998,,50,15231039,2710199,,0,11087911,1972938,,50,4143128,737261,PDN
GB139,,2009,1998,,10,12638894,2248924,,0,11087911,1972938,,10,1550983,275986,PDN
GB139,,2010,1998,,10,12638894,2248924,,10,11916572,2120396,,0,722322,128527,PDN
GB139,,2011,1998,,10,12638894,2248924,,10,12607527,2243342,,0,31367,5581,PDN
GB139,,2012,1998,,10,12638894,2248924,,10,12638894,2248924,,0,0,0,PDN
GB139,,2013,1998,,10,12638894,2248924,,10,12638894,2248924,,0,0,0,PDN
GB139,,2014,1998,,10,12638894,2248924,,10,12638894,2248924,,0,0,0,PDN
GB139,,2015,1998,,10,12638894,2248924,,10,12638894,2248924,,0,0,0,PDN
GB139,,2016,1998,,10,12638894,2248924,,10,12638894,2248924,,0,0,0,PDN
GB139,,2017,1998,,10,12638894,2248924,,10,12638894,2248924,,0,0,0,PDN
GB139,,2017,1998,,10,12638894,2248924,,10,12638894,2248924,,0,0,0,PDN
GB142,,2002,1990,,4586,10186522,1817134,,0,0,0,,4586,10186522,1817134,PDN
GB142,,2003,1990,,4586,10186522,1817134,,169,372631,66473,,4417,9813891,1750661,PDN
GB142,,2004,1990,,5961,6359179,1137488,,501,4086396,727618,,5460,2272783,409870,PDN
GB142,,2005,1990,,5961,6359179,1137488,,1822,5763503,1027356,,4139,595676,110132,PDN
GB142,,2006,1990,,5961,6359179,1137488,,5770,5826129,1042448,,191,533050,95040,PDN
GB142,,2007,1990,,16845,5918209,1069907,,14198,5884819,1061319,,2647,33390,8588,PDN
GB142,,2008,1990,,123649,6304791,1245498,,16845,5913737,1069111,,106804,391054,176387,PDN
GB142,,2009,1990,,73283,6216799,1179475,,24290,5962784,1085284,,48993,254015,94191,PDN
GB142,,2010,1990,,73311,6208207,1177974,,52909,6090887,1136696,,20402,117320,41277,PDN
GB142,,2011,1990,,73311,6208207,1177974,,73272,6208207,1177935,,39,0,39,PDN
GB142,,2012,1990,,73311,6208207,1177974,,73311,6208207,1177974,,0,0,0,PDN
GB142,,2013,1990,,73311,6208207,1177974,,73311,6208207,1177974,,0,0,0,PDN
GB142,,2014,1990,,73311,6208207,1177974,,73311,6208207,1177974,,0,0,0,PDN
GB142,,2015,1990,,73311,6208207,1177974,,73311,6208207,1177974,,0,0,0,PDN
GB142,,2016,1990,,73311,6208207,1177974,,73311,6208207,1177974,,0,0,0,PDN
GB142,,2017,1990,,73311,6208207,1177974,,73311,6208207,1177974,,0,0,0,PDN
GB142,,2017,1990,,73311,6208207,1177974,,73311,6208207,1177974,,0,0,0,PDN
GB161,,1993,1988,,2630100,16231800,5518321,,0,0,0,,2630100,16231800,5518321,PDN
GB161,,1994,1988,,2630100,16231799,5518320,,0,0,0,,2630100,16231799,5518320,PDN
GB161,,1995,1988,,1206885,56368113,11236798,,0,0,0,,1206885,56368113,11236798,PDN
GB161,,1996,1988,,3505929,23543919,7695238,,379856,630306,492010,,3126073,22913613,7203228,PDN
GB161,,1997,1988,,15186790,27646199,20106042,,1333142,2456930,1770318,,13853648,25189269,18335724,PDN
GB161,,1998,1988,,12468978,26052524,17104659,,2031521,3688055,2687759,,10437457,22364469,14416900,PDN
GB161,,1999,1988,,12468978,26052524,17104658,,3071263,5517929,4053101,,9397715,20534595,13051557,PDN
GB161,,2000,1988,,14207353,46178215,22424118,,5176504,9077765,6791765,,9030849,37100450,15632353,PDN
GB161,,2001,1988,,12629333,40229775,19787656,,6034600,10399427,7885032,,6594733,29830348,11902624,PDN
GB161,,2002,1988,,12629333,40229775,19787656,,6519857,11234582,8518893,,6109476,28995193,11268763,PDN
GB161,,2003,1988,,12847539,37998069,19608761,,7048305,11991351,9181997,,5799234,26006718,10426764,PDN
GB161,,2004,1988,,12436731,36528311,18936431,,7424325,12557693,9658790,,5012406,23970618,9277641,PDN
GB161,,2005,1988,,12436731,36528311,18936431,,7694047,12958167,9999771,,4742684,23570144,8936660,PDN
GB161,,2006,1988,,12816177,37543127,19496449,,7890184,13281302,10253405,,4925993,24261825,9243044,PDN
GB161,,2007,1988,,10906210,18095533,14126056,,8202421,13901363,10675973,,2703789,4194170,3450083,PDN
GB161,,2008,1988,,11863483,20308510,15477097,,8339493,14195685,10865416,,3523990,6112825,4611681,PDN
GB161,,2009,1988,,11863483,20308510,15477096,,8386714,14378844,10945227,,3476769,5929666,4531869,PDN
GB161,,2010,1988,,11863483,20308510,15477096,,8485681,14590411,11081839,,3377802,5718099,4395257,PDN
GB161,,2011,1988,,11863483,20308510,15477096,,8681648,14980303,11347183,,3181835,5328207,4129914,PDN
GB161,,2012,1988,,11863483,20308510,15477096,,8814478,15309745,11538632,,3049005,4998765,3938464,PDN
GB161,,2013,1988,,11869306,20462604,15510338,,8927918,15558729,11696374,,2941388,4903875,3813963,PDN
GB161,,2014,1988,,11869306,20462604,15510338,,9111798,15882992,11937953,,2757508,4579612,3572385,PDN
GB161,,2015,1988,,9465889,16949375,12481792,,9116367,15893123,11944325,,349522,1056252,537467,PDN
GB161,,2016,1988,,9465889,16949375,12481792,,9116367,15893123,11944325,,349522,1056252,537467,PDN
GB161,,2017,1988,,9465889,16947641,12481483,,9116367,15891121,11943969,,349522,1056520,537515,PDN
GB161,,2017,1988,,9465889,16947641,12481483,,9116367,15891121,11943969,,349522,1056520,537515,PDN
GB171,,1995,1984,,61613638,23886534,65863911,,0,0,0,,61613638,23886534,65863911,PDP
GB171,,1996,1984,,61613638,102278015,79812573,,0,0,0,,61613638,102278015,79812573,PDP
GB171,,1997,1984,,45727940,114271313,66060914,,0,0,0,,45727940,114271313,66060914,PDP
GB171,,1998,1984,,46957741,141104506,72065305,,249235,6632196,1429341,,46708506,134472310,70635964,PDP
GB171,,1999,1984,,47712966,142992569,73156484,,1158915,23530640,5345862,,46554051,119461929,67810622,PDP
GB171,,2000,1984,,69605405,243081071,112858265,,1544252,29472545,6788477,,68061153,213608526,106069788,PDP
GB171,,2001,1984,,85745409,279953360,135559174,,9578732,66621337,21433062,,76166677,213332023,114126112,PDP
GB171,,2002,1984,,90052994,298198351,143113199,,17721683,104468263,36310342,,72331311,193730088,106802857,PDP
GB171,,2003,1984,,100257312,332349717,159394272,,26496017,141392917,51654899,,73761295,190956800,107739373,PDP
GB171,,2004,1984,,72623911,309093826,127622812,,35578453,175711510,66843846,,37045458,133382316,60778966,PDP
GB171,,2005,1984,,73290113,311197799,128663387,,43139101,203869705,79414849,,30151012,107328094,49248538,PDP
GB171,,2006,1984,,77787973,326455715,135876178,,49118061,225447850,89233337,,28669912,101007865,46642841,PDP
GB171,,2007,1984,,66878188,307592861,121610014,,53673702,241668525,96675219,,13204486,65924336,24934795,PDP
GB171,,2008,1984,,109613367,469602147,193172468,,56268325,250885396,100909855,,53345042,218716751,92262613,PDP
GB171,,2009,1984,,119743199,493659315,207582936,,63291556,277806019,112723231,,56451643,215853296,94859703,PDP
GB171,,2010,1984,,119743199,493659315,207582936,,73373767,315696558,129547533,,46369432,177962757,78035402,PDP
GB171,,2011,1984,,125958711,513225550,217279985,,83691458,354260383,146727114,,42267253,158965167,70552870,PDP
GB171,,2012,1984,,128242776,519980727,220766039,,95720722,398318448,166595891,,32522054,121662279,54170146,PDP
GB171,,2013,1984,,128242776,519980727,220766039,,106092275,436765252,183808513,,22150501,83215475,36957524,PDP
GB171,,2014,1984,,128001487,516628984,219928355,,118549551,482498366,204403354,,9451936,34130618,15524999,PDP
GB171,,2015,1984,,155283367,615074323,264727199,,129657351,523111869,222737756,,25626016,91962454,41989442,PDP
GB171,,2016,1984,,161501026,639660211,275319570,,138673176,555051641,237436814,,22827850,84608570,37882756,PDP
GB171,,2017,1984,,161501026,639660211,275319570,,143719350,573179966,245708668,,17781676,66480245,29610903,PDP
GB171,,2017,1984,,161501026,639660211,275319570,,143719350,573179966,245708668,,17781676,66480245,29610903,PDP
GB179,,1997,1997,,0,19926394,3545622,,0,0,0,,0,19926394,3545622,PDN
GB179,,1998,1997,,0,19926394,3545622,,0,801782,142666,,0,19124612,3402956,PDN
GB179,,1999,1997,,0,19926394,3545622,,0,3713922,660840,,0,16212472,2884782,PDN
GB179,,2000,1997,,0,19926394,3545622,,0,6728363,1197218,,0,13198031,2348404,PDN
GB179,,2001,1997,,0,21507854,3827020,,0,9596628,1707585,,0,11911226,2119435,PDN
GB179,,2002,1997,,0,20558978,3658181,,0,12393635,2205273,,0,8165343,1452908,PDN
GB179,,2003,1997,,0,20558978,3658181,,0,14304533,2545291,,0,6254445,1112890,PDN
GB179,,2004,1997,,0,16221200,2886335,,0,15708749,2795151,,0,512451,91184,PDN
GB179,,2005,1997,,0,16221200,2886335,,0,16221200,2886335,,0,0,0,PDN
GB179,,2006,1997,,0,16221200,2886335,,0,16221200,2886335,,0,0,0,PDN
GB179,,2007,1997,,0,16221200,2886335,,0,16221200,2886335,,0,0,0,PDN
GB179,,2008,1997,,0,16221200,2886335,,0,16221200,2886335,,0,0,0,PDN
GB179,,2009,1997,,0,16221419,2886373,,0,16221419,2886373,,0,0,0,PDN
GB179,,2010,1997,,0,16221419,2886373,,0,16221419,2886373,,0,0,0,PDN
GB179,,2011,1997,,0,16221419,2886373,,0,16221419,2886373,,0,0,0,PDN
GB179,,2012,1997,,0,16221419,2886373,,0,16221419,2886373,,0,0,0,PDN
GB179,,2013,1997,,0,16221419,2886373,,0,16221419,2886373,,0,0,0,PDN
GB179,,2014,1997,,0,16221419,2886373,,0,16221419,2886373,,0,0,0,PDN
GB179,,2015,1997,,0,16221419,2886373,,0,16221419,2886373,,0,0,0,PDN
GB179,,2016,1997,,0,16221419,2886373,,0,16221419,2886373,,0,0,0,PDN
GB179,,2017,1997,,0,16221419,2886373,,0,16221419,2886373,,0,0,0,PDN
GB179,,2017,1997,,0,16221419,2886373,,0,16221419,2886373,,0,0,0,PDN
GB184,,2000,1999,,427087,12664844,2680618,,100511,2752276,590240,,326576,9912568,2090378,PDN
GB184,,2001,1999,,405567,14669347,3015771,,273516,8693317,1820370,,132051,5976030,1195401,PDN
GB184,,2002,1999,,405567,14669347,3015771,,345022,12378735,2547644,,60545,2290612,468127,PDN
GB184,,2003,1999,,416899,15008335,3087421,,385093,13900428,2858479,,31806,1107907,228942,PDN
GB184,,2004,1999,,416899,15008335,3087421,,402251,14487131,2980032,,14648,521204,107389,PDN
GB184,,2005,1999,,445216,15671598,3233757,,414269,14878075,3061613,,30947,793523,172144,PDN
GB184,,2006,1999,,457856,16084500,3319867,,432131,15294428,3153559,,25725,790072,166308,PDN
GB184,,2007,1999,,457856,16084500,3319867,,444439,15636415,3226719,,13417,448085,93148,PDN
GB184,,2008,1999,,450551,15839500,3268967,,450551,15839500,3268967,,0,0,0,PDN
GB184,,2009,1999,,450064,15835472,3267764,,450064,15835472,3267764,,0,0,0,PDN
GB184,,2010,1999,,450064,15835472,3267764,,450064,15835472,3267764,,0,0,0,PDN
GB184,,2011,1999,,450064,15835472,3267764,,450064,15835472,3267764,,0,0,0,PDN
GB184,,2012,1999,,450064,15835472,3267764,,450064,15835472,3267764,,0,0,0,PDN
GB184,,2013,1999,,450064,15835472,3267764,,450064,15835472,3267764,,0,0,0,PDN
GB184,,2014,1999,,450064,15835472,3267764,,450064,15835472,3267764,,0,0,0,PDN
GB184,,2015,1999,,450064,15835472,3267764,,450064,15835472,3267764,,0,0,0,PDN
GB184,,2016,1999,,450064,15835472,3267764,,450064,15835472,3267764,,0,0,0,PDN
GB184,,2017,1999,,450064,15835472,3267764,,450064,15835472,3267764,,0,0,0,PDN
GB184,,2017,1999,,450064,15835472,3267764,,450064,15835472,3267764,,0,0,0,PDN
GB186,,1993,1986,,3173,31733615,5649724,,0,0,0,,3173,31733615,5649724,PDN
GB186,,1994,1986,,3173,31733615,5649724,,0,0,0,,3173,31733615,5649724,PDN
GB186,,2002,1986,,53525,35487275,6367987,,0,0,0,,53525,35487275,6367987,PDN
GB186,,2003,1986,,53525,35487275,6367987,,0,0,0,,53525,35487275,6367987,PDN
GB186,,2004,1986,,12229,17743638,3169460,,1012,1247448,222978,,11217,16496190,2946482,PDN
GB186,,2005,1986,,13533,5002970,903741,,1041,1639198,292713,,12492,3363772,611028,PDN
GB186,,2006,1986,,13533,5002970,903741,,2382,2084078,373214,,11151,2918892,530527,PDN
GB186,,2007,1986,,13533,5002970,903741,,2384,2267994,405942,,11149,2734976,497799,PDN
GB186,,2008,1986,,13533,5002970,903741,,2385,2310508,413507,,11148,2692462,490234,PDN
GB186,,2009,1986,,13533,5002970,903741,,2385,2346568,419923,,11148,2656402,483817,PDN
GB186,,2010,1986,,2385,2396489,428806,,2385,2353176,421099,,0,43313,7707,PDN
GB186,,2011,1986,,2385,2396489,428806,,2385,2384628,426696,,0,11861,2110,PDN
GB186,,2012,1986,,2385,2396489,428806,,2385,2396489,428806,,0,0,0,PDN
GB186,,2013,1986,,2385,2396489,428806,,2385,2396489,428806,,0,0,0,PDN
GB186,,2014,1986,,2385,2396489,428806,,2385,2396489,428806,,0,0,0,PDN
GB186,,2015,1986,,2385,2396489,428806,,2385,2396489,428806,,0,0,0,PDN
GB186,,2016,1986,,2385,2396489,428806,,2385,2396489,428806,,0,0,0,PDN
GB186,,2017,1986,,2385,2396489,428806,,2385,2396489,428806,,0,0,0,PDN
GB186,,2017,1986,,2385,2396489,428806,,2385,2396489,428806,,0,0,0,PDN
GB189,,1991,1988,,10267405,62205124,21335932,,0,0,0,,10267405,62205124,21335932,PDN
GB189,,1992,1988,,15586808,71763728,28356155,,1487569,3704051,2146653,,14099239,68059677,26209502,PDN
GB189,,1993,1988,,16822288,71477280,29540665,,4729309,23882763,8978911,,12092979,47594517,20561754,PDN
GB189,,1994,1988,,15506851,96100043,32606503,,7891213,47609286,16362616,,7615638,48490757,16243887,PDN
GB189,,1995,1988,,16471757,106347768,35394847,,10423374,75201846,23804485,,6048383,31145922,11590362,PDN
GB189,,1996,1988,,16982661,132157702,40498266,,12681297,97381872,30009032,,4301364,34775830,10489234,PDN
GB189,,1997,1988,,18015210,182418827,50474076,,14117857,115151803,34607502,,3897353,67267024,15866574,PDN
GB189,,1998,1988,,18768867,198516757,54092133,,15292904,134717213,39263938,,3475963,63799544,14828195,PDN
GB189,,1999,1988,,17999207,214139460,56102314,,16117742,159825578,44556457,,1881465,54313882,11545857,PDN
GB189,,2000,1988,,17999207,214139460,56102314,,16576484,181083465,48797741,,1422723,33055995,7304573,PDN
GB189,,2001,1988,,18003514,228412436,58646296,,16863930,199081121,52287617,,1139584,29331315,6358679,PDN
GB189,,2002,1988,,17968491,234552677,59703843,,17052118,211107042,54615649,,916373,23445635,5088194,PDN
GB189,,2003,1988,,17968491,234552677,59703843,,17162925,219535731,56226222,,805566,15016946,3477621,PDN
GB189,,2004,1988,,18023626,239261435,60596835,,17250092,226260906,57510040,,773534,13000529,3086795,PDN
GB189,,2005,1988,,18023626,239261435,60596835,,17309474,230826049,58381725,,714152,8435386,2215110,PDN
GB189,,2006,1988,,18053755,243227939,61332748,,17362383,235550131,59275218,,691372,7677808,2057530,PDN
GB189,,2007,1988,,17433007,242616647,60603229,,17386585,238896797,59894912,,46422,3719850,708317,PDN
GB189,,2008,1988,,17487525,253290480,62557005,,17396250,240794974,60242331,,91275,12495506,2314674,PDN
GB189,,2009,1988,,17644893,256971359,63369334,,17397151,243703097,60760692,,247742,13268262,2608642,PDN
GB189,,2010,1988,,17640246,256968262,63364136,,17413531,245853940,61159784,,226715,11114322,2204352,PDN
GB189,,2011,1988,,17640246,256968262,63364136,,17438653,247473633,61473107,,201593,9494629,1891028,PDN
GB189,,2012,1988,,17640246,256968262,63364136,,17469251,249037727,61782014,,170995,7930535,1582122,PDN
GB189,,2013,1988,,17637624,256968262,63361514,,17507345,250379604,62058877,,130279,6588658,1302638,PDN
GB189,,2014,1988,,17637624,256968262,63361514,,17547063,251470062,62292626,,90561,5498200,1068888,PDN
GB189,,2015,1988,,17637624,256968262,63361514,,17572951,252391325,62482440,,64673,4576937,879074,PDN
GB189,,2016,1988,,17572951,252391325,62482440,,17572951,252391325,62482440,,0,0,0,PDN
GB189,,2017,1988,,17572951,252391325,62482440,,17572951,252391325,62482440,,0,0,0,PDN
GB189,,2017,1988,,17572951,252391325,62482440,,17572951,252391325,62482440,,0,0,0,PDN
GB195,,2006,2006,,23431,18393955,3296377,,0,0,0,,23431,18393955,3296377,PDN
GB195,,2007,2006,,23431,18393955,3296377,,784,1834737,327250,,22647,16559218,2969127,PDN
GB195,,2008,2006,,15697,12486022,2237409,,12592,9747718,1747061,,3105,2738304,490348,PDN
GB195,,2009,2006,,15697,12486022,2237409,,15697,12486022,2237409,,0,0,0,PDN
GB195,,2010,2006,,15697,12486022,2237409,,15697,12486022,2237409,,0,0,0,PDN
GB195,,2011,2006,,15697,12486022,2237409,,15697,12486022,2237409,,0,0,0,PDN
GB195,,2012,2006,,15697,12486022,2237409,,15697,12486022,2237409,,0,0,0,PDN
GB195,,2013,2006,,15697,12486022,2237409,,15697,12486022,2237409,,0,0,0,PDN
GB195,,2014,2006,,15697,12486022,2237409,,15697,12486022,2237409,,0,0,0,PDN
GB195,,2015,2006,,15697,12486022,2237409,,15697,12486022,2237409,,0,0,0,PDN
GB195,,2016,2006,,15697,12486022,2237409,,15697,12486022,2237409,,0,0,0,PDN
GB195,,2017,2006,,15697,12486022,2237409,,15697,12486022,2237409,,0,0,0,PDN
GB195,,2017,2006,,15697,12486022,2237409,,15697,12486022,2237409,,0,0,0,PDN
GB197,,2001,2003,,2622,26224040,4668821,,0,0,0,,2622,26224040,4668821,PDN
GB197,,2003,2003,,18432,21753788,3889213,,0,0,0,,18432,21753788,3889213,PDN
GB197,,2004,2003,,8908,10911232,1950408,,4406,4860269,869223,,4502,6050963,1081185,PDN
GB197,,2005,2003,,8908,10911232,1950408,,5233,6397805,1143632,,3675,4513427,806776,PDN
GB197,,2006,2003,,7369,9125693,1631157,,5233,6509569,1163519,,2136,2616124,467638,PDN
GB197,,2007,2003,,5233,6509569,1163519,,5233,6509569,1163519,,0,0,0,PDN
GB197,,2008,2003,,5233,6509569,1163519,,5233,6509569,1163519,,0,0,0,PDN
GB197,,2009,2003,,5233,6509569,1163519,,5233,6509569,1163519,,0,0,0,PDN
GB197,,2010,2003,,5233,6509569,1163519,,5233,6509569,1163519,,0,0,0,PDN
GB197,,2011,2003,,5233,6509569,1163519,,5233,6509569,1163519,,0,0,0,PDN
GB197,,2012,2003,,5233,6509569,1163519,,5233,6509569,1163519,,0,0,0,PDN
GB197,,2013,2003,,5233,6509569,1163519,,5233,6509569,1163519,,0,0,0,PDN
GB197,,2014,2003,,5233,6509569,1163519,,5233,6509569,1163519,,0,0,0,PDN
GB197,,2015,2003,,5233,6509569,1163519,,5233,6509569,1163519,,0,0,0,PDN
GB197,,2016,2003,,5233,6509569,1163519,,5233,6509569,1163519,,0,0,0,PDN
GB197,,2017,2003,,5233,6509569,1163519,,5233,6509569,1163519,,0,0,0,PDN
GB197,,2017,2003,,5233,6509569,1163519,,5233,6509569,1163519,,0,0,0,PDN
GB200,,1998,1998,,875584,63398560,12156467,,0,0,0,,875584,63398560,12156467,PDP
GB200,,1999,1998,,862385,62445441,11973673,,0,0,0,,862385,62445441,11973673,PDP
GB200,,2000,1998,,3089282,136776209,27426686,,26592,1296637,257310,,3062690,135479572,27169376,PDP
GB200,,2001,1998,,3038776,130412371,26243824,,659620,31448435,6255427,,2379156,98963936,19988397,PDP
GB200,,2002,1998,,3090986,151148202,29985684,,1284392,63107810,12513540,,1806594,88040392,17472144,PDP
GB200,,2003,1998,,3090986,151148202,29985684,,1659306,89326628,17553724,,1431680,61821574,12431960,PDP
GB200,,2004,1998,,3265364,152493323,30399407,,1897951,103638825,20339023,,1367413,48854498,10060384,PDP
GB200,,2005,1998,,2615093,145735525,28546681,,1994091,108730480,21341151,,621002,37005045,7205530,PDP
GB200,,2006,1998,,2615093,145735525,28546681,,2098564,114681396,22504506,,516529,31054129,6042175,PDP
GB200,,2007,1998,,2615228,145813646,28560717,,2228711,123746481,24247658,,386517,22067165,4313059,PDP
GB200,,2008,1998,,2738657,160941600,31375952,,2317215,128502321,25182397,,421442,32439279,6193555,PDP
GB200,,2009,1998,,2776191,163337135,31839739,,2419867,133549435,26183112,,356324,29787700,5656627,PDP
GB200,,2010,1998,,2776191,163337135,31839739,,2489598,137772453,27004269,,286593,25564682,4835469,PDP
GB200,,2011,1998,,2776191,163337135,31839739,,2543594,141399055,27703568,,232597,21938080,4136171,PDP
GB200,,2012,1998,,2792846,157603295,30836138,,2581815,143461770,28108820,,211031,14141525,2727317,PDP
GB200,,2013,1998,,2792846,157603295,30836138,,2600399,144221203,28262536,,192447,13382092,2573602,PDP
GB200,,2014,1998,,2792846,157603295,30836138,,2610049,144593446,28338420,,182797,13009849,2497716,PDP
GB200,,2015,1998,,2792846,157603295,30836138,,2620693,145077408,28435178,,172153,12525887,2400957,PDP
GB200,,2016,1998,,2656948,146904296,28796503,,2631834,145446813,28512049,,25114,1457483,284452,PDP
GB200,,2017,1998,,2675347,147347542,28893771,,2645927,146042740,28632180,,29420,1304802,261591,PDP
GB200,,2017,1998,,2675347,147347542,28893771,,2645927,146042740,28632180,,29420,1304802,261591,PDP
GB205,,2002,2002,,14434,9708745,1741969,,1394,539984,97477,,13040,9168761,1644492,PDN
GB205,,2003,2002,,13000,8671797,1556024,,12593,6404288,1152146,,407,2267509,403878,PDN
GB205,,2004,2002,,14951,9322727,1673799,,12750,7319690,1315186,,2201,2003037,358613,PDN
GB205,,2005,2002,,37146,15335752,2765927,,13398,7942498,1426654,,23748,7393254,1339273,PDN
GB205,,2006,2002,,37618,15335752,2766399,,16334,8847838,1590682,,21284,6487914,1175717,PDN
GB205,,2007,2002,,37618,15335752,2766399,,25817,11342135,2043990,,11801,3993617,722409,PDN
GB205,,2008,2002,,37618,15335752,2766399,,26203,12059148,2171959,,11415,3276604,594440,PDN
GB205,,2009,2002,,26421,12867203,2315959,,26382,12283302,2212023,,39,583901,103936,PDN
GB205,,2010,2002,,26421,12867203,2315959,,26382,12611243,2270375,,39,255960,45583,PDN
GB205,,2011,2002,,26421,12867203,2315959,,26421,12867203,2315959,,0,0,0,PDN
GB205,,2012,2002,,26421,12867203,2315959,,26421,12867203,2315959,,0,0,0,PDN
GB205,,2013,2002,,26421,12867203,2315959,,26421,12867203,2315959,,0,0,0,PDN
GB205,,2014,2002,,26421,12867203,2315959,,26421,12867203,2315959,,0,0,0,PDN
GB205,,2015,2002,,26421,12867203,2315959,,26421,12867203,2315959,,0,0,0,PDN
GB205,,2016,2002,,26421,12867203,2315959,,26421,12867203,2315959,,0,0,0,PDN
GB205,,2017,2002,,26421,12867203,2315959,,26421,12867203,2315959,,0,0,0,PDN
GB205,,2017,2002,,26421,12867203,2315959,,26421,12867203,2315959,,0,0,0,PDN
GB208,,1993,1991,,3641290,21625013,7489157,,0,0,0,,3641290,21625013,7489157,PDN
GB208,,1994,1991,,3643712,21580869,7483724,,0,0,0,,3643712,21580869,7483724,PDN
GB208,,2003,1991,,3613594,21989959,7526398,,0,0,0,,3613594,21989959,7526398,PDN
GB208,,2004,1991,,1145006,19607568,4633897,,4459,456004,85599,,1140547,19151564,4548298,PDN
GB208,,2005,1991,,106191,19607610,3595090,,42894,5041923,940033,,63297,14565687,2655057,PDN
GB208,,2006,1991,,106191,19607610,3595090,,63132,9686946,1786788,,43059,9920664,1808302,PDN
GB208,,2007,1991,,106191,19607610,3595090,,87880,16224128,2974736,,18311,3383482,620354,PDN
GB208,,2008,1991,,94211,18673826,3416956,,94211,18673826,3416956,,0,0,0,PDN
GB208,,2009,1991,,94211,18673826,3416956,,94211,18673826,3416956,,0,0,0,PDN
GB208,,2010,1991,,94211,18673826,3416956,,94211,18673826,3416956,,0,0,0,PDN
GB208,,2011,1991,,94211,18673826,3416956,,94211,18673826,3416956,,0,0,0,PDN
GB208,,2012,1991,,94211,18673826,3416956,,94211,18673826,3416956,,0,0,0,PDN
GB208,,2013,1991,,94211,18673826,3416956,,94211,18673826,3416956,,0,0,0,PDN
GB208,,2014,1991,,94211,18673826,3416956,,94211,18673826,3416956,,0,0,0,PDN
GB208,,2015,1991,,94211,18673826,3416956,,94211,18673826,3416956,,0,0,0,PDN
GB208,,2016,1991,,94211,18673826,3416956,,94211,18673826,3416956,,0,0,0,PDN
GB208,,2017,1991,,94211,18673826,3416956,,94211,18673826,3416956,,0,0,0,PDN
GB208,,2017,1991,,94211,18673826,3416956,,94211,18673826,3416956,,0,0,0,PDN
GB224,,1986,1984,,12582,6291187,1132010,,0,0,0,,12582,6291187,1132010,PDN
GB224,,1987,1984,,12582,6291187,1132010,,0,0,0,,12582,6291187,1132010,PDN
GB224,,1991,1984,,0,35243472,6271080,,0,1540455,274102,,0,33703017,5996978,PDN
GB224,,1992,1984,,0,35243472,6271080,,0,6968643,1239972,,0,28274829,5031108,PDN
GB224,,1993,1984,,0,35243472,6271080,,0,11077444,1971075,,0,24166028,4300005,PDN
GB224,,1994,1984,,0,35166315,6257351,,0,16809654,2991042,,0,18356661,3266309,PDN
GB224,,1995,1984,,0,35179173,6259639,,0,22482155,4000383,,0,12697018,2259256,PDN
GB224,,1996,1984,,32,46835430,8333738,,7,28083323,4997040,,25,18752107,3336698,PDN
GB224,,1997,1984,,32,54038184,9615367,,7,33964774,6043561,,25,20073410,3571806,PDN
GB224,,1998,1984,,32,54038184,9615367,,7,40178234,7149159,,25,13859950,2466208,PDN
GB224,,1999,1984,,32,54038184,9615367,,7,46312354,8240639,,25,7725830,1374728,PDN
GB224,,2000,1984,,32,60266679,10723640,,7,50151172,8923703,,25,10115507,1799937,PDN
GB224,,2001,1984,,32,59091936,10514611,,7,52848208,9403603,,25,6243728,1111008,PDN
GB224,,2002,1984,,32,60266679,10723640,,7,54399879,9679701,,25,5866800,1043939,PDN
GB224,,2003,1984,,32,60266679,10723640,,7,55386204,9855203,,25,4880475,868437,PDN
GB224,,2004,1984,,7,55939517,9953658,,7,55939517,9953658,,0,0,0,PDN
GB224,,2005,1984,,7,55939517,9953658,,7,55939517,9953658,,0,0,0,PDN
GB224,,2006,1984,,7,55939517,9953658,,7,55939517,9953658,,0,0,0,PDN
GB224,,2007,1984,,7,55939517,9953658,,7,55939517,9953658,,0,0,0,PDN
GB224,,2008,1984,,7,55939517,9953658,,7,55939517,9953658,,0,0,0,PDN
GB224,,2009,1984,,7,56700388,10089044,,7,56700388,10089044,,0,0,0,PDN
GB224,,2010,1984,,7,56700388,10089044,,7,56700388,10089044,,0,0,0,PDN
GB224,,2011,1984,,7,56700388,10089044,,7,56700388,10089044,,0,0,0,PDN
GB224,,2012,1984,,7,56700388,10089044,,7,56700388,10089044,,0,0,0,PDN
GB224,,2013,1984,,7,56700388,10089044,,7,56700388,10089044,,0,0,0,PDN
GB224,,2014,1984,,7,56700388,10089044,,7,56700388,10089044,,0,0,0,PDN
GB224,,2015,1984,,7,56700388,10089044,,7,56700388,10089044,,0,0,0,PDN
GB224,,2016,1984,,7,56700388,10089044,,7,56700388,10089044,,0,0,0,PDN
GB224,,2017,1984,,7,56700388,10089044,,7,56700388,10089044,,0,0,0,PDN
GB224,,2017,1984,,7,56700388,10089044,,7,56700388,10089044,,0,0,0,PDN
GB236,,1979,1976,,30000,30000000,5368078,,0,0,0,,30000,30000000,5368078,PDN
GB236,,1980,1976,,30000,32000000,5723950,,0,4700,836,,30000,31995300,5723114,PDN
GB236,,1981,1976,,30000,32000000,5723950,,0,4700,836,,30000,31995300,5723114,PDN
GB236,,1982,1976,,30000,32000000,5723950,,0,150083,26705,,30000,31849917,5697245,PDN
GB236,,1983,1976,,414924,41492432,7797919,,0,150083,26705,,414924,41342349,7771214,PDN
GB236,,1984,1976,,414924,41492432,7797919,,0,150083,26705,,414924,41342349,7771214,PDN
GB236,,1985,1976,,5619,56177006,10001528,,0,150277,26740,,5619,56026729,9974788,PDN
GB236,,1986,1976,,0,321539411,57213418,,0,150277,26740,,0,321389134,57186678,PDN
GB236,,1987,1976,,0,321539411,57213418,,0,150277,26740,,0,321389134,57186678,PDN
GB236,,1988,1976,,0,321539411,57213418,,0,7014673,1248162,,0,314524738,55965256,PDN
GB236,,1989,1976,,0,158669456,28232999,,0,35609101,6336139,,0,123060355,21896860,PDN
GB236,,1990,1976,,0,403769208,71845055,,0,71357738,12697106,,0,332411470,59147949,PDN
GB236,,1991,1976,,0,410721324,73082086,,0,99649057,17731149,,0,311072267,55350937,PDN
GB236,,1992,1976,,0,432238082,76910691,,0,126504027,22509613,,0,305734055,54401078,PDN
GB236,,1993,1976,,4770,432238082,76915461,,96,158161152,28142650,,4674,274076930,48772811,PDN
GB236,,1994,1976,,16371,457311697,81388559,,4054,227263273,40442359,,12317,230048424,40946200,PDN
GB236,,1995,1976,,24418,461020980,82056621,,15520,309362050,55062148,,8898,151658930,26994473,PDN
GB236,,1996,1976,,47629,542349459,96551091,,22272,374741452,66702246,,25357,167608007,29848845,PDN
GB236,,1997,1976,,49101,579221972,103113509,,28971,418232935,74447643,,20130,160989037,28665866,PDN
GB236,,1998,1976,,45043,578040845,102899286,,31255,447437320,79646436,,13788,130603525,23252850,PDN
GB236,,1999,1976,,39160,549653363,97842250,,33813,471216133,83880100,,5347,78437230,13962150,PDN
GB236,,2000,1976,,39422,555197503,98829013,,34600,483387871,86046677,,4822,71809632,12782336,PDN
GB236,,2001,1976,,34935,495886310,88270933,,34808,491747524,87534367,,127,4138786,736566,PDN
GB236,,2002,1976,,34935,500304673,89057119,,34928,495302018,88166960,,7,5002655,890159,PDN
GB236,,2003,1976,,34935,495886310,88270933,,34935,495886310,88270933,,0,0,0,PDN
GB236,,2004,1976,,34935,495886310,88270933,,34935,495886310,88270933,,0,0,0,PDN
GB236,,2005,1976,,34935,495886310,88270933,,34935,495886310,88270933,,0,0,0,PDN
GB236,,2006,1976,,34935,495886310,88270933,,34935,495886310,88270933,,0,0,0,PDN
GB236,,2007,1976,,34935,495886310,88270933,,34935,495886310,88270933,,0,0,0,PDN
GB236,,2008,1976,,34935,495886310,88270933,,34935,495886310,88270933,,0,0,0,PDN
GB236,,2009,1976,,34935,504671457,89834125,,34935,504671457,89834125,,0,0,0,PDN
GB236,,2010,1976,,34935,504671457,89834125,,34935,504671457,89834125,,0,0,0,PDN
GB236,,2011,1976,,34935,504671457,89834125,,34935,504671457,89834125,,0,0,0,PDN
GB236,,2012,1976,,34935,504671457,89834125,,34935,504671457,89834125,,0,0,0,PDN
GB236,,2013,1976,,34935,504671457,89834125,,34935,504671457,89834125,,0,0,0,PDN
GB236,,2014,1976,,34935,504671457,89834125,,34935,504671457,89834125,,0,0,0,PDN
GB236,,2015,1976,,34935,504671457,89834125,,34935,504671457,89834125,,0,0,0,PDN
GB236,,2016,1976,,34935,504671457,89834125,,34935,504671457,89834125,,0,0,0,PDN
GB236,,2017,1976,,34935,504671457,89834125,,34935,504671457,89834125,,0,0,0,PDN
GB236,,2017,1976,,34935,504671457,89834125,,34935,504671457,89834125,,0,0,0,PDN
GB240,,1994,1989,,2591,25909728,4612863,,0,0,0,,2591,25909728,4612863,PDN
GB240,,1995,1989,,8024,80239826,14285573,,0,0,0,,8024,80239826,14285573,PDN
GB240,,1996,1989,,359206,48178925,8931968,,0,0,0,,359206,48178925,8931968,PDN
GB240,,1997,1989,,731443,80458774,15047951,,136762,14364264,2692681,,594681,66094510,12355270,PDN
GB240,,1998,1989,,731469,80461605,15048481,,189607,20796067,3889975,,541862,59665538,11158506,PDN
GB240,,1999,1989,,731469,80461605,15048481,,227503,24676299,4618304,,503966,55785306,10430177,PDN
GB240,,2000,1989,,408636,45686563,8537918,,235178,25760137,4818832,,173458,19926426,3719086,PDN
GB240,,2001,1989,,281407,29627608,5553223,,278827,29447179,5518539,,2580,180429,34684,PDN
GB240,,2002,1989,,281407,29627608,5553223,,281407,29627608,5553223,,0,0,0,PDN
GB240,,2003,1989,,281407,29627608,5553223,,281407,29627608,5553223,,0,0,0,PDN
GB240,,2004,1989,,281407,29627608,5553223,,281407,29627608,5553223,,0,0,0,PDN
GB240,,2005,1989,,281407,29627608,5553223,,281407,29627608,5553223,,0,0,0,PDN
GB240,,2006,1989,,281407,29627608,5553223,,281407,29627608,5553223,,0,0,0,PDN
GB240,,2007,1989,,281407,29627608,5553223,,281407,29627608,5553223,,0,0,0,PDN
GB240,,2008,1989,,281407,29627608,5553223,,281407,29627608,5553223,,0,0,0,PDN
GB240,,2009,1989,,281407,30005317,5620431,,281407,30005317,5620431,,0,0,0,PDN
GB240,,2010,1989,,281407,30005317,5620431,,281407,30005317,5620431,,0,0,0,PDN
GB240,,2011,1989,,281407,30005317,5620431,,281407,30005317,5620431,,0,0,0,PDN
GB240,,2012,1989,,281407,30005317,5620431,,281407,30005317,5620431,,0,0,0,PDN
GB240,,2013,1989,,281407,30005317,5620431,,281407,30005317,5620431,,0,0,0,PDN
GB240,,2014,1989,,281407,30005317,5620431,,281407,30005317,5620431,,0,0,0,PDN
GB240,,2015,1989,,281407,30005317,5620431,,281407,30005317,5620431,,0,0,0,PDN
GB240,,2016,1989,,281407,30005317,5620431,,281407,30005317,5620431,,0,0,0,PDN
GB240,,2017,1989,,281407,30005317,5620431,,281407,30005317,5620431,,0,0,0,PDN
GB240,,2017,1989,,281407,30005317,5620431,,281407,30005317,5620431,,0,0,0,PDN
GB244,,2001,2001,,9756855,43031791,17413757,,0,0,0,,9756855,43031791,17413757,PDP
GB244,,2002,2001,,9756837,43031436,17413676,,0,0,0,,9756837,43031436,17413676,PDP
GB244,,2003,2001,,9756837,43031436,17413676,,0,0,0,,9756837,43031436,17413676,PDP
GB244,,2004,2001,,9756855,43031791,17413757,,0,0,0,,9756855,43031791,17413757,PDP
GB244,,2005,2001,,9756855,43031791,17413757,,0,0,0,,9756855,43031791,17413757,PDP
GB244,,2006,2001,,9756855,43031791,17413757,,0,0,0,,9756855,43031791,17413757,PDP
GB244,,2007,2001,,13794253,59457834,24373939,,1085588,7694641,2454741,,12708665,51763193,21919198,PDP
GB244,,2008,2001,,4207951,19861112,7741957,,1508641,9636876,3223388,,2699310,10224236,4518569,PDP
GB244,,2009,2001,,4713816,21880631,8607167,,1996624,11306799,4008510,,2717192,10573832,4598657,PDP
GB244,,2010,2001,,4713816,21880631,8607167,,2384102,12460693,4601307,,2329714,9419938,4005860,PDP
GB244,,2011,2001,,4713816,21880631,8607167,,2989280,13997323,5479907,,1724536,7883308,3127260,PDP
GB244,,2012,2001,,4713816,21880631,8607167,,3622718,15790900,6432487,,1091098,6089731,2174680,PDP
GB244,,2013,2001,,5657047,22432959,9648677,,4019318,16851532,7017811,,1637729,5581427,2630866,PDP
GB244,,2014,2001,,5592871,22432959,9584501,,4775489,19375860,8223151,,817382,3057099,1361350,PDP
GB244,,2015,2001,,6546247,27478450,11435652,,5274507,21022689,9015199,,1271740,6455761,2420452,PDP
GB244,,2016,2001,,6373061,26619190,11109572,,5677315,23213115,9807762,,695746,3406075,1301809,PDP
GB244,,2017,2001,,6373061,26619190,11109572,,5890482,23741721,10114988,,482579,2877469,994584,PDP
GB244,,2017,2001,,6373061,26619190,11109572,,5890482,23741721,10114988,,482579,2877469,994584,PDP
GB260,,1993,1991,,57043151,254405840,102311094,,0,0,0,,57043151,254405840,102311094,PDP
GB260,,1994,1991,,48811986,235898039,90786726,,0,0,0,,48811986,235898039,90786726,PDP
GB260,,1995,1991,,48980840,235905359,90956883,,0,0,0,,48980840,235905359,90956883,PDP
GB260,,1996,1991,,51446200,247616707,95506112,,0,0,0,,51446200,247616707,95506112,PDP
GB260,,1997,1991,,61262065,270507640,109395097,,0,0,0,,61262065,270507640,109395097,PDP
GB260,,1998,1991,,65774666,331152018,124698512,,492916,2789181,989212,,65281750,328362837,123709300,PDP
GB260,,1999,1991,,81632859,391143173,151231288,,16155868,65743245,27853954,,65476991,325399928,123377334,PDP
GB260,,2000,1991,,81303371,399615203,152409279,,34303828,131353087,57676263,,46999543,268262116,94733016,PDP
GB260,,2001,1991,,85729054,398917823,156710873,,50056952,189591717,83792133,,35672102,209326106,72918740,PDP
GB260,,2002,1991,,85207859,387545597,154166151,,59027268,222388101,98598104,,26180591,165157496,55568047,PDP
GB260,,2003,1991,,85521893,389124333,154761099,,65579456,239056337,108116171,,19942437,150067996,46644928,PDP
GB260,,2004,1991,,88250953,401952149,159772688,,70161259,253902745,115339683,,18089694,148049404,44433005,PDP
GB260,,2005,1991,,93472939,405736823,165668103,,73600782,265539381,120849782,,19872157,140197442,44818321,PDP
GB260,,2006,1991,,93472939,405736823,165668103,,76602420,273552233,125277195,,16870519,132184590,40390908,PDP
GB260,,2007,1991,,105503431,382455669,173556041,,80142890,283735798,130629687,,25360541,98719871,42926354,PDP
GB260,,2008,1991,,108868285,391129427,178464268,,84655989,299530654,137953258,,24212296,91598773,40511010,PDP
GB260,,2009,1991,,120730789,441070529,199213090,,89385272,316156748,145640921,,31345517,124913781,53572168,PDP
GB260,,2010,1991,,120730789,441070529,199213090,,93715584,331809789,152756473,,27015205,109260740,46456618,PDP
GB260,,2011,1991,,121812787,447365151,201415128,,97523476,345977359,159085284,,24289311,101387792,42329844,PDP
GB260,,2012,1991,,121812787,447365151,201415128,,100955023,359119768,164855337,,20857764,88245383,36559790,PDP
GB260,,2013,1991,,121812787,447365151,201415128,,104125253,371348247,170201452,,17687534,76016904,31213672,PDP
GB260,,2014,1991,,118586329,441917814,197219391,,107622643,386679366,176426801,,10963686,55238448,20792592,PDP
GB260,,2015,1991,,119278517,443323789,198161752,,110480168,398096638,181315868,,8798349,45227151,16845884,PDP
GB260,,2016,1991,,120511559,435940094,198080970,,112978617,406867857,185375031,,7532942,29072237,12705938,PDP
GB260,,2017,1991,,119483688,425248765,195150727,,114302824,411462035,187516709,,5180864,13786730,7634018,PDP
GB260,,2017,1991,,119483688,425248765,195150727,,114302824,411462035,187516709,,5180864,13786730,7634018,PDP
GB293,,2010,2009,,3049960,48997600,11768394,,0,0,0,,3049960,48997600,11768394,PDN
GB293,,2011,2009,,3553156,53581368,13087208,,0,0,0,,3553156,53581368,13087208,PDN
GB293,,2012,2009,,3553156,53581368,13087208,,484754,7332239,1789423,,3068402,46249129,11297785,PDN
GB293,,2013,2009,,3553156,53581368,13087208,,866887,11951111,2993419,,2686269,41630257,10093788,PDN
GB293,,2014,2009,,3553156,53581368,13087208,,1121853,15277525,3840274,,2431303,38303843,9246934,PDN
GB293,,2015,2009,,2325822,39003220,9265897,,1168084,15848451,3988093,,1157738,23154769,5277804,PDN
GB293,,2016,2009,,1168084,15848451,3988093,,1168084,15848451,3988093,,0,0,0,PDN
GB293,,2017,2009,,1168084,15848451,3988093,,1168084,15848451,3988093,,0,0,0,PDN
GB293,,2017,2009,,1168084,15848451,3988093,,1168084,15848451,3988093,,0,0,0,PDN
GB302,,1993,1991,,9404001,23233050,13537996,,0,0,0,,9404001,23233050,13537996,PDP
GB302,,1994,1991,,9404008,23233066,13538006,,0,0,0,,9404008,23233066,13538006,PDP
GB302,,2005,1991,,10163716,23704557,14381609,,0,0,0,,10163716,23704557,14381609,PDP
GB302,,2006,1991,,5335931,13120383,7670519,,0,0,0,,5335931,13120383,7670519,PDP
GB302,,2007,1991,,5337669,13124913,7673063,,0,0,0,,5337669,13124913,7673063,PDP
GB302,,2008,1991,,10175502,29090582,15351762,,1216257,4440179,2006324,,8959245,24650403,13345438,PDP
GB302,,2009,1991,,9724706,26791972,14491961,,3256877,10209248,5073469,,6467829,16582724,9418492,PDP
GB302,,2010,1991,,9724706,26791972,14491961,,5061637,14423045,7628015,,4663069,12368927,6863946,PDP
GB302,,2011,1991,,11485738,31756219,17136311,,5918854,16186180,8798958,,5566884,15570039,8337353,PDP
GB302,,2012,1991,,11289354,31528759,16899454,,6469846,17595438,9600706,,4819508,13933321,7298747,PDP
GB302,,2013,1991,,11289354,31528759,16899454,,7351931,20999887,11088566,,3937423,10528872,5810888,PDP
GB302,,2014,1991,,10743129,32545008,16534056,,8483804,24845360,12904686,,2259325,7699648,3629369,PDP
GB302,,2015,1991,,10491976,32113308,16206088,,9438634,28426000,14496642,,1053342,3687308,1709447,PDP
GB302,,2016,1991,,10740032,33400134,16683117,,9866830,29820057,15172890,,873202,3580077,1510226,PDP
GB302,,2017,1991,,10740032,33400134,16683117,,10250070,30837372,15737148,,489962,2562762,945969,PDP
GB302,,2017,1991,,10740032,33400134,16683117,,10250070,30837372,15737148,,489962,2562762,945969,PDP
GB339,,2008,2008,,0,52129275,9275672,,0,0,0,,0,52129275,9275672,PDP
GB339,,2009,2008,,0,53181064,9462823,,0,0,0,,0,53181064,9462823,PDP
GB339,,2010,2008,,0,53181064,9462823,,0,8632577,1536046,,0,44548487,7926777,PDP
GB339,,2011,2008,,0,53181064,9462823,,0,16749985,2980424,,0,36431079,6482398,PDP
GB339,,2012,2008,,0,53181064,9462823,,0,21975320,3910199,,0,31205744,5552623,PDP
GB339,,2013,2008,,0,53230366,9471595,,0,27099687,4822008,,0,26130679,4649587,PDP
GB339,,2014,2008,,0,53230366,9471595,,0,30338109,5398240,,0,22892257,4073355,PDP
GB339,,2015,2008,,0,53230366,9471595,,0,32892049,5852678,,0,20338317,3618918,PDP
GB339,,2016,2008,,0,53230366,9471595,,0,34634442,6162712,,0,18595924,3308883,PDP
GB339,,2017,2008,,0,53230366,9471595,,0,35869759,6382519,,0,17360607,3089076,PDP
GB339,,2017,2008,,0,53230366,9471595,,0,35869759,6382519,,0,17360607,3089076,PDP
GB367,,1998,1998,,12006,16795318,3000497,,0,0,0,,12006,16795318,3000497,PDN
GB367,,1999,1998,,4039,28274147,5035026,,2436,12036748,2144206,,1603,16237399,2890820,PDN
GB367,,2000,1998,,4318,30585508,5446579,,2436,18874019,3360802,,1882,11711489,2085777,PDN
GB367,,2001,1998,,3084,24806180,4416995,,3084,24806180,4416995,,0,0,0,PDN
GB367,,2002,1998,,3084,24806180,4416995,,3084,24806180,4416995,,0,0,0,PDN
GB367,,2003,1998,,3084,24806180,4416995,,3084,24806180,4416995,,0,0,0,PDN
GB367,,2004,1998,,3084,24806180,4416995,,3084,24806180,4416995,,0,0,0,PDN
GB367,,2005,1998,,3084,24806180,4416995,,3084,24806180,4416995,,0,0,0,PDN
GB367,,2006,1998,,3084,24806180,4416995,,3084,24806180,4416995,,0,0,0,PDN
GB367,,2007,1998,,3084,24806180,4416995,,3084,24806180,4416995,,0,0,0,PDN
GB367,,2008,1998,,3084,24806180,4416995,,3084,24806180,4416995,,0,0,0,PDN
GB367,,2009,1998,,3084,24806180,4416996,,3084,24806180,4416996,,0,0,0,PDN
GB367,,2010,1998,,3084,24806180,4416996,,3084,24806180,4416996,,0,0,0,PDN
GB367,,2011,1998,,3084,24806180,4416996,,3084,24806180,4416996,,0,0,0,PDN
GB367,,2012,1998,,3084,24806180,4416996,,3084,24806180,4416996,,0,0,0,PDN
GB367,,2013,1998,,3084,24806180,4416996,,3084,24806180,4416996,,0,0,0,PDN
GB367,,2014,1998,,3084,24806180,4416996,,3084,24806180,4416996,,0,0,0,PDN
GB367,,2015,1998,,3084,24806180,4416996,,3084,24806180,4416996,,0,0,0,PDN
GB367,,2016,1998,,3084,24806180,4416996,,3084,24806180,4416996,,0,0,0,PDN
GB367,,2017,1998,,3084,24806180,4416996,,3084,24806180,4416996,,0,0,0,PDN
GB367,,2017,1998,,3084,24806180,4416996,,3084,24806180,4416996,,0,0,0,PDN
GB379,,1987,1985,,484308,2421541,915187,,0,0,0,,484308,2421541,915187,PDN
GB379,,2004,1985,,1567780,15841985,4386639,,113,80676,14468,,1567667,15761309,4372171,PDN
GB379,,2005,1985,,1567780,15841985,4386639,,8918,3082700,557441,,1558862,12759285,3829198,PDN
GB379,,2006,1985,,1567780,15841985,4386639,,11058,4114119,743108,,1556722,11727866,3643531,PDN
GB379,,2007,1985,,31159,11387321,2057373,,14342,5793894,1045284,,16817,5593427,1012089,PDN
GB379,,2008,1985,,24003,17434596,3126244,,14342,5817030,1049401,,9661,11617566,2076843,PDN
GB379,,2009,1985,,24488,17786526,3189350,,21844,8967126,1617418,,2644,8819400,1571932,PDN
GB379,,2010,1985,,24488,17786526,3189350,,22702,14024443,2518154,,1786,3762083,671196,PDN
GB379,,2011,1985,,23875,15446091,2772290,,23875,15446091,2772290,,0,0,0,PDN
GB379,,2012,1985,,23875,15446091,2772290,,23875,15446091,2772290,,0,0,0,PDN
GB379,,2013,1985,,23875,15446091,2772290,,23875,15446091,2772290,,0,0,0,PDN
GB379,,2014,1985,,23875,15446091,2772290,,23875,15446091,2772290,,0,0,0,PDN
GB379,,2015,1985,,23875,15446091,2772290,,23875,15446091,2772290,,0,0,0,PDN
GB379,,2016,1985,,23875,15446091,2772290,,23875,15446091,2772290,,0,0,0,PDN
GB379,,2017,1985,,23875,15445475,2772180,,23875,15445475,2772180,,0,0,0,PDN
GB379,,2017,1985,,23875,15445475,2772180,,23875,15445475,2772180,,0,0,0,PDN
GB387,,1992,1994,,669010,2060260,1035604,,0,0,0,,669010,2060260,1035604,PDP
GB387,,1993,1994,,669010,2060260,1035604,,0,0,0,,669010,2060260,1035604,PDP
GB387,,1994,1994,,751978,2316105,1164096,,0,0,0,,751978,2316105,1164096,PDP
GB387,,1995,1994,,393829,364747,458731,,38785,29617,44055,,355044,335130,414676,PDP
GB387,,1996,1994,,14220386,16480768,17152907,,1904925,2245426,2304467,,12315461,14235342,14848440,PDP
GB387,,1997,1994,,132180494,254425150,177451873,,4231566,6558328,5398528,,127948928,247866822,172053345,PDP
GB387,,1998,1994,,131338917,253619514,176466944,,5861013,7803599,7249554,,125477904,245815915,169217390,PDP
GB387,,1999,1994,,69420478,167362100,99200211,,6267438,8087583,7706510,,63153040,159274517,91493701,PDP
GB387,,2000,1994,,70057548,168250747,99995404,,6266031,8087583,7705103,,63791517,160163164,92290301,PDP
GB387,,2001,1994,,117352192,298861825,170530453,,5900984,7472622,7230632,,111451208,291389203,163299821,PDP
GB387,,2002,1994,,117352192,298861825,170530453,,5900984,7472622,7230632,,111451208,291389203,163299821,PDP
GB387,,2003,1994,,128054313,309201317,183072341,,6428272,8297707,7904732,,121626041,300903610,175167609,PDP
GB387,,2004,1994,,106316023,260199619,152614888,,16973767,34405191,23095687,,89342256,225794428,129519201,PDP
GB387,,2005,1994,,84612096,197222337,119705039,,30416064,61545439,41367210,,54196032,135676898,78337829,PDP
GB387,,2006,1994,,78697670,183566327,111360718,,39061132,78994590,53117109,,39636538,104571737,58243609,PDP
GB387,,2007,1994,,54548868,111220079,74338918,,46526315,95168810,63460267,,8022553,16051269,10878651,PDP
GB387,,2008,1994,,81035137,163239882,110081379,,50426735,102941029,68743644,,30608402,60298853,41337735,PDP
GB387,,2009,1994,,81036191,163407285,110112220,,53585763,109017800,72983948,,27450428,54389485,37128272,PDP
GB387,,2010,1994,,91288835,197537975,126437941,,60041188,122523243,81842477,,31247647,75014732,44595463,PDP
GB387,,2011,1994,,91288835,197537975,126437941,,64098127,130710438,87356212,,27190708,66827537,39081729,PDP
GB387,,2012,1994,,91288835,197537975,126437941,,68964663,141744101,94186033,,22324172,55793874,32251908,PDP
GB387,,2013,1994,,93902768,214662392,132098923,,73153580,153212189,100415535,,20749188,61450203,31683389,PDP
GB387,,2014,1994,,96925170,231656359,138145162,,82779405,182635961,115276906,,14145765,49020398,22868256,PDP
GB387,,2015,1994,,104115475,245160115,147738272,,88868644,200847016,124606548,,15246831,44313099,23131725,PDP
GB387,,2016,1994,,111567899,269497976,159521277,,96098311,219226466,135106580,,15469588,50271510,24414696,PDP
GB387,,2017,1994,,111567899,270448394,159690390,,101566948,232887381,143005984,,10000951,37561013,16684405,PDP
GB387,,2017,1994,,111567899,270448394,159690390,,101566948,232887381,143005984,,10000951,37561013,16684405,PDP
GB388,,1992,1989,,36775895,95790992,53820555,,0,0,0,,36775895,95790992,53820555,PDN
GB388,,1993,1989,,36775895,95790992,53820555,,0,0,0,,36775895,95790992,53820555,PDN
GB388,,1994,1989,,38109222,99187830,55758302,,0,0,0,,38109222,99187830,55758302,PDN
GB388,,1995,1989,,38570802,69010839,50850311,,400838,505195,490730,,38169964,68505644,50359581,PDN
GB388,,1996,1989,,36290227,69557588,48667022,,983307,1193049,1195593,,35306920,68364539,47471429,PDN
GB388,,1997,1989,,21364761,43268753,29063827,,1221706,2390418,1647047,,20143055,40878335,27416780,PDN
GB388,,1998,1989,,13215688,27392104,18089728,,1415011,3986582,2124367,,11800677,23405522,15965361,PDN
GB388,,1999,1989,,12882990,25311757,17386861,,1435137,4267295,2194442,,11447853,21044462,15192419,PDN
GB388,,2000,1989,,13333453,33781382,19344375,,1431695,4267295,2191000,,11901758,29514087,17153375,PDN
GB388,,2001,1989,,14847393,33982176,20894044,,1796742,4882256,2665471,,13050651,29099920,18228573,PDN
GB388,,2002,1989,,48963506,121801475,70636366,,1796742,4882256,2665471,,47166764,116919219,67970895,PDN
GB388,,2003,1989,,48963506,121801475,70636366,,1796742,4882256,2665471,,47166764,116919219,67970895,PDN
GB388,,2004,1989,,48963506,121801475,70636366,,1796742,4882256,2665471,,47166764,116919219,67970895,PDN
GB388,,2005,1989,,48963506,121801475,70636366,,1796742,4882256,2665471,,47166764,116919219,67970895,PDN
GB388,,2006,1989,,48963506,121801475,70636366,,1796742,4882256,2665471,,47166764,116919219,67970895,PDN
GB388,,2007,1989,,1796742,4882256,2665471,,1796742,4882256,2665471,,0,0,0,PDN
GB388,,2008,1989,,1796742,4882256,2665471,,1796742,4882256,2665471,,0,0,0,PDN
GB388,,2009,1989,,1796742,4969693,2681029,,1796742,4969693,2681029,,0,0,0,PDN
GB388,,2010,1989,,1796742,4969693,2681029,,1796742,4969693,2681029,,0,0,0,PDN
GB388,,2011,1989,,1796742,4969693,2681029,,1796742,4969693,2681029,,0,0,0,PDN
GB388,,2012,1989,,1796742,4969693,2681029,,1796742,4969693,2681029,,0,0,0,PDN
GB388,,2013,1989,,1796742,4969693,2681029,,1796742,4969693,2681029,,0,0,0,PDN
GB388,,2014,1989,,1796742,4969693,2681029,,1796742,4969693,2681029,,0,0,0,PDN
GB388,,2015,1989,,1796742,4969693,2681029,,1796742,4969693,2681029,,0,0,0,PDN
GB388,,2016,1989,,1796742,4969693,2681029,,1796742,4969693,2681029,,0,0,0,PDN
GB388,,2017,1989,,1796742,4969693,2681029,,1796742,4969693,2681029,,0,0,0,PDN
GB388,,2017,1989,,1796742,4969693,2681029,,1796742,4969693,2681029,,0,0,0,PDN
GB409,,1997,1997,,4545315,4545315,5354090,,0,0,0,,4545315,4545315,5354090,PDN
GB409,,1998,1997,,4545315,4545315,5354090,,0,0,0,,4545315,4545315,5354090,PDN
GB409,,1999,1997,,4545315,4545315,5354090,,0,0,0,,4545315,4545315,5354090,PDN
GB409,,2000,1997,,5118168,5996682,6185193,,0,0,0,,5118168,5996682,6185193,PDN
GB409,,2001,1997,,5250296,5404279,6211911,,896201,785928,1036046,,4354095,4618351,5175865,PDN
GB409,,2002,1997,,8293415,9465570,9977680,,3280768,3542774,3911155,,5012647,5922796,6066525,PDN
GB409,,2003,1997,,8293415,9465570,9977680,,5047398,5701747,6061944,,3246017,3763823,3915736,PDN
GB409,,2004,1997,,8293415,9465570,9977680,,6074058,6548502,7239272,,2219357,2917068,2738408,PDN
GB409,,2005,1997,,7982262,8600350,9512573,,6583088,7106379,7847568,,1399174,1493971,1665005,PDN
GB409,,2006,1997,,7982262,8600350,9512573,,6806271,7349107,8113941,,1175991,1251243,1398632,PDN
GB409,,2007,1997,,9132984,9659328,10851726,,8242513,8780837,9804940,,890471,878491,1046786,PDN
GB409,,2008,1997,,12437027,13440506,14828576,,9207936,9720794,10937615,,3229091,3719712,3890961,PDN
GB409,,2009,1997,,12437027,13440506,14828574,,9928475,10449227,11787767,,2508552,2991279,3040808,PDN
GB409,,2010,1997,,12437027,13440506,14828574,,10722343,11379646,12747189,,1714684,2060860,2081385,PDN
GB409,,2011,1997,,12437027,13440506,14828574,,11103862,11776647,13199350,,1333165,1663859,1629226,PDN
GB409,,2012,1997,,12437027,13440506,14828574,,11170039,11882016,13284275,,1266988,1558490,1544298,PDN
GB409,,2013,1997,,12437027,13440506,14828574,,11236869,11961077,13365173,,1200158,1479429,1463401,PDN
GB409,,2014,1997,,12437027,13440506,14828574,,11349307,12082295,13499180,,1087720,1358211,1329394,PDN
GB409,,2015,1997,,11387277,12111730,13542387,,11387277,12111730,13542387,,0,0,0,PDN
GB409,,2016,1997,,11387277,12111730,13542387,,11387277,12111730,13542387,,0,0,0,PDN
GB409,,2017,1997,,11387277,12111730,13542387,,11387277,12111730,13542387,,0,0,0,PDN
GB409,,2017,1997,,11387277,12111730,13542387,,11387277,12111730,13542387,,0,0,0,PDN
GB426,,1989,1987,,88695837,373935441,155232392,,0,0,0,,88695837,373935441,155232392,PDP
GB426,,1990,1987,,88695837,373935441,155232392,,0,0,0,,88695837,373935441,155232392,PDP
GB426,,1991,1987,,122489916,416516007,196603085,,0,0,0,,122489916,416516007,196603085,PDP
GB426,,1992,1987,,122489916,416516007,196603085,,0,0,0,,122489916,416516007,196603085,PDP
GB426,,1993,1987,,122489916,416516007,196603085,,0,0,0,,122489916,416516007,196603085,PDP
GB426,,1994,1987,,108842219,452639861,189383120,,7781037,17754890,10940270,,101061182,434884971,178442850,PDP
GB426,,1995,1987,,106024486,452313912,186507388,,26709961,57420757,36927178,,79314525,394893155,149580210,PDP
GB426,,1996,1987,,198051240,672076225,317637757,,50887146,112776155,70954077,,147164094,559300070,246683680,PDP
GB426,,1997,1987,,225874064,921399902,389824224,,81366707,196940487,116409498,,144507357,724459415,273414726,PDP
GB426,,1998,1987,,219686138,890116963,378069939,,110090642,291104171,161888537,,109595496,599012792,216181402,PDP
GB426,,1999,1987,,224393055,909113959,386157105,,133599106,383008147,201750022,,90793949,526105812,184407083,PDP
GB426,,2000,1987,,230448876,931520038,396199772,,157060771,501640548,246320655,,73388105,429879490,149879117,PDP
GB426,,2001,1987,,229581219,897748176,389322887,,178870571,617659276,288774357,,50710648,280088900,100548530,PDP
GB426,,2002,1987,,234322001,924955904,398904902,,191187041,676062380,311482838,,43134960,248893524,87422064,PDP
GB426,,2003,1987,,219284080,820218629,365230455,,197218757,703972035,322480685,,22065323,116246594,42749770,PDP
GB426,,2004,1987,,218107294,813515430,362860929,,201881596,726609928,331171619,,16225698,86905502,31689310,PDP
GB426,,2005,1987,,228093340,821346882,374240472,,206345311,741448616,338275670,,21748029,79898266,35964802,PDP
GB426,,2006,1987,,228967260,819431274,374773537,,211660750,757941967,346525869,,17306510,61489307,28247668,PDP
GB426,,2007,1987,,235324313,841305791,385022852,,217381211,776378609,355526871,,17943102,64927182,29495981,PDP
GB426,,2008,1987,,244948649,892018024,403670717,,221052433,792949052,362146570,,23896216,99068972,41524147,PDP
GB426,,2009,1987,,248851679,910053572,410782921,,224022414,815513692,369131612,,24829265,94539880,41651308,PDP
GB426,,2010,1987,,242975119,878947701,399371509,,224928346,819183548,370690545,,18046773,59764153,28680966,PDP
GB426,,2011,1987,,247456485,888752930,405597578,,227746653,827429378,374976081,,19709832,61323552,30621498,PDP
GB426,,2012,1987,,247456485,888752930,405597578,,231156359,835937410,379899672,,16300126,52815520,25697907,PDP
GB426,,2013,1987,,247456485,888752930,405597578,,233591457,841552894,383333966,,13865028,47200036,22263612,PDP
GB426,,2014,1987,,257775966,923993546,422187631,,238510556,857027328,391006523,,19265410,66966218,31181107,PDP
GB426,,2015,1987,,264850085,941276606,432337027,,251190745,894539535,410361481,,13659340,46737071,21975544,PDP
GB426,,2016,1987,,278370346,966027702,450261397,,261854958,922352539,425974627,,16515388,43675163,24286770,PDP
GB426,,2017,1987,,289023171,1012365458,469159374,,267980901,937419675,434781554,,21042270,74945783,34377819,PDP
GB426,,2017,1987,,289023171,1012365458,469159374,,267980901,937419675,434781554,,21042270,74945783,34377819,PDP
GB462,,2007,2007,,321016,241637598,43317030,,0,0,0,,321016,241637598,43317030,PDP
GB462,,2008,2007,,6900597,200945089,42655951,,0,38585,6866,,6900597,200906504,42649085,PDP
GB462,,2009,2007,,6834688,151490937,33790369,,36100,31668192,5671009,,6798588,119822745,28119360,PDP
GB462,,2010,2007,,6834688,151490937,33790369,,1528909,69796192,13948161,,5305779,81694745,19842210,PDP
GB462,,2011,2007,,6834688,151490937,33790369,,2739457,77919381,16604116,,4095231,73571556,17186254,PDP
GB462,,2012,2007,,7212257,143748988,32790368,,3733721,84650418,18796072,,3478536,59098570,13994296,PDP
GB462,,2013,2007,,7445382,166764498,37118779,,4504262,87678474,20105415,,2941120,79086024,17013365,PDP
GB462,,2014,2007,,7402217,134415850,31319627,,5140288,96949887,22391158,,2261929,37465963,8928470,PDP
GB462,,2015,2007,,7401529,138737651,32087943,,5624031,105671088,24426715,,1777498,33066563,7661228,PDP
GB462,,2016,2007,,7383415,125163215,29654449,,5760463,110278433,25382960,,1622952,14884782,4271490,PDP
GB462,,2017,2007,,7283162,123119554,29190555,,6263310,113713875,26497096,,1019852,9405679,2693460,PDP
GB462,,2017,2007,,7283162,123119554,29190555,,6263310,113713875,26497096,,1019852,9405679,2693460,PDP
GB516,,1996,1996,,3071322,334466962,62585016,,0,0,0,,3071322,334466962,62585016,PDN
GB516,,1997,1996,,3065332,333814642,62462955,,0,0,0,,3065332,333814642,62462955,PDN
GB516,,1998,1996,,3065332,333814642,62462955,,0,0,0,,3065332,333814642,62462955,PDN
GB516,,1999,1996,,3065332,333814642,62462955,,0,0,0,,3065332,333814642,62462955,PDN
GB516,,2000,1996,,7114644,407710130,79660930,,0,0,0,,7114644,407710130,79660930,PDN
GB516,,2001,1996,,13595165,312643822,69225738,,47254,889183,205472,,13547911,311754639,69020266,PDN
GB516,,2002,1996,,19182666,302478531,73004469,,1089394,18773200,4429821,,18093272,283705331,68574648,PDN
GB516,,2003,1996,,19182666,302478531,73004469,,1627460,34783579,7816709,,17555206,267694952,65187760,PDN
GB516,,2004,1996,,15539328,100376480,33399912,,1812577,38540741,8670360,,13726751,61835739,24729552,PDN
GB516,,2005,1996,,14200983,79191227,28291949,,2006847,40303700,9178324,,12194136,38887527,19113625,PDN
GB516,,2006,1996,,14939460,83282071,29758334,,2620769,43323701,10329613,,12318691,39958370,19428721,PDN
GB516,,2007,1996,,59845105,155591189,87530370,,2657143,43481019,10393979,,57187962,112110170,77136391,PDN
GB516,,2008,1996,,59845105,155591189,87530370,,2920472,45050220,10936525,,56924633,110540969,76593845,PDN
GB516,,2009,1996,,27698984,113179878,47837752,,3057046,45493075,11151899,,24641938,67686803,36685853,PDN
GB516,,2010,1996,,3939835,46952119,12294304,,3057046,45493075,11151899,,882789,1459044,1142405,PDN
GB516,,2011,1996,,3939835,46952119,12294304,,3117375,45612124,11233411,,822460,1339995,1060893,PDN
GB516,,2012,1996,,3895403,47211357,12296000,,3881762,46948768,12235635,,13641,262589,60365,PDN
GB516,,2013,1996,,3893038,46986112,12253556,,3893038,46986112,12253556,,0,0,0,PDN
GB516,,2014,1996,,3893038,46986112,12253556,,3893038,46986112,12253556,,0,0,0,PDN
GB516,,2015,1996,,3899957,46986370,12260521,,3899957,46986370,12260521,,0,0,0,PDN
GB516,,2016,1996,,3899957,46986370,12260521,,3899957,46986370,12260521,,0,0,0,PDN
GB516,,2017,1996,,3899957,46986370,12260521,,3899957,46986370,12260521,,0,0,0,PDN
GB516,,2017,1996,,3899957,46986370,12260521,,3899957,46986370,12260521,,0,0,0,PDN
GB559,,1999,1999,,19376659,29686042,24658873,,0,0,0,,19376659,29686042,24658873,PDP
GB559,,2000,1999,,20346244,31453235,25942905,,0,0,0,,20346244,31453235,25942905,PDP
GB559,,2001,1999,,24024138,36982637,30604678,,713525,1173868,922398,,23310613,35808769,29682280,PDP
GB559,,2002,1999,,24024138,36982637,30604678,,7013455,11240486,9013541,,17010683,25742151,21591137,PDP
GB559,,2003,1999,,28756275,62507780,39878656,,12107817,18840229,15460171,,16648458,43667551,24418485,PDP
GB559,,2004,1999,,20304313,32143748,26023841,,14666661,22273991,18630005,,5637652,9869757,7393836,PDP
GB559,,2005,1999,,18624613,29301856,23838466,,15850032,24050210,20129429,,2774581,5251646,3709037,PDP
GB559,,2006,1999,,18790383,29302812,24004406,,16934729,25950824,21552313,,1855654,3351988,2452093,PDP
GB559,,2007,1999,,21733698,34322388,27840884,,17889513,27347426,22755603,,3844185,6974962,5085281,PDP
GB559,,2008,1999,,29438246,44428048,37343593,,19172451,29300962,24386145,,10265795,15127086,12957448,PDP
GB559,,2009,1999,,35373699,53100748,44822231,,21425410,32333117,27178633,,13948289,20767631,17643597,PDP
GB559,,2010,1999,,35373699,53100748,44822231,,23976832,36163786,30411670,,11396867,16936962,14410562,PDP
GB559,,2011,1999,,35373699,53100748,44822231,,26272175,39547688,33309130,,9101524,13553060,11513101,PDP
GB559,,2012,1999,,35373699,53100748,44822231,,28292862,42460773,35848159,,7080837,10639975,8974071,PDP
GB559,,2013,1999,,35373699,53100748,44822231,,29674195,44410317,37576386,,5699504,8690431,7245844,PDP
GB559,,2014,1999,,35373699,53100748,44822231,,30958157,46246327,39187041,,4415542,6854421,5635190,PDP
GB559,,2015,1999,,35373699,53100748,44822231,,31551711,47134303,39938598,,3821988,5966445,4883633,PDP
GB559,,2016,1999,,35373699,53100748,44822231,,32591553,48734719,41263211,,2782146,4366029,3559020,PDP
GB559,,2017,1999,,35373699,53100748,44822231,,33118404,49612558,41946261,,2255295,3488190,2875969,PDP
GB559,,2017,1999,,35373699,53100748,44822231,,33118404,49612558,41946261,,2255295,3488190,2875969,PDP
GB602,,1998,1996,,55602341,65332749,67227385,,0,0,0,,55602341,65332749,67227385,PDP
GB602,,1999,1996,,52369554,63150943,63606377,,102956,141214,128083,,52266598,63009729,63478294,PDP
GB602,,2000,1996,,51736485,73271161,64774058,,2814274,5364888,3768880,,48922211,67906273,61005178,PDP
GB602,,2001,1996,,43918031,58001379,54238561,,5272884,9311645,6929760,,38645147,48689734,47308801,PDP
GB602,,2002,1996,,43918031,58001379,54238561,,7049266,12257355,9230290,,36868765,45744024,45008271,PDP
GB602,,2003,1996,,45608949,61225777,56503215,,8550271,14972774,11214466,,37058678,46253003,45288749,PDP
GB602,,2004,1996,,45608949,61225777,56503215,,9709254,17153963,12761561,,35899695,44071814,43741654,PDP
GB602,,2005,1996,,45608949,61225777,56503215,,10413942,18452774,13697354,,35195007,42773003,42805861,PDP
GB602,,2006,1996,,45242143,60928770,56083562,,11243859,19984415,14799805,,33998284,40944355,41283757,PDP
GB602,,2007,1996,,11996302,21375297,15799736,,11702631,20745900,15394072,,293671,629397,405664,PDP
GB602,,2008,1996,,13437244,23746573,17662613,,11855646,21047626,15600775,,1581598,2698947,2061838,PDP
GB602,,2009,1996,,12793877,22903671,16869263,,12072014,21372193,15874896,,721863,1531478,994368,PDP
GB602,,2010,1996,,12793877,22903671,16869263,,12150687,21534506,15982449,,643190,1369165,886814,PDP
GB602,,2011,1996,,12793877,22903671,16869263,,12206894,21639657,16057367,,586983,1264014,811897,PDP
GB602,,2012,1996,,12793877,22903671,16869263,,12235122,21713538,16098741,,558755,1190133,770522,PDP
GB602,,2013,1996,,12793877,22903671,16869263,,12343699,21956198,16250496,,450178,947473,618768,PDP
GB602,,2014,1996,,12793877,22903671,16869263,,12673931,22824241,16735184,,119946,79430,134079,PDP
GB602,,2015,1996,,13685470,25742803,18266040,,12989519,23683464,17203658,,695951,2059339,1062381,PDP
GB602,,2016,1996,,13767544,25970804,18388683,,13290558,24517352,17653076,,476986,1453452,735607,PDP
GB602,,2017,1996,,13767544,25970804,18388683,,13444938,24907426,17876864,,322606,1063378,511819,PDP
GB602,,2017,1996,,13767544,25970804,18388683,,13444938,24907426,17876864,,322606,1063378,511819,PDP
GB668,,1999,2000,,13515081,23867634,17761991,,0,0,0,,13515081,23867634,17761991,PDP
GB668,,2000,2000,,50200313,84501448,65236158,,0,0,0,,50200313,84501448,65236158,PDP
GB668,,2001,2000,,50202126,102627112,68463178,,0,0,0,,50202126,102627112,68463178,PDP
GB668,,2002,2000,,50202126,102627112,68463178,,0,0,0,,50202126,102627112,68463178,PDP
GB668,,2003,2000,,63733464,148179342,90099895,,54504,1367521,297835,,63678960,146811821,89802060,PDP
GB668,,2004,2000,,41157723,216438307,79669878,,4242408,46378772,12494859,,36915315,170059535,67175019,PDP
GB668,,2005,2000,,41390116,204592256,77794432,,10316642,81601508,24836483,,31073474,122990748,52957949,PDP
GB668,,2006,2000,,42883903,224490096,82828760,,16406135,125019855,38651661,,26477768,99470241,44177099,PDP
GB668,,2007,2000,,41204747,232140904,82510958,,20479009,154067679,47893187,,20725738,78073225,34617771,PDP
GB668,,2008,2000,,43576287,234653300,85329543,,23461246,169799434,53674668,,20115041,64853866,31654875,PDP
GB668,,2009,2000,,46147496,235735569,88093328,,26549453,186779170,59784180,,19598043,48956399,28309146,PDP
GB668,,2010,2000,,44889788,232165391,86200356,,29032589,198087853,64279536,,15857199,34077538,21920820,PDP
GB668,,2011,2000,,44889788,232165391,86200356,,30700517,201999506,66643490,,14189271,30165885,19556865,PDP
GB668,,2012,2000,,45117995,231787766,86361370,,32283179,205068587,68772251,,12834816,26719179,17589117,PDP
GB668,,2013,2000,,41614533,226390688,81897573,,33661614,208448219,70752044,,7952919,17942469,11145527,PDP
GB668,,2014,2000,,41888056,227147439,82305749,,34580417,210966517,72118943,,7307639,16180922,10186807,PDP
GB668,,2015,2000,,41585513,225771772,81758425,,35437466,213070599,73350385,,6148047,12701173,8408040,PDP
GB668,,2016,2000,,40994557,224305216,80906516,,36070928,214767762,74285833,,4923629,9537454,6620684,PDP
GB668,,2017,2000,,38620323,219886263,77745993,,36523171,216203409,74993528,,2097152,3682854,2752463,PDP
GB668,,2017,2000,,38620323,219886263,77745993,,36523171,216203409,74993528,,2097152,3682854,2752463,PDP
GB783,,1999,1999,,5296772,21321119,9090565,,0,0,0,,5296772,21321119,9090565,PDP
GB783,,2000,1999,,5296772,21321119,9090565,,0,0,0,,5296772,21321119,9090565,PDP
GB783,,2001,1999,,5621713,21682701,9479845,,0,0,0,,5621713,21682701,9479845,PDP
GB783,,2002,1999,,71422787,171892659,102008669,,0,0,0,,71422787,171892659,102008669,PDP
GB783,,2003,1999,,71422832,171895324,102009188,,0,0,0,,71422832,171895324,102009188,PDP
GB783,,2004,1999,,82568573,187057338,115852797,,177709,330433,236505,,82390864,186726905,115616292,PDP
GB783,,2005,1999,,83128615,190576773,117039073,,9299462,27565121,14204288,,73829153,163011652,102834785,PDP
GB783,,2006,1999,,56707429,158823476,84967834,,17509098,55877539,27451721,,39198331,102945937,57516113,PDP
GB783,,2007,1999,,44620560,131197541,67965318,,20973683,64830668,32509389,,23646877,66366873,35455929,PDP
GB783,,2008,1999,,40562229,125707488,62930109,,23597184,71228621,36271316,,16965045,54478867,26658793,PDP
GB783,,2009,1999,,39475891,124137484,61564410,,27167531,81832041,41728393,,12308360,42305443,19836019,PDP
GB783,,2010,1999,,39475925,124137484,61564444,,29361699,86078554,44678167,,10114226,38058930,16886276,PDP
GB783,,2011,1999,,40554133,120978110,62080486,,30892697,89033041,46734875,,9661436,31945069,15345612,PDP
GB783,,2012,1999,,40554133,120978110,62080486,,31992459,91166651,48214283,,8561674,29811459,13866203,PDP
GB783,,2013,1999,,40554133,120978110,62080486,,33457277,93895193,50164606,,7096856,27082917,11915879,PDP
GB783,,2014,1999,,40402589,119421378,61651944,,34928853,96629542,52122721,,5473736,22791836,9529223,PDP
GB783,,2015,1999,,40402589,119421378,61651944,,36022838,98848042,53611457,,4379751,20573336,8040487,PDP
GB783,,2016,1999,,40402589,119421378,61651944,,37088926,100916418,55045584,,3313663,18504960,6606361,PDP
GB783,,2017,1999,,40403764,119423897,61653567,,37772633,102229635,55962960,,2631131,17194262,5690609,PDP
GB783,,2017,1999,,40403764,119423897,61653567,,37772633,102229635,55962960,,2631131,17194262,5690609,PDP
GB877,,2001,2001,,406188,216680481,38961434,,0,0,0,,406188,216680481,38961434,PDN
GB877,,2002,2001,,406188,216680481,38961434,,0,0,0,,406188,216680481,38961434,PDN
GB877,,2003,2001,,405864,216513844,38931459,,0,0,0,,405864,216513844,38931459,PDN
GB877,,2004,2001,,302703,220434962,39526006,,17422,19356523,3461643,,285281,201078439,36064363,PDN
GB877,,2005,2001,,403612,299187899,53639893,,57351,50618407,9064185,,346261,248569492,44575708,PDN
GB877,,2006,2001,,403612,299187899,53639893,,94195,79146747,14177246,,309417,220041152,39462647,PDN
GB877,,2007,2001,,403612,299187899,53639893,,133746,116801215,20916880,,269866,182386684,32723013,PDN
GB877,,2008,2001,,136750,125093871,22395446,,136750,125093871,22395446,,0,0,0,PDN
GB877,,2009,2001,,136750,125093871,22395446,,136750,125093871,22395446,,0,0,0,PDN
GB877,,2010,2001,,136750,125093871,22395446,,136750,125093871,22395446,,0,0,0,PDN
GB877,,2011,2001,,136750,125093871,22395446,,136750,125093871,22395446,,0,0,0,PDN
GB877,,2012,2001,,136750,125093871,22395446,,136750,125093871,22395446,,0,0,0,PDN
GB877,,2013,2001,,136750,125093871,22395446,,136750,125093871,22395446,,0,0,0,PDN
GB877,,2014,2001,,136750,125093871,22395446,,136750,125093871,22395446,,0,0,0,PDN
GB877,,2015,2001,,136750,125093871,22395446,,136750,125093871,22395446,,0,0,0,PDN
GB877,,2016,2001,,136750,125093871,22395446,,136750,125093871,22395446,,0,0,0,PDN
GB877,,2017,2001,,136750,125093871,22395446,,136750,125093871,22395446,,0,0,0,PDN
GB877,,2017,2001,,136750,125093871,22395446,,136750,125093871,22395446,,0,0,0,PDN
GC006,,1987,1985,,5004746,49600249,13830413,,0,0,0,,5004746,49600249,13830413,PDP
GC006,,1989,1985,,4174867,53022403,13609458,,0,0,0,,4174867,53022403,13609458,PDP
GC006,,1990,1985,,7169230,86392581,22541575,,666392,6886631,1891771,,6502838,79505950,20649804,PDP
GC006,,1991,1985,,9366745,98722008,26932939,,2585826,12916294,4884099,,6780919,85805714,22048840,PDP
GC006,,1992,1985,,9910332,89631744,25859041,,3991581,22396582,7976738,,5918751,67235162,17882303,PDP
GC006,,1993,1985,,9910332,89631744,25859041,,5488785,39409148,12501089,,4421547,50222596,13357952,PDP
GC006,,1994,1985,,10833533,97633300,28206006,,6816234,50157679,15741088,,4017299,47475621,12464918,PDP
GC006,,1995,1985,,10260841,89180912,26129331,,7835645,60207976,18548808,,2425196,28972936,7580523,PDP
GC006,,1996,1985,,10898948,96170850,28011199,,8795627,74121778,21984555,,2103321,22049072,6026644,PDP
GC006,,1997,1985,,11700448,137359964,36141723,,9480173,88419965,25213263,,2220275,48939999,10928460,PDP
GC006,,1998,1985,,11816915,137320279,36251128,,10049557,106415352,28984673,,1767358,30904927,7266455,PDP
GC006,,1999,1985,,11520926,136210606,35757689,,10553996,118091089,31566645,,966930,18119517,4191044,PDP
GC006,,2000,1985,,11845497,151244986,38757416,,10847483,126983409,33442396,,998014,24261577,5315020,PDP
GC006,,2001,1985,,11556228,152760060,38737733,,11017682,132646978,34620347,,538546,20113082,4117386,PDP
GC006,,2002,1985,,11658797,158509261,39863292,,11141292,136833639,35488915,,517505,21675622,4374377,PDP
GC006,,2003,1985,,11658797,158509261,39863292,,11228965,141945738,36486214,,429832,16563523,3377078,PDP
GC006,,2004,1985,,12830084,183532130,45487046,,11284123,148171203,37649106,,1545961,35360927,7837940,PDP
GC006,,2005,1985,,12581860,183076115,45157681,,11651170,155196673,39266236,,930690,27879442,5891445,PDP
GC006,,2006,1985,,12581860,183076115,45157681,,12114452,160911949,40746471,,467408,22164166,4411210,PDP
GC006,,2007,1985,,12297885,177653442,43908818,,12214452,162661024,41157695,,83433,14992418,2751123,PDP
GC006,,2008,1985,,12477838,177905059,44133542,,12422157,164008513,41605166,,55681,13896546,2528376,PDP
GC006,,2009,1985,,12447693,166588697,42089810,,12422157,166040054,41966650,,25536,548643,123159,PDP
GC006,,2010,1985,,13582767,167422998,43373335,,12422157,166040054,41966650,,1160610,1382944,1406685,PDP
GC006,,2011,1985,,13582767,167422998,43373335,,12422157,166040054,41966650,,1160610,1382944,1406685,PDP
GC006,,2012,1985,,13582767,167422998,43373335,,12612198,166314246,42205480,,970569,1108752,1167856,PDP
GC006,,2013,1985,,13582767,167422998,43373335,,13070556,166858425,42760667,,512211,564573,612669,PDP
GC006,,2014,1985,,13582767,167422998,43373335,,13369457,167241331,43127700,,213310,181667,245635,PDP
GC006,,2015,1985,,13584952,167530165,43394589,,13559637,167469086,43358406,,25315,61079,36183,PDP
GC006,,2016,1985,,13825180,167903144,43701184,,13729012,167657710,43561344,,96168,245434,139840,PDP
GC006,,2017,1985,,13936427,168011721,43831750,,13858238,167837522,43722565,,78189,174199,109185,PDP
GC006,,2017,1985,,13936427,168011721,43831750,,13858238,167837522,43722565,,78189,174199,109185,PDP
GC019,,1982,1980,,3200000,7400000,4516726,,0,0,0,,3200000,7400000,4516726,PDP
GC019,,1983,1980,,3200000,7400000,4516726,,0,0,0,,3200000,7400000,4516726,PDP
GC019,,1984,1980,,3200000,7400000,4516726,,0,0,0,,3200000,7400000,4516726,PDP
GC019,,1985,1980,,13961013,20298340,17572817,,0,0,0,,13961013,20298340,17572817,PDP
GC019,,1986,1980,,13961013,20298340,17572817,,0,0,0,,13961013,20298340,17572817,PDP
GC019,,1987,1980,,13961013,20298340,17572817,,383048,315451,439178,,13577965,19982889,17133639,PDP
GC019,,1988,1980,,67219957,71133403,79877146,,4525554,4276518,5286500,,62694403,66856885,74590646,PDP
GC019,,1989,1980,,70588349,96864541,87824032,,11114259,19562151,14595069,,59474090,77302390,73228963,PDP
GC019,,1990,1980,,50394018,123563928,72380482,,17333503,33482656,23291271,,33060515,90081272,49089211,PDP
GC019,,1991,1980,,52945449,126582890,75469095,,24765190,48896627,33465657,,28180259,77686263,42003438,PDP
GC019,,1992,1980,,59039508,117391281,79927636,,30558194,61741236,41544179,,28481314,55650045,38383457,PDP
GC019,,1993,1980,,67736201,125676037,90098485,,36498153,71976435,49305348,,31238048,53699602,40793137,PDP
GC019,,1994,1980,,67935368,125803291,90320295,,43511951,85133098,58660189,,24423417,40670193,31660106,PDP
GC019,,1995,1980,,62276790,121627262,83918652,,48853833,94912766,65742226,,13422957,26714496,18176426,PDP
GC019,,1996,1980,,71862576,131686464,95294331,,55620468,106630167,74593807,,16242108,25056297,20700524,PDP
GC019,,1997,1980,,87408526,152636501,114568046,,63919032,117887806,84895510,,23489494,34748695,29672536,PDP
GC019,,1998,1980,,87429898,152644614,114590861,,70119032,125546820,92458324,,17310866,27097794,22132537,PDP
GC019,,1999,1980,,96349732,164083142,125546021,,78005203,135793743,102167791,,18344529,28289399,23378230,PDP
GC019,,2000,1980,,99450164,170524321,129792570,,83761520,144375393,109451092,,15688644,26148928,20341478,PDP
GC019,,2001,1980,,101373207,171182268,131832685,,87611525,149584511,114227986,,13761682,21597757,17604699,PDP
GC019,,2002,1980,,101933944,172073790,132552056,,89723414,152647258,116884848,,12210530,19426532,15667208,PDP
GC019,,2003,1980,,101788291,171795531,132356891,,91579013,155300055,119212475,,10209278,16495476,13144416,PDP
GC019,,2004,1980,,98573254,166524414,128203933,,92958334,157210909,120931805,,5614920,9313505,7272128,PDP
GC019,,2005,1980,,98435931,164099945,127635209,,94301615,158935499,122581953,,4134316,5164446,5053256,PDP
GC019,,2006,1980,,98435931,164099941,127635209,,95546670,160524416,124109733,,2889261,3575525,3525476,PDP
GC019,,2007,1980,,98435931,164099941,127635209,,96412675,161514793,125151962,,2023256,2585148,2483247,PDP
GC019,,2008,1980,,98437381,164099831,127636639,,96988032,162176374,125845038,,1449349,1923457,1791601,PDP
GC019,,2009,1980,,100169128,168244383,130105853,,97700222,165397602,127130403,,2468906,2846781,2975450,PDP
GC019,,2010,1980,,100169128,168244383,130105853,,98321236,166031293,127864173,,1847892,2213090,2241681,PDP
GC019,,2011,1980,,100169128,168244383,130105853,,98942349,166730470,128609696,,1226779,1513913,1496158,PDP
GC019,,2012,1980,,100406676,168541316,130396236,,99411966,167240281,129170024,,994710,1301035,1226210,PDP
GC019,,2013,1980,,100401156,168274876,130343307,,99756426,167614043,129580991,,644730,660833,762318,PDP
GC019,,2014,1980,,101857546,171534387,132379682,,100405489,168500109,130387716,,1452057,3034278,1991964,PDP
GC019,,2015,1980,,102309576,171827429,132883855,,100791798,168968430,130857358,,1517778,2858999,2026495,PDP
GC019,,2016,1980,,103444239,173064212,134238586,,101359704,169665792,131549350,,2084535,3398420,2689237,PDP
GC019,,2017,1980,,103642898,172255271,134293306,,101899653,170313716,132204587,,1743245,1941555,2088717,PDP
GC019,,2017,1980,,103642898,172255271,134293306,,101899653,170313716,132204587,,1743245,1941555,2088717,PDP
GC020,,1999,1997,,3969053,79103217,18044359,,7314,137716,31819,,3961739,78965501,18012540,PDN
GC020,,2000,1997,,2905679,57910167,13209979,,136351,2726670,621524,,2769328,55183497,12588455,PDN
GC020,,2001,1997,,2604114,54863487,12366300,,209570,4131671,944743,,2394544,50731816,11421557,PDN
GC020,,2002,1997,,1831941,34852666,8033483,,253567,4900370,1125519,,1578374,29952296,6907964,PDN
GC020,,2003,1997,,1831941,34852666,8033483,,294325,5599572,1290690,,1537616,29253094,6742793,PDN
GC020,,2004,1997,,1831941,34852666,8033483,,321392,6080153,1403270,,1510549,28772513,6630213,PDN
GC020,,2005,1997,,1831941,34852666,8033483,,357190,6680210,1545839,,1474751,28172456,6487644,PDN
GC020,,2006,1997,,1831941,34852666,8033483,,378021,7095712,1640603,,1453920,27756954,6392880,PDN
GC020,,2007,1997,,1812820,34404366,7934594,,387380,7306095,1687397,,1425440,27098271,6247197,PDN
GC020,,2008,1997,,1812820,34404366,7934594,,392316,7379280,1705355,,1420504,27025086,6229239,PDN
GC020,,2009,1997,,392316,7379280,1705355,,392316,7379280,1705355,,0,0,0,PDN
GC020,,2010,1997,,399488,7497641,1733588,,392316,7379280,1705355,,7172,118361,28233,PDN
GC020,,2011,1997,,392316,7379280,1705355,,392316,7379280,1705355,,0,0,0,PDN
GC020,,2012,1997,,392316,7379280,1705355,,392316,7379280,1705355,,0,0,0,PDN
GC020,,2013,1997,,399488,7497641,1733588,,399488,7497641,1733588,,0,0,0,PDN
GC020,,2014,1997,,399488,7497641,1733588,,399488,7497641,1733588,,0,0,0,PDN
GC020,,2015,1997,,399488,7497641,1733588,,399488,7497641,1733588,,0,0,0,PDN
GC020,,2016,1997,,399488,7497641,1733588,,399488,7497641,1733588,,0,0,0,PDN
GC020,,2017,1997,,399488,7497641,1733588,,399488,7497641,1733588,,0,0,0,PDN
GC020,,2017,1997,,399488,7497641,1733588,,399488,7497641,1733588,,0,0,0,PDN
GC029,,1986,1984,,1221663,3694093,1878975,,0,0,0,,1221663,3694093,1878975,PDN
GC029,,1987,1984,,10495349,15743024,13296599,,0,0,0,,10495349,15743024,13296599,PDN
GC029,,1988,1984,,10495349,15743024,13296599,,20289,133787,44095,,10475060,15609237,13252504,PDN
GC029,,1989,1984,,10876143,40564010,18093938,,76063,1253945,299185,,10800080,39310065,17794753,PDN
GC029,,1990,1984,,8895766,42654400,16485517,,90291,1597930,374620,,8805475,41056470,16110897,PDN
GC029,,1991,1984,,90291,1597930,374620,,90291,1597930,374620,,0,0,0,PDN
GC029,,1992,1984,,90291,1597930,374620,,90291,1597930,374620,,0,0,0,PDN
GC029,,1993,1984,,90291,1597930,374620,,90291,1597930,374620,,0,0,0,PDN
GC029,,1994,1984,,90291,1597930,374620,,90291,1597930,374620,,0,0,0,PDN
GC029,,1995,1984,,90291,1597930,374620,,90291,1597930,374620,,0,0,0,PDN
GC029,,1996,1984,,90291,1597930,374620,,90291,1597930,374620,,0,0,0,PDN
GC029,,1997,1984,,90291,1597930,374620,,90291,1597930,374620,,0,0,0,PDN
GC029,,1998,1984,,90291,1597930,374620,,90291,1597930,374620,,0,0,0,PDN
GC029,,1999,1984,,90291,1597930,374620,,90291,1597930,374620,,0,0,0,PDN
GC029,,2000,1984,,90291,1597930,374620,,90291,1597930,374620,,0,0,0,PDN
GC029,,2001,1984,,90291,1597930,374620,,90291,1597930,374620,,0,0,0,PDN
GC029,,2002,1984,,90291,1597930,374620,,90291,1597930,374620,,0,0,0,PDN
GC029,,2003,1984,,90291,1597930,374620,,90291,1597930,374620,,0,0,0,PDN
GC029,,2004,1984,,90291,1597930,374620,,90291,1597930,374620,,0,0,0,PDN
GC029,,2005,1984,,90291,1597930,374620,,90291,1597930,374620,,0,0,0,PDN
GC029,,2006,1984,,90291,1597930,374620,,90291,1597930,374620,,0,0,0,PDN
GC029,,2007,1984,,90291,1597930,374620,,90291,1597930,374620,,0,0,0,PDN
GC029,,2008,1984,,90291,1597930,374620,,90291,1597930,374620,,0,0,0,PDN
GC029,,2009,1984,,90291,1629930,380314,,90291,1629930,380314,,0,0,0,PDN
GC029,,2010,1984,,90291,1629930,380314,,90291,1629930,380314,,0,0,0,PDN
GC029,,2011,1984,,90291,1629930,380314,,90291,1629930,380314,,0,0,0,PDN
GC029,,2012,1984,,90291,1629930,380314,,90291,1629930,380314,,0,0,0,PDN
GC029,,2013,1984,,90291,1629930,380314,,90291,1629930,380314,,0,0,0,PDN
GC029,,2014,1984,,90291,1629930,380314,,90291,1629930,380314,,0,0,0,PDN
GC029,,2015,1984,,90291,1629930,380314,,90291,1629930,380314,,0,0,0,PDN
GC029,,2016,1984,,90291,1629930,380314,,90291,1629930,380314,,0,0,0,PDN
GC029,,2017,1984,,90291,1629930,380314,,90291,1629930,380314,,0,0,0,PDN
GC029,,2017,1984,,90291,1629930,380314,,90291,1629930,380314,,0,0,0,PDN
GC045,,1995,1988,,1000824,21951847,4906847,,5616,111120,25388,,995208,21840727,4881459,PDN
GC045,,1996,1988,,3331989,25537521,7876032,,474834,7369330,1786103,,2857155,18168191,6089929,PDN
GC045,,1997,1988,,3356642,28894459,8498005,,800218,11548108,2855041,,2556424,17346351,5642964,PDN
GC045,,1998,1988,,3900427,29419212,9135162,,990635,14108600,3501062,,2909792,15310612,5634100,PDN
GC045,,1999,1988,,4608420,24875095,9034593,,1998871,16250447,4890410,,2609549,8624648,4144183,PDN
GC045,,2000,1988,,5089110,25348397,9599501,,2622304,17613083,5756305,,2466806,7735314,3843196,PDN
GC045,,2001,1988,,5089110,25348397,9599501,,3117465,18191304,6354352,,1971645,7157093,3245149,PDN
GC045,,2002,1988,,4258053,21250751,8039325,,3467515,18794180,6811675,,790538,2456571,1227650,PDN
GC045,,2003,1988,,4249812,21301728,8040155,,3655486,19368657,7101866,,594326,1933071,938289,PDN
GC045,,2004,1988,,4482317,22072239,8409762,,3832645,19732141,7343702,,649672,2340098,1066060,PDN
GC045,,2005,1988,,4728473,21541148,8561417,,4070789,20327744,7687825,,657684,1213404,873592,PDN
GC045,,2006,1988,,4761045,21925559,8662390,,4306696,20745053,7997987,,454349,1180506,664403,PDN
GC045,,2007,1988,,4761045,21925559,8662390,,4520597,21356842,8320747,,240448,568717,341643,PDN
GC045,,2008,1988,,4761045,21925559,8662390,,4588749,21611259,8434169,,172296,314300,228221,PDN
GC045,,2009,1988,,4880698,22815490,8940395,,4721039,22352888,8698424,,159659,462602,241972,PDN
GC045,,2010,1988,,4880698,22815490,8940395,,4725070,22387912,8708686,,155628,427578,231708,PDN
GC045,,2011,1988,,4880698,22815490,8940395,,4846908,22718649,8889374,,33790,96841,51021,PDN
GC045,,2012,1988,,4880698,22815490,8940395,,4880698,22815490,8940395,,0,0,0,PDN
GC045,,2013,1988,,4880698,22815490,8940395,,4880698,22815490,8940395,,0,0,0,PDN
GC045,,2014,1988,,4880698,22815490,8940395,,4880698,22815490,8940395,,0,0,0,PDN
GC045,,2015,1988,,4880698,22815490,8940395,,4880698,22815490,8940395,,0,0,0,PDN
GC045,,2016,1988,,4880698,22815490,8940395,,4880698,22815490,8940395,,0,0,0,PDN
GC045,,2017,1988,,4880698,22815490,8940395,,4880698,22815490,8940395,,0,0,0,PDN
GC045,,2017,1988,,4880698,22815490,8940395,,4880698,22815490,8940395,,0,0,0,PDN
GC052,,1986,1984,,4309592,4309592,5076423,,0,0,0,,4309592,4309592,5076423,PDP
GC052,,1987,1984,,4309592,4309592,5076423,,0,0,0,,4309592,4309592,5076423,PDP
GC052,,1989,1984,,32353913,27565535,37258812,,0,0,0,,32353913,27565535,37258812,PDP
GC052,,1990,1984,,33011422,28119809,38014947,,0,0,0,,33011422,28119809,38014947,PDP
GC052,,1991,1984,,33011422,28119809,38014947,,0,0,0,,33011422,28119809,38014947,PDP
GC052,,1992,1984,,17020224,25798433,21610693,,6404321,7936290,7816472,,10615903,17862143,13794221,PDP
GC052,,1993,1984,,17020224,25798425,21610691,,7866688,9592380,9573517,,9153536,16206045,12037174,PDP
GC052,,1994,1984,,17018975,25774922,21605260,,8964193,10453786,10824297,,8054782,15321136,10780963,PDP
GC052,,1995,1984,,17130310,21230615,20908000,,10271510,11635524,12341888,,6858800,9595091,8566112,PDP
GC052,,1996,1984,,16128089,18650293,19446646,,11125876,12424201,13336588,,5002213,6226092,6110058,PDP
GC052,,1997,1984,,16467489,19816830,19993615,,11765173,13037078,14084938,,4702316,6779752,5908677,PDP
GC052,,1998,1984,,16467489,19816830,19993615,,12239053,13555195,14651009,,4228436,6261635,5342606,PDP
GC052,,1999,1984,,15909788,19723750,19419352,,12626419,13941799,15107166,,3283369,5781951,4312186,PDP
GC052,,2000,1984,,15643850,19162705,19053584,,12970668,14242764,15504968,,2673182,4919941,3548616,PDP
GC052,,2001,1984,,15650395,18769633,18990187,,13295733,14513718,15878245,,2354662,4255915,3111942,PDP
GC052,,2002,1984,,15867542,18977497,19244321,,13586693,14762918,16213547,,2280849,4214579,3030774,PDP
GC052,,2003,1984,,15916758,19006742,19298741,,13839479,14963030,16501940,,2077279,4043712,2796801,PDP
GC052,,2004,1984,,16482672,18351135,19747999,,14100229,15152141,16796339,,2382443,3198994,2951660,PDP
GC052,,2005,1984,,16353499,18192571,19590611,,14282515,15297056,17004411,,2070984,2895515,2586200,PDP
GC052,,2006,1984,,16774827,18708293,20103705,,14533992,15491880,17290554,,2240835,3216413,2813151,PDP
GC052,,2007,1984,,16774827,18708293,20103705,,14685370,15659136,17471693,,2089457,3049157,2632012,PDP
GC052,,2008,1984,,16774818,18708170,20103674,,14791641,15750631,17594244,,1983177,2957539,2509430,PDP
GC052,,2009,1984,,16928157,19102613,20327199,,14857195,16049985,17713065,,2070962,3052628,2614134,PDP
GC052,,2010,1984,,16928157,19102613,20327199,,15012015,16221041,17898323,,1916142,2881572,2428877,PDP
GC052,,2011,1984,,17080306,19191624,20495185,,15145898,16315216,18048962,,1934408,2876408,2446224,PDP
GC052,,2012,1984,,17080306,19191624,20495185,,15301768,16404435,18220707,,1778538,2787189,2274479,PDP
GC052,,2013,1984,,17345946,19339258,20787093,,15488281,16500012,18424228,,1857665,2839246,2362867,PDP
GC052,,2014,1984,,17546827,19586746,21032011,,15658085,16650295,18620771,,1888742,2936451,2411241,PDP
GC052,,2015,1984,,17623422,19665158,21122559,,15814153,16802945,18804003,,1809269,2862213,2318560,PDP
GC052,,2016,1984,,17679212,19767346,21196532,,15937125,16935195,18950505,,1742087,2832151,2246029,PDP
GC052,,2017,1984,,17880092,19891242,21419459,,16070498,17065526,19107069,,1809594,2825716,2312391,PDP
GC052,,2017,1984,,17880092,19891242,21419459,,16070498,17065526,19107069,,1809594,2825716,2312391,PDP
GC060,,1986,1984,,1031852,1031852,1215456,,0,0,0,,1031852,1031852,1215456,PDP
GC060,,1987,1984,,1031852,1031852,1215456,,0,0,0,,1031852,1031852,1215456,PDP
GC060,,1993,1984,,4553257,10035732,6338974,,0,0,0,,4553257,10035732,6338974,PDP
GC060,,1994,1984,,4543587,10024128,6327240,,0,0,0,,4543587,10024128,6327240,PDP
GC060,,1995,1984,,4543587,10024128,6327240,,0,0,0,,4543587,10024128,6327240,PDP
GC060,,1996,1984,,2372667,9154691,4001616,,67033,774072,204768,,2305634,8380619,3796848,PDP
GC060,,1997,1984,,2353055,9092411,3970922,,329115,1634852,620014,,2023940,7457559,3350908,PDP
GC060,,1998,1984,,2353055,9092411,3970922,,544169,2175529,931274,,1808886,6916882,3039648,PDP
GC060,,1999,1984,,8815333,33385501,14755814,,702757,2453589,1139339,,8112576,30931912,13616475,PDP
GC060,,2000,1984,,9102819,35597363,15436869,,808424,2651111,1280152,,8294395,32946252,14156717,PDP
GC060,,2001,1984,,8857581,28652107,13955821,,1113078,2990491,1645194,,7744503,25661616,12310627,PDP
GC060,,2002,1984,,8857195,28651672,13955357,,1495765,3463884,2112114,,7361430,25187788,11843243,PDP
GC060,,2003,1984,,2896461,10193291,4710214,,1654781,3663585,2306664,,1241680,6529706,2403550,PDP
GC060,,2004,1984,,2896461,10193291,4710214,,1703844,3698994,2362028,,1192617,6494297,2348186,PDP
GC060,,2005,1984,,1781902,8768758,3342179,,1744376,3728811,2407866,,37526,5039947,934313,PDP
GC060,,2006,1984,,1947416,8920175,3534636,,1785952,3759363,2454878,,161464,5160812,1079758,PDP
GC060,,2007,1984,,1947416,8920175,3534636,,1821168,3791263,2495770,,126248,5128912,1038866,PDP
GC060,,2008,1984,,1947416,8920175,3534636,,1842863,3808901,2520603,,104553,5111274,1014033,PDP
GC060,,2009,1984,,1947994,9023051,3553520,,1864526,3869510,2553051,,83468,5153541,1000468,PDP
GC060,,2010,1984,,2003165,9165340,3634009,,1890095,3901911,2584386,,113070,5263429,1049623,PDP
GC060,,2011,1984,,2003165,9165340,3634009,,1910891,3929864,2610156,,92274,5235476,1023854,PDP
GC060,,2012,1984,,2003165,9165340,3634009,,1930998,3952116,2634222,,72167,5213224,999787,PDP
GC060,,2013,1984,,2003165,9165340,3634009,,1956893,3978347,2664784,,46272,5186993,969224,PDP
GC060,,2014,1984,,2135424,9490886,3824194,,2026870,4050385,2747580,,108554,5440501,1076614,PDP
GC060,,2015,1984,,2146761,9478870,3833393,,2088685,4083593,2815304,,58076,5395277,1018089,PDP
GC060,,2016,1984,,2180014,9287415,3832579,,2129902,4111605,2861505,,50112,5175810,971074,PDP
GC060,,2017,1984,,2209625,8083301,3647935,,2172522,4139589,2909104,,37103,3943712,738831,PDP
GC060,,2017,1984,,2209625,8083301,3647935,,2172522,4139589,2909104,,37103,3943712,738831,PDP
GC065,,1985,1983,,70053670,159186314,98378637,,0,0,0,,70053670,159186314,98378637,PDP
GC065,,1986,1983,,70053670,159186314,98378637,,0,0,0,,70053670,159186314,98378637,PDP
GC065,,1987,1983,,69953426,159061510,98256186,,0,0,0,,69953426,159061510,98256186,PDP
GC065,,1988,1983,,65013324,152450304,92139713,,0,0,0,,65013324,152450304,92139713,PDP
GC065,,1989,1983,,117771583,123514193,139749197,,876503,937060,1043240,,116895080,122577133,138705957,PDP
GC065,,1990,1983,,113500958,146794289,139620938,,5552082,6364165,6684496,,107948876,140430124,132936442,PDP
GC065,,1991,1983,,106848668,168647735,136857162,,13748515,17432055,16850304,,93100153,151215680,120006858,PDP
GC065,,1992,1983,,122240927,173276905,153073117,,32534272,43135456,40209620,,89706655,130141449,112863497,PDP
GC065,,1993,1983,,131771157,213958998,169842153,,50974679,77205697,64712348,,80796478,136753301,105129805,PDP
GC065,,1994,1983,,142840839,229270390,183636282,,66844907,100616131,84748133,,75995932,128654259,98888149,PDP
GC065,,1995,1983,,143273945,198706462,178630967,,80397397,117494344,101303864,,62876548,81212118,77327103,PDP
GC065,,1996,1983,,141807112,205033315,178289908,,88797788,130688483,112051966,,53009324,74344832,66237942,PDP
GC065,,1997,1983,,127383165,191603440,161476304,,92159731,136404687,116431028,,35223434,55198753,45045276,PDP
GC065,,1998,1983,,128940713,210082714,166321979,,95486224,146246419,121508718,,33454489,63836295,44813261,PDP
GC065,,1999,1983,,134061017,210587106,171532032,,98355095,156466964,126196192,,35705922,54120142,45335840,PDP
GC065,,2000,1983,,134124401,207898246,171116971,,100638137,160634866,129220853,,33486264,47263380,41896118,PDP
GC065,,2001,1983,,134366371,207515933,171290914,,102518226,163857127,131674298,,31848145,43658806,39616616,PDP
GC065,,2002,1983,,134512760,207260132,171391787,,104058725,166303346,133650068,,30454035,40956786,37741719,PDP
GC065,,2003,1983,,134593416,207411120,171499309,,105397479,168162577,135319646,,29195937,39248543,36179663,PDP
GC065,,2004,1983,,134593416,207411120,171499309,,106183870,169250577,136299631,,28409546,38160543,35199678,PDP
GC065,,2005,1983,,137024777,233000306,178483906,,106745798,170065348,137006536,,30278979,62934958,41477370,PDP
GC065,,2006,1983,,137024777,233000306,178483906,,108870544,179607015,140829088,,28154233,53393291,37654818,PDP
GC065,,2007,1983,,139049991,221017213,178376897,,111049093,184953830,143959027,,28000898,36063383,34417870,PDP
GC065,,2008,1983,,139049991,221017213,178376897,,112086139,186303089,145236155,,26963852,34714124,33140742,PDP
GC065,,2009,1983,,116343912,193633856,150798335,,113538251,190957553,147516463,,2805661,2676303,3281872,PDP
GC065,,2010,1983,,117377947,196098969,152271002,,114586886,192262776,148797344,,2791061,3836193,3473658,PDP
GC065,,2011,1983,,118490616,197480582,153629510,,115553153,193377586,149961976,,2937463,4102996,3667534,PDP
GC065,,2012,1983,,119041918,197974078,154268622,,116668077,194616379,151297326,,2373841,3357699,2971296,PDP
GC065,,2013,1983,,119552050,198677550,154903927,,117573096,195692340,152393797,,1978954,2985210,2510130,PDP
GC065,,2014,1983,,121774316,205165384,158280611,,119221276,199059886,154641183,,2553040,6105498,3639425,PDP
GC065,,2015,1983,,122228615,208703814,159364525,,120462980,202589363,156510908,,1765635,6114451,2853616,PDP
GC065,,2016,1983,,123120030,210565750,160587243,,121483289,205978863,158134330,,1636741,4586887,2452911,PDP
GC065,,2017,1983,,123808711,211916803,161516326,,122141397,207585386,159078299,,1667314,4331417,2438029,PDP
GC065,,2017,1983,,123808711,211916803,161516326,,122141397,207585386,159078299,,1667314,4331417,2438029,PDP
GC072,,1989,1985,,1554194,73016748,14546498,,0,0,0,,1554194,73016748,14546498,PDN
GC072,,1990,1985,,1554194,73016748,14546498,,0,0,0,,1554194,73016748,14546498,PDN
GC072,,1991,1985,,1554194,73016748,14546498,,0,0,0,,1554194,73016748,14546498,PDN
GC072,,1992,1985,,1554194,73016748,14546498,,0,0,0,,1554194,73016748,14546498,PDN
GC072,,1993,1985,,1554194,73016748,14546498,,0,0,0,,1554194,73016748,14546498,PDN
GC072,,1994,1985,,1554560,73017114,14546929,,0,0,0,,1554560,73017114,14546929,PDN
GC072,,1995,1985,,7367,73675743,13116930,,0,0,0,,7367,73675743,13116930,PDN
GC072,,1996,1985,,4869517,77447524,18650215,,1154883,13722709,3596646,,3714634,63724815,15053569,PDN
GC072,,1997,1985,,9772056,142200854,35074699,,2677460,37709338,9387307,,7094596,104491516,25687392,PDN
GC072,,1998,1985,,9771813,142196248,35073636,,3097690,44490014,11014063,,6674123,97706234,24059573,PDN
GC072,,1999,1985,,9771813,142196248,35073636,,3836700,56087636,13816706,,5935113,86108612,21256930,PDN
GC072,,2000,1985,,11185227,146215923,37202295,,5051579,77761748,18888189,,6133648,68454175,18314106,PDN
GC072,,2001,1985,,12125527,177455319,43701207,,6156905,97560990,23516512,,5968622,79894329,20184695,PDN
GC072,,2002,1985,,11871631,195898602,46729033,,7567665,129166195,30550974,,4303966,66732407,16178059,PDN
GC072,,2003,1985,,13481392,226942992,53862707,,8793257,158004628,36907959,,4688135,68938364,16954748,PDN
GC072,,2004,1985,,13481392,226942992,53862707,,9718543,177105715,41232015,,3762849,49837277,12630692,PDN
GC072,,2005,1985,,14088043,255665232,59580077,,10394297,193146241,44761956,,3693746,62518991,14818121,PDN
GC072,,2006,1985,,14088043,255665232,59580077,,10847899,206477396,47587649,,3240144,49187836,11992428,PDN
GC072,,2007,1985,,15084442,247983762,59209666,,11428136,215844591,49834647,,3656306,32139171,9375019,PDN
GC072,,2008,1985,,15084442,247983764,59209666,,11868350,220606459,51122168,,3216092,27377305,8087498,PDN
GC072,,2009,1985,,14271336,250874917,58911000,,12253607,224400132,52182456,,2017729,26474785,6728544,PDN
GC072,,2010,1985,,13431243,241609994,56422345,,12253607,224400132,52182456,,1177636,17209862,4239889,PDN
GC072,,2011,1985,,13431243,241609994,56422345,,12256293,224403183,52185685,,1174950,17206811,4236659,PDN
GC072,,2012,1985,,13355740,239798790,56024564,,12283116,224888887,52298933,,1072624,14909903,3725631,PDN
GC072,,2013,1985,,13355740,239798790,56024564,,12283116,224888887,52298933,,1072624,14909903,3725631,PDN
GC072,,2014,1985,,13355740,239798790,56024564,,12283116,224888887,52298933,,1072624,14909903,3725631,PDN
GC072,,2015,1985,,12283116,224888887,52298933,,12283116,224888887,52298933,,0,0,0,PDN
GC072,,2016,1985,,12283116,224888887,52298933,,12283116,224888887,52298933,,0,0,0,PDN
GC072,,2017,1985,,12283116,224888887,52298933,,12283116,224888887,52298933,,0,0,0,PDN
GC072,,2017,1985,,12283116,224888887,52298933,,12283116,224888887,52298933,,0,0,0,PDN
GC075,,1987,1985,,1916045,9580228,3620712,,0,0,0,,1916045,9580228,3620712,PDN
GC075,,1989,1985,,2744842,18970032,6120293,,442119,3688864,1098500,,2302723,15281168,5021793,PDN
GC075,,1990,1985,,442119,3688864,1098500,,442119,3688864,1098500,,0,0,0,PDN
GC075,,1991,1985,,442119,3688864,1098500,,442119,3688864,1098500,,0,0,0,PDN
GC075,,1992,1985,,442119,3688864,1098500,,442119,3688864,1098500,,0,0,0,PDN
GC075,,1993,1985,,442119,3688864,1098500,,442119,3688864,1098500,,0,0,0,PDN
GC075,,1994,1985,,442119,3688864,1098500,,442119,3688864,1098500,,0,0,0,PDN
GC075,,1995,1985,,442119,3688864,1098500,,442119,3688864,1098500,,0,0,0,PDN
GC075,,1996,1985,,442119,3688864,1098500,,442119,3688864,1098500,,0,0,0,PDN
GC075,,1997,1985,,442119,3688864,1098500,,442119,3688864,1098500,,0,0,0,PDN
GC075,,1998,1985,,442119,3688864,1098500,,442119,3688864,1098500,,0,0,0,PDN
GC075,,1999,1985,,442119,3688864,1098500,,442119,3688864,1098500,,0,0,0,PDN
GC075,,2000,1985,,442119,3688864,1098500,,442119,3688864,1098500,,0,0,0,PDN
GC075,,2001,1985,,442119,3688864,1098500,,442119,3688864,1098500,,0,0,0,PDN
GC075,,2002,1985,,442119,3688864,1098500,,442119,3688864,1098500,,0,0,0,PDN
GC075,,2003,1985,,442119,3688864,1098500,,442119,3688864,1098500,,0,0,0,PDN
GC075,,2004,1985,,442119,3688864,1098500,,442119,3688864,1098500,,0,0,0,PDN
GC075,,2005,1985,,442119,3688864,1098500,,442119,3688864,1098500,,0,0,0,PDN
GC075,,2006,1985,,442119,3688864,1098500,,442119,3688864,1098500,,0,0,0,PDN
GC075,,2007,1985,,442119,3688864,1098500,,442119,3688864,1098500,,0,0,0,PDN
GC075,,2008,1985,,442119,3688864,1098500,,442119,3688864,1098500,,0,0,0,PDN
GC075,,2009,1985,,442119,3762742,1111646,,442119,3762742,1111646,,0,0,0,PDN
GC075,,2010,1985,,442119,3762742,1111646,,442119,3762742,1111646,,0,0,0,PDN
GC075,,2011,1985,,442119,3762742,1111646,,442119,3762742,1111646,,0,0,0,PDN
GC075,,2012,1985,,442119,3762742,1111646,,442119,3762742,1111646,,0,0,0,PDN
GC075,,2013,1985,,442119,3762742,1111646,,442119,3762742,1111646,,0,0,0,PDN
GC075,,2014,1985,,442119,3762742,1111646,,442119,3762742,1111646,,0,0,0,PDN
GC075,,2015,1985,,442119,3762742,1111646,,442119,3762742,1111646,,0,0,0,PDN
GC075,,2016,1985,,442119,3762742,1111646,,442119,3762742,1111646,,0,0,0,PDN
GC075,,2017,1985,,442119,3762742,1111646,,442119,3762742,1111646,,0,0,0,PDN
GC075,,2017,1985,,442119,3762742,1111646,,442119,3762742,1111646,,0,0,0,PDN
GC110,,1988,1987,,4940102,6611206,6116473,,0,0,0,,4940102,6611206,6116473,PDP
GC110,,1989,1987,,12958632,11040755,14923179,,0,0,0,,12958632,11040755,14923179,PDP
GC110,,1990,1987,,2065251,2271776,2469482,,0,0,0,,2065251,2271776,2469482,PDP
GC110,,1991,1987,,2065251,2271776,2469482,,0,0,0,,2065251,2271776,2469482,PDP
GC110,,1992,1987,,1497461,1647208,1790559,,0,0,0,,1497461,1647208,1790559,PDP
GC110,,1993,1987,,1497461,1647208,1790559,,0,0,0,,1497461,1647208,1790559,PDP
GC110,,1994,1987,,1223970,1346367,1463537,,0,0,0,,1223970,1346367,1463537,PDP
GC110,,1995,1987,,1223970,1346367,1463537,,0,0,0,,1223970,1346367,1463537,PDP
GC110,,1996,1987,,5464045,8185139,6920475,,1502978,2047176,1867244,,3961067,6137963,5053231,PDP
GC110,,1997,1987,,4814346,7552656,6158235,,2292010,3359463,2889779,,2522336,4193193,3268456,PDP
GC110,,1998,1987,,5315731,8957666,6909622,,3123388,4860200,3988192,,2192343,4097466,2921430,PDP
GC110,,1999,1987,,18793231,29173916,23984320,,3740999,6080098,4822867,,15052232,23093818,19161453,PDP
GC110,,2000,1987,,19876989,30799553,25357337,,4211585,6963280,5450603,,15665404,23836273,19906734,PDP
GC110,,2001,1987,,13984944,23117031,18098295,,4309432,7137736,5579492,,9675512,15979295,12518803,PDP
GC110,,2002,1987,,12784947,21335392,16581280,,5026283,8292395,6501798,,7758664,13042997,10079482,PDP
GC110,,2003,1987,,17348831,27040247,22160263,,7690362,12730867,9955641,,9658469,14309380,12204622,PDP
GC110,,2004,1987,,15126773,23352482,19282019,,8734887,14580025,11329197,,6391886,8772457,7952822,PDP
GC110,,2005,1987,,22552537,35865500,28934299,,9778453,16311567,12680867,,12774084,19553933,16253432,PDP
GC110,,2006,1987,,22552537,35865500,28934299,,15586855,24770885,19994486,,6965682,11094615,8939813,PDP
GC110,,2007,1987,,21667785,33261599,27586219,,19990762,30795718,25470427,,1677023,2465881,2115792,PDP
GC110,,2008,1987,,26080880,40322727,33255742,,21189706,32813702,27028443,,4891174,7509025,6227299,PDP
GC110,,2009,1987,,26080880,40411413,33271524,,22526593,35179633,28786315,,3554287,5231780,4485209,PDP
GC110,,2010,1987,,28031560,43474356,35767212,,24052600,37558147,30735546,,3978960,5916209,5031666,PDP
GC110,,2011,1987,,28031560,43474356,35767212,,25037681,38971576,31972126,,2993879,4502780,3795085,PDP
GC110,,2012,1987,,28031560,43474356,35767212,,25901205,40368613,33084234,,2130355,3105743,2682979,PDP
GC110,,2013,1987,,28031560,43474356,35767212,,26625360,41513645,34012130,,1406200,1960711,1755081,PDP
GC110,,2014,1987,,28031560,43474356,35767212,,27147706,42309922,34676163,,883854,1164434,1091048,PDP
GC110,,2015,1987,,29117406,45172931,37155295,,28094490,43879722,35902270,,1022916,1293209,1253024,PDP
GC110,,2016,1987,,29297868,45666925,37423657,,28739374,45007043,36747745,,558494,659882,675911,PDP
GC110,,2017,1987,,29464072,46007311,37650428,,29089745,45572244,37198686,,374327,435067,451740,PDP
GC110,,2017,1987,,29464072,46007311,37650428,,29089745,45572244,37198686,,374327,435067,451740,PDP
GC112,,1997,1997,,20932479,55715807,30846324,,0,0,0,,20932479,55715807,30846324,PDP
GC112,,1998,1997,,20932425,55710355,30845299,,0,0,0,,20932425,55710355,30845299,PDP
GC112,,1999,1997,,27248400,40872601,34521104,,2615589,3726355,3278641,,24632811,37146246,31242463,PDP
GC112,,2000,1997,,29530528,44280604,37409639,,13233978,19810276,16758938,,16296550,24470328,20650701,PDP
GC112,,2001,1997,,34348095,51360567,43486986,,20654249,30946526,26160748,,13693846,20414041,17326238,PDP
GC112,,2002,1997,,37009551,55275564,46845061,,25775018,38537307,32632190,,11234533,16738257,14212871,PDP
GC112,,2003,1997,,37009551,55275564,46845061,,29253831,43648920,37020543,,7755720,11626644,9824518,PDP
GC112,,2004,1997,,39099951,58464591,49502903,,31428896,46933781,39780103,,7671055,11530810,9722800,PDP
GC112,,2005,1997,,39648818,59146832,50173166,,32889675,49101520,41626600,,6759143,10045312,8546566,PDP
GC112,,2006,1997,,39648818,59146832,50173166,,34295146,51155766,43397595,,5353672,7991066,6775571,PDP
GC112,,2007,1997,,39648818,59146832,50173166,,35326636,52758814,44714325,,4322182,6388018,5458841,PDP
GC112,,2008,1997,,41899172,62575768,53033651,,36048519,53842757,45629081,,5850653,8733011,7404570,PDP
GC112,,2009,1997,,39402024,58830046,49870004,,36683517,54838868,46441323,,2718507,3991178,3428681,PDP
GC112,,2010,1997,,41394934,62853652,52578858,,37262560,55894974,47208285,,4132374,6958678,5370573,PDP
GC112,,2011,1997,,41394934,62853652,52578858,,37639845,56622465,47715017,,3755089,6231187,4863841,PDP
GC112,,2012,1997,,41394934,62853652,52578858,,38142191,57611884,48393416,,3252743,5241768,4185442,PDP
GC112,,2013,1997,,41394934,62853652,52578858,,38588148,58326679,48966561,,2806786,4526973,3612297,PDP
GC112,,2014,1997,,41394934,62853652,52578858,,39077114,59050738,49584364,,2317820,3802914,2994495,PDP
GC112,,2015,1997,,41394934,62853652,52578858,,39739420,60078549,50429554,,1655514,2775103,2149304,PDP
GC112,,2016,1997,,42335473,64469782,53806965,,40560080,61541035,51510442,,1775393,2928747,2296522,PDP
GC112,,2017,1997,,42837621,65207093,54440306,,41446866,63021203,52660603,,1390755,2185890,1779704,PDP
GC112,,2017,1997,,42837621,65207093,54440306,,41446866,63021203,52660603,,1390755,2185890,1779704,PDP
GC116,,1987,1985,,2917511,76162874,16469624,,0,0,0,,2917511,76162874,16469624,PDN
GC116,,1989,1985,,12415,124145373,22102339,,0,0,0,,12415,124145373,22102339,PDN
GC116,,1990,1985,,12415,124145373,22102339,,0,0,0,,12415,124145373,22102339,PDN
GC116,,1991,1985,,12415,124145373,22102339,,0,0,0,,12415,124145373,22102339,PDN
GC116,,1992,1985,,12415,124145373,22102339,,0,0,0,,12415,124145373,22102339,PDN
GC116,,1993,1985,,12415,124145373,22102339,,0,0,0,,12415,124145373,22102339,PDN
GC116,,1994,1985,,12414,124145373,22102338,,0,0,0,,12414,124145373,22102338,PDN
GC116,,1995,1985,,749385,32728005,6572873,,0,0,0,,749385,32728005,6572873,PDN
GC116,,1996,1985,,7557499,189485421,41273766,,1181383,31211264,6734989,,6376116,158274157,34538777,PDN
GC116,,1997,1985,,7866684,227044234,48266014,,1829193,53950298,11428890,,6037491,173093936,36837124,PDN
GC116,,1998,1985,,7869976,227149560,48288048,,3137130,100046566,20939010,,4732846,127102994,27349038,PDN
GC116,,1999,1985,,7869976,227149560,48288048,,4251061,139549519,29081936,,3618915,87600041,19206112,PDN
GC116,,2000,1985,,9670282,261355386,56174800,,5049740,168254969,34988347,,4620542,93100417,21186453,PDN
GC116,,2001,1985,,8897230,260088705,55176359,,5359399,185154689,38305073,,3537831,74934016,16871286,PDN
GC116,,2002,1985,,8546780,260456965,54891435,,5493824,192920453,39821307,,3052956,67536512,15070128,PDN
GC116,,2003,1985,,8546780,260456965,54891435,,5625314,201332794,41449655,,2921466,59124171,13441780,PDN
GC116,,2004,1985,,8546780,260456965,54891435,,5690888,209279185,42929177,,2855892,51177780,11962258,PDN
GC116,,2005,1985,,8418417,257069059,54160242,,5744758,215530033,44095298,,2673659,41539026,10064944,PDN
GC116,,2006,1985,,8418417,257069059,54160242,,5802952,219501983,44860244,,2615465,37567076,9299998,PDN
GC116,,2007,1985,,8418417,257069059,54160242,,5803593,219783030,44910894,,2614824,37286029,9249348,PDN
GC116,,2008,1985,,8418417,257069059,54160242,,5803549,219783030,44910850,,2614868,37286029,9249392,PDN
GC116,,2009,1985,,7559440,256049952,53119930,,5803549,221483358,45213399,,1755891,34566594,7906531,PDN
GC116,,2010,1985,,7559440,256049952,53119930,,5803549,221483358,45213399,,1755891,34566594,7906531,PDN
GC116,,2011,1985,,7397766,251773494,52197320,,5803549,221483358,45213399,,1594217,30290136,6983921,PDN
GC116,,2012,1985,,8438980,260521385,54795098,,6033329,227278713,46474381,,2405651,33242672,8320717,PDN
GC116,,2013,1985,,8438980,260521385,54795098,,6341954,235698764,48281235,,2097026,24822621,6513863,PDN
GC116,,2014,1985,,8438980,260521385,54795098,,6525369,240500185,49318996,,1913611,20021200,5476102,PDN
GC116,,2015,1985,,6701047,244167934,50147298,,6596159,242175063,49687807,,104888,1992871,459491,PDN
GC116,,2016,1985,,6595349,242175063,49686997,,6595349,242175063,49686997,,0,0,0,PDN
GC116,,2017,1985,,6596748,242175238,49688427,,6596748,242175238,49688427,,0,0,0,PDN
GC116,,2017,1985,,6596748,242175238,49688427,,6596748,242175238,49688427,,0,0,0,PDN
GC136,,1983,1981,,720000,11360000,2741352,,0,0,0,,720000,11360000,2741352,PDN
GC136,,1984,1981,,720000,11360000,2741352,,0,0,0,,720000,11360000,2741352,PDN
GC136,,1985,1981,,1552650,14989540,4219828,,0,0,0,,1552650,14989540,4219828,PDN
GC136,,1986,1981,,1552650,14989540,4219828,,0,0,0,,1552650,14989540,4219828,PDN
GC136,,1987,1981,,1552650,14989540,4219828,,0,0,0,,1552650,14989540,4219828,PDN
GC136,,1993,1981,,2986825,44964643,10987651,,0,0,0,,2986825,44964643,10987651,PDN
GC136,,1994,1981,,2986824,44964642,10987650,,0,0,0,,2986824,44964642,10987650,PDN
GC136,,1995,1981,,486128,55141878,10297850,,4480,1190892,216382,,481648,53950986,10081468,PDN
GC136,,1996,1981,,486092,54789294,10235077,,170910,19611070,3660424,,315182,35178224,6574653,PDN
GC136,,1997,1981,,395590,73573540,13486967,,222343,32458998,5997965,,173247,41114542,7489002,PDN
GC136,,1998,1981,,395590,73573540,13486967,,250994,42447827,7803988,,144596,31125713,5682979,PDN
GC136,,1999,1981,,395590,73573540,13486967,,265722,50698621,9286829,,129868,22874919,4200138,PDN
GC136,,2000,1981,,2292721,77245869,16037537,,272384,56145628,10262709,,2020337,21100241,5774828,PDN
GC136,,2001,1981,,2175017,90432320,18266177,,272893,60245764,10992780,,1902124,30186556,7273397,PDN
GC136,,2002,1981,,2175017,85804665,17442751,,272910,62415214,11378820,,1902107,23389451,6063931,PDN
GC136,,2003,1981,,2175017,85804665,17442751,,272910,70701866,12853313,,1902107,15102799,4589438,PDN
GC136,,2004,1981,,2174743,77573734,15977898,,272910,73123124,13284142,,1901833,4450610,2693756,PDN
GC136,,2005,1981,,272910,73250292,13306770,,272910,73250292,13306770,,0,0,0,PDN
GC136,,2006,1981,,272910,73250292,13306770,,272910,73250292,13306770,,0,0,0,PDN
GC136,,2007,1981,,272910,73250292,13306770,,272910,73250292,13306770,,0,0,0,PDN
GC136,,2008,1981,,272910,73250292,13306770,,272910,73250292,13306770,,0,0,0,PDN
GC136,,2009,1981,,272910,74040709,13447413,,272910,74040709,13447413,,0,0,0,PDN
GC136,,2010,1981,,272910,74040709,13447413,,272910,74040709,13447413,,0,0,0,PDN
GC136,,2011,1981,,272910,74040709,13447413,,272910,74040709,13447413,,0,0,0,PDN
GC136,,2012,1981,,272910,74040709,13447413,,272910,74040709,13447413,,0,0,0,PDN
GC136,,2013,1981,,272910,74040709,13447413,,272910,74040709,13447413,,0,0,0,PDN
GC136,,2014,1981,,272910,74040709,13447413,,272910,74040709,13447413,,0,0,0,PDN
GC136,,2015,1981,,272910,74040709,13447413,,272910,74040709,13447413,,0,0,0,PDN
GC136,,2016,1981,,272910,74040709,13447413,,272910,74040709,13447413,,0,0,0,PDN
GC136,,2017,1981,,272910,74040709,13447413,,272910,74040709,13447413,,0,0,0,PDN
GC136,,2017,1981,,272910,74040709,13447413,,272910,74040709,13447413,,0,0,0,PDN
GC137,,2004,2004,,2244,15655520,2787924,,0,0,0,,2244,15655520,2787924,PDP
GC137,,2005,2004,,1664,15669372,2789809,,700,3083131,549300,,964,12586241,2240509,PDP
GC137,,2006,2004,,1664,15669372,2789809,,700,7525689,1339791,,964,8143683,1450018,PDP
GC137,,2007,2004,,1664,15669372,2789809,,700,11992782,2134647,,964,3676590,655162,PDP
GC137,,2008,2004,,1812,14848466,2643888,,1812,14835441,2641570,,0,13025,2318,PDP
GC137,,2009,2004,,5334,16414107,2925994,,1812,14835441,2641570,,3522,1578666,284423,PDP
GC137,,2010,2004,,5334,16414107,2925994,,1812,14835441,2641570,,3522,1578666,284423,PDP
GC137,,2011,2004,,5334,16414107,2925994,,1812,14835441,2641570,,3522,1578666,284423,PDP
GC137,,2012,2004,,5334,16414107,2925994,,4597,16064476,2863045,,737,349631,62949,PDP
GC137,,2013,2004,,20644,24298194,4344166,,12346,19705887,3518732,,8298,4592307,825434,PDP
GC137,,2014,2004,,20644,24298194,4344166,,19524,22549997,4031979,,1120,1748197,312187,PDP
GC137,,2015,2004,,25075,24609709,4404027,,25040,24575636,4397929,,35,34073,6098,PDP
GC137,,2016,2004,,28410,26741362,4786659,,27892,26161631,4682986,,518,579731,103673,PDP
GC137,,2017,2004,,29752,27819643,4979866,,29700,27770699,4971106,,52,48944,8761,PDP
GC137,,2017,2004,,29752,27819643,4979866,,29700,27770699,4971106,,52,48944,8761,PDP
GC141,,2008,2008,,1185551,9225234,2827052,,0,0,0,,1185551,9225234,2827052,PDP
GC141,,2009,2008,,4669232,14855046,7312479,,0,0,0,,4669232,14855046,7312479,PDP
GC141,,2010,2008,,4856023,14521256,7439876,,739202,2061523,1106021,,4116821,12459733,6333855,PDP
GC141,,2011,2008,,4856023,14521256,7439876,,2164211,5793271,3195042,,2691812,8727985,4244834,PDP
GC141,,2012,2008,,4856023,14521256,7439876,,3297920,8758977,4856457,,1558103,5762279,2583420,PDP
GC141,,2013,2008,,4856023,14521256,7439876,,3933830,10581581,5816674,,922193,3939675,1623203,PDP
GC141,,2014,2008,,4856023,14521256,7439876,,4572748,12369495,6773726,,283275,2151761,666151,PDP
GC141,,2015,2008,,5142760,15203690,7848043,,5040602,13588512,7458487,,102158,1615178,389556,PDP
GC141,,2016,2008,,5736568,15335578,8465319,,5428245,14557432,8018535,,308323,778146,446783,PDP
GC141,,2017,2008,,5929214,16088064,8791859,,5869065,15845664,8688578,,60149,242400,103281,PDP
GC141,,2017,2008,,5929214,16088064,8791859,,5869065,15845664,8688578,,60149,242400,103281,PDP
GC158,,1993,1989,,6513453,10100106,8310625,,0,0,0,,6513453,10100106,8310625,PDP
GC158,,1994,1989,,6513452,10100102,8310623,,0,0,0,,6513452,10100102,8310623,PDP
GC158,,1995,1989,,6513452,10100102,8310623,,0,0,0,,6513452,10100102,8310623,PDP
GC158,,1996,1989,,6525203,10725162,8433595,,0,0,0,,6525203,10725162,8433595,PDP
GC158,,1997,1989,,101698767,235162611,143542648,,0,0,0,,101698767,235162611,143542648,PDP
GC158,,1998,1989,,101727001,235281332,143592007,,0,0,0,,101727001,235281332,143592007,PDP
GC158,,1999,1989,,103092510,237021241,145267108,,0,0,0,,103092510,237021241,145267108,PDP
GC158,,2000,1989,,103092510,237021241,145267108,,0,0,0,,103092510,237021241,145267108,PDP
GC158,,2001,1989,,91062240,164373979,120310278,,2195755,2956325,2721791,,88866485,161417654,117588487,PDP
GC158,,2002,1989,,94400416,168199529,124329157,,25227640,33409759,31172437,,69172776,134789770,93156720,PDP
GC158,,2003,1989,,87947454,160599581,116523891,,43791887,57658093,54051334,,44155567,102941488,62472557,PDP
GC158,,2004,1989,,85367724,161084336,114030417,,52676475,70080050,65146235,,32691249,91004286,48884182,PDP
GC158,,2005,1989,,104646227,178145522,136344718,,57903582,76844680,71577013,,46742645,101300842,64767705,PDP
GC158,,2006,1989,,105352318,178923126,137189173,,69240141,97463407,86582384,,36112177,81459719,50606789,PDP
GC158,,2007,1989,,105352318,178923126,137189173,,80274474,114384104,100627517,,25077844,64539022,36561656,PDP
GC158,,2008,1989,,120081453,194777579,154739385,,87814465,126682506,110355836,,32266988,68095073,44383549,PDP
GC158,,2009,1989,,123328273,193725334,157798975,,92990924,132737065,116609619,,30337349,60988269,41189357,PDP
GC158,,2010,1989,,125998638,197072756,161064966,,97084658,137699229,121586301,,28913980,59373527,39478665,PDP
GC158,,2011,1989,,125998638,197072756,161064966,,100053416,141470807,125226158,,25945222,55601949,35838807,PDP
GC158,,2012,1989,,123443588,196146884,158345170,,105407374,147967932,131736189,,18036214,48178952,26608981,PDP
GC158,,2013,1989,,121980158,193369683,156387576,,108766661,152250165,135857437,,13213497,41119518,20530139,PDP
GC158,,2014,1989,,121980158,193369683,156387576,,111533635,154847270,139086530,,10446523,38522413,17301047,PDP
GC158,,2015,1989,,127250941,197268105,162352027,,114259321,158276984,142422484,,12991620,38991121,19929544,PDP
GC158,,2016,1989,,128123113,201265383,163935460,,116396087,160495877,144954072,,11727026,40769506,18981390,PDP
GC158,,2017,1989,,128123113,199677924,163652994,,118199474,162455721,147106185,,9923639,37222203,16546808,PDP
GC158,,2017,1989,,128123113,199677924,163652994,,118199474,162455721,147106185,,9923639,37222203,16546808,PDP
GC177,,2000,1999,,472431,12680247,2728703,,0,0,0,,472431,12680247,2728703,PDN
GC177,,2001,1999,,2072498,15129237,4764533,,0,0,0,,2072498,15129237,4764533,PDN
GC177,,2002,1999,,2071666,15123159,4762620,,101743,1155847,307410,,1969923,13967312,4455210,PDN
GC177,,2003,1999,,2071666,15123159,4762620,,143351,1519823,413782,,1928315,13603336,4348838,PDN
GC177,,2004,1999,,230337,2595176,692112,,200480,2147327,582567,,29857,447849,109545,PDN
GC177,,2005,1999,,230337,2595176,692112,,200480,2147327,582567,,29857,447849,109545,PDN
GC177,,2006,1999,,230337,2595176,692112,,200480,2147327,582567,,29857,447849,109545,PDN
GC177,,2007,1999,,230337,2595176,692112,,200480,2147327,582567,,29857,447849,109545,PDN
GC177,,2008,1999,,230337,2595176,692112,,200480,2147327,582567,,29857,447849,109545,PDN
GC177,,2009,1999,,230931,2604086,694291,,200480,2147327,582566,,30451,456759,111725,PDN
GC177,,2010,1999,,200480,2147327,582566,,200480,2147327,582566,,0,0,0,PDN
GC177,,2011,1999,,200480,2147327,582566,,200480,2147327,582566,,0,0,0,PDN
GC177,,2012,1999,,200480,2147327,582566,,200480,2147327,582566,,0,0,0,PDN
GC177,,2013,1999,,200480,2147327,582566,,200480,2147327,582566,,0,0,0,PDN
GC177,,2014,1999,,200480,2147327,582566,,200480,2147327,582566,,0,0,0,PDN
GC177,,2015,1999,,200480,2147327,582566,,200480,2147327,582566,,0,0,0,PDN
GC177,,2016,1999,,200480,2147327,582566,,200480,2147327,582566,,0,0,0,PDN
GC177,,2017,1999,,200480,2147327,582566,,200480,2147327,582566,,0,0,0,PDN
GC177,,2017,1999,,200480,2147327,582566,,200480,2147327,582566,,0,0,0,PDN
GC178,,2004,2004,,129254,3231352,704228,,0,0,0,,129254,3231352,704228,PDN
GC178,,2005,2004,,0,4817781,857256,,0,362289,64464,,0,4455492,792792,PDN
GC178,,2006,2004,,0,4817781,857256,,0,3973442,707018,,0,844339,150238,PDN
GC178,,2007,2004,,0,4817781,857256,,0,4449212,791675,,0,368569,65581,PDN
GC178,,2008,2004,,0,4817781,857256,,0,4574432,813956,,0,243349,43300,PDN
GC178,,2009,2004,,0,4574432,813956,,0,4574432,813956,,0,0,0,PDN
GC178,,2010,2004,,0,4574432,813956,,0,4574432,813956,,0,0,0,PDN
GC178,,2011,2004,,0,4574432,813956,,0,4574432,813956,,0,0,0,PDN
GC178,,2012,2004,,0,4574432,813956,,0,4574432,813956,,0,0,0,PDN
GC178,,2013,2004,,0,4574432,813956,,0,4574432,813956,,0,0,0,PDN
GC178,,2014,2004,,0,4574432,813956,,0,4574432,813956,,0,0,0,PDN
GC178,,2015,2004,,0,4574432,813956,,0,4574432,813956,,0,0,0,PDN
GC178,,2016,2004,,0,4574432,813956,,0,4574432,813956,,0,0,0,PDN
GC178,,2017,2004,,0,4574432,813956,,0,4574432,813956,,0,0,0,PDN
GC178,,2017,2004,,0,4574432,813956,,0,4574432,813956,,0,0,0,PDN
GC184,,1983,1981,,24884885,46432981,33146981,,0,0,0,,24884885,46432981,33146981,PDP
GC184,,1984,1981,,30270278,57443360,40491516,,0,0,0,,30270278,57443360,40491516,PDP
GC184,,1985,1981,,30270278,57443360,40491516,,0,0,0,,30270278,57443360,40491516,PDP
GC184,,1986,1981,,30270278,57443360,40491516,,0,0,0,,30270278,57443360,40491516,PDP
GC184,,1987,1981,,30062297,57141579,40229838,,0,0,0,,30062297,57141579,40229838,PDP
GC184,,1988,1981,,30062297,57141579,40229838,,0,0,0,,30062297,57141579,40229838,PDP
GC184,,1989,1981,,30062297,57141579,40229838,,12921,21921,16822,,30049376,57119658,40213016,PDP
GC184,,1990,1981,,28647796,54272643,38304850,,151059,175409,182271,,28496737,54097234,38122579,PDP
GC184,,1991,1981,,87190344,343783821,148361842,,7197319,25211440,11683340,,79993025,318572381,136678502,PDP
GC184,,1992,1981,,43859785,192172749,78054224,,10967853,44286612,18848033,,32891932,147886137,59206191,PDP
GC184,,1993,1981,,38832131,173094752,69631909,,14166366,61422028,25095552,,24665765,111672724,44536357,PDP
GC184,,1994,1981,,39354550,176571670,70772997,,16362543,71542832,29092584,,22992007,105028838,41680413,PDP
GC184,,1995,1981,,38637716,173718228,69548433,,19131230,83464166,33982505,,19506486,90254062,35565928,PDP
GC184,,1996,1981,,31475431,140771966,56523824,,20965817,91978438,37332087,,10509614,48793528,19191737,PDP
GC184,,1997,1981,,33600633,154931543,61168523,,23016387,101988811,41163862,,10584246,52942732,20004661,PDP
GC184,,1998,1981,,34930881,160225739,63440799,,24756501,109352393,44214222,,10174380,50873346,19226577,PDP
GC184,,1999,1981,,36773486,160322724,65300661,,26077485,114737120,46493343,,10696001,45585604,18807318,PDP
GC184,,2000,1981,,38525937,163022692,67533533,,27253495,118278959,48299573,,11272442,44743733,19233960,PDP
GC184,,2001,1981,,37489288,151366915,64422902,,28315161,120774288,49805248,,9174127,30592627,14617654,PDP
GC184,,2002,1981,,38852757,154709054,66381058,,29611063,123621167,51607712,,9241694,31087887,14773346,PDP
GC184,,2003,1981,,38921719,155644063,66616392,,30765989,126326423,53244000,,8155730,29317640,13372392,PDP
GC184,,2004,1981,,38992167,155809621,66716299,,31550715,128087434,54342073,,7441452,27722187,12374226,PDP
GC184,,2005,1981,,38970210,150909528,65822439,,32091145,129125691,55067247,,6879065,21783837,10755192,PDP
GC184,,2006,1981,,39481512,152458796,66609411,,32732359,130387906,55933054,,6749153,22070890,10676357,PDP
GC184,,2007,1981,,39463995,151830488,66480096,,33314253,131518480,56716118,,6149742,20312008,9763978,PDP
GC184,,2008,1981,,39468640,151839121,66486277,,33703900,132236750,57233571,,5764740,19602371,9252706,PDP
GC184,,2009,1981,,39973335,154677676,67496052,,34074766,134884914,58075640,,5898569,19792762,9420413,PDP
GC184,,2010,1981,,40072560,154894025,67633773,,34426838,135329137,58506754,,5645722,19564888,9127019,PDP
GC184,,2011,1981,,40072560,154894025,67633773,,34710067,135727698,58860902,,5362493,19166327,8772872,PDP
GC184,,2012,1981,,40507744,155881049,68244584,,34989044,136162591,59217262,,5518700,19718458,9027326,PDP
GC184,,2013,1981,,40675873,156079655,68448052,,35295333,136765385,59630809,,5380540,19314270,8817244,PDP
GC184,,2014,1981,,41110536,156766538,69004938,,35560726,137372700,60004265,,5549810,19393838,9000673,PDP
GC184,,2015,1981,,41156965,157154122,69120332,,35786127,137812603,60307940,,5370838,19341519,8812392,PDP
GC184,,2016,1981,,41385527,157540750,69417688,,35996182,138182155,60583752,,5389345,19358595,8833934,PDP
GC184,,2017,1981,,41559681,158216234,69712036,,36179532,138538089,60830437,,5380149,19678145,8881599,PDP
GC184,,2017,1981,,41559681,158216234,69712036,,36179532,138538089,60830437,,5380149,19678145,8881599,PDP
GC195,,2006,2006,,645227,20664431,4322172,,0,0,0,,645227,20664431,4322172,PDN
GC195,,2007,2006,,645227,20664431,4322172,,70378,17876282,3251211,,574849,2788149,1070961,PDN
GC195,,2008,2006,,82323,20587765,3745626,,82323,20587765,3745626,,0,0,0,PDN
GC195,,2009,2006,,82323,20587765,3745626,,82323,20587765,3745626,,0,0,0,PDN
GC195,,2010,2006,,82323,20587765,3745626,,82323,20587765,3745626,,0,0,0,PDN
GC195,,2011,2006,,82323,20587765,3745626,,82323,20587765,3745626,,0,0,0,PDN
GC195,,2012,2006,,82323,20587765,3745626,,82323,20587765,3745626,,0,0,0,PDN
GC195,,2013,2006,,82323,20587765,3745626,,82323,20587765,3745626,,0,0,0,PDN
GC195,,2014,2006,,82323,20587765,3745626,,82323,20587765,3745626,,0,0,0,PDN
GC195,,2015,2006,,82323,20587765,3745626,,82323,20587765,3745626,,0,0,0,PDN
GC195,,2016,2006,,82323,20587765,3745626,,82323,20587765,3745626,,0,0,0,PDN
GC195,,2017,2006,,82323,20587765,3745626,,82323,20587765,3745626,,0,0,0,PDN
GC195,,2017,2006,,82323,20587765,3745626,,82323,20587765,3745626,,0,0,0,PDN
GC205,,1993,1988,,64626947,77552322,78426293,,0,0,0,,64626947,77552322,78426293,PDP
GC205,,1994,1988,,64630184,77556221,78430223,,0,0,0,,64630184,77556221,78430223,PDP
GC205,,1995,1988,,64630184,77556221,78430223,,0,0,0,,64630184,77556221,78430223,PDP
GC205,,1996,1988,,94862289,160317267,123388493,,0,0,0,,94862289,160317267,123388493,PDP
GC205,,1997,1988,,117038493,186655620,150251237,,0,0,0,,117038493,186655620,150251237,PDP
GC205,,1998,1988,,124624958,167158842,154368524,,0,0,0,,124624958,167158842,154368524,PDP
GC205,,1999,1988,,123410614,176437816,154805243,,10793325,11916699,12913734,,112617289,164521117,141891509,PDP
GC205,,2000,1988,,130328316,196446258,165283166,,25563006,36641293,32082809,,104765310,159804965,133200357,PDP
GC205,,2001,1988,,120989136,207085674,157837121,,43808003,69268864,56133424,,77181133,137816810,101703697,PDP
GC205,,2002,1988,,116444394,202386018,152456141,,61015198,97776457,78413144,,55429196,104609561,74042997,PDP
GC205,,2003,1988,,126306982,180886721,158493232,,72482341,115523688,93038157,,53824641,65363033,65455075,PDP
GC205,,2004,1988,,123915453,178887098,155745898,,83236122,130970231,106540434,,40679331,47916867,49205464,PDP
GC205,,2005,1988,,130642257,196461645,165599845,,91648524,142474806,116999913,,38993733,53986839,48599932,PDP
GC205,,2006,1988,,130734514,196004568,165610771,,98003250,152950921,125218716,,32731264,43053647,40392055,PDP
GC205,,2007,1988,,130734514,196004568,165610771,,103281761,160189748,131785275,,27452753,35814820,33825496,PDP
GC205,,2008,1988,,135188026,200511975,170866313,,107477778,165392746,136907092,,27710248,35119229,33959221,PDP
GC205,,2009,1988,,134823355,199706115,170358251,,111900111,171230221,142368124,,22923244,28475894,27990129,PDP
GC205,,2010,1988,,134734665,199123688,170165926,,115661618,176308210,147033186,,19073047,22815478,23132740,PDP
GC205,,2011,1988,,136949602,201132221,172738254,,119699282,181028157,151910699,,17250320,20104064,20827554,PDP
GC205,,2012,1988,,139132378,203284021,175303912,,124285484,185872777,157358931,,14846894,17411244,17944979,PDP
GC205,,2013,1988,,139132378,203284021,175303912,,129268537,191115275,163274814,,9863841,12168746,12029097,PDP
GC205,,2014,1988,,146155566,213106238,184074826,,133371477,195758361,168203927,,12784089,17347877,15870901,PDP
GC205,,2015,1988,,152787350,219183897,191788045,,139656454,201408839,175494326,,13130896,17775058,16293718,PDP
GC205,,2016,1988,,157463257,222298262,197018109,,145148532,206383001,181871487,,12314725,15915261,15146623,PDP
GC205,,2017,1988,,163623671,228034110,204199137,,150435559,210887400,187960010,,13188112,17146710,16239126,PDP
GC205,,2017,1988,,163623671,228034110,204199137,,150435559,210887400,187960010,,13188112,17146710,16239126,PDP
GC236,,1986,1984,,357,3566021,634880,,0,0,0,,357,3566021,634880,PDP
GC236,,1987,1984,,357,3566021,634880,,0,0,0,,357,3566021,634880,PDP
GC236,,1998,1984,,24322434,90947434,40505251,,0,0,0,,24322434,90947434,40505251,PDP
GC236,,1999,1984,,24368215,91176339,40591763,,0,0,0,,24368215,91176339,40591763,PDP
GC236,,2000,1984,,25037537,91912593,41392091,,0,0,0,,25037537,91912593,41392091,PDP
GC236,,2001,1984,,25175816,38987932,32113170,,4217626,5788808,5247663,,20958190,33199124,26865507,PDP
GC236,,2002,1984,,29158441,44394507,37057819,,14396707,20327025,18013615,,14761734,24067482,19044204,PDP
GC236,,2003,1984,,29159289,44394937,37058744,,20459940,29232914,25661526,,8699349,15162023,11397218,PDP
GC236,,2004,1984,,32363530,50644099,41374935,,26276184,38088097,33053425,,6087346,12556002,8321510,PDP
GC236,,2005,1984,,32363530,50644099,41374935,,28373335,41347071,35730465,,3990195,9297028,5644470,PDP
GC236,,2006,1984,,32363530,50644099,41374935,,28373335,41347071,35730465,,3990195,9297028,5644470,PDP
GC236,,2007,1984,,32363530,50644099,41374935,,28373335,41347071,35730465,,3990195,9297028,5644470,PDP
GC236,,2008,1984,,32363530,50644099,41374935,,28373335,41347071,35730465,,3990195,9297028,5644470,PDP
GC236,,2009,1984,,32367479,50723064,41392935,,28373335,41347071,35730465,,3994144,9375993,5662470,PDP
GC236,,2010,1984,,41619284,64060767,53017997,,28845506,42013422,36321204,,12773778,22047345,16696793,PDP
GC236,,2011,1984,,41619284,64060767,53017997,,31101518,45355131,39171826,,10517766,18705636,13846171,PDP
GC236,,2012,1984,,41619284,64060767,53017997,,32829744,47918167,41356108,,8789540,16142600,11661889,PDP
GC236,,2013,1984,,44837328,69122750,57136750,,34979176,51165885,44083426,,9858152,17956865,13053324,PDP
GC236,,2014,1984,,45155279,69671547,57552352,,38277007,56080664,48255773,,6878272,13590883,9296579,PDP
GC236,,2015,1984,,53361239,82335207,68011631,,41046417,60269180,51770471,,12314822,22066027,16241160,PDP
GC236,,2016,1984,,74657608,109740818,94184443,,44787229,65825320,56499920,,29870379,43915498,37684523,PDP
GC236,,2017,1984,,74662301,109748077,94190428,,52179497,75791579,65665545,,22482804,33956498,28524883,PDP
GC236,,2017,1984,,74662301,109748077,94190428,,52179497,75791579,65665545,,22482804,33956498,28524883,PDP
GC243,,2001,2001,,34142740,40101451,41278230,,0,0,0,,34142740,40101451,41278230,PDP
GC243,,2002,2001,,27314233,42776605,34925728,,282124,300903,335665,,27032109,42475702,34590063,PDP
GC243,,2003,2001,,27314233,42776605,34925728,,8517253,8580223,10043983,,18796980,34196382,24881745,PDP
GC243,,2004,2001,,36392952,51855324,45619878,,15650634,15716405,18447147,,20742318,36138919,27172731,PDP
GC243,,2005,2001,,40127670,55590042,50019136,,20169035,20217202,23766402,,19958635,35372840,26252734,PDP
GC243,,2006,2001,,40127670,55590042,50019136,,22996792,22986243,27086871,,17130878,32603799,22932265,PDP
GC243,,2007,2001,,40127670,55590042,50019137,,26244809,26425428,30946842,,13882861,29164614,19072295,PDP
GC243,,2008,2001,,40127670,55590042,50019137,,27225290,27381209,32097391,,12902380,28208833,17921746,PDP
GC243,,2009,2001,,36417926,44222238,44286653,,28600493,28657510,33699694,,7817433,15564728,10586958,PDP
GC243,,2010,2001,,36417926,44222238,44286653,,29793367,29763882,35089432,,6624559,14458356,9197220,PDP
GC243,,2011,2001,,36417926,44222238,44286653,,30770993,30864235,36262851,,5646933,13358003,8023802,PDP
GC243,,2012,2001,,36417926,44222238,44286653,,31511166,31583620,37131028,,4906760,12638618,7155625,PDP
GC243,,2013,2001,,36417926,44222238,44286653,,32253111,32312378,38002645,,4164815,11909860,6284008,PDP
GC243,,2014,2001,,36417926,44222238,44286653,,32888475,32910480,38744433,,3529451,11311758,5542219,PDP
GC243,,2015,2001,,36459283,44264629,44335552,,33258388,33292198,39182266,,3200895,10972431,5153285,PDP
GC243,,2016,2001,,36459283,44264629,44335552,,33576630,33630714,39560742,,2882653,10633915,4774809,PDP
GC243,,2017,2001,,36459283,44264629,44335552,,33797565,33849275,39820567,,2661718,10415354,4514983,PDP
GC243,,2017,2001,,36459283,44264629,44335552,,33797565,33849275,39820567,,2661718,10415354,4514983,PDP
GC244,,1995,1994,,52058942,56296259,62076070,,0,0,0,,52058942,56296259,62076070,PDP
GC244,,1996,1994,,51718645,56006326,61684183,,0,0,0,,51718645,56006326,61684183,PDP
GC244,,1997,1994,,121221086,243769480,164596438,,1147085,1807867,1468770,,120074001,241961613,163127668,PDP
GC244,,1998,1994,,121220051,243767529,164595056,,19781208,36698241,26311144,,101438843,207069288,138283912,PDP
GC244,,1999,1994,,147273734,299042502,200484143,,54757996,104964355,73434927,,92515738,194078147,127049216,PDP
GC244,,2000,1994,,154417919,322858856,211866114,,86426885,165189198,115819981,,67991034,157669658,96046133,PDP
GC244,,2001,1994,,171961350,355987049,235304241,,113422101,228692251,154114672,,58539249,127294798,81189569,PDP
GC244,,2002,1994,,164739119,343895172,225930431,,135048500,272153792,183474442,,29690619,71741380,42455989,PDP
GC244,,2003,1994,,164777105,346222376,226382510,,147490701,295293102,200033958,,17286404,50929274,26348552,PDP
GC244,,2004,1994,,169557299,356615634,233012038,,152604545,305330122,206933748,,16952754,51285512,26078290,PDP
GC244,,2005,1994,,170375928,353505079,233277188,,157366703,314712210,213365317,,13009225,38792869,19911871,PDP
GC244,,2006,1994,,170375928,353505079,233277188,,159970560,318832855,216702385,,10405368,34672224,16574803,PDP
GC244,,2007,1994,,170375928,353505079,233277188,,161310710,321215821,218466550,,9065218,32289258,14810638,PDP
GC244,,2008,1994,,170375928,353505079,233277188,,162279929,322773161,219712876,,8095999,30731918,13564312,PDP
GC244,,2009,1994,,192882176,378618208,260251964,,163297784,325134236,221150852,,29584392,53483972,39101114,PDP
GC244,,2010,1994,,192882176,378618208,260251964,,168467894,330643040,227301176,,24414282,47975168,32950788,PDP
GC244,,2011,1994,,192882176,378618208,260251964,,174532194,337153419,234523906,,18349982,41464789,25728058,PDP
GC244,,2012,1994,,192882176,378618208,260251964,,177122601,339831223,237590790,,15759575,38786985,22661174,PDP
GC244,,2013,1994,,192882176,378618208,260251964,,178531109,341307826,239262038,,14351067,37310382,20989926,PDP
GC244,,2014,1994,,192882176,378618208,260251964,,179187414,342170792,240071897,,13694762,36447416,20180068,PDP
GC244,,2015,1994,,192882176,378618208,260251964,,179503752,342639744,240471678,,13378424,35978464,19780286,PDP
GC244,,2016,1994,,180453835,343971017,241658642,,179735029,342975269,240762657,,718806,995748,895985,PDP
GC244,,2017,1994,,182512875,346250698,244123320,,180137385,343519527,241261856,,2375490,2731171,2861464,PDP
GC244,,2017,1994,,182512875,346250698,244123320,,180137385,343519527,241261856,,2375490,2731171,2861464,PDP
GC254,,1994,1985,,25259977,37839448,31992975,,0,0,0,,25259977,37839448,31992975,PDP
GC254,,1995,1985,,25259977,37839448,31992975,,0,0,0,,25259977,37839448,31992975,PDP
GC254,,1996,1985,,25259978,37839447,31992976,,0,0,0,,25259978,37839447,31992976,PDP
GC254,,1997,1985,,24405356,36559224,30910556,,0,0,0,,24405356,36559224,30910556,PDP
GC254,,1998,1985,,20256546,42034036,27735912,,0,0,0,,20256546,42034036,27735912,PDP
GC254,,1999,1985,,23703801,45769817,31847897,,1064699,1720594,1370855,,22639102,44049223,30477042,PDP
GC254,,2000,1985,,24600448,45322523,32664954,,7300669,10092304,9096453,,17299779,35230219,23568501,PDP
GC254,,2001,1985,,34636927,70452421,47172945,,11797703,17289995,14874215,,22839224,53162426,32298730,PDP
GC254,,2002,1985,,34636348,70451372,47172179,,18054587,32589432,23853418,,16581761,37861940,23318761,PDP
GC254,,2003,1985,,34636348,70451372,47172179,,23235115,43850264,31037653,,11401233,26601108,16134526,PDP
GC254,,2004,1985,,46073828,81832322,60634739,,28435291,51971057,37682810,,17638537,29861265,22951929,PDP
GC254,,2005,1985,,48715637,87131155,64219401,,32192931,58703926,42638469,,16522706,28427229,21580932,PDP
GC254,,2006,1985,,48539103,86920431,64005372,,35099878,63629887,46421922,,13439225,23290544,17583450,PDP
GC254,,2007,1985,,48539103,86920431,64005372,,38015610,69270574,50341335,,10523493,17649857,13664037,PDP
GC254,,2008,1985,,51230313,92155342,67628061,,39732117,71973838,52538850,,11498196,20181504,15089211,PDP
GC254,,2009,1985,,49343025,89269645,65227304,,41125626,74269208,54340788,,8217399,15000437,10886516,PDP
GC254,,2010,1985,,52305929,95591698,69315128,,42394186,76614718,56026698,,9911743,18976980,13288430,PDP
GC254,,2011,1985,,52305929,95591698,69315128,,44489239,80095492,58741106,,7816690,15496206,10574022,PDP
GC254,,2012,1985,,60907688,112258357,80882485,,45784325,83467933,60636272,,15123363,28790424,20246215,PDP
GC254,,2013,1985,,60907688,112258357,80882485,,48092005,89018955,63931677,,12815683,23239402,16950808,PDP
GC254,,2014,1985,,60907688,112258357,80882485,,49912966,91953589,66274816,,10994722,20304768,14607671,PDP
GC254,,2015,1985,,60907688,112258357,80882485,,51326311,94224178,68092180,,9581377,18034179,12790305,PDP
GC254,,2016,1985,,62989038,114857944,83426396,,52488039,95950955,69561163,,10500999,18906989,13865232,PDP
GC254,,2017,1985,,62989038,114857944,83426396,,53491129,97553964,70849487,,9497909,17303980,12576910,PDP
GC254,,2017,1985,,62989038,114857944,83426396,,53491129,97553964,70849487,,9497909,17303980,12576910,PDP
GC282,,2001,2001,,18916100,29319955,24133174,,0,0,0,,18916100,29319955,24133174,PDP
GC282,,2002,2001,,18916100,29319955,24133174,,2217,0,2217,,18913883,29319955,24130957,PDP
GC282,,2003,2001,,15998200,25917084,20609781,,4285359,6804013,5496037,,11712841,19113071,15113744,PDP
GC282,,2004,2001,,14345457,23526550,18531676,,9760508,15888342,12587615,,4584949,7638208,5944061,PDP
GC282,,2005,2001,,14900502,24419062,19245531,,11489645,18840914,14842121,,3410857,5578148,4403410,PDP
GC282,,2006,2001,,14900502,24419062,19245531,,11489645,18840914,14842121,,3410857,5578148,4403410,PDP
GC282,,2007,2001,,14900502,24419062,19245531,,11489645,18840914,14842121,,3410857,5578148,4403410,PDP
GC282,,2008,2001,,14900502,24419062,19245531,,11486145,18840914,14838621,,3414357,5578148,4406910,PDP
GC282,,2009,2001,,14900502,24419062,19245531,,11486145,18840914,14838621,,3414357,5578148,4406910,PDP
GC282,,2010,2001,,21255618,34937209,27472203,,11712914,19185609,15126723,,9542704,15751600,12345481,PDP
GC282,,2011,2001,,21255618,34937209,27472203,,14607534,23908420,18861701,,6648084,11028789,8610501,PDP
GC282,,2012,2001,,21255618,34937209,27472203,,16999275,27938471,21970533,,4256343,6998738,5501670,PDP
GC282,,2013,2001,,21255618,34937209,27472203,,18238666,30035117,23582993,,3016952,4902092,3889211,PDP
GC282,,2014,2001,,21255618,34937209,27472203,,19179516,31908354,24857158,,2076102,3028855,2615044,PDP
GC282,,2015,2001,,21255618,34937209,27472203,,19751449,33112633,25643377,,1504169,1824576,1828827,PDP
GC282,,2016,2001,,21255618,35314144,27539273,,20122338,33836112,26142999,,1133280,1478032,1396275,PDP
GC282,,2017,2001,,22938241,35611243,29274761,,20521372,34181643,26603514,,2416869,1429600,2671247,PDP
GC282,,2017,2001,,22938241,35611243,29274761,,20521372,34181643,26603514,,2416869,1429600,2671247,PDP
GC299,,2005,2005,,5004864,7807588,6394115,,0,0,0,,5004864,7807588,6394115,PDP
GC299,,2006,2005,,5898766,15140323,8592774,,0,0,0,,5898766,15140323,8592774,PDP
GC299,,2007,2005,,5898766,15140323,8592774,,0,0,0,,5898766,15140323,8592774,PDP
GC299,,2008,2005,,1118588,7673822,2484037,,0,0,0,,1118588,7673822,2484037,PDP
GC299,,2011,2005,,449708,6745623,1649997,,0,0,0,,449708,6745623,1649997,PDP
GC299,,2012,2005,,449708,6745623,1649997,,0,0,0,,449708,6745623,1649997,PDP
GC299,,2013,2005,,4802770,13536400,7211382,,1885503,2950411,2410488,,2917267,10585989,4800895,PDP
GC299,,2014,2005,,11451201,39829919,18538375,,4228191,11452074,6265926,,7223010,28377845,12272449,PDP
GC299,,2015,2005,,11451201,39829919,18538375,,6388031,18541536,9687236,,5063170,21288383,8851139,PDP
GC299,,2016,2005,,11451201,39829919,18538375,,7102787,19402139,10555124,,4348414,20427780,7983250,PDP
GC299,,2017,2005,,10410114,23023883,14506890,,7676010,20060884,11245562,,2734104,2962999,3261328,PDP
GC299,,2017,2005,,10410114,23023883,14506890,,7676010,20060884,11245562,,2734104,2962999,3261328,PDP
GC339,,2001,2001,,59617952,57931478,69926044,,0,0,0,,59617952,57931478,69926044,PDP
GC339,,2002,2001,,86375766,78435156,100332199,,0,0,0,,86375766,78435156,100332199,PDP
GC339,,2003,2001,,94299191,84999696,109423692,,0,0,0,,94299191,84999696,109423692,PDP
GC339,,2004,2001,,106321288,106985501,125357854,,302641,275362,351638,,106018647,106710139,125006216,PDP
GC339,,2005,2001,,45321284,44324532,53208212,,8624734,8058119,10058563,,36696550,36266413,43149649,PDP
GC339,,2006,2001,,45222463,44227771,53092173,,14232287,13288243,16596743,,30990176,30939528,36495430,PDP
GC339,,2007,2001,,46204067,45757707,54346008,,17855195,16826979,20849319,,28348872,28930728,33496689,PDP
GC339,,2008,2001,,46204066,45757707,54346007,,19477694,18377948,22747792,,26726372,27379759,31598215,PDP
GC339,,2009,2001,,46378491,45988840,54561558,,22976925,21739902,26845234,,23401566,24248938,27716323,PDP
GC339,,2010,2001,,49710714,49035892,58435962,,25723324,24155947,30021535,,23987390,24879945,28414426,PDP
GC339,,2011,2001,,49782059,51406407,58929107,,28450208,26855424,33228752,,21331851,24550983,25700354,PDP
GC339,,2012,2001,,51597916,53049238,61037284,,31627368,31142374,37168714,,19970548,21906864,23868566,PDP
GC339,,2013,2001,,49836395,51566381,59011907,,34511046,34278704,40610459,,15325349,17287677,18401447,PDP
GC339,,2014,2001,,50212849,51941605,59455127,,36725151,36592543,43236278,,13487698,15349062,16218848,PDP
GC339,,2015,2001,,50824002,52513634,60168065,,38297668,38012843,45061518,,12526334,14500791,15106546,PDP
GC339,,2016,2001,,51876890,52935666,61296046,,39614101,39271092,46601838,,12262789,13664574,14694208,PDP
GC339,,2017,2001,,53386532,54276151,63044209,,41113345,40932886,48396776,,12273187,13343265,14647435,PDP
GC339,,2017,2001,,53386532,54276151,63044209,,41113345,40932886,48396776,,12273187,13343265,14647435,PDP
GC385,,2006,2005,,20846787,11215571,22842440,,0,0,0,,20846787,11215571,22842440,PDP
GC385,,2007,2005,,20846787,11215571,22842440,,0,0,0,,20846787,11215571,22842440,PDP
GC385,,2008,2005,,20846787,11215571,22842440,,84407,79219,98503,,20762380,11136352,22743937,PDP
GC385,,2009,2005,,20846787,11215571,22842440,,1938051,1742270,2248063,,18908736,9473301,20594377,PDP
GC385,,2010,2005,,20846787,11215571,22842440,,3433155,3072561,3979874,,17413632,8143010,18862566,PDP
GC385,,2011,2005,,20846787,11215571,22842440,,4007018,3579917,4644014,,16839769,7635654,18198426,PDP
GC385,,2012,2005,,5692820,5163388,6611572,,4298529,3810717,4976593,,1394291,1352671,1634980,PDP
GC385,,2013,2005,,10771700,9954587,12542979,,4780320,4247868,5536169,,5991380,5706719,7006810,PDP
GC385,,2014,2005,,10771700,9954587,12542979,,7478987,6905389,8707704,,3292713,3049198,3835275,PDP
GC385,,2015,2005,,10771700,9954587,12542979,,8973951,8468447,10480792,,1797749,1486140,2062186,PDP
GC385,,2016,2005,,10771700,9954587,12542979,,9569069,9292789,11222590,,1202631,661798,1320389,PDP
GC385,,2017,2005,,11128985,11371846,13152445,,10121658,10075729,11914492,,1007327,1296117,1237953,PDP
GC385,,2017,2005,,11128985,11371846,13152445,,10121658,10075729,11914492,,1007327,1296117,1237953,PDP
GC448,,2009,2008,,4333322,9920422,6098522,,1743,0,1743,,4331579,9920422,6096779,PDN
GC448,,2010,2008,,5314737,9062825,6927339,,1743,0,1743,,5312994,9062825,6925596,PDN
GC448,,2011,2008,,5314737,9062825,6927339,,968491,1595165,1252328,,4346246,7467660,5675011,PDN
GC448,,2012,2008,,5314737,9062825,6927339,,2470435,3917838,3167559,,2844302,5144987,3759780,PDN
GC448,,2013,2008,,5314737,9062825,6927339,,3416157,5265280,4353040,,1898580,3797545,2574300,PDN
GC448,,2014,2008,,5314737,9062825,6927339,,3943253,6045515,5018967,,1371484,3017310,1908372,PDN
GC448,,2015,2008,,5314737,9062825,6927339,,3948924,6053250,5026015,,1365813,3009575,1901325,PDN
GC448,,2016,2008,,3962517,6053250,5039608,,3962517,6053250,5039608,,0,0,0,PDN
GC448,,2017,2008,,3962517,6053250,5039608,,3962517,6053250,5039608,,0,0,0,PDN
GC448,,2017,2008,,3962517,6053250,5039608,,3962517,6053250,5039608,,0,0,0,PDN
GC468,,2005,2006,,108572816,41754350,116002416,,0,0,0,,108572816,41754350,116002416,PU
GC468,,2006,2006,,403955117,156059431,431723699,,0,0,0,,403955117,156059431,431723699,PU
GC468,,2007,2006,,403955117,156059431,431723699,,0,0,0,,403955117,156059431,431723699,PU
GC468,,2008,2006,,403955117,156059431,431723699,,0,0,0,,403955117,156059431,431723699,PU
GC468,,2015,2006,,214314302,82668247,229023954,,0,0,0,,214314302,82668247,229023954,PU
GC468,,2016,2006,,214314302,82668247,229023954,,0,0,0,,214314302,82668247,229023954,PU
GC468,,2017,2006,,231010508,110520188,250676021,,0,0,0,,231010508,110520188,250676021,PU
GC468,,2017,2006,,231010508,110520188,250676021,,0,0,0,,231010508,110520188,250676021,PU
GC472,,1993,1989,,21663900,92298583,38087135,,0,0,0,,21663900,92298583,38087135,PDN
GC472,,1994,1989,,21663092,92161368,38061912,,0,0,0,,21663092,92161368,38061912,PDN
GC472,,1995,1989,,21663092,92161368,38061912,,0,0,0,,21663092,92161368,38061912,PDN
GC472,,1996,1989,,22931246,118931133,44093369,,0,0,0,,22931246,118931133,44093369,PDN
GC472,,1997,1989,,6065920,98440942,23582102,,0,0,0,,6065920,98440942,23582102,PDN
GC472,,1998,1989,,6065920,98440942,23582102,,0,0,0,,6065920,98440942,23582102,PDN
GC472,,1999,1989,,6065920,98440942,23582102,,0,0,0,,6065920,98440942,23582102,PDN
GC472,,2000,1989,,3464052,87292772,18996574,,0,0,0,,3464052,87292772,18996574,PDN
GC472,,2001,1989,,3456929,180641631,35599568,,0,0,0,,3456929,180641631,35599568,PDN
GC472,,2002,1989,,3443361,180798822,35613970,,112911,44308450,7996977,,3330450,136490372,27616993,PDN
GC472,,2003,1989,,3443361,180798822,35613970,,187925,78420887,14141819,,3255436,102377935,21472151,PDN
GC472,,2004,1989,,3568613,195002310,38266533,,245854,112047106,20183061,,3322759,82955204,18083472,PDN
GC472,,2005,1989,,3503404,180703338,35657023,,286685,134792841,24271176,,3216719,45910497,11385847,PDN
GC472,,2006,1989,,3503404,180703338,35657023,,310570,145995670,26288447,,3192834,34707668,9368576,PDN
GC472,,2007,1989,,3502797,180703338,35656416,,327682,156440890,28164139,,3175115,24262448,7492277,PDN
GC472,,2008,1989,,3497680,195926785,38360098,,331654,161931129,29145022,,3166026,33995656,9215076,PDN
GC472,,2009,1989,,353554,184495488,33181934,,341241,172490750,31033546,,12313,12004738,2148388,PDN
GC472,,2010,1989,,353554,184495488,33181934,,343310,177061432,31848904,,10244,7434056,1333030,PDN
GC472,,2011,1989,,353554,184495488,33181934,,344316,179285037,32245569,,9238,5210451,936365,PDN
GC472,,2012,1989,,353328,184356569,33156989,,344907,179700886,32320155,,8421,4655683,836834,PDN
GC472,,2013,1989,,344907,179700886,32320155,,344907,179700886,32320155,,0,0,0,PDN
GC472,,2014,1989,,344907,179700886,32320155,,344907,179700886,32320155,,0,0,0,PDN
GC472,,2015,1989,,344907,179700886,32320155,,344907,179700886,32320155,,0,0,0,PDN
GC472,,2016,1989,,344907,179700886,32320155,,344907,179700886,32320155,,0,0,0,PDN
GC472,,2017,1989,,344907,179700886,32320155,,344907,179700886,32320155,,0,0,0,PDN
GC472,,2017,1989,,344907,179700886,32320155,,344907,179700886,32320155,,0,0,0,PDN
GC490,,2010,2009,,514471,7871412,1915078,,0,0,0,,514471,7871412,1915078,PDP
GC490,,2011,2009,,514471,7871412,1915078,,0,0,0,,514471,7871412,1915078,PDP
GC490,,2012,2009,,592422,9064050,2205242,,402449,6544258,1566908,,189973,2519792,638335,PDP
GC490,,2013,2009,,1118738,18347302,4383382,,588371,11058374,2556053,,530367,7288928,1827329,PDP
GC490,,2014,2009,,1118738,18347302,4383382,,730418,12915564,3028561,,388320,5431738,1354821,PDP
GC490,,2015,2009,,1118738,18347302,4383382,,933575,13510667,3337608,,185163,4836635,1045774,PDP
GC490,,2016,2009,,1972828,18347302,5237472,,1129224,13843693,3592515,,843604,4503609,1644958,PDP
GC490,,2017,2009,,1972828,18347302,5237472,,1239590,14049786,3739552,,733238,4297516,1497921,PDP
GC490,,2017,2009,,1972828,18347302,5237472,,1239590,14049786,3739552,,733238,4297516,1497921,PDP
GC562,,1999,1999,,40296391,95059187,57210837,,0,0,0,,40296391,95059187,57210837,PDP
GC562,,2000,1999,,40313174,49988336,49207896,,0,0,0,,40313174,49988336,49207896,PDP
GC562,,2001,1999,,40268081,104697011,58897442,,0,0,0,,40268081,104697011,58897442,PDP
GC562,,2002,1999,,40268081,104697011,58897442,,0,0,0,,40268081,104697011,58897442,PDP
GC562,,2003,1999,,112626651,76409057,126222569,,0,0,0,,112626651,76409057,126222569,PDP
GC562,,2004,1999,,112626651,76409057,126222569,,0,0,0,,112626651,76409057,126222569,PDP
GC562,,2005,1999,,98552423,69511033,110920934,,1629554,1059678,1818109,,96922869,68451355,109102825,PDP
GC562,,2006,1999,,98548942,69509119,110917113,,10325272,7225893,11611018,,88223670,62283226,99306095,PDP
GC562,,2007,1999,,98548942,69509119,110917113,,21207863,17726394,24362026,,77341079,51782725,86555087,PDP
GC562,,2008,1999,,115337550,76353104,128923512,,26804376,21544499,30637917,,88533174,54808605,98285595,PDP
GC562,,2009,1999,,124196919,80189030,138465430,,30350546,23507378,34533354,,93846373,56681652,103932076,PDP
GC562,,2010,1999,,127032970,82679254,141744582,,37195949,27613585,42109399,,89837021,55065669,99635182,PDP
GC562,,2011,1999,,127032970,82679254,141744582,,43755677,31717778,49399410,,83277293,50961476,92345171,PDP
GC562,,2012,1999,,127032970,82679254,141744582,,50018957,36158137,56452790,,77014013,46521117,85291792,PDP
GC562,,2013,1999,,74929594,52008362,84183750,,55513425,40051616,62640046,,19416169,11956746,21543704,PDP
GC562,,2014,1999,,74929594,52008362,84183750,,60184831,43209888,67873424,,14744763,8798474,16310329,PDP
GC562,,2015,1999,,156104793,103409609,174505080,,63858986,45693121,71989435,,92245807,57716488,102515645,PDP
GC562,,2016,1999,,174798720,116676210,195559611,,70051940,50191756,78982857,,104746780,66484454,116576755,PDP
GC562,,2017,1999,,189663114,128449750,212518941,,78768735,56499833,88822086,,110894379,71949917,123696855,PDP
GC562,,2017,1999,,189663114,128449750,212518941,,78768735,56499833,88822086,,110894379,71949917,123696855,PDP
GC599,,2006,2006,,7495217,2735754,7982006,,0,0,0,,7495217,2735754,7982006,PDP
GC599,,2007,2006,,7495217,2735754,7982006,,0,0,0,,7495217,2735754,7982006,PDP
GC599,,2008,2006,,7495217,2735754,7982006,,0,0,0,,7495217,2735754,7982006,PDP
GC599,,2016,2006,,25398131,7016446,26646609,,1497208,494054,1585118,,23900923,6522392,25061491,PDP
GC599,,2017,2006,,25398131,7016446,26646609,,3311169,1111876,3509012,,22086962,5904570,23137597,PDP
GC599,,2017,2006,,25398131,7016446,26646609,,3311169,1111876,3509012,,22086962,5904570,23137597,PDP
GC608,,2000,2000,,25021881,29305187,30236327,,0,0,0,,25021881,29305187,30236327,PDP
GC608,,2001,2000,,25019207,29304870,30233597,,0,0,0,,25019207,29304870,30233597,PDP
GC608,,2002,2000,,25019207,29304870,30233597,,0,0,0,,25019207,29304870,30233597,PDP
GC608,,2003,2000,,8056512,12695096,10315426,,0,0,0,,8056512,12695096,10315426,PDP
GC608,,2004,2000,,11317793,12175209,13484200,,3723123,4109366,4454327,,7594670,8065843,9029873,PDP
GC608,,2005,2000,,11317793,12175209,13484200,,5800585,6702883,6993269,,5517208,5472326,6490931,PDP
GC608,,2006,2000,,11317793,12175209,13484200,,6863536,8755593,8421471,,4454257,3419616,5062729,PDP
GC608,,2007,2000,,9567183,15916742,12399343,,7687153,9787271,9428660,,1880030,6129471,2970683,PDP
GC608,,2008,2000,,10548216,18419100,13825636,,8542494,13455042,10936630,,2005722,4964058,2889006,PDP
GC608,,2009,2000,,11652901,19015050,15036362,,8827610,14868966,11473334,,2825291,4146084,3563028,PDP
GC608,,2010,2000,,11654805,19719652,15163640,,9332902,15478823,12087142,,2321903,4240829,3076499,PDP
GC608,,2011,2000,,11654805,19719652,15163640,,9569101,15890699,12396628,,2085704,3828953,2767012,PDP
GC608,,2012,2000,,14392504,22041487,18314477,,10279146,17002865,13304567,,4113358,5038622,5009910,PDP
GC608,,2013,2000,,14392504,22041487,18314477,,11593489,19100718,14992194,,2799015,2940769,3322283,PDP
GC608,,2014,2000,,14392504,22041487,18314477,,12889403,20648759,16563560,,1503101,1392728,1750917,PDP
GC608,,2015,2000,,15469924,24637893,19853891,,13630273,22058189,17555218,,1839651,2579704,2298673,PDP
GC608,,2016,2000,,16097884,26110182,20743824,,14157436,22823109,18218488,,1940448,3287073,2525336,PDP
GC608,,2017,2000,,15932397,26779965,20697515,,14831186,24404121,19173557,,1101211,2375844,1523959,PDP
GC608,,2017,2000,,15932397,26779965,20697515,,14831186,24404121,19173557,,1101211,2375844,1523959,PDP
GC627,,2017,2014,,19074861,17987594,22275501,,3203,2645,3674,,19071658,17984949,22271827,PU
GC627,,2017,2014,,19074861,17987594,22275501,,3203,2645,3674,,19071658,17984949,22271827,PU
GC640,,2002,2002,,576808904,456749147,658080994,,0,0,0,,576808904,456749147,658080994,PDP
GC640,,2003,2002,,518303124,254098364,563516356,,0,0,0,,518303124,254098364,563516356,PDP
GC640,,2004,2002,,432045854,213816219,470091445,,0,0,0,,432045854,213816219,470091445,PDP
GC640,,2005,2002,,432045853,213816220,470091443,,0,0,0,,432045853,213816220,470091443,PDP
GC640,,2006,2002,,547280122,271433355,595577872,,0,0,0,,547280122,271433355,595577872,PDP
GC640,,2007,2002,,547280122,271433355,595577872,,27501,14787,30132,,547252621,271418568,595547740,PDP
GC640,,2008,2002,,532668032,264127310,579665774,,35668,14787,38299,,532632364,264112523,579627475,PDP
GC640,,2009,2002,,414010246,201552007,449873592,,22593543,12254204,24774006,,391416703,189297803,425099586,PDP
GC640,,2010,2002,,583318760,317022344,639728430,,62976998,34089514,69042748,,520341762,282932830,570685682,PDP
GC640,,2011,2002,,583318760,317022344,639728430,,98448709,53442738,107958093,,484870051,263579606,531770337,PDP
GC640,,2012,2002,,583318760,317022344,639728430,,140123912,81380501,154604428,,443194848,235641843,485124002,PDP
GC640,,2013,2002,,583318760,317022344,639728430,,173816199,103534095,192238636,,409502561,213488249,447489794,PDP
GC640,,2014,2002,,602379025,326647777,660501406,,205212654,124844205,227426926,,397166371,201803572,433074480,PDP
GC640,,2015,2002,,602379025,326647777,660501406,,238698485,147827419,265002297,,363680540,178820358,395499109,PDP
GC640,,2016,2002,,616328730,372656117,682637648,,276917616,176249705,308278773,,339411114,196406412,374358874,PDP
GC640,,2017,2002,,616702900,373035151,683079262,,322895129,208118402,359926874,,293807771,164916749,323152389,PDP
GC640,,2017,2002,,616702900,373035151,683079262,,322895129,208118402,359926874,,293807771,164916749,323152389,PDP
GC644,,1999,1999,,111330079,140275899,136290203,,0,0,0,,111330079,140275899,136290203,PDP
GC644,,2000,1999,,111330079,128501970,134195198,,0,0,0,,111330079,128501970,134195198,PDP
GC644,,2001,1999,,111330079,128501970,134195198,,0,0,0,,111330079,128501970,134195198,PDP
GC644,,2002,1999,,242570149,334194185,302035306,,0,0,0,,242570149,334194185,302035306,PDP
GC644,,2003,1999,,242570149,334194185,302035306,,0,0,0,,242570149,334194185,302035306,PDP
GC644,,2004,1999,,253145797,303674472,307180401,,236857,258048,282773,,252908940,303416424,306897628,PDP
GC644,,2005,1999,,209575614,258670103,255602323,,16627100,19041014,20015181,,192948514,239629089,235587142,PDP
GC644,,2006,1999,,209575614,258670103,255602323,,28038734,29352942,33261677,,181536880,229317161,222340646,PDP
GC644,,2007,1999,,209575614,258670103,255602323,,40379515,41558667,47774296,,169196099,217111436,207828027,PDP
GC644,,2008,1999,,211739739,262024497,258363315,,50691154,51505530,59855839,,161048585,210518967,198507476,PDP
GC644,,2009,1999,,215917674,255035654,261297684,,61706971,62493775,72826859,,154210703,192541879,188470824,PDP
GC644,,2010,1999,,215917674,255035654,261297684,,68381686,68817259,80626751,,147535988,186218395,180670935,PDP
GC644,,2011,1999,,215917674,255035654,261297684,,72794692,72983262,85781038,,143122982,182052392,175516647,PDP
GC644,,2012,1999,,216211980,255523792,261678848,,76883107,76766989,90542714,,139328873,178756803,171136135,PDP
GC644,,2013,1999,,216211980,255523792,261678848,,81893974,81413822,96380420,,134318006,174109970,165298428,PDP
GC644,,2014,1999,,216211980,255523792,261678848,,87506500,86466478,102891994,,128705480,169057314,158786853,PDP
GC644,,2015,1999,,216211980,255523792,261678848,,91853244,90244581,107910998,,124358736,165279211,153767849,PDP
GC644,,2016,1999,,216211980,255523792,261678848,,95289260,93270674,111885465,,120922720,162253118,149793382,PDP
GC644,,2017,1999,,117778121,111392895,137598921,,98278526,95809793,115326532,,19499595,15583102,22272388,PDP
GC644,,2017,1999,,117778121,111392895,137598921,,98278526,95809793,115326532,,19499595,15583102,22272388,PDP
GC646,,2004,2004,,3822458,4029922,4539526,,0,0,0,,3822458,4029922,4539526,PDN
GC646,,2005,2004,,3822458,4029922,4539526,,0,0,0,,3822458,4029922,4539526,PDN
GC646,,2006,2004,,3822458,4029922,4539526,,0,0,0,,3822458,4029922,4539526,PDN
GC646,,2007,2004,,3822458,4029922,4539526,,0,0,0,,3822458,4029922,4539526,PDN
GC646,,2008,2004,,3822474,4031309,4539789,,0,0,0,,3822474,4031309,4539789,PDN
GC646,,2009,2004,,1355080,2903007,1871629,,382547,405000,454611,,972533,2498007,1417018,PDN
GC646,,2010,2004,,1355080,2903007,1871629,,647559,662954,765523,,707521,2240053,1106107,PDN
GC646,,2011,2004,,1355080,2903007,1871629,,791123,814225,936003,,563957,2088782,935627,PDN
GC646,,2012,2004,,1349193,2898203,1864888,,863119,900030,1023267,,486074,1998173,841621,PDN
GC646,,2013,2004,,1349193,2898203,1864888,,884846,919331,1048428,,464347,1978872,816460,PDN
GC646,,2014,2004,,1349193,2898203,1864888,,966239,1009651,1145893,,382954,1888552,718995,PDN
GC646,,2015,2004,,1349193,2898203,1864888,,991878,1034663,1175982,,357315,1863540,688906,PDN
GC646,,2016,2004,,991878,1034663,1175982,,991878,1034663,1175982,,0,0,0,PDN
GC646,,2017,2004,,991878,1034663,1175982,,991878,1034663,1175982,,0,0,0,PDN
GC646,,2017,2004,,991878,1034663,1175982,,991878,1034663,1175982,,0,0,0,PDN
GC654,,2003,2002,,886730522,439417631,964918713,,0,0,0,,886730522,439417631,964918713,PDP
GC654,,2004,2002,,886730522,439417631,964918713,,0,0,0,,886730522,439417631,964918713,PDP
GC654,,2005,2002,,501530406,248514362,545750043,,0,0,0,,501530406,248514362,545750043,PDP
GC654,,2006,2002,,501530406,248514362,545750043,,0,0,0,,501530406,248514362,545750043,PDP
GC654,,2007,2002,,229764935,105962325,248619442,,75904,39644,82958,,229689031,105922681,248536484,PDP
GC654,,2008,2002,,225124714,103642214,243566390,,1768701,798985,1910869,,223356013,102843229,241655521,PDP
GC654,,2009,2002,,214726280,98442996,232242827,,32153692,12551192,34387000,,182572588,85891804,197855827,PDP
GC654,,2010,2002,,232587158,106480391,251533846,,69821292,26727652,74577102,,162765866,79752739,176956745,PDP
GC654,,2011,2002,,254615863,119763700,275926129,,103637520,39499858,110665965,,150978343,80263842,165260165,PDP
GC654,,2012,2002,,236524011,94063607,253261308,,138768707,53530867,148293772,,97755304,40532740,104967536,PDP
GC654,,2013,2002,,236524011,94063607,253261308,,171439881,67008595,183363119,,65084130,27055012,69898189,PDP
GC654,,2014,2002,,259854251,102997039,278181126,,205651061,80987129,220061581,,54203190,22009910,58119543,PDP
GC654,,2015,2002,,283312700,112078249,303255447,,237689526,94008290,254416981,,45623174,18069959,48838469,PDP
GC654,,2016,2002,,386341386,153054171,413575223,,265065847,104988846,283747136,,121275539,48065325,129828088,PDP
GC654,,2017,2002,,462425586,182294123,494862261,,289750145,114816232,310180080,,172675441,67477891,184682182,PDP
GC654,,2017,2002,,462425586,182294123,494862261,,289750145,114816232,310180080,,172675441,67477891,184682182,PDP
GC680,,2003,2001,,58642108,91500780,74923386,,0,0,0,,58642108,91500780,74923386,PDP
GC680,,2004,2001,,58642108,91500780,74923386,,0,0,0,,58642108,91500780,74923386,PDP
GC680,,2005,2001,,39867453,76171556,53421111,,0,0,0,,39867453,76171556,53421111,PDP
GC680,,2006,2001,,42177403,78749127,56189703,,3772246,11105745,5748357,,38405157,67643382,50441346,PDP
GC680,,2007,2001,,42177403,78749127,56189703,,10394741,16784788,13381358,,31782662,61964339,42808345,PDP
GC680,,2008,2001,,42177403,78749127,56189703,,14748987,20417884,18382062,,27428416,58331243,37807641,PDP
GC680,,2009,2001,,42216412,79607324,56381416,,17363553,22421906,21353216,,24852859,57185418,35028201,PDP
GC680,,2010,2001,,32686400,35328249,38972565,,20331553,25012315,24782144,,12354847,10315934,14190422,PDP
GC680,,2011,2001,,34308583,36993439,40891045,,22659399,26958931,27456363,,11649184,10034508,13434684,PDP
GC680,,2012,2001,,34308355,37014410,40894549,,24246818,28350940,29291471,,10061537,8663470,11603080,PDP
GC680,,2013,2001,,35416857,38242898,42221643,,25615378,29497949,30864124,,9801479,8744949,11357519,PDP
GC680,,2014,2001,,37383104,40181057,44532757,,27097519,30503617,32525210,,10285585,9677440,12007550,PDP
GC680,,2015,2001,,38036717,40664321,45272360,,28051410,31389173,33636673,,9985307,9275148,11635689,PDP
GC680,,2016,2001,,38580731,41187662,45909496,,29286289,32490357,35067492,,9294442,8697305,10842005,PDP
GC680,,2017,2001,,38580731,41187662,45909496,,29961328,33054159,35842852,,8619403,8133503,10066646,PDP
GC680,,2017,2001,,38580731,41187662,45909496,,29961328,33054159,35842852,,8619403,8133503,10066646,PDP
GC743,,1998,1998,,12213369,427467928,88275278,,0,0,0,,12213369,427467928,88275278,PDP
GC743,,1999,1998,,11665609,411139850,84822166,,0,0,0,,11665609,411139850,84822166,PDP
GC743,,2000,1998,,482875939,722785139,611485394,,0,0,0,,482875939,722785139,611485394,PDP
GC743,,2001,1998,,689149190,472734605,773265668,,0,0,0,,689149190,472734605,773265668,PDP
GC743,,2002,1998,,642129531,442312888,720832892,,0,0,0,,642129531,442312888,720832892,PDP
GC743,,2003,1998,,642129531,442312888,720832892,,0,0,0,,642129531,442312888,720832892,PDP
GC743,,2004,1998,,642135224,442303687,720836947,,0,0,0,,642135224,442303687,720836947,PDP
GC743,,2005,1998,,559660323,388942424,628867160,,0,0,0,,559660323,388942424,628867160,PDP
GC743,,2006,1998,,559442841,388780130,628620800,,22686,0,22686,,559420155,388780130,628598114,PDP
GC743,,2007,1998,,559442841,388780130,628620800,,1550731,912463,1713091,,557892110,387867667,626907709,PDP
GC743,,2008,1998,,559442841,388780130,628620800,,30956787,19197270,34372671,,528486054,369582860,594248129,PDP
GC743,,2009,1998,,397990351,280652017,447928433,,69064782,43668948,76835056,,328925569,236983069,371093375,PDP
GC743,,2010,1998,,352104667,251934814,396932927,,102737832,65220637,114342928,,249366835,186714177,282589998,PDP
GC743,,2011,1998,,352104667,251934814,396932927,,126401897,79756557,140593454,,225702770,172178257,256339472,PDP
GC743,,2012,1998,,358105139,255711012,403605320,,142700223,89595189,158642428,,215404916,166115823,244962891,PDP
GC743,,2013,1998,,358105139,255711012,403605320,,171299348,108341752,190577241,,186805791,147369260,213028081,PDP
GC743,,2014,1998,,325159149,239429567,367762276,,212427905,136427083,236703187,,112731244,103002484,131059088,PDP
GC743,,2015,1998,,364077853,267006978,411587992,,250409488,161987991,279232975,,113668365,105018987,132355016,PDP
GC743,,2016,1998,,342925271,256742230,388608941,,287679135,187042942,320960797,,55246136,69699288,67648144,PDP
GC743,,2017,1998,,494733701,369943636,560559970,,323552628,213627859,361564703,,171181073,156315777,198995266,PDP
GC743,,2017,1998,,494733701,369943636,560559970,,323552628,213627859,361564703,,171181073,156315777,198995266,PDP
GC768,,2004,2004,,25665707,20285658,29275255,,0,0,0,,25665707,20285658,29275255,PDP
GC768,,2005,2004,,25665707,24313840,29992013,,0,0,0,,25665707,24313840,29992013,PDP
GC768,,2006,2004,,25665707,24313840,29992013,,4970965,4834374,5831174,,20694742,19479466,24160839,PDP
GC768,,2007,2004,,25665707,24313840,29992013,,7701692,7227136,8987659,,17964015,17086704,21004354,PDP
GC768,,2008,2004,,25665707,24313840,29992013,,10749359,9747324,12483758,,14916348,14566516,17508255,PDP
GC768,,2009,2004,,25665707,24313840,29992014,,12453868,11010249,14412987,,13211839,13303591,15579026,PDP
GC768,,2010,2004,,25665707,24313840,29992014,,14949904,12914335,17247828,,10715803,11399505,12744185,PDP
GC768,,2011,2004,,25665707,24313840,29992014,,17058004,14715560,19676431,,8607703,9598280,10315582,PDP
GC768,,2012,2004,,26507439,22383468,30490263,,18944830,15928595,21779099,,7562609,6454873,8711163,PDP
GC768,,2013,2004,,29593789,25363199,34106814,,20470639,17064035,23506944,,9123150,8299164,10599870,PDP
GC768,,2014,2004,,29593789,25363199,34106814,,21960831,18233385,25205205,,7632958,7129814,8901608,PDP
GC768,,2015,2004,,29593789,25363199,34106814,,22785527,19110025,26185888,,6808262,6253174,7920927,PDP
GC768,,2016,2004,,29593789,25363199,34106814,,23207714,19624700,26699653,,6386075,5738499,7407160,PDP
GC768,,2017,2004,,27552600,23123928,31667178,,23619091,20008074,27179247,,3933509,3115854,4487932,PDP
GC768,,2017,2004,,27552600,23123928,31667178,,23619091,20008074,27179247,,3933509,3115854,4487932,PDP
GC826,,1998,1998,,192803879,964019393,364337579,,0,0,0,,192803879,964019393,364337579,PDP
GC826,,1999,1998,,363637405,1599940551,648324336,,0,0,0,,363637405,1599940551,648324336,PDP
GC826,,2000,1998,,323874142,647748282,439131843,,0,0,0,,323874142,647748282,439131843,PDP
GC826,,2001,1998,,325013360,650026718,440676477,,0,0,0,,325013360,650026718,440676477,PDP
GC826,,2002,1998,,331202916,215871880,369614283,,0,0,0,,331202916,215871880,369614283,PDP
GC826,,2003,1998,,254541786,141083767,279645659,,0,0,0,,254541786,141083767,279645659,PDP
GC826,,2004,1998,,254541786,141083767,279645659,,0,0,0,,254541786,141083767,279645659,PDP
GC826,,2005,1998,,209184699,123625208,231182067,,8895054,2403389,9322703,,200289645,121221819,221859364,PDP
GC826,,2006,1998,,209184699,123625208,231182067,,20001219,6539863,21164896,,189183480,117085345,210017171,PDP
GC826,,2007,1998,,209404959,123792570,231432106,,36494367,11606149,38559518,,172910592,112186421,192872588,PDP
GC826,,2008,1998,,209404959,123792570,231432106,,56963165,17663577,60106150,,152441794,106128993,171325956,PDP
GC826,,2009,1998,,198281477,123223698,220207402,,80515646,24364538,84850973,,117765831,98859160,135356429,PDP
GC826,,2010,1998,,198281477,123223698,220207402,,101077539,30381436,106483488,,97203938,92842262,113723914,PDP
GC826,,2011,1998,,198281477,123223698,220207402,,106213380,31903088,111890086,,92068097,91320610,108317316,PDP
GC826,,2012,1998,,198281477,123223698,220207402,,112329497,33668494,118320332,,85951980,89555204,101887070,PDP
GC826,,2013,1998,,198281477,123223698,220207402,,125097391,37291828,131732948,,73184086,85931870,88474454,PDP
GC826,,2014,1998,,165525400,101774466,183634736,,135543527,40557311,142760130,,29981873,61217155,40874606,PDP
GC826,,2015,1998,,165525400,101774466,183634736,,147578810,44385821,155476643,,17946590,57388645,28158093,PDP
GC826,,2016,1998,,234984540,119183969,256191652,,167738748,49958811,176628216,,67245792,69225158,79563435,PDP
GC826,,2017,1998,,393358006,162080012,422197867,,189535281,56153163,199526948,,203822725,105926849,222670919,PDP
GC826,,2017,1998,,393358006,162080012,422197867,,189535281,56153163,199526948,,203822725,105926849,222670919,PDP
GC859,,2014,2009,,64000413,24582770,68374572,,0,0,0,,64000413,24582770,68374572,PDP
GC859,,2015,2009,,59895665,30222253,65273290,,0,0,0,,59895665,30222253,65273290,PDP
GC859,,2016,2009,,52272448,26868038,57053238,,4687072,2199765,5078489,,47585376,24668273,51974748,PDP
GC859,,2017,2009,,37138792,16229652,40026630,,17027044,7735173,18403409,,20111748,8494479,21623221,PDP
GC859,,2017,2009,,37138792,16229652,40026630,,17027044,7735173,18403409,,20111748,8494479,21623221,PDP
GI016,,1975,1948,,350000000,299950000,403371886,,223470395,207350229,260365454,,126529605,92599771,143006432,PDP
GI016,,1976,1948,,330000000,279940000,379811388,,231277921,217499321,269978868,,98722079,62440679,109832520,PDP
GI016,,1977,1948,,330000000,265800000,377295374,,236269718,225946915,276473795,,93730282,39853085,100821579,PDP
GI016,,1978,1948,,265000000,267820000,312654804,,240809132,236235918,282843993,,24190868,31584082,29810811,PDP
GI016,,1979,1948,,260166986,304213727,314297542,,242548998,257349662,288340753,,17617988,46864065,25956789,PDP
GI016,,1980,1948,,261960623,309475183,317027382,,244992808,262530440,291706409,,16967815,46944743,25320973,PDP
GI016,,1981,1948,,265728062,310433658,320965368,,247072217,266574652,294505429,,18655845,43859006,26459939,PDP
GI016,,1982,1948,,270414679,315990511,326640749,,250150569,270144408,298218969,,20264110,45846103,28421780,PDP
GI016,,1983,1948,,275493452,321618789,332720995,,251461681,273880608,300194885,,24031771,47738181,32526110,PDP
GI016,,1984,1948,,281309089,318513081,337984014,,254432004,276807186,303685952,,26877085,41705895,34298062,PDP
GI016,,1985,1948,,285569907,338940724,345879644,,256234053,283351002,306652381,,29335854,55589722,39227263,PDP
GI016,,1986,1948,,289971071,342284645,350875812,,259958004,289870133,311536319,,30013067,52414512,39339493,PDP
GI016,,1987,1948,,289149124,362234335,353603632,,262729456,298418801,315828887,,26419668,63815534,37774745,PDP
GI016,,1988,1948,,292385830,360046259,356451001,,265692632,302072012,319442100,,26693198,57974247,37008901,PDP
GI016,,1989,1948,,296976112,369161682,362663244,,269209171,308310483,324068688,,27766941,60851199,38594556,PDP
GI016,,1990,1948,,297919537,380257876,365581081,,271796748,316414340,328098232,,26122789,63843536,37482849,PDP
GI016,,1991,1948,,285758457,362208945,350208447,,273893891,321774911,331149213,,11864566,40434034,19059234,PDP
GI016,,1992,1948,,287409712,368429372,352966540,,275821395,325436540,333728253,,11588317,42992832,19238287,PDP
GI016,,1993,1948,,289041042,385575520,357648786,,277510690,330675919,336349821,,11530352,54899601,21298965,PDP
GI016,,1994,1948,,291472813,390300088,360921227,,279347196,338709364,339615766,,12125617,51590724,21305461,PDP
GI016,,1995,1948,,291356340,357545199,354976482,,281880873,343290260,342964549,,9475467,14254939,12011933,PDP
GI016,,1996,1948,,292394834,365153727,357368807,,284336956,345689536,345847550,,8057878,19464191,11521257,PDP
GI016,,1997,1948,,294907813,378834799,362316140,,286572724,353220655,349423374,,8335089,25614144,12892766,PDP
GI016,,1998,1948,,295104385,375561088,361930201,,288189799,357119802,351734248,,6914586,18441286,10195953,PDP
GI016,,1999,1948,,294943075,374906033,361652334,,289891569,363064232,354493746,,5051506,11841801,7158588,PDP
GI016,,2000,1948,,300895692,383086467,369060543,,291865486,366367785,357055483,,9030206,16718682,12005060,PDP
GI016,,2001,1948,,301367502,385500807,369961951,,293508553,368999146,359166764,,7858949,16501661,10795187,PDP
GI016,,2002,1948,,300337109,382448749,368388487,,294622461,370652973,360574947,,5714648,11795776,7813540,PDP
GI016,,2003,1948,,302041042,381762313,369970279,,295679886,372300313,361925493,,6361156,9462000,8044786,PDP
GI016,,2004,1948,,301392321,383363541,369606474,,296720314,373238368,363132835,,4672007,10125173,6473639,PDP
GI016,,2005,1948,,304015712,385849560,372672217,,297823382,376385898,364795962,,6192330,9463662,7876255,PDP
GI016,,2006,1948,,304462851,386428562,373222381,,299191863,377925584,366438408,,5270988,8502978,6783973,PDP
GI016,,2007,1948,,304683912,386106918,373386210,,300118436,378714749,367505402,,4565476,7392169,5880808,PDP
GI016,,2008,1948,,304340545,386268617,373071615,,300692845,379219286,368169586,,3647700,7049331,4902029,PDP
GI016,,2009,1948,,305340080,394529204,375541008,,301276248,386808120,370103314,,4063832,7721084,5437691,PDP
GI016,,2010,1948,,306652253,397081454,377307318,,301721140,387297963,370635369,,4931113,9783491,6671949,PDP
GI016,,2011,1948,,307085953,397835137,377875126,,302419657,388667638,371577599,,4666296,9167499,6297521,PDP
GI016,,2012,1948,,570260036,398892525,641237355,,303427150,391430692,373076738,,266832886,7461833,268160616,PDP
GI016,,2013,1948,,308356345,400352305,379593411,,304361152,393085593,374305207,,3995193,7266712,5288204,PDP
GI016,,2014,1948,,308128380,399843516,379274915,,305336851,393929492,375431066,,2791529,5914024,3843850,PDP
GI016,,2015,1948,,309001374,401347854,380415585,,306172240,394812469,376423572,,2829134,6535385,3992015,PDP
GI016,,2016,1948,,309441055,401338295,380853566,,306804639,395614193,377198625,,2636416,5724102,3654940,PDP
GI016,,2017,1948,,310076631,401961622,381600055,,307285356,396399379,377819055,,2791275,5562243,3781000,PDP
GI016,,2017,1948,,310076631,401961622,381600055,,307285356,396399379,377819055,,2791275,5562243,3781000,PDP
GI018,,1975,1965,,45000000,31995000,50693060,,40514000,30000000,45852078,,4486000,1995000,4840982,PDP
GI018,,1976,1965,,45000000,31995000,50693060,,40514000,30000000,45852078,,4486000,1995000,4840982,PDP
GI018,,1983,1965,,1000000,1400000,1249110,,345696,353826,408654,,654304,1046174,840456,PDP
GI018,,1984,1965,,2024934,2175575,2412047,,663924,628837,775817,,1361010,1546738,1636230,PDP
GI018,,1985,1965,,2748188,2514733,3195649,,968115,965161,1139852,,1780073,1549572,2055797,PDP
GI018,,1986,1965,,2748188,2514733,3195649,,1232963,1345575,1472389,,1515225,1169158,1723260,PDP
GI018,,1987,1965,,2748188,5674407,3757869,,1529116,2458181,1966515,,1219072,3216226,1791354,PDP
GI018,,1988,1965,,2748188,5674407,3757869,,1979647,3585015,2617550,,768541,2089392,1140319,PDP
GI018,,1989,1965,,3798975,17471931,6907860,,2307566,4083947,3034247,,1491409,13387984,3873613,PDP
GI018,,1990,1965,,3798975,17471931,6907860,,2543012,4380086,3322387,,1255963,13091845,3585473,PDP
GI018,,1991,1965,,3549119,5658308,4555935,,2761314,4650596,3588822,,787805,1007712,967113,PDP
GI018,,1992,1965,,3549119,5658308,4555935,,2930470,4845249,3792614,,618649,813059,763321,PDP
GI018,,1993,1965,,3549119,5658308,4555935,,3064609,5036696,3960818,,484510,621612,595117,PDP
GI018,,1994,1965,,3549119,5658307,4555935,,3270523,5355380,4223438,,278596,302927,332497,PDP
GI018,,1995,1965,,4777595,7863586,6176810,,3521860,5668515,4530493,,1255735,2195071,1646317,PDP
GI018,,1996,1965,,7482477,9966078,9255800,,4109449,6164205,5206283,,3373028,3801873,4049517,PDP
GI018,,1997,1965,,7785587,11362189,9807329,,5248324,7590861,6599011,,2537263,3771328,3208318,PDP
GI018,,1998,1965,,7718856,11296325,9728878,,6450748,8755108,8008596,,1268108,2541217,1720282,PDP
GI018,,1999,1965,,7895397,11506419,9942803,,7275008,9322219,8933766,,620389,2184200,1009037,PDP
GI018,,2000,1965,,10126646,12729458,12391674,,7900916,9695814,9626150,,2225730,3033644,2765524,PDP
GI018,,2001,1965,,10126646,12729458,12391674,,8397857,10033130,10183111,,1728789,2696328,2208563,PDP
GI018,,2002,1965,,10012184,11457181,12050828,,8743776,10276499,10572335,,1268408,1180682,1478493,PDP
GI018,,2003,1965,,9927171,11344704,11945802,,9077151,10552024,10954735,,850020,792680,991067,PDP
GI018,,2004,1965,,9927171,11308964,11939442,,9307507,10727436,11216303,,619664,581528,723139,PDP
GI018,,2005,1965,,10142501,12341987,12338584,,9495447,11070838,11465347,,647054,1271149,873237,PDP
GI018,,2006,1965,,10411278,11521505,12461368,,9720516,11151249,11704724,,690762,370256,756644,PDP
GI018,,2007,1965,,10479275,12062909,12625700,,9947282,11424584,11980126,,531993,638325,645574,PDP
GI018,,2008,1965,,10479275,12225342,12654603,,10076548,11609296,12142259,,402727,616046,512344,PDP
GI018,,2009,1965,,10538567,12510420,12764620,,10164173,11968126,12293733,,374394,542294,470887,PDP
GI018,,2010,1965,,10538567,12510420,12764621,,10256992,12179492,12424161,,281575,330928,340459,PDP
GI018,,2011,1965,,10538567,12563804,12774120,,10362718,12300325,12551388,,175849,263479,222732,PDP
GI018,,2012,1965,,10674592,16601581,13628610,,10467303,13196518,12815438,,207289,3405063,813172,PDP
GI018,,2013,1965,,10674592,16601581,13628610,,10598546,16246609,13489403,,76046,354972,139208,PDP
GI018,,2014,1965,,10655571,16559048,13602022,,10632580,16525366,13573037,,22991,33682,28984,PDP
GI018,,2015,1965,,10680928,16595790,13633916,,10645568,16541525,13588901,,35360,54265,45016,PDP
GI018,,2016,1965,,10670178,16580214,13620395,,10656498,16558454,13602843,,13680,21760,17552,PDP
GI018,,2017,1965,,10700530,16609269,13655917,,10672500,16572970,13621428,,28030,36299,34489,PDP
GI018,,2017,1965,,10700530,16609269,13655917,,10672500,16572970,13621428,,28030,36299,34489,PDP
GI020,,1983,1978,,4751777,4751777,5597289,,0,0,0,,4751777,4751777,5597289,PDN
GI020,,1984,1978,,11272795,15815731,14086982,,0,0,0,,11272795,15815731,14086982,PDN
GI020,,1985,1978,,11272795,15815731,14086982,,32817,17037,35848,,11239978,15798694,14051134,PDN
GI020,,1986,1978,,9337694,18320608,12597589,,937319,1396021,1185721,,8400375,16924587,11411868,PDN
GI020,,1987,1978,,9337694,18320608,12597589,,1905527,3069904,2451773,,7432167,15250704,10145816,PDN
GI020,,1988,1978,,9337694,18320608,12597589,,2812179,4644291,3638565,,6525515,13676317,8959024,PDN
GI020,,1989,1978,,9337694,18320608,12597589,,3465693,5960257,4526237,,5872001,12360351,8071352,PDN
GI020,,1990,1978,,9337694,18320608,12597589,,3930180,6857672,5150406,,5407514,11462936,7447183,PDN
GI020,,1991,1978,,7665802,17775772,10828751,,4616559,8043548,6047795,,3049243,9732224,4780956,PDN
GI020,,1992,1978,,7665802,17775772,10828751,,5110048,8754523,6667792,,2555754,9021249,4160959,PDN
GI020,,1993,1978,,7665802,17775772,10828751,,5484589,9244650,7129545,,2181213,8531122,3699206,PDN
GI020,,1994,1978,,7665093,17774316,10827783,,5977176,9998864,7756333,,1687917,7775452,3071450,PDN
GI020,,1995,1978,,7626393,12744591,9894114,,6384504,10691780,8286956,,1241889,2052811,1607158,PDN
GI020,,1996,1978,,7626410,12953960,9931385,,6668882,11179453,8658109,,957528,1774507,1273276,PDN
GI020,,1997,1978,,7626410,12953960,9931385,,6858503,11527283,8909621,,767907,1426677,1021764,PDN
GI020,,1998,1978,,7626410,12953960,9931385,,6954025,11646393,9026337,,672385,1307567,905048,PDN
GI020,,1999,1978,,7626410,12953960,9931385,,7044462,11741428,9133684,,581948,1212532,797701,PDN
GI020,,2000,1978,,7169966,11908206,9288864,,7104735,11801366,9204622,,65231,106840,84242,PDN
GI020,,2001,1978,,7144537,11833085,9250068,,7144537,11833085,9250068,,0,0,0,PDN
GI020,,2002,1978,,7144537,11833085,9250068,,7144537,11833085,9250068,,0,0,0,PDN
GI020,,2003,1978,,7144537,11833085,9250068,,7144537,11833085,9250068,,0,0,0,PDN
GI020,,2004,1978,,7144537,11833085,9250068,,7144537,11833085,9250068,,0,0,0,PDN
GI020,,2005,1978,,7144537,11833085,9250068,,7144537,11833085,9250068,,0,0,0,PDN
GI020,,2006,1978,,7144537,11833085,9250068,,7144537,11833085,9250068,,0,0,0,PDN
GI020,,2007,1978,,7144537,11833085,9250068,,7144537,11833085,9250068,,0,0,0,PDN
GI020,,2008,1978,,7144537,11833085,9250068,,7144537,11833085,9250068,,0,0,0,PDN
GI020,,2009,1978,,7144537,12065891,9291493,,7144537,12065891,9291493,,0,0,0,PDN
GI020,,2010,1978,,7144537,12065891,9291493,,7144537,12065891,9291493,,0,0,0,PDN
GI020,,2011,1978,,7144537,12065891,9291493,,7144537,12065891,9291493,,0,0,0,PDN
GI020,,2012,1978,,7144537,12065891,9291493,,7144537,12065891,9291493,,0,0,0,PDN
GI020,,2013,1978,,7144537,12065891,9291493,,7144537,12065891,9291493,,0,0,0,PDN
GI020,,2014,1978,,7144537,12065891,9291493,,7144537,12065891,9291493,,0,0,0,PDN
GI020,,2015,1978,,7144537,12065891,9291493,,7144537,12065891,9291493,,0,0,0,PDN
GI020,,2016,1978,,7144537,12065891,9291493,,7144537,12065891,9291493,,0,0,0,PDN
GI020,,2017,1978,,7144537,12065891,9291493,,7144537,12065891,9291493,,0,0,0,PDN
GI020,,2017,1978,,7144537,12065891,9291493,,7144537,12065891,9291493,,0,0,0,PDN
GI028,,2001,2002,,525,5253755,935357,,0,0,0,,525,5253755,935357,PDN
GI028,,2002,2002,,218342,5253755,1153174,,0,0,0,,218342,5253755,1153174,PDN
GI028,,2003,2002,,69869,1370545,313738,,21148,423786,96555,,48721,946759,217183,PDN
GI028,,2004,2002,,78106,1522827,349072,,55887,1089628,249771,,22219,433199,99301,PDN
GI028,,2005,2002,,83163,1598969,367677,,69749,1352381,310386,,13414,246588,57291,PDN
GI028,,2006,2002,,83084,1597470,367331,,79451,1531086,351886,,3633,66384,15445,PDN
GI028,,2007,2002,,83084,1597470,367331,,83084,1597470,367331,,0,0,0,PDN
GI028,,2008,2002,,83084,1597470,367331,,83084,1597470,367331,,0,0,0,PDN
GI028,,2009,2002,,83084,1597470,367331,,83084,1597470,367331,,0,0,0,PDN
GI028,,2010,2002,,83084,1597470,367331,,83084,1597470,367331,,0,0,0,PDN
GI028,,2011,2002,,83084,1597470,367331,,83084,1597470,367331,,0,0,0,PDN
GI028,,2012,2002,,83084,1597470,367331,,83084,1597470,367331,,0,0,0,PDN
GI028,,2013,2002,,83084,1597470,367331,,83084,1597470,367331,,0,0,0,PDN
GI028,,2014,2002,,83084,1597470,367331,,83084,1597470,367331,,0,0,0,PDN
GI028,,2015,2002,,83084,1597470,367331,,83084,1597470,367331,,0,0,0,PDN
GI028,,2016,2002,,83084,1597470,367331,,83084,1597470,367331,,0,0,0,PDN
GI028,,2017,2002,,83084,1597470,367331,,83084,1597470,367331,,0,0,0,PDN
GI028,,2017,2002,,83084,1597470,367331,,83084,1597470,367331,,0,0,0,PDN
GI030,,1983,1979,,0,1400000,249110,,0,0,0,,0,1400000,249110,PDN
GI030,,1984,1979,,0,1845437,328370,,0,0,0,,0,1845437,328370,PDN
GI030,,1999,1979,,492002,11057261,2459486,,16905,400373,88146,,475097,10656888,2371340,PDN
GI030,,2000,1979,,474897,21683048,4333091,,282978,12775641,2556224,,191919,8907407,1776867,PDN
GI030,,2001,1979,,449901,20364664,4073507,,302158,16040196,3156285,,147743,4324468,917222,PDN
GI030,,2002,1979,,306893,16631491,3266233,,306853,16631201,3266141,,40,290,92,PDN
GI030,,2003,1979,,317009,16643429,3278473,,317009,16643429,3278473,,0,0,0,PDN
GI030,,2004,1979,,317009,16643429,3278473,,317009,16643429,3278473,,0,0,0,PDN
GI030,,2005,1979,,317009,16643429,3278473,,317009,16643429,3278473,,0,0,0,PDN
GI030,,2006,1979,,317009,16643429,3278473,,317009,16643429,3278473,,0,0,0,PDN
GI030,,2007,1979,,317009,16643429,3278473,,317009,16643429,3278473,,0,0,0,PDN
GI030,,2008,1979,,317009,16643429,3278473,,317009,16643429,3278473,,0,0,0,PDN
GI030,,2009,1979,,317009,16643428,3278473,,317009,16643428,3278473,,0,0,0,PDN
GI030,,2010,1979,,317009,16643428,3278473,,317009,16643428,3278473,,0,0,0,PDN
GI030,,2011,1979,,317009,16643428,3278473,,317009,16643428,3278473,,0,0,0,PDN
GI030,,2012,1979,,317009,16643428,3278473,,317009,16643428,3278473,,0,0,0,PDN
GI030,,2013,1979,,317009,16643428,3278473,,317009,16643428,3278473,,0,0,0,PDN
GI030,,2014,1979,,317009,16643428,3278473,,317009,16643428,3278473,,0,0,0,PDN
GI030,,2015,1979,,317009,16643428,3278473,,317009,16643428,3278473,,0,0,0,PDN
GI030,,2016,1979,,317009,16643428,3278473,,317009,16643428,3278473,,0,0,0,PDN
GI030,,2017,1979,,317009,16643428,3278473,,317009,16643428,3278473,,0,0,0,PDN
GI030,,2017,1979,,317009,16643428,3278473,,317009,16643428,3278473,,0,0,0,PDN
GI033,,1975,1966,,11000,200000,46587,,10000,190000,43808,,1000,10000,2779,PDN
GI033,,1976,1966,,11000,200000,46587,,10000,190000,43808,,1000,10000,2779,PDN
GI033,,1977,1966,,11000,200000,46587,,10000,190000,43808,,1000,10000,2779,PDN
GI033,,1978,1966,,10000,190000,43808,,10000,190000,43808,,0,0,0,PDN
GI033,,1979,1966,,17887,187121,51183,,17887,187121,51183,,0,0,0,PDN
GI033,,1980,1966,,17887,187121,51183,,17887,187121,51183,,0,0,0,PDN
GI033,,1981,1966,,17887,187121,51183,,17887,187121,51183,,0,0,0,PDN
GI033,,1982,1966,,13672,187121,46968,,13672,187121,46968,,0,0,0,PDN
GI033,,1983,1966,,2160895,14038318,4658816,,13672,187121,46968,,2147223,13851197,4611848,PDN
GI033,,1984,1966,,2160895,14038318,4658816,,13672,187121,46968,,2147223,13851197,4611848,PDN
GI033,,1985,1966,,2160895,17754269,5320018,,13672,187121,46968,,2147223,17567148,5273050,PDN
GI033,,1986,1966,,5175176,19203113,8592100,,17805,318842,74538,,5157371,18884271,8517562,PDN
GI033,,1987,1966,,7581575,52153353,16861531,,824609,8806543,2391610,,6756966,43346810,14469921,PDN
GI033,,1988,1966,,8593041,61996203,19624394,,1652788,18956394,5025812,,6940253,43039809,14598582,PDN
GI033,,1989,1966,,8658224,68689763,20880602,,2275026,27235347,7121173,,6383198,41454416,13759429,PDN
GI033,,1990,1966,,5204376,54363254,14877553,,2764198,32678111,8578808,,2440178,21685143,6298745,PDN
GI033,,1991,1966,,5204376,54418763,14887430,,3176911,37498346,9849215,,2027465,16920417,5038215,PDN
GI033,,1992,1966,,5198664,60634627,15987744,,3571771,42656831,11161954,,1626893,17977796,4825790,PDN
GI033,,1993,1966,,5482963,60862065,16312512,,3923033,48293003,12516094,,1559930,12569062,3796418,PDN
GI033,,1994,1966,,5409001,70411257,17937694,,4220236,53789988,13791408,,1188765,16621269,4146286,PDN
GI033,,1995,1966,,5493309,66796242,17378761,,4455173,58259699,14821667,,1038136,8536543,2557094,PDN
GI033,,1996,1966,,5219524,72237723,18073211,,4638715,62029486,15675990,,580809,10208237,2397221,PDN
GI033,,1997,1966,,5229139,73162886,18247446,,4788059,65076318,16367475,,441080,8086568,1879971,PDN
GI033,,1998,1966,,5419469,73335033,18468407,,4925291,67610953,16955710,,494178,5724080,1512697,PDN
GI033,,1999,1966,,5331936,75726829,18806461,,5046543,69656819,17440995,,285393,6070010,1365466,PDN
GI033,,2000,1966,,5551339,79468018,19691555,,5217701,72843708,18179215,,333638,6624310,1512340,PDN
GI033,,2001,1966,,7019782,92652226,23505943,,5481239,76287202,19055474,,1538543,16365024,4450469,PDN
GI033,,2002,1966,,7076840,89522860,23006174,,5873935,78806677,19896475,,1202905,10716183,3109699,PDN
GI033,,2003,1966,,6868113,89668301,22823326,,6114044,79952774,20340516,,754069,9715527,2482810,PDN
GI033,,2004,1966,,6957283,89731224,22923693,,6260511,80710154,20621748,,696772,9021070,2301945,PDN
GI033,,2005,1966,,7104153,90501453,23207614,,6354797,81264928,20814749,,749356,9236525,2392865,PDN
GI033,,2006,1966,,7172717,90879944,23343525,,6476019,81926405,21053671,,696698,8953539,2289854,PDN
GI033,,2007,1966,,7335516,91135345,23551769,,6585070,82390543,21245309,,750446,8744802,2306460,PDN
GI033,,2008,1966,,7335291,91259188,23573580,,6684002,82707880,21400707,,651289,8551308,2172873,PDN
GI033,,2009,1966,,7239401,90098680,23271195,,6780413,84231530,21768230,,458988,5867150,1502966,PDN
GI033,,2010,1966,,7202470,88897379,23020508,,6870911,84367490,21882920,,331559,4529889,1137590,PDN
GI033,,2011,1966,,7202470,88403802,22932683,,6961401,85123019,22107845,,241069,3280783,824838,PDN
GI033,,2012,1966,,7202470,88403802,22932683,,7023699,85511009,22239180,,178771,2892793,693503,PDN
GI033,,2013,1966,,7202470,88403802,22932683,,7072858,85681326,22318645,,129612,2722476,614040,PDN
GI033,,2014,1966,,7237881,87140988,22743395,,7115359,85762918,22375664,,122522,1378070,367730,PDN
GI033,,2015,1966,,7298786,86049441,22610073,,7159758,85795675,22425892,,139028,253766,184182,PDN
GI033,,2016,1966,,7302530,85984086,22602189,,7192728,85801633,22459922,,109802,182453,142267,PDN
GI033,,2017,1966,,7192728,85801633,22459922,,7192728,85801633,22459922,,0,0,0,PDN
GI033,,2017,1966,,7192728,85801633,22459922,,7192728,85801633,22459922,,0,0,0,PDN
GI041,,1975,1959,,45000000,210015000,82369217,,33094427,118848763,54241894,,11905573,91166237,28127323,PDP
GI041,,1976,1959,,49000000,213003000,86900890,,36190671,136234773,60431734,,12809329,76768227,26469156,PDP
GI041,,1977,1959,,49000000,213003000,86900890,,40893818,152594785,68045915,,8106182,60408215,18854975,PDP
GI041,,1978,1959,,51000000,214200000,89113879,,43438737,166667073,73094800,,7561263,47532927,16019079,PDP
GI041,,1979,1959,,72561381,286387060,123519933,,50110019,197457978,85244891,,22451362,88929082,38275042,PDP
GI041,,1980,1959,,72566044,282331429,122802953,,49001716,150568360,75793239,,23564328,131763069,47009714,PDP
GI041,,1981,1959,,73223437,286678042,124233765,,53344608,203941628,89633154,,19878829,82736414,34600611,PDP
GI041,,1982,1959,,73369467,287562195,124537117,,54965313,208967445,92148132,,18404154,78594750,32388985,PDP
GI041,,1983,1959,,75629233,288166629,126904434,,56736312,213707710,94762595,,18892921,74458919,32141839,PDP
GI041,,1984,1959,,77715548,294797348,130170592,,58400607,218324579,97248397,,19314941,76472769,32922195,PDP
GI041,,1985,1959,,81868849,304685179,136083294,,60007809,223368455,99753086,,21861040,81316724,36330208,PDP
GI041,,1986,1959,,82129850,305657855,136517369,,61514606,229184348,102294739,,20615244,76473507,34222630,PDP
GI041,,1987,1959,,82944496,311246091,138326363,,62759479,233474682,104303017,,20185017,77771409,34023346,PDP
GI041,,1988,1959,,83186274,307968645,137984965,,64114024,237465679,106367704,,19072250,70502966,31617261,PDP
GI041,,1989,1959,,86265473,318125466,142871428,,65829425,242725387,109018996,,20436048,75400079,33852432,PDP
GI041,,1990,1959,,74613542,286616256,125612876,,67454473,248285177,111633330,,7159069,38331079,13979546,PDP
GI041,,1991,1959,,74613542,287395252,125751487,,68868506,253682265,114007699,,5745036,33712987,11743788,PDP
GI041,,1992,1959,,75435509,290650384,127152659,,69983224,257451921,115793174,,5452285,33198463,11359485,PDP
GI041,,1993,1959,,75890704,301271454,129497724,,71331299,263285789,118179304,,4559405,37985665,11318420,PDP
GI041,,1994,1959,,77916169,305769659,132323582,,72555782,269834352,120569012,,5360387,35935307,11754570,PDP
GI041,,1995,1959,,78308629,302345589,132106777,,73862104,273591171,122543807,,4446525,28754418,9562970,PDP
GI041,,1996,1959,,82139663,313033563,137839585,,75631894,278505508,125188034,,6507769,34528055,12651551,PDP
GI041,,1997,1959,,82389372,316549728,138714946,,77129208,285013689,127843388,,5260164,31536039,10871558,PDP
GI041,,1998,1959,,83920498,325303828,141803741,,78408156,294322882,130778776,,5512342,30980946,11024965,PDP
GI041,,1999,1959,,83151208,330099080,141887699,,79716176,304213680,133846724,,3435032,25885400,8040975,PDP
GI041,,2000,1959,,83367172,341637298,144156727,,80374931,309735580,135488024,,2992241,31901718,8668703,PDP
GI041,,2001,1959,,84047798,352698892,146805608,,81195005,321271723,138360792,,2852793,31427169,8444816,PDP
GI041,,2002,1959,,85185360,351573381,147742902,,81904980,327233520,140131585,,3280380,24339861,7611317,PDP
GI041,,2003,1959,,85480489,349228115,147620723,,82574889,331861846,141625040,,2905600,17366269,5995683,PDP
GI041,,2004,1959,,85632803,349786773,147872443,,83005534,334418043,142510524,,2627269,15368730,5361919,PDP
GI041,,2005,1959,,82983976,341207415,143697040,,82025995,328933643,140555113,,957981,12273772,3141927,PDP
GI041,,2006,1959,,83258385,340072781,143769556,,82094784,329878524,140792030,,1163601,10194257,2977526,PDP
GI041,,2007,1959,,83641625,341433143,144394854,,82294035,330982830,141187777,,1347590,10450313,3207077,PDP
GI041,,2008,1959,,84493812,342573792,145450003,,82763629,332192592,141872631,,1730183,10381200,3577372,PDP
GI041,,2009,1959,,85023937,346668439,146708718,,83295355,339498192,143704290,,1728582,7170247,3004428,PDP
GI041,,2010,1959,,85712015,350435442,148067081,,83703342,341760340,144514794,,2008673,8675102,3552286,PDP
GI041,,2011,1959,,86995307,353978144,149980746,,84086586,343030023,145123959,,2908721,10948121,4856786,PDP
GI041,,2012,1959,,87294526,354070241,150296352,,84440085,343979421,145646392,,2854441,10090820,4649961,PDP
GI041,,2013,1959,,87318783,354710458,150434526,,84732438,344869882,146097189,,2586345,9840576,4337337,PDP
GI041,,2014,1959,,86203256,352061608,148847674,,84973615,345527798,146455434,,1229641,6533810,2392240,PDP
GI041,,2015,1959,,86696585,353687242,149630263,,85306301,346248059,146916277,,1390284,7439183,2713982,PDP
GI041,,2016,1959,,86776350,354645778,149880586,,85631607,347179616,147407343,,1144743,7466162,2473243,PDP
GI041,,2017,1959,,87000026,354654040,150105732,,85929246,348434552,147928278,,1070780,6219488,2177451,PDP
GI041,,2017,1959,,86986026,354701207,150100125,,85929246,348434552,147928278,,1056780,6266655,2171843,PDP
GI043,,1975,1956,,297000000,1100088000,492745196,,197152505,600898473,304073941,,99847495,499189527,188671255,PDP
GI043,,1976,1956,,297000000,1100088000,492745196,,213380751,714441790,340505625,,83619249,385646210,152239571,PDP
GI043,,1977,1956,,297000000,1100088000,492745196,,232225920,792319015,373207951,,64774080,307768985,119537245,PDP
GI043,,1978,1956,,297000000,1100088000,492745196,,244138731,859526447,397079380,,52861269,240561553,95665816,PDP
GI043,,1979,1956,,340810888,1457328979,600122094,,226312279,866112264,380424781,,114498609,591216715,219697313,PDP
GI043,,1980,1956,,367675358,1554026493,644192528,,252023199,957086066,422323211,,115652159,596940427,221869317,PDP
GI043,,1981,1956,,371434501,1723966966,678190189,,259713846,994741156,436714052,,111720655,729225810,241476137,PDP
GI043,,1982,1956,,390272553,1752352500,702079048,,266863142,1028921658,449945288,,123409411,723430842,252133760,PDP
GI043,,1983,1956,,379169301,1561255502,656972771,,274157971,1054190954,461736433,,105011330,507064548,195236338,PDP
GI043,,1984,1956,,380938922,1580164742,662107026,,281006691,1087518049,474515241,,99932231,492646693,187591785,PDP
GI043,,1985,1956,,385251669,1587857463,667788584,,287563131,1111169008,485280036,,97688538,476688455,182508548,PDP
GI043,,1986,1956,,391918684,1615045702,679293364,,293641632,1138152021,496159785,,98277052,476893681,183133579,PDP
GI043,,1987,1956,,390639526,1638458776,682180233,,299414698,1166819102,507033755,,91224828,471639674,175146478,PDP
GI043,,1988,1956,,377278519,1478563775,640368159,,304650130,1188729720,516167874,,72628389,289834055,124200285,PDP
GI043,,1989,1956,,378645643,1481640131,642282677,,309367670,1206235170,524000263,,69277973,275404961,118282414,PDP
GI043,,1990,1956,,371318297,1458993331,630925651,,313756507,1223748961,531505432,,57561790,235244370,99420219,PDP
GI043,,1991,1956,,363969599,1425033006,617534191,,317413279,1237612210,537628975,,46556320,187420796,79905216,PDP
GI043,,1992,1956,,364848280,1436281277,620414344,,321114552,1251120662,543733887,,43733728,185160615,76680457,PDP
GI043,,1993,1956,,359133622,1411709102,610327412,,324576294,1262882763,549288529,,34557328,148826339,61038883,PDP
GI043,,1994,1956,,371824405,1496560091,638116236,,328857204,1295220237,559323438,,42967201,201339854,78792798,PDP
GI043,,1995,1956,,367774829,1491481852,633163059,,332921462,1329859636,569551290,,34853367,161622216,63611769,PDP
GI043,,1996,1956,,360428430,1515907691,630162895,,336414100,1373898551,580880034,,24014330,142009140,49282861,PDP
GI043,,1997,1956,,362431210,1554172622,638974381,,340611780,1409671845,591443069,,21819430,144500777,47531312,PDP
GI043,,1998,1956,,364498049,1578874608,645436591,,343533689,1431759061,598295088,,20964360,147115547,47141503,PDP
GI043,,1999,1956,,364446189,1567458648,643353422,,346788794,1446405302,604156285,,17657395,121053346,39197137,PDP
GI043,,2000,1956,,382648658,1615908052,670176781,,348885926,1458840459,608466079,,33762732,157067593,61710702,PDP
GI043,,2001,1956,,383668796,1624562964,672736939,,350905023,1473954588,613174523,,32763773,150608376,59562416,PDP
GI043,,2002,1956,,384594782,1634826185,675489121,,353179819,1489594317,618232189,,31414963,145231868,57256932,PDP
GI043,,2003,1956,,387537736,1646658859,680537533,,356000196,1510276069,624732593,,31537540,136382790,55804940,PDP
GI043,,2004,1956,,387891983,1645144504,680622322,,358688480,1526305736,630273131,,29203503,118838768,50349191,PDP
GI043,,2005,1956,,387383582,1641814465,679521387,,360416849,1534351799,633433183,,26966733,107462666,46088204,PDP
GI043,,2006,1956,,392519860,1661204388,688107830,,360775664,1537098032,634280652,,31744196,124106356,53827178,PDP
GI043,,2007,1956,,396823940,1664431291,692986091,,362677514,1545363878,637653293,,34146426,119067413,55332798,PDP
GI043,,2008,1956,,397017615,1672489922,694613687,,364964595,1552818378,641266797,,32053020,119671544,53346890,PDP
GI043,,2009,1956,,394053717,1722150388,700486163,,367409462,1591499740,650594466,,26644255,130650648,49891696,PDP
GI043,,2010,1956,,394917159,1725965988,702028536,,369551008,1604388699,655029416,,25366151,121577289,46999120,PDP
GI043,,2011,1956,,396670204,1731301399,704730944,,371398135,1621176950,659863781,,25272069,110124449,44867162,PDP
GI043,,2012,1956,,397553609,1734967553,706266689,,372641944,1630532963,662772363,,24911665,104434590,43494329,PDP
GI043,,2013,1956,,398008297,1735991149,706903512,,373934786,1636903601,665198768,,24073511,99087548,41704745,PDP
GI043,,2014,1956,,396780831,1737078619,705869543,,375214909,1641934905,667374140,,21565922,95143714,38495404,PDP
GI043,,2015,1956,,399083138,1753242477,711047983,,376681423,1647193216,669776298,,22401715,106049261,41271685,PDP
GI043,,2016,1956,,401668903,1743393774,711881312,,378319673,1651772357,672229335,,23349230,91621417,39651969,PDP
GI043,,2017,1956,,401874922,1743436073,712094856,,379755006,1653971303,674055942,,22119916,89464770,38038910,PDP
GI043,,2017,1956,,401874922,1743436073,712094856,,379755006,1653971303,674055942,,22119916,89464770,38038910,PDP
GI045,,1975,1972,,0,45100000,8024911,,0,0,0,,0,45100000,8024911,PDN
GI045,,1976,1972,,0,45100000,8024911,,9116,497899,97710,,-9116,44602101,7927201,PDN
GI045,,1977,1972,,205203,56975500,10343192,,30935,1790274,349489,,174268,55185226,9993703,PDN
GI045,,1978,1972,,205203,11875500,2318281,,64832,3436202,676256,,140371,8439298,1642025,PDN
GI045,,1979,1972,,205203,11875500,2318281,,111722,5883457,1158600,,93481,5992043,1159681,PDN
GI045,,1980,1972,,290000,15000000,2959039,,138649,7524256,1477485,,151351,7475744,1481554,PDN
GI045,,1981,1972,,290000,15000000,2959039,,162333,9856797,1916211,,127667,5143203,1042828,PDN
GI045,,1982,1972,,290000,15000000,2959039,,176885,11859799,2287170,,113115,3140201,671869,PDN
GI045,,1983,1972,,253147,20251792,3856669,,195874,13515710,2600805,,57273,6736082,1255864,PDN
GI045,,1984,1972,,253147,20251792,3856669,,213531,15321737,2939819,,39616,4930055,916850,PDN
GI045,,1985,1972,,253147,20251792,3856669,,220064,16048194,3075615,,33083,4203598,781054,PDN
GI045,,1986,1972,,253147,20251792,3856669,,228112,16745411,3207722,,25035,3506381,648947,PDN
GI045,,1987,1972,,253147,20251792,3856669,,230792,16933017,3243784,,22355,3318775,612885,PDN
GI045,,1988,1972,,230792,16933017,3243784,,230792,16933017,3243784,,0,0,0,PDN
GI045,,1989,1972,,230792,16937582,3244597,,230792,16937582,3244597,,0,0,0,PDN
GI045,,1990,1972,,230792,16937582,3244597,,230792,16937582,3244597,,0,0,0,PDN
GI045,,1991,1972,,230792,16937582,3244597,,230792,16937582,3244597,,0,0,0,PDN
GI045,,1992,1972,,230792,16937582,3244597,,230792,16937582,3244597,,0,0,0,PDN
GI045,,1993,1972,,230792,16937582,3244597,,230792,16937582,3244597,,0,0,0,PDN
GI045,,1994,1972,,230792,16937582,3244597,,230792,16937582,3244597,,0,0,0,PDN
GI045,,1995,1972,,230792,16937582,3244597,,230792,16937582,3244597,,0,0,0,PDN
GI045,,1996,1972,,230792,16937582,3244597,,230792,16937582,3244597,,0,0,0,PDN
GI045,,1997,1972,,308263,20970230,4039621,,245462,17787741,3410540,,62801,3182489,629081,PDN
GI045,,1998,1972,,354526,26763153,5116653,,279548,21104476,4034793,,74978,5658677,1081860,PDN
GI045,,1999,1972,,381021,28763251,5499037,,299105,23650446,4507369,,81916,5112805,991668,PDN
GI045,,2000,1972,,482507,32842009,6326281,,364048,26580857,5093738,,118459,6261152,1232543,PDN
GI045,,2001,1972,,561276,35773009,6926580,,430516,29519305,5683061,,130760,6253704,1243519,PDN
GI045,,2002,1972,,515223,34518712,6657343,,466392,31664835,6100704,,48831,2853877,556639,PDN
GI045,,2003,1972,,528780,35250528,6801116,,483041,33207731,6391890,,45739,2042797,409226,PDN
GI045,,2004,1972,,523644,35184721,6784271,,493950,33990259,6542039,,29694,1194462,242232,PDN
GI045,,2005,1972,,504431,35184721,6765058,,496752,34309598,6601663,,7679,875123,163395,PDN
GI045,,2006,1972,,501404,34790174,6691826,,500291,34634545,6663021,,1113,155629,28805,PDN
GI045,,2007,1972,,501404,34790174,6691826,,501403,34789904,6691777,,1,270,49,PDN
GI045,,2008,1972,,511290,35686264,6861159,,505519,35091067,6749481,,5771,595197,111678,PDN
GI045,,2009,1972,,511278,36086057,6932284,,511278,36085818,6932242,,0,239,43,PDN
GI045,,2010,1972,,511278,36086057,6932284,,511278,36086057,6932284,,0,0,0,PDN
GI045,,2011,1972,,511278,36086057,6932284,,511278,36086057,6932284,,0,0,0,PDN
GI045,,2012,1972,,511278,36086057,6932284,,511278,36086057,6932284,,0,0,0,PDN
GI045,,2013,1972,,511278,36086057,6932284,,511278,36086057,6932284,,0,0,0,PDN
GI045,,2014,1972,,511278,36086057,6932284,,511278,36086057,6932284,,0,0,0,PDN
GI045,,2015,1972,,511278,36086057,6932284,,511278,36086057,6932284,,0,0,0,PDN
GI045,,2016,1972,,511278,36086057,6932284,,511278,36086057,6932284,,0,0,0,PDN
GI045,,2017,1972,,511278,36086057,6932284,,511278,36086057,6932284,,0,0,0,PDN
GI045,,2017,1972,,511278,36086057,6932284,,511278,36086057,6932284,,0,0,0,PDN
GI047,,1975,1955,,110000000,319990000,166937722,,91550696,259801280,137778682,,18449304,60188720,29159040,PDP
GI047,,1976,1955,,110000000,319990000,166937722,,94041728,268537732,141824243,,15958272,51452268,25113479,PDP
GI047,,1977,1955,,110000000,319990000,166937722,,99238791,281262648,149285526,,10761209,38727352,17652196,PDP
GI047,,1978,1955,,112000000,345986000,173563345,,102274729,296959109,155114428,,9725271,49026891,18448917,PDP
GI047,,1979,1955,,98882140,330176626,157632429,,83556180,252768667,128532811,,15325960,77407959,29099618,PDP
GI047,,1980,1955,,99336418,330497596,158143819,,85994118,268373606,133747429,,13342300,62123990,24396390,PDP
GI047,,1981,1955,,100172916,333664144,159543760,,88405261,285477331,139201939,,11767655,48186813,20341821,PDP
GI047,,1982,1955,,104085884,349236589,166227626,,90718283,298656767,143860056,,13367601,50579822,22367570,PDP
GI047,,1983,1955,,130742559,366275074,195916060,,92788624,306983605,147412041,,37953935,59291469,48504019,PDP
GI047,,1984,1955,,118060828,407107514,190499887,,95449471,314921081,151485251,,22611357,92186433,39014636,PDP
GI047,,1985,1955,,119695635,422306264,194839098,,99171353,325772509,157137992,,20524282,96533755,37701106,PDP
GI047,,1986,1955,,121436213,437514307,199285734,,103217555,342350120,164133946,,18218658,95164187,35151788,PDP
GI047,,1987,1955,,125093312,468380580,208435052,,106041911,358010796,169744900,,19051401,110369784,38690152,PDP
GI047,,1988,1955,,125588647,470824978,209365333,,108805810,366502036,174019695,,16782837,104322942,35345638,PDP
GI047,,1989,1955,,129106335,476353220,213866694,,111782200,376645915,178801046,,17324135,99707305,35065648,PDP
GI047,,1990,1955,,130559892,479838896,215940478,,114421668,388051333,183469948,,16138224,91787563,32470530,PDP
GI047,,1991,1955,,131364856,464054117,213936763,,116818930,399229630,187856231,,14545926,64824487,26080532,PDP
GI047,,1992,1955,,132069198,474579435,216513937,,118943492,408730185,191671283,,13125706,65849250,24842654,PDP
GI047,,1993,1955,,132698612,478060659,217762786,,121401381,420024051,196138757,,11297231,58036608,21624029,PDP
GI047,,1994,1955,,135124541,516901848,227099959,,123720017,433273809,200815001,,11404524,83628039,26284958,PDP
GI047,,1995,1955,,135898853,498526407,224604619,,125699676,446246146,205102905,,10199177,52280261,19501714,PDP
GI047,,1996,1955,,137068508,474085594,221425375,,127444713,452665822,207990233,,9623795,21419772,13435142,PDP
GI047,,1997,1955,,137250857,478255099,222349629,,129308743,457891920,210784174,,7942114,20363179,11565455,PDP
GI047,,1998,1955,,137827238,483444017,223849305,,131163699,466261046,214128298,,6663539,17182971,9721007,PDP
GI047,,1999,1955,,137035240,488040049,223875106,,132317996,471171756,216156387,,4717244,16868293,7718719,PDP
GI047,,2000,1955,,137575487,497040171,226016799,,133144580,473719845,217436367,,4430907,23320326,8580432,PDP
GI047,,2001,1955,,156312135,537727129,251993119,,134121679,477778470,219135642,,22190456,59948659,32857477,PDP
GI047,,2002,1955,,145955724,514588511,237519516,,136163265,484976604,222458034,,9792459,29611907,15061482,PDP
GI047,,2003,1955,,146180983,515065337,237829620,,139119046,493770289,226978528,,7061937,21295048,10851092,PDP
GI047,,2004,1955,,148161776,522641876,241158551,,140950531,500024245,229922817,,7211245,22617631,11235734,PDP
GI047,,2005,1955,,148686851,533337400,243586744,,143476548,512830769,234727575,,5210303,20506631,8859169,PDP
GI047,,2006,1955,,150464906,540940563,246717675,,144207946,516234665,236064648,,6256960,24705898,10653027,PDP
GI047,,2007,1955,,152155702,570907252,253740622,,145367113,529389223,239564484,,6788589,41518029,14176138,PDP
GI047,,2008,1955,,152369652,571903856,254131904,,146779017,540464641,242947103,,5590635,31439215,11184801,PDP
GI047,,2009,1955,,152768522,579980561,255967912,,147939950,558891857,247386899,,4828572,21088704,8581012,PDP
GI047,,2010,1955,,153018962,584154612,256961066,,148723430,564763497,249215157,,4295532,19391115,7745909,PDP
GI047,,2011,1955,,154570740,592264891,259955953,,149367604,569377062,250680252,,5203136,22887829,9275706,PDP
GI047,,2012,1955,,155713525,596751116,261896998,,149932486,573920201,252053516,,5781039,22830915,9843480,PDP
GI047,,2013,1955,,156803581,605027196,264459667,,150935104,579658697,254077222,,5868477,25368499,10382447,PDP
GI047,,2014,1955,,156781652,601205276,263757684,,151982113,584515580,255988447,,4799539,16689696,7769238,PDP
GI047,,2015,1955,,157031937,603631279,264439643,,152850767,588116830,257497889,,4181170,15514449,6941748,PDP
GI047,,2016,1955,,157209972,603613831,264614570,,153578141,591939097,258905382,,3631831,11674734,5709186,PDP
GI047,,2017,1955,,156620051,602134609,263761443,,154190662,593590434,259811738,,2429389,8544175,3949702,PDP
GI047,,2017,1955,,156620051,602134609,263761443,,154190662,593590434,259811738,,2429389,8544175,3949702,PDP
GI054,,2008,2008,,3004534,3304988,3592610,,0,0,0,,3004534,3304988,3592610,PDN
GI054,,2009,2008,,93795,102132,111968,,4728,4158,5468,,89067,97974,106500,PDN
GI054,,2010,2008,,650125,545137,747124,,507690,404739,579708,,142435,140398,167417,PDN
GI054,,2011,2008,,762336,640629,876327,,648832,523138,741917,,113504,117491,134410,PDN
GI054,,2012,2008,,1042865,1075617,1234256,,659489,534814,754652,,383376,540803,479604,PDN
GI054,,2013,2008,,1042865,1075617,1234256,,912009,934439,1078279,,130856,141178,155977,PDN
GI054,,2014,2008,,1683173,1725252,1990157,,1023727,1021318,1205456,,659446,703934,784701,PDN
GI054,,2015,2008,,1066009,1420990,1318854,,1033381,1039203,1218293,,32628,381787,100562,PDN
GI054,,2016,2008,,1112999,1261929,1337541,,1044996,1071039,1235572,,68003,190890,101969,PDN
GI054,,2017,2008,,1044996,1071616,1235675,,1044996,1071616,1235675,,0,0,0,PDN
GI054,,2017,2008,,1044996,1071616,1235675,,1044996,1071616,1235675,,0,0,0,PDN
GI065,,1996,1996,,973430,3483061,1593192,,0,0,0,,973430,3483061,1593192,PDN
GI065,,1997,1996,,976072,29900620,6296467,,0,0,0,,976072,29900620,6296467,PDN
GI065,,1998,1996,,976072,29900620,6296467,,17,262014,46639,,976055,29638606,6249828,PDN
GI065,,1999,1996,,2787,35615040,6339983,,77,6377381,1134842,,2710,29237659,5205141,PDN
GI065,,2000,1996,,2770,32210187,5734120,,156,13140373,2338301,,2614,19069814,3395819,PDN
GI065,,2001,1996,,209,16606077,2955027,,209,16606077,2955027,,0,0,0,PDN
GI065,,2002,1996,,209,16606077,2955027,,209,16606077,2955027,,0,0,0,PDN
GI065,,2003,1996,,209,16606077,2955027,,209,16606077,2955027,,0,0,0,PDN
GI065,,2004,1996,,209,16606077,2955027,,209,16606077,2955027,,0,0,0,PDN
GI065,,2005,1996,,209,16606077,2955027,,209,16606077,2955027,,0,0,0,PDN
GI065,,2006,1996,,209,16606077,2955027,,209,16606077,2955027,,0,0,0,PDN
GI065,,2007,1996,,209,16606077,2955027,,209,16606077,2955027,,0,0,0,PDN
GI065,,2008,1996,,209,16606077,2955027,,209,16606077,2955027,,0,0,0,PDN
GI065,,2009,1996,,209,16606077,2955027,,209,16606077,2955027,,0,0,0,PDN
GI065,,2010,1996,,209,16606077,2955027,,209,16606077,2955027,,0,0,0,PDN
GI065,,2011,1996,,209,16606077,2955027,,209,16606077,2955027,,0,0,0,PDN
GI065,,2012,1996,,209,16606077,2955027,,209,16606077,2955027,,0,0,0,PDN
GI065,,2013,1996,,209,16606077,2955027,,209,16606077,2955027,,0,0,0,PDN
GI065,,2014,1996,,209,16606077,2955027,,209,16606077,2955027,,0,0,0,PDN
GI065,,2015,1996,,209,16606077,2955027,,209,16606077,2955027,,0,0,0,PDN
GI065,,2016,1996,,209,16606077,2955027,,209,16606077,2955027,,0,0,0,PDN
GI065,,2017,1996,,209,16606077,2955027,,209,16606077,2955027,,0,0,0,PDN
GI065,,2017,1996,,209,16606077,2955027,,209,16606077,2955027,,0,0,0,PDN
GI068,,1998,1998,,166134,5347396,1117628,,0,0,0,,166134,5347396,1117628,PDN
GI068,,1999,1998,,166134,5347396,1117628,,0,0,0,,166134,5347396,1117628,PDN
GI068,,2000,1998,,327550,2974241,856774,,173047,2033238,534833,,154503,941003,321941,PDN
GI068,,2001,1998,,764895,3522905,1391746,,443496,2782694,938637,,321399,740211,453109,PDN
GI068,,2002,1998,,565764,8804910,2132474,,553539,2965047,1081127,,12225,5839863,1051347,PDN
GI068,,2003,1998,,564410,8804910,2131120,,554019,3178851,1119651,,10391,5626059,1011469,PDN
GI068,,2004,1998,,554200,3320137,1144972,,554200,3320137,1144972,,0,0,0,PDN
GI068,,2005,1998,,554200,3320137,1144972,,554200,3320137,1144972,,0,0,0,PDN
GI068,,2006,1998,,554200,3320137,1144972,,554200,3320137,1144972,,0,0,0,PDN
GI068,,2007,1998,,554200,3320137,1144972,,554200,3320137,1144972,,0,0,0,PDN
GI068,,2008,1998,,554200,3320137,1144972,,554200,3320137,1144972,,0,0,0,PDN
GI068,,2009,1998,,554200,3320137,1144972,,554200,3320137,1144972,,0,0,0,PDN
GI068,,2010,1998,,554200,3320137,1144972,,554200,3320137,1144972,,0,0,0,PDN
GI068,,2011,1998,,554200,3320137,1144972,,554200,3320137,1144972,,0,0,0,PDN
GI068,,2012,1998,,554200,3320137,1144972,,554200,3320137,1144972,,0,0,0,PDN
GI068,,2013,1998,,554200,3320137,1144972,,554200,3320137,1144972,,0,0,0,PDN
GI068,,2014,1998,,554200,3320137,1144972,,554200,3320137,1144972,,0,0,0,PDN
GI068,,2015,1998,,554200,3320137,1144972,,554200,3320137,1144972,,0,0,0,PDN
GI068,,2016,1998,,554200,3320137,1144972,,554200,3320137,1144972,,0,0,0,PDN
GI068,,2017,1998,,554200,3320137,1144972,,554200,3320137,1144972,,0,0,0,PDN
GI068,,2017,1998,,554200,3320137,1144972,,554200,3320137,1144972,,0,0,0,PDN
GI070,,2005,2006,,623171,8037495,2053330,,0,0,0,,623171,8037495,2053330,PDP
GI070,,2006,2006,,623171,8037495,2053330,,0,0,0,,623171,8037495,2053330,PDP
GI070,,2007,2006,,623171,8037495,2053330,,0,0,0,,623171,8037495,2053330,PDP
GI070,,2008,2006,,623171,8037495,2053330,,0,0,0,,623171,8037495,2053330,PDP
GI070,,2010,2006,,636034,8204170,2095851,,0,0,0,,636034,8204170,2095851,PDP
GI070,,2011,2006,,636034,8204170,2095851,,0,0,0,,636034,8204170,2095851,PDP
GI070,,2012,2006,,636034,8204170,2095851,,12715,2336696,428497,,623319,5867474,1667353,PDP
GI070,,2013,2006,,279245,5695913,1292753,,18933,3549243,650471,,260312,2146670,642282,PDP
GI070,,2014,2006,,47091,6217826,1153466,,19964,4037792,738433,,27127,2180034,415034,PDP
GI070,,2015,2006,,20136,4452965,812478,,20048,4158464,759988,,88,294501,52490,PDP
GI070,,2016,2006,,20311,4452965,812653,,20203,4392537,801793,,108,60428,10860,PDP
GI070,,2017,2006,,20253,4664906,850307,,20215,4596959,838179,,38,67947,12128,PDP
GI070,,2017,2006,,20253,4664906,850307,,20215,4596959,838179,,38,67947,12128,PDP
GI072,,1975,1966,,3000000,33000000,8871886,,384021,744835,516554,,2615979,32255165,8355332,PDN
GI072,,1976,1966,,3000000,33000000,8871886,,419454,1213404,635362,,2580546,31786596,8236524,PDN
GI072,,1977,1966,,3000000,33000000,8871886,,466394,1733532,774852,,2533606,31266468,8097034,PDN
GI072,,1978,1966,,459213,3429345,1069417,,436999,2067407,804865,,22214,1361938,264552,PDN
GI072,,1979,1966,,460225,3431679,1070844,,438539,2179697,826385,,21686,1251982,244459,PDN
GI072,,1980,1966,,468225,5431679,1434716,,440731,2691760,919692,,27494,2739919,515024,PDN
GI072,,1981,1966,,770262,5760235,1795215,,499580,2925606,1020150,,270682,2834629,775065,PDN
GI072,,1982,1966,,801162,5301970,1744573,,547108,3125821,1103304,,254054,2176149,641269,PDN
GI072,,1983,1966,,799445,5299452,1742408,,631875,3400656,1236974,,167570,1898796,505434,PDN
GI072,,1984,1966,,1098517,4897121,1969891,,664818,3593572,1304244,,433699,1303549,665647,PDN
GI072,,1985,1966,,1116938,4897121,1988312,,728701,3668739,1381502,,388237,1228382,606810,PDN
GI072,,1986,1966,,1116938,4897121,1988312,,743327,3847117,1427867,,373611,1050004,560445,PDN
GI072,,1987,1966,,743896,3855195,1429874,,743896,3855195,1429874,,0,0,0,PDN
GI072,,1988,1966,,743896,3855195,1429874,,743896,3855195,1429874,,0,0,0,PDN
GI072,,1989,1966,,743896,3855195,1429874,,743896,3855195,1429874,,0,0,0,PDN
GI072,,1990,1966,,743896,3855195,1429874,,743896,3855195,1429874,,0,0,0,PDN
GI072,,1991,1966,,743896,3855195,1429874,,743896,3855195,1429874,,0,0,0,PDN
GI072,,1992,1966,,743896,3855195,1429874,,743896,3855195,1429874,,0,0,0,PDN
GI072,,1993,1966,,743896,3855195,1429874,,743896,3855195,1429874,,0,0,0,PDN
GI072,,1994,1966,,743896,3855195,1429874,,743896,3855195,1429874,,0,0,0,PDN
GI072,,1995,1966,,743896,3855195,1429874,,743896,3855195,1429874,,0,0,0,PDN
GI072,,1996,1966,,743896,3855195,1429874,,743896,3855195,1429874,,0,0,0,PDN
GI072,,1997,1966,,743896,3855195,1429874,,743896,3855195,1429874,,0,0,0,PDN
GI072,,1998,1966,,1322708,23497421,5503744,,743896,3855195,1429874,,578812,19642226,4073870,PDN
GI072,,1999,1966,,836204,23360051,4992797,,759630,4350727,1533781,,76574,19009324,3459016,PDN
GI072,,2000,1966,,1015816,20591674,4679815,,788070,6971245,2028505,,227746,13620429,2651310,PDN
GI072,,2001,1966,,1404783,22195419,5354146,,872176,10737027,2782679,,532607,11458392,2571467,PDN
GI072,,2002,1966,,872201,10744522,2784038,,872201,10744522,2784038,,0,0,0,PDN
GI072,,2003,1966,,872201,10744522,2784038,,872201,10744522,2784038,,0,0,0,PDN
GI072,,2004,1966,,872201,10744522,2784038,,872201,10744522,2784038,,0,0,0,PDN
GI072,,2005,1966,,872201,10744522,2784038,,872201,10744522,2784038,,0,0,0,PDN
GI072,,2006,1966,,873654,25277169,5371371,,872201,10744522,2784038,,1453,14532647,2587333,PDN
GI072,,2007,1966,,877215,20214256,4474058,,873850,11141123,2856256,,3365,9073133,1617802,PDN
GI072,,2008,1966,,877215,20214256,4474058,,874127,11403953,2903300,,3088,8810303,1570758,PDN
GI072,,2009,1966,,876024,13258101,3235116,,875913,12145949,3037113,,111,1112152,198003,PDN
GI072,,2010,1966,,876024,13258101,3235116,,875913,12145949,3037113,,111,1112152,198003,PDN
GI072,,2011,1966,,875913,12145949,3037113,,875913,12145949,3037113,,0,0,0,PDN
GI072,,2012,1966,,875913,12145949,3037113,,875913,12145949,3037113,,0,0,0,PDN
GI072,,2013,1966,,875913,12145949,3037113,,875913,12145949,3037113,,0,0,0,PDN
GI072,,2014,1966,,875913,12145949,3037113,,875913,12145949,3037113,,0,0,0,PDN
GI072,,2015,1966,,875913,12145949,3037113,,875913,12145949,3037113,,0,0,0,PDN
GI072,,2016,1966,,875913,12145949,3037113,,875913,12145949,3037113,,0,0,0,PDN
GI072,,2017,1966,,875913,12145949,3037113,,875913,12145949,3037113,,0,0,0,PDN
GI072,,2017,1966,,875913,12145949,3037113,,875913,12145949,3037113,,0,0,0,PDN
GI076,,1975,1972,,0,93486382,16634588,,0,0,0,,0,93486382,16634588,PDP
GI076,,1976,1972,,0,93486384,16634588,,177641,15699991,2971234,,-177641,77786393,13663354,PDP
GI076,,1977,1972,,1274018,134478146,25202514,,744858,44404632,8646038,,529160,90073514,16556476,PDP
GI076,,1978,1972,,1279242,200357755,36930088,,759653,76770540,14419891,,519589,123587215,22510197,PDP
GI076,,1979,1972,,534555,201121985,36321385,,107074,105337573,18850414,,427481,95784412,17470971,PDP
GI076,,1980,1972,,537208,259771783,46759945,,107074,131227267,23457122,,430134,128544516,23302823,PDP
GI076,,1981,1972,,251625,274084388,49021089,,119205,154233364,27562864,,132420,119851024,21458225,PDP
GI076,,1982,1972,,253445,274384394,49076291,,139079,174249550,31144337,,114366,100134844,17931954,PDP
GI076,,1983,1972,,253645,274384394,49076491,,147836,193550761,34587473,,105809,80833633,14489018,PDP
GI076,,1984,1972,,257530,297592664,53209961,,160681,209711825,37475952,,96849,87880839,15734009,PDP
GI076,,1985,1972,,279600,298451762,53384896,,175290,221576019,39601628,,104310,76875743,13783268,PDP
GI076,,1986,1972,,288634,301130161,53870513,,205151,233705476,41789755,,83483,67424685,12080758,PDP
GI076,,1987,1972,,327509,301130161,53909388,,233335,247887803,44341485,,94174,53242358,9567903,PDP
GI076,,1988,1972,,558189,329342114,59159989,,339493,258228220,46287575,,218696,71113894,12872414,PDP
GI076,,1989,1972,,599996,314517138,56563900,,433333,266661935,47882076,,166663,47855203,8681824,PDP
GI076,,1990,1972,,653032,321354414,57833533,,512636,275923568,49609356,,140396,45430846,8224177,PDP
GI076,,1991,1972,,732315,323805021,58348867,,631874,284303531,51219691,,100441,39501490,7129176,PDP
GI076,,1992,1972,,750837,324585795,58506317,,655617,289995919,52256314,,95220,34589876,6250003,PDP
GI076,,1993,1972,,927386,334503907,60447654,,697352,292643256,52769106,,230034,41860651,7678548,PDP
GI076,,1994,1972,,948997,335730913,60687594,,737787,294126430,53073451,,211210,41604483,7614143,PDP
GI076,,1995,1972,,914394,317976534,57493848,,774273,295623386,53376299,,140121,22353148,4117549,PDP
GI076,,1996,1972,,1400220,317527611,57899795,,829806,297027364,53681650,,570414,20500247,4218145,PDP
GI076,,1997,1972,,1425097,320215027,58402860,,883417,298753008,54042315,,541680,21462019,4360545,PDP
GI076,,1998,1972,,1390455,330102286,60127517,,934660,303981769,55023943,,455795,26120517,5103574,PDP
GI076,,1999,1972,,1102882,334220789,60572773,,975978,310375233,56202888,,126904,23845556,4369885,PDP
GI076,,2000,1972,,1129270,343619716,62271568,,1003159,316669380,57350024,,126111,26950336,4921544,PDP
GI076,,2001,1972,,1093514,332502490,60257658,,1023669,321012158,58143270,,69845,11490332,2114388,PDP
GI076,,2002,1972,,1063821,333350355,60378831,,1034526,323781847,58646954,,29295,9568508,1731877,PDP
GI076,,2003,1972,,1068787,334899274,60659405,,1059159,328384732,59490606,,9628,6514542,1168799,PDP
GI076,,2004,1972,,1065969,335302595,60728352,,1064612,330703599,59908669,,1357,4598996,819683,PDP
GI076,,2005,1972,,1661618,340672500,62279501,,1066328,333389547,60388311,,595290,7282953,1891190,PDP
GI076,,2006,1972,,1829718,342302074,62737560,,1232072,336398510,61089458,,597646,5903564,1648102,PDP
GI076,,2007,1972,,1993919,340914447,62654853,,1565661,337917956,61693411,,428258,2996491,961442,PDP
GI076,,2008,1972,,2021670,344690629,63354522,,1735450,339434471,62133043,,286220,5256158,1221479,PDP
GI076,,2009,1972,,2220219,353046829,65039940,,1877907,349224525,64017502,,342312,3822304,1022437,PDP
GI076,,2010,1972,,2230345,354536586,65315147,,1974527,350649091,64367606,,255818,3887495,947542,PDP
GI076,,2011,1972,,2232386,355544373,65496510,,2059626,351771744,64652464,,172760,3772629,844045,PDP
GI076,,2012,1972,,2245307,359745063,66256885,,2121231,353229761,64973504,,124076,6515302,1283382,PDP
GI076,,2013,1972,,2261885,362214539,66712872,,2202584,356832614,65695933,,59301,5381925,1016939,PDP
GI076,,2014,1972,,2327604,361336759,66622403,,2266033,358431059,66043802,,61571,2905700,578599,PDP
GI076,,2015,1972,,2399883,361766339,66771119,,2310838,359774613,66327674,,89045,1991726,443444,PDP
GI076,,2016,1972,,2489566,362916956,67065538,,2378102,360415735,66509017,,111464,2501221,556520,PDP
GI076,,2017,1972,,2490085,362007795,66904285,,2425136,360932455,66647994,,64949,1075340,256290,PDP
GI076,,2017,1972,,2490085,362007795,66904285,,2425136,360932455,66647994,,64949,1075340,256290,PDP
GI079,,1991,1988,,852008,23574212,5046708,,52226,2472795,492225,,799782,21101417,4554483,PDN
GI079,,1992,1988,,852008,23574212,5046708,,54707,3878668,744861,,797301,19695544,4301847,PDN
GI079,,1993,1988,,854201,23574212,5048901,,62956,6608226,1238797,,791245,16965986,3810104,PDN
GI079,,1994,1988,,865180,29063625,6036644,,83107,10328269,1920877,,782073,18735356,4115767,PDN
GI079,,1995,1988,,148434,20731469,3837307,,89594,12840492,2374379,,58840,7890977,1462928,PDN
GI079,,1996,1988,,153516,23656134,4362793,,90394,15097353,2776756,,63122,8558781,1586037,PDN
GI079,,1997,1988,,153516,23656134,4362793,,90686,15617524,2869605,,62830,8038610,1493188,PDN
GI079,,1998,1988,,89678,11547681,2144426,,89678,11547681,2144426,,0,0,0,PDN
GI079,,1999,1988,,90892,15799507,2902192,,90892,15799507,2902192,,0,0,0,PDN
GI079,,2000,1988,,90892,15799507,2902192,,90892,15799507,2902192,,0,0,0,PDN
GI079,,2001,1988,,90892,15799507,2902192,,90892,15799507,2902192,,0,0,0,PDN
GI079,,2002,1988,,90892,15799507,2902192,,90892,15799507,2902192,,0,0,0,PDN
GI079,,2003,1988,,90892,15799507,2902192,,90892,15799507,2902192,,0,0,0,PDN
GI079,,2004,1988,,90892,15799507,2902192,,90892,15799507,2902192,,0,0,0,PDN
GI079,,2005,1988,,90892,15799507,2902192,,90892,15799507,2902192,,0,0,0,PDN
GI079,,2006,1988,,90892,15799507,2902192,,90892,15799507,2902192,,0,0,0,PDN
GI079,,2007,1988,,90892,15799507,2902192,,90892,15799507,2902192,,0,0,0,PDN
GI079,,2008,1988,,90892,15799507,2902192,,90892,15799507,2902192,,0,0,0,PDN
GI079,,2009,1988,,90892,16115410,2958404,,90892,16115410,2958404,,0,0,0,PDN
GI079,,2010,1988,,90892,16115410,2958404,,90892,16115410,2958404,,0,0,0,PDN
GI079,,2011,1988,,90892,16115410,2958404,,90892,16115410,2958404,,0,0,0,PDN
GI079,,2012,1988,,90892,16115410,2958404,,90892,16115410,2958404,,0,0,0,PDN
GI079,,2013,1988,,90892,16115410,2958404,,90892,16115410,2958404,,0,0,0,PDN
GI079,,2014,1988,,90892,16115410,2958404,,90892,16115410,2958404,,0,0,0,PDN
GI079,,2015,1988,,90892,16115410,2958404,,90892,16115410,2958404,,0,0,0,PDN
GI079,,2016,1988,,90892,16115410,2958404,,90892,16115410,2958404,,0,0,0,PDN
GI079,,2017,1988,,90892,16115410,2958404,,90892,16115410,2958404,,0,0,0,PDN
GI079,,2017,1988,,90892,16115410,2958404,,90892,16115410,2958404,,0,0,0,PDN
GI082,,1975,1966,,10000000,70000000,22455516,,773310,8549812,2294629,,9226690,61450188,20160887,PDN
GI082,,1976,1966,,2000000,40000000,9117438,,887318,11833780,2992973,,1112682,28166220,6124465,PDN
GI082,,1977,1966,,2000000,40000000,9117438,,1000563,14219073,3530647,,999437,25780927,5586791,PDN
GI082,,1978,1966,,3081031,108432128,22375004,,889754,16338816,3797017,,2191277,92093312,18577987,PDN
GI082,,1979,1966,,2915370,56645731,12994682,,909990,14979211,3575330,,2005380,41666520,9419352,PDN
GI082,,1980,1966,,2915370,56645731,12994682,,936284,15690554,3728198,,1979086,40955177,9266484,PDN
GI082,,1981,1966,,3027963,56645731,13107275,,975384,16365739,3887437,,2052579,40279992,9219838,PDN
GI082,,1982,1966,,2847963,56795731,12953965,,1009800,16913450,4019311,,1838163,39882281,8934654,PDN
GI082,,1983,1966,,2847963,56795731,12953965,,1019904,17115793,4065419,,1828059,39679938,8888546,PDN
GI082,,1984,1966,,2847963,56795731,12953965,,1019904,17115793,4065419,,1828059,39679938,8888546,PDN
GI082,,1985,1966,,1039522,17602498,4171639,,1037228,17194887,4096816,,2294,407611,74823,PDN
GI082,,1986,1966,,1037228,17194887,4096816,,1037228,17194887,4096816,,0,0,0,PDN
GI082,,1987,1966,,1037228,17194887,4096816,,1037228,17194887,4096816,,0,0,0,PDN
GI082,,1988,1966,,1037228,17194887,4096816,,1037228,17194887,4096816,,0,0,0,PDN
GI082,,1989,1966,,1037228,17194887,4096816,,1037228,17194887,4096816,,0,0,0,PDN
GI082,,1990,1966,,1037228,17194887,4096816,,1037228,17194887,4096816,,0,0,0,PDN
GI082,,1991,1966,,1037228,17194887,4096816,,1037228,17194887,4096816,,0,0,0,PDN
GI082,,1992,1966,,1037228,17194887,4096816,,1037228,17194887,4096816,,0,0,0,PDN
GI082,,1993,1966,,1570711,24905250,6002250,,1438706,23902172,5691762,,132005,1003078,310488,PDN
GI082,,1994,1966,,1570393,24889213,5999079,,1545042,24197131,5850581,,25351,692082,148498,PDN
GI082,,1995,1966,,2896880,25836150,7494060,,2322487,24845390,6743375,,574393,990760,750685,PDN
GI082,,1996,1966,,5974289,52314826,15282977,,2550142,26573316,7278490,,3424147,25741510,8004487,PDN
GI082,,1997,1966,,6965918,58669277,17405291,,3782846,32389448,9546093,,3183072,26279829,7859198,PDN
GI082,,1998,1966,,8174171,60440908,18928781,,4661965,38358263,11487279,,3512206,22082645,7441502,PDN
GI082,,1999,1966,,7586526,54300283,17248498,,5396203,41762585,12827268,,2190323,12537698,4421230,PDN
GI082,,2000,1966,,6623208,53370759,16119784,,5816278,43447639,13547175,,806930,9923120,2572609,PDN
GI082,,2001,1966,,6809144,54449775,16497716,,6086034,44796910,14057014,,723110,9652865,2440702,PDN
GI082,,2002,1966,,7056246,55953200,17012331,,6266656,45219578,14312844,,789590,10733622,2699487,PDN
GI082,,2003,1966,,7079237,52262603,16378633,,6462160,47968807,14997535,,617077,4293796,1381098,PDN
GI082,,2004,1966,,7057806,52468798,16393891,,6598860,49480439,15403209,,458946,2988359,990682,PDN
GI082,,2005,1966,,6984567,52406868,16309632,,6686470,49684938,15527206,,298097,2721930,782426,PDN
GI082,,2006,1966,,6969333,52607452,16330090,,6726644,49837676,15594558,,242689,2769776,735532,PDN
GI082,,2007,1966,,7797802,67826317,19866542,,6753875,51195944,15863474,,1043927,16630373,4003068,PDN
GI082,,2008,1966,,7824926,67928068,19911771,,6816312,53135921,16271102,,1008614,14792147,3640669,PDN
GI082,,2009,1966,,7608060,64758078,19130849,,6840968,55259543,16673625,,767092,9498535,2457222,PDN
GI082,,2010,1966,,7633838,64784166,19161269,,6856103,56977481,16994443,,777735,7806685,2166824,PDN
GI082,,2011,1966,,7643069,66995828,19564034,,6868891,57898706,17171151,,774178,9097122,2392883,PDN
GI082,,2012,1966,,7643069,66995828,19564034,,6872741,58329456,17251646,,770328,8666372,2312386,PDN
GI082,,2013,1966,,7643069,66995828,19564034,,6877576,58945229,17366049,,765493,8050599,2197983,PDN
GI082,,2014,1966,,6879025,59105227,17395968,,6879025,59105227,17395968,,0,0,0,PDN
GI082,,2015,1966,,6879025,59105227,17395968,,6879025,59105227,17395968,,0,0,0,PDN
GI082,,2016,1966,,6879025,59105227,17395968,,6879025,59105227,17395968,,0,0,0,PDN
GI082,,2017,1966,,6879025,59105227,17395968,,6879025,59105227,17395968,,0,0,0,PDN
GI082,,2017,1966,,6879025,59105227,17395968,,6879025,59105227,17395968,,0,0,0,PDN
GI095,,1975,1970,,23300512,566000000,124012256,,0,0,0,,23300512,566000000,124012256,PDN
GI095,,1976,1970,,18000434,498000000,106612534,,149769,17279223,3224364,,17850665,480720777,103388170,PDN
GI095,,1977,1970,,5499983,611422150,114293960,,2517477,133305165,26237257,,2982506,478116985,88056703,PDN
GI095,,1978,1970,,4785713,617040626,114579419,,2150360,267664241,49777449,,2635353,349376385,64801970,PDN
GI095,,1979,1970,,4807619,617278726,114643691,,2633403,345114406,64041660,,2174216,272164320,50602031,PDN
GI095,,1980,1970,,5831541,795210283,147328033,,3086301,419885384,77799003,,2745240,375324899,69529030,PDN
GI095,,1981,1970,,5831541,795210283,147328033,,3415034,479688901,88768931,,2416507,315521382,58559102,PDN
GI095,,1982,1970,,5831541,795210283,147328033,,3727482,537661063,99396710,,2104059,257549220,47931323,PDN
GI095,,1983,1970,,5831541,801725177,148487266,,3869006,563341003,104107619,,1962535,238384174,44379647,PDN
GI095,,1984,1970,,5213732,734855945,135971018,,4039271,594204646,109769635,,1174461,140651299,26201383,PDN
GI095,,1985,1970,,5213732,728341051,134811784,,4184512,619894633,114486048,,1029220,108446418,20325736,PDN
GI095,,1986,1970,,5246356,731659516,135434882,,4287667,640975909,118340320,,958689,90683607,17094562,PDN
GI095,,1987,1970,,5371642,742732150,137530388,,4409036,657627802,121424659,,962606,85104348,16105729,PDN
GI095,,1988,1970,,6096867,773903174,143802058,,4677180,683420605,126282270,,1419687,90482569,17519788,PDN
GI095,,1989,1970,,6263618,814708025,151229459,,5012988,712361079,131767628,,1250630,102346946,19461831,PDN
GI095,,1990,1970,,5955941,813892947,150776750,,5240954,733845537,135818452,,714987,80047410,14958298,PDN
GI095,,1991,1970,,5996347,821004451,152082548,,5383951,750244909,138879486,,612396,70759542,13203062,PDN
GI095,,1992,1970,,5996720,821096634,152099324,,5451748,760226528,140723372,,544972,60870106,11375952,PDN
GI095,,1993,1970,,6123521,852533790,157819925,,5515043,773434771,143136888,,608478,79099019,14683037,PDN
GI095,,1994,1970,,5868529,850537051,157209641,,5567807,787226084,145643623,,300722,63310967,11566018,PDN
GI095,,1995,1970,,5883935,853846564,157813929,,5596924,796856469,147386331,,287011,56990095,10427598,PDN
GI095,,1996,1970,,5714360,833764446,154071023,,5626383,810059956,149765165,,87977,23704490,4305858,PDN
GI095,,1997,1970,,7869347,878278465,164146654,,5731319,819918716,151624329,,2138028,58359749,12522325,PDN
GI095,,1998,1970,,8129795,882778924,165207895,,6254515,838361237,155429112,,1875280,44417687,9778783,PDN
GI095,,1999,1970,,6927690,875961971,162792810,,6804307,850915394,158212740,,123383,25046577,4580070,PDN
GI095,,2000,1970,,11419731,917962737,174758296,,6991418,864982601,160902913,,4428313,52980136,13855383,PDN
GI095,,2001,1970,,12360251,931761559,178154123,,7962307,882732190,165032092,,4397944,49029369,13122031,PDN
GI095,,2002,1970,,9364732,935272087,175783253,,9059036,910543326,171077421,,305696,24728761,4705832,PDN
GI095,,2003,1970,,11802012,972203484,184791956,,9785067,933991176,175975668,,2016945,38212308,8816288,PDN
GI095,,2004,1970,,11462466,960209393,182318230,,10078649,942699827,177818832,,1383817,17509566,4499398,PDN
GI095,,2005,1970,,11358744,974290442,184720032,,10274378,945996051,178601077,,1084366,28294391,6118955,PDN
GI095,,2006,1970,,11988443,977454715,185912769,,10551940,950989047,179767073,,1436503,26465668,6145696,PDN
GI095,,2007,1970,,11518307,968452125,183840750,,10871864,956568980,181079868,,646443,11883145,2760882,PDN
GI095,,2008,1970,,11588490,968780373,183969340,,11191947,960662297,182128299,,396543,8118076,1841041,PDN
GI095,,2009,1970,,12207426,992793910,188861148,,11360294,979432369,185636518,,847132,13361541,3224631,PDN
GI095,,2010,1970,,12338737,995730138,189514918,,11540838,982325663,186331883,,797899,13404475,3183037,PDN
GI095,,2011,1970,,12359906,996059235,189594646,,11757595,985430647,187101125,,602311,10628588,2493519,PDN
GI095,,2012,1970,,12363074,1001020718,190480640,,11884345,987660883,187624716,,478729,13359835,2855925,PDN
GI095,,2013,1970,,12350008,1002149031,190668342,,11935752,989185096,187947334,,414256,12963935,2721006,PDN
GI095,,2014,1970,,12239301,999072887,190010277,,12005784,990562417,188262441,,233517,8510470,1747836,PDN
GI095,,2015,1970,,12267346,998573178,189949406,,12051765,990972210,188381339,,215581,7600968,1568067,PDN
GI095,,2016,1970,,12245120,996958315,189639837,,12054852,991332562,188448546,,190268,5625753,1191292,PDN
GI095,,2017,1970,,12054875,991332574,188448571,,12054875,991332574,188448571,,0,0,0,PDN
GI095,,2017,1970,,12054875,991332574,188448571,,12054875,991332574,188448571,,0,0,0,PDN
GI102,,1986,1984,,1051499,11090990,3024985,,0,0,0,,1051499,11090990,3024985,PDN
GI102,,1987,1984,,872771,1082237,1065340,,0,0,0,,872771,1082237,1065340,PDN
GI102,,1993,1984,,872771,1082237,1065340,,0,0,0,,872771,1082237,1065340,PDN
GI102,,1994,1984,,8277312,48467430,16901410,,2234061,18034399,5443029,,6043251,30433031,11458381,PDN
GI102,,1995,1984,,21796347,102605526,40053558,,5419544,50452982,14396943,,16376803,52152544,25656615,PDN
GI102,,1996,1984,,19805003,186221159,52940441,,7388253,83105272,22175668,,12416750,103115887,30764773,PDN
GI102,,1997,1984,,14314617,166727801,43981486,,8853171,112809488,28926034,,5461446,53918313,15055452,PDN
GI102,,1998,1984,,14157216,169438480,44306412,,9434862,127799496,32174986,,4722354,41638984,12131426,PDN
GI102,,1999,1984,,11881205,172806888,42629762,,9878354,138357097,34497055,,2002851,34449791,8132707,PDN
GI102,,2000,1984,,11789171,172585516,42498338,,10351868,145937453,36319386,,1437303,26648063,6178952,PDN
GI102,,2001,1984,,10998549,165770762,40495126,,10604407,150415250,37368686,,394142,15355512,3126440,PDN
GI102,,2002,1984,,11112265,176410633,42502057,,10762052,158097585,38893295,,350213,18313048,3608762,PDN
GI102,,2003,1984,,11112269,176410916,42502112,,10904499,165263494,40310815,,207770,11147422,2191297,PDN
GI102,,2004,1984,,11427487,185011604,44347701,,11047518,172434573,41729826,,379969,12577031,2617875,PDN
GI102,,2005,1984,,11175530,179256088,43071631,,11144035,177346448,42700342,,31495,1909640,371289,PDN
GI102,,2006,1984,,11182254,179624933,43143986,,11177481,179407495,43100523,,4773,217438,43463,PDN
GI102,,2007,1984,,12000153,180737155,44159789,,11299396,179771227,43287159,,700757,965928,872630,PDN
GI102,,2008,1984,,12000153,180598090,44135044,,11587718,180113148,43636321,,412435,484942,498723,PDN
GI102,,2009,1984,,11845309,182954365,44399466,,11826580,182923649,44375272,,18729,30716,24194,PDN
GI102,,2010,1984,,12147185,183526497,44803145,,12055626,183326328,44675969,,91559,200169,127176,PDN
GI102,,2011,1984,,12076309,183360606,44702751,,12076309,183360606,44702751,,0,0,0,PDN
GI102,,2012,1984,,12076309,183360606,44702751,,12076309,183360606,44702751,,0,0,0,PDN
GI102,,2013,1984,,12076309,183360606,44702751,,12076309,183360606,44702751,,0,0,0,PDN
GI102,,2014,1984,,12076309,183360606,44702751,,12076309,183360606,44702751,,0,0,0,PDN
GI102,,2015,1984,,12076309,183360606,44702751,,12076309,183360606,44702751,,0,0,0,PDN
GI102,,2016,1984,,12076309,183360606,44702751,,12076309,183360606,44702751,,0,0,0,PDN
GI102,,2017,1984,,12076309,183360606,44702751,,12076309,183360606,44702751,,0,0,0,PDN
GI102,,2017,1984,,12076309,183360606,44702751,,12076309,183360606,44702751,,0,0,0,PDN
GI109,,2000,2000,,3217,32163109,5726191,,0,0,0,,3217,32163109,5726191,PDN
GI109,,2001,2000,,1345,16954117,3018092,,2,3042358,541347,,1343,13911759,2476745,PDN
GI109,,2002,2000,,508,9398811,1672895,,2,3602654,641044,,506,5796157,1031851,PDN
GI109,,2003,2000,,508,9398811,1672895,,2,4339819,772212,,506,5058992,900683,PDN
GI109,,2004,2000,,508,9398811,1672895,,2,4339819,772212,,506,5058992,900683,PDN
GI109,,2005,2000,,2,4339819,772212,,2,4339819,772212,,0,0,0,PDN
GI109,,2006,2000,,2,4339819,772212,,2,4339819,772212,,0,0,0,PDN
GI109,,2007,2000,,2,4339819,772212,,2,4339819,772212,,0,0,0,PDN
GI109,,2008,2000,,2,4339819,772212,,2,4339819,772212,,0,0,0,PDN
GI109,,2009,2000,,2,4339819,772212,,2,4339819,772212,,0,0,0,PDN
GI109,,2010,2000,,2,4339819,772212,,2,4339819,772212,,0,0,0,PDN
GI109,,2011,2000,,2,4339819,772212,,2,4339819,772212,,0,0,0,PDN
GI109,,2012,2000,,2,4339819,772212,,2,4339819,772212,,0,0,0,PDN
GI109,,2013,2000,,2,4339819,772212,,2,4339819,772212,,0,0,0,PDN
GI109,,2014,2000,,2,4339819,772212,,2,4339819,772212,,0,0,0,PDN
GI109,,2015,2000,,2,4339819,772212,,2,4339819,772212,,0,0,0,PDN
GI109,,2016,2000,,2,4339819,772212,,2,4339819,772212,,0,0,0,PDN
GI109,,2017,2000,,2,4339819,772212,,2,4339819,772212,,0,0,0,PDN
GI109,,2017,2000,,2,4339819,772212,,2,4339819,772212,,0,0,0,PDN
GI115,,1995,1994,,663537,1327074,899671,,0,0,0,,663537,1327074,899671,PDN
GI115,,1996,1994,,664747,1329494,901312,,0,0,0,,664747,1329494,901312,PDN
GI115,,1997,1994,,624667,1249334,846968,,0,0,0,,624667,1249334,846968,PDN
GI115,,1998,1994,,567455,957165,737769,,95520,144434,121220,,471935,812731,616549,PDN
GI115,,1999,1994,,567455,957165,737769,,145598,228459,186249,,421857,728706,551520,PDN
GI115,,2000,1994,,308921,538266,404698,,181665,283754,232155,,127256,254512,172543,PDN
GI115,,2001,1994,,321673,554113,420270,,194417,299601,247727,,127256,254512,172543,PDN
GI115,,2002,1994,,194417,299601,247727,,194417,299601,247727,,0,0,0,PDN
GI115,,2003,1994,,194417,299601,247727,,194417,299601,247727,,0,0,0,PDN
GI115,,2004,1994,,194417,299601,247727,,194417,299601,247727,,0,0,0,PDN
GI115,,2005,1994,,194417,299601,247727,,194417,299601,247727,,0,0,0,PDN
GI115,,2006,1994,,194417,299601,247727,,194417,299601,247727,,0,0,0,PDN
GI115,,2007,1994,,194417,299601,247727,,194417,299601,247727,,0,0,0,PDN
GI115,,2008,1994,,194417,299601,247727,,194417,299601,247727,,0,0,0,PDN
GI115,,2009,1994,,194417,301656,248093,,194417,301656,248093,,0,0,0,PDN
GI115,,2010,1994,,194417,301656,248093,,194417,301656,248093,,0,0,0,PDN
GI115,,2011,1994,,194417,301656,248093,,194417,301656,248093,,0,0,0,PDN
GI115,,2012,1994,,194417,301656,248093,,194417,301656,248093,,0,0,0,PDN
GI115,,2013,1994,,194417,301656,248093,,194417,301656,248093,,0,0,0,PDN
GI115,,2014,1994,,194417,301656,248093,,194417,301656,248093,,0,0,0,PDN
GI115,,2015,1994,,194417,301656,248093,,194417,301656,248093,,0,0,0,PDN
GI115,,2016,1994,,194417,301656,248093,,194417,301656,248093,,0,0,0,PDN
GI115,,2017,1994,,194417,301656,248093,,194417,301656,248093,,0,0,0,PDN
GI115,,2017,1994,,194417,301656,248093,,194417,301656,248093,,0,0,0,PDN
GI116,,1998,1998,,11375954,227519038,51859769,,0,0,0,,11375954,227519038,51859769,PDP
GI116,,1999,1998,,7871939,545562842,104947178,,0,0,0,,7871939,545562842,104947178,PDP
GI116,,2000,1998,,22234578,513834301,113664168,,3547,63499,14846,,22231031,513770802,113649322,PDP
GI116,,2001,1998,,15246713,287518669,66406618,,3703185,60403819,14451195,,11543528,227114850,51955423,PDP
GI116,,2002,1998,,14295352,282701255,64598066,,6020106,102055017,24179362,,8275246,180646238,40418704,PDP
GI116,,2003,1998,,13633705,279866291,63431977,,7362169,126101058,29800080,,6271536,153765233,33631897,PDP
GI116,,2004,1998,,12748260,261806445,59333036,,7998407,140034481,32915574,,4749853,121771964,26417462,PDP
GI116,,2005,1998,,12204818,253532474,57317357,,8365371,146100544,34361909,,3839447,107431930,22955448,PDP
GI116,,2006,1998,,12249048,253587078,57371303,,8575488,148400935,34981348,,3673560,105186143,22389955,PDP
GI116,,2007,1998,,12922505,262505627,59631691,,8755962,150128343,35469190,,4166543,112377284,24162501,PDP
GI116,,2008,1998,,12929857,262604785,59656687,,9127820,154969736,36702506,,3802037,107635049,22954181,PDP
GI116,,2009,1998,,14165031,275064662,63108920,,9557922,160466017,38110594,,4607109,114598645,24998327,PDP
GI116,,2010,1998,,14165161,275064662,63109050,,10001740,165836233,39509966,,4163421,109228429,23599084,PDP
GI116,,2011,1998,,14095972,275364452,63093204,,10392029,170407363,40713623,,3703943,104957089,22379581,PDP
GI116,,2012,1998,,16265685,300280942,69696456,,10906874,176887408,42381502,,5358811,123393534,27314954,PDP
GI116,,2013,1998,,16265685,300280942,69696456,,11492620,184382346,44300866,,4773065,115898596,25395590,PDP
GI116,,2014,1998,,16635344,305805206,71049080,,11984390,190503270,45881769,,4650954,115301936,25167312,PDP
GI116,,2015,1998,,16977260,311566957,72416219,,12438429,195944845,47304059,,4538831,115622112,25112160,PDP
GI116,,2016,1998,,17874729,312759734,73525926,,12862617,200966464,48621775,,5012112,111793270,24904152,PDP
GI116,,2017,1998,,14844813,220620722,54101169,,13284177,206006900,49940209,,1560636,14613822,4160961,PDP
GI116,,2017,1998,,14844813,220620722,54101169,,13284177,206006900,49940209,,1560636,14613822,4160961,PDP
HI006A,,1984,1982,,1514424,151442304,28461453,,0,0,0,,1514424,151442304,28461453,PDN
HI006A,,1985,1982,,550989,146901511,26690048,,81518,21941402,3985682,,469471,124960109,22704366,PDN
HI006A,,1986,1982,,544694,147496495,26789622,,222841,64543398,11707431,,321853,82953097,15082191,PDN
HI006A,,1987,1982,,596742,172342884,31262736,,307976,97101863,17585888,,288766,75241021,13676848,PDN
HI006A,,1988,1982,,545501,190040077,34360461,,361247,119112728,21555683,,184254,70927349,12804778,PDN
HI006A,,1989,1982,,545501,190040077,34360461,,393401,135276683,24463985,,152100,54763394,9896476,PDN
HI006A,,1990,1982,,519593,190258222,34373369,,412191,144932363,26200868,,107402,45325859,8172501,PDN
HI006A,,1991,1982,,518554,190466297,34409354,,421788,151301840,27343824,,96766,39164457,7065530,PDN
HI006A,,1992,1982,,527544,195392128,35294827,,434488,156960277,28363363,,93056,38431851,6931464,PDN
HI006A,,1993,1982,,491616,186239198,33630263,,442615,161232546,29131680,,49001,25006652,4498583,PDN
HI006A,,1994,1982,,544826,196402602,35491908,,464357,170082901,30728218,,80469,26319701,4763690,PDN
HI006A,,1995,1982,,604641,209416560,37867374,,490003,177794006,32125947,,114638,31622554,5741427,PDN
HI006A,,1996,1982,,578636,209152704,37794420,,503447,182956424,33057971,,75189,26196280,4736449,PDN
HI006A,,1997,1982,,578636,209122116,37788977,,506700,185626267,33536285,,71936,23495849,4252692,PDN
HI006A,,1998,1982,,575377,211066463,38131687,,507922,186947781,33772652,,67455,24118682,4359035,PDN
HI006A,,1999,1982,,526720,195959616,35394979,,509976,188569314,34063235,,16744,7390302,1331744,PDN
HI006A,,2000,1982,,526719,201491479,36379295,,510319,188888399,34120354,,16400,12603080,2258941,PDN
HI006A,,2001,1982,,549373,202042771,36500044,,520586,191736232,34637353,,28787,10306539,1862691,PDN
HI006A,,2002,1982,,561517,210537279,38023666,,532919,196909376,35570175,,28598,13627903,2453491,PDN
HI006A,,2003,1982,,565386,212127309,38310459,,543242,201751642,36442111,,22144,10375667,1868348,PDN
HI006A,,2004,1982,,560815,210411005,38000496,,551285,205503521,37117748,,9530,4907484,882748,PDN
HI006A,,2005,1982,,563151,210900826,38089989,,555739,206980244,37384964,,7412,3920582,705025,PDN
HI006A,,2006,1982,,562657,210296245,37981918,,556481,207564540,37489673,,6176,2731705,492245,PDN
HI006A,,2007,1982,,556829,207586319,37493896,,556829,207586319,37493896,,0,0,0,PDN
HI006A,,2008,1982,,556829,207598931,37496141,,556829,207598931,37496141,,0,0,0,PDN
HI006A,,2009,1982,,556830,211337851,38161428,,556830,211337851,38161428,,0,0,0,PDN
HI006A,,2010,1982,,556830,211337851,38161428,,556830,211337851,38161428,,0,0,0,PDN
HI006A,,2011,1982,,556830,211337851,38161428,,556830,211337851,38161428,,0,0,0,PDN
HI006A,,2012,1982,,556830,211337851,38161428,,556830,211337851,38161428,,0,0,0,PDN
HI006A,,2013,1982,,556830,211337851,38161428,,556830,211337851,38161428,,0,0,0,PDN
HI006A,,2014,1982,,556830,211337851,38161428,,556830,211337851,38161428,,0,0,0,PDN
HI006A,,2015,1982,,556830,211337851,38161428,,556830,211337851,38161428,,0,0,0,PDN
HI006A,,2016,1982,,556830,211337851,38161428,,556830,211337851,38161428,,0,0,0,PDN
HI006A,,2017,1982,,556830,211337851,38161428,,556830,211337851,38161428,,0,0,0,PDN
HI006A,,2017,1982,,556830,211337851,38161428,,556830,211337851,38161428,,0,0,0,PDN
HI009A,,1990,1989,,24792,8685787,1570306,,0,0,0,,24792,8685787,1570306,PDN
HI009A,,1991,1989,,24792,8685787,1570306,,0,0,0,,24792,8685787,1570306,PDN
HI009A,,1992,1989,,68124,8685787,1613638,,9153,1139554,211921,,58971,7546233,1401717,PDN
HI009A,,1993,1989,,68124,8685787,1613638,,48006,5518246,1029900,,20118,3167541,583738,PDN
HI009A,,1994,1989,,108502,12492003,2331278,,80670,9266697,1729548,,27832,3225306,601730,PDN
HI009A,,1995,1989,,156751,17976400,3355399,,115882,13424594,2504600,,40869,4551806,850799,PDN
HI009A,,1996,1989,,156751,17976400,3355399,,132650,15231679,2842913,,24101,2744721,512486,PDN
HI009A,,1997,1989,,156045,17976400,3354693,,147880,17032583,3178589,,8165,943817,176104,PDN
HI009A,,1998,1989,,171489,19292640,3604343,,156095,17835699,3329707,,15394,1456941,274636,PDN
HI009A,,1999,1989,,171489,19292640,3604343,,159881,18395846,3433163,,11608,896794,171180,PDN
HI009A,,2000,1989,,171489,19292640,3604343,,159881,18397602,3433476,,11608,895038,170867,PDN
HI009A,,2001,1989,,159958,18418923,3437346,,159958,18418923,3437346,,0,0,0,PDN
HI009A,,2002,1989,,159958,18418923,3437346,,159958,18418923,3437346,,0,0,0,PDN
HI009A,,2003,1989,,159958,18418923,3437346,,159958,18418923,3437346,,0,0,0,PDN
HI009A,,2004,1989,,159958,18418923,3437346,,159958,18418923,3437346,,0,0,0,PDN
HI009A,,2005,1989,,159958,18418923,3437346,,159958,18418923,3437346,,0,0,0,PDN
HI009A,,2006,1989,,159958,18418923,3437346,,159958,18418923,3437346,,0,0,0,PDN
HI009A,,2007,1989,,159958,18418923,3437346,,159958,18418923,3437346,,0,0,0,PDN
HI009A,,2008,1989,,159958,18418923,3437346,,159958,18418923,3437346,,0,0,0,PDN
HI009A,,2009,1989,,159958,18773955,3500519,,159958,18773955,3500519,,0,0,0,PDN
HI009A,,2010,1989,,159958,18773955,3500519,,159958,18773955,3500519,,0,0,0,PDN
HI009A,,2011,1989,,159958,18773955,3500519,,159958,18773955,3500519,,0,0,0,PDN
HI009A,,2012,1989,,159958,18773955,3500519,,159958,18773955,3500519,,0,0,0,PDN
HI009A,,2013,1989,,159958,18773955,3500519,,159958,18773955,3500519,,0,0,0,PDN
HI009A,,2014,1989,,159958,18773955,3500519,,159958,18773955,3500519,,0,0,0,PDN
HI009A,,2015,1989,,159958,18773955,3500519,,159958,18773955,3500519,,0,0,0,PDN
HI009A,,2016,1989,,159958,18773955,3500519,,159958,18773955,3500519,,0,0,0,PDN
HI009A,,2017,1989,,159958,18773955,3500519,,159958,18773955,3500519,,0,0,0,PDN
HI009A,,2017,1989,,159958,18773955,3500519,,159958,18773955,3500519,,0,0,0,PDN
HI014A,,1988,1987,,70127,7433485,1392811,,0,1391602,247616,,70127,6041883,1145195,PDN
HI014A,,1989,1987,,71,8816393,1568824,,30,4637033,825125,,41,4179360,743699,PDN
HI014A,,1990,1987,,72,11574750,2059636,,42,6898875,1227600,,30,4675875,832036,PDN
HI014A,,1991,1987,,42,13701400,2438014,,42,9486735,1688073,,0,4214665,749941,PDN
HI014A,,1992,1987,,42,13701400,2438014,,42,10460698,1861376,,0,3240702,576638,PDN
HI014A,,1993,1987,,42,10460745,1861385,,42,10460745,1861385,,0,0,0,PDN
HI014A,,1994,1987,,42,10460745,1861385,,42,10460745,1861385,,0,0,0,PDN
HI014A,,1995,1987,,42,10460745,1861385,,42,10460745,1861385,,0,0,0,PDN
HI014A,,1996,1987,,42,10460745,1861385,,42,10460745,1861385,,0,0,0,PDN
HI014A,,1997,1987,,42,10460745,1861385,,42,10460745,1861385,,0,0,0,PDN
HI014A,,1998,1987,,42,10460745,1861385,,42,10460745,1861385,,0,0,0,PDN
HI014A,,1999,1987,,42,10460745,1861385,,42,10460745,1861385,,0,0,0,PDN
HI014A,,2000,1987,,42,10460745,1861385,,42,10460745,1861385,,0,0,0,PDN
HI014A,,2001,1987,,42,10460745,1861385,,42,10460745,1861385,,0,0,0,PDN
HI014A,,2002,1987,,42,10460745,1861385,,42,10460745,1861385,,0,0,0,PDN
HI014A,,2003,1987,,42,10460745,1861385,,42,10460745,1861385,,0,0,0,PDN
HI014A,,2004,1987,,42,10460745,1861385,,42,10460745,1861385,,0,0,0,PDN
HI014A,,2005,1987,,42,10460745,1861385,,42,10460745,1861385,,0,0,0,PDN
HI014A,,2006,1987,,42,10460745,1861385,,42,10460745,1861385,,0,0,0,PDN
HI014A,,2007,1987,,42,10460745,1861385,,42,10460745,1861385,,0,0,0,PDN
HI014A,,2008,1987,,42,10460745,1861385,,42,10460745,1861385,,0,0,0,PDN
HI014A,,2009,1987,,42,10670241,1898661,,42,10670241,1898661,,0,0,0,PDN
HI014A,,2010,1987,,42,10670241,1898661,,42,10670241,1898661,,0,0,0,PDN
HI014A,,2011,1987,,42,10670241,1898661,,42,10670241,1898661,,0,0,0,PDN
HI014A,,2012,1987,,42,10670241,1898661,,42,10670241,1898661,,0,0,0,PDN
HI014A,,2013,1987,,42,10670241,1898661,,42,10670241,1898661,,0,0,0,PDN
HI014A,,2014,1987,,42,10670241,1898661,,42,10670241,1898661,,0,0,0,PDN
HI014A,,2015,1987,,42,10670241,1898661,,42,10670241,1898661,,0,0,0,PDN
HI014A,,2016,1987,,42,10670241,1898661,,42,10670241,1898661,,0,0,0,PDN
HI014A,,2017,1987,,42,10670241,1898661,,42,10670241,1898661,,0,0,0,PDN
HI014A,,2017,1987,,42,10670241,1898661,,42,10670241,1898661,,0,0,0,PDN
HI020A,,1985,1984,,213871,29287551,5425179,,4418,507190,94665,,209453,28780361,5330514,PDN
HI020A,,1986,1984,,752845,98157031,18218509,,220272,26761473,4982100,,532573,71395558,13236409,PDN
HI020A,,1987,1984,,752845,98157031,18218509,,350609,44967628,8351966,,402236,53189403,9866543,PDN
HI020A,,1988,1984,,1277945,134246924,25165298,,466510,64336673,11914317,,811435,69910251,13250981,PDN
HI020A,,1989,1984,,5650088,213788577,43690760,,541234,78547455,14517649,,5108854,135241122,29173111,PDN
HI020A,,1990,1984,,5552884,206579627,42310825,,729997,91206146,16958849,,4822887,115373481,25351976,PDN
HI020A,,1991,1984,,5374877,197365035,40493211,,1382280,106926686,20408381,,3992597,90438349,20084830,PDN
HI020A,,1992,1984,,5264378,190039503,39079236,,1958299,119039577,23139718,,3306079,70999926,15939518,PDN
HI020A,,1993,1984,,5279546,192856575,39595663,,2436680,131039973,25753401,,2842866,61816602,13842262,PDN
HI020A,,1994,1984,,5282630,192888500,39604427,,2707070,140301609,27671769,,2575560,52586891,11932658,PDN
HI020A,,1995,1984,,4489946,180083119,36533206,,2847709,145599470,28755088,,1642237,34483649,7778118,PDN
HI020A,,1996,1984,,4389775,186783007,37625185,,3025492,152111946,30091675,,1364283,34671061,7533510,PDN
HI020A,,1997,1984,,4395328,188862166,38000696,,3165526,160986752,31810856,,1229802,27875414,6189840,PDN
HI020A,,1998,1984,,4407688,198885766,39796614,,3218532,166647562,32871123,,1189156,32238204,6925491,PDN
HI020A,,1999,1984,,3397300,184885038,36294993,,3242920,170716532,33619527,,154380,14168506,2675466,PDN
HI020A,,2000,1984,,3372936,184065693,36124838,,3264758,173361411,34111984,,108178,10704282,2012854,PDN
HI020A,,2001,1984,,3483869,185389257,36471281,,3266859,175008785,34407212,,217010,10380472,2064069,PDN
HI020A,,2002,1984,,3483869,185389257,36471281,,3299996,176891473,34775347,,183873,8497784,1695934,PDN
HI020A,,2003,1984,,3483869,185389257,36471281,,3343801,178819902,35162289,,140068,6569355,1308992,PDN
HI020A,,2004,1984,,3486996,187271971,36809410,,3373106,180513699,35492981,,113890,6758272,1316429,PDN
HI020A,,2005,1984,,3486996,187271971,36809410,,3382797,181417954,35663572,,104199,5854017,1145838,PDN
HI020A,,2006,1984,,3390596,183520960,36045571,,3386691,181974698,35766531,,3905,1546262,279040,PDN
HI020A,,2007,1984,,3390596,183520960,36045571,,3387833,182398940,35843160,,2763,1122020,202411,PDN
HI020A,,2008,1984,,3390596,183520960,36045571,,3388615,182718519,35900807,,1981,802441,144764,PDN
HI020A,,2009,1984,,3389688,186692298,36608958,,3389145,186387579,36554194,,543,304719,54763,PDN
HI020A,,2010,1984,,3389688,186692298,36608958,,3389501,186606142,36593440,,187,86156,15517,PDN
HI020A,,2011,1984,,3389688,186692298,36608958,,3389688,186692298,36608958,,0,0,0,PDN
HI020A,,2012,1984,,3389688,186692298,36608958,,3389688,186692298,36608958,,0,0,0,PDN
HI020A,,2013,1984,,3389688,186692298,36608958,,3389688,186692298,36608958,,0,0,0,PDN
HI020A,,2014,1984,,3389688,186692298,36608958,,3389688,186692298,36608958,,0,0,0,PDN
HI020A,,2015,1984,,3389688,186692298,36608958,,3389688,186692298,36608958,,0,0,0,PDN
HI020A,,2016,1984,,3389688,186692298,36608958,,3389688,186692298,36608958,,0,0,0,PDN
HI020A,,2017,1984,,3389688,186692298,36608958,,3389688,186692298,36608958,,0,0,0,PDN
HI020A,,2017,1984,,3389688,186692298,36608958,,3389688,186692298,36608958,,0,0,0,PDN
HI022,,1985,1983,,1396575,191246916,35426275,,0,0,0,,1396575,191246916,35426275,PDP
HI022,,1986,1983,,1460255,199967235,37041614,,425,763289,136242,,1459830,199203946,36905372,PDP
HI022,,1987,1983,,1460255,199967235,37041614,,67327,25245599,4559426,,1392928,174721636,32482188,PDP
HI022,,1988,1983,,1426438,201835875,37340295,,112773,46400332,8369060,,1313665,155435543,28971235,PDP
HI022,,1989,1983,,666139,230425784,41667168,,140110,58018634,10463710,,526029,172407150,31203458,PDP
HI022,,1990,1983,,412786,167764964,30264203,,153815,63232948,11405229,,258971,104532016,18858974,PDP
HI022,,1991,1983,,413927,168135868,30331341,,171916,67052737,12103008,,242011,101083131,18228333,PDP
HI022,,1992,1983,,400983,170712756,30776918,,195446,78273412,14123099,,205537,92439344,16653819,PDP
HI022,,1993,1983,,415964,176564356,31833109,,208586,84288431,15206527,,207378,92275925,16626582,PDP
HI022,,1994,1983,,416360,176740653,31864875,,220995,90115507,16255783,,195365,86625146,15609092,PDP
HI022,,1995,1983,,445293,188843917,34047413,,251993,104154933,18784899,,193300,84688984,15262514,PDP
HI022,,1996,1983,,530504,226812054,40888521,,290185,121591377,21925661,,240319,105220677,18962860,PDP
HI022,,1997,1983,,537121,247521541,44580100,,321890,139386798,25123811,,215231,108134743,19456289,PDP
HI022,,1998,1983,,537121,247521541,44580100,,355454,156249721,28157895,,181667,91271820,16422205,PDP
HI022,,1999,1983,,442421,205784375,37058858,,369466,164410794,29624056,,72955,41373581,7434802,PDP
HI022,,2000,1983,,442421,205784375,37058858,,379208,168880958,30429201,,63213,36903417,6629657,PDP
HI022,,2001,1983,,541169,212133156,38287282,,393168,173352121,31238741,,148001,38781035,7048541,PDP
HI022,,2002,1983,,541165,212131597,38287001,,406126,177312874,31956459,,135039,34818723,6330542,PDP
HI022,,2003,1983,,541165,212131597,38287001,,435391,183236585,33039766,,105774,28895012,5247235,PDP
HI022,,2004,1983,,541169,212133155,38287282,,447443,185490217,33452820,,93726,26642938,4834462,PDP
HI022,,2005,1983,,510758,198647346,35857261,,456385,186806500,33695976,,54373,11840846,2161285,PDP
HI022,,2006,1983,,513133,200182347,36132767,,464313,188481987,34002033,,48820,11700360,2130734,PDP
HI022,,2007,1983,,512515,199922503,36085914,,481691,193136169,34847557,,30824,6786334,1238357,PDP
HI022,,2008,1983,,511402,199944357,36088690,,492701,195715927,35317599,,18701,4228430,771091,PDP
HI022,,2009,1983,,547475,203315080,36724535,,499138,200191104,36120331,,48337,3123976,604204,PDP
HI022,,2010,1983,,547475,203315080,36724535,,503179,200904891,36251380,,44296,2410189,473155,PDP
HI022,,2011,1983,,516770,202542377,36556339,,505524,201393472,36340661,,11246,1148905,215678,PDP
HI022,,2012,1983,,520140,204257377,36864868,,514815,201886662,36437708,,5325,2370715,427161,PDP
HI022,,2013,1983,,520533,204522206,36912384,,516181,202253918,36504422,,4352,2268288,407962,PDP
HI022,,2014,1983,,521918,204522206,36913769,,517306,202863676,36614045,,4612,1658530,299724,PDP
HI022,,2015,1983,,521918,204522206,36913769,,518126,203224615,36679089,,3792,1297591,234680,PDP
HI022,,2016,1983,,521142,212518681,38335853,,518840,203358385,36703605,,2302,9160296,1632248,PDP
HI022,,2017,1983,,524499,206526283,37272948,,519937,204137311,36843301,,4562,2388972,429646,PDP
HI022,,2017,1983,,524499,206526283,37272948,,519937,204137311,36843301,,4562,2388972,429646,PDP
HI023A,,1996,1996,,27478,6374902,1161802,,0,0,0,,27478,6374902,1161802,PDN
HI023A,,1997,1996,,31539,6374902,1165863,,5265,1381404,251066,,26274,4993498,914797,PDN
HI023A,,1998,1996,,13808,3190531,581518,,13478,3129281,570290,,330,61250,11228,PDN
HI023A,,1999,1996,,13808,3190531,581518,,13808,3190531,581518,,0,0,0,PDN
HI023A,,2000,1996,,13808,3190531,581518,,13808,3190531,581518,,0,0,0,PDN
HI023A,,2001,1996,,13808,3190531,581518,,13808,3190531,581518,,0,0,0,PDN
HI023A,,2002,1996,,13808,3190531,581518,,13808,3190531,581518,,0,0,0,PDN
HI023A,,2003,1996,,13808,3190531,581518,,13808,3190531,581518,,0,0,0,PDN
HI023A,,2004,1996,,13808,3190531,581518,,13808,3190531,581518,,0,0,0,PDN
HI023A,,2005,1996,,13808,3190531,581518,,13808,3190531,581518,,0,0,0,PDN
HI023A,,2006,1996,,13808,3190531,581518,,13808,3190531,581518,,0,0,0,PDN
HI023A,,2007,1996,,13808,3190531,581518,,13808,3190531,581518,,0,0,0,PDN
HI023A,,2008,1996,,13808,3190531,581518,,13808,3190531,581518,,0,0,0,PDN
HI023A,,2009,1996,,13808,3250410,592173,,13808,3250410,592173,,0,0,0,PDN
HI023A,,2010,1996,,13808,3250410,592173,,13808,3250410,592173,,0,0,0,PDN
HI023A,,2011,1996,,13808,3250410,592173,,13808,3250410,592173,,0,0,0,PDN
HI023A,,2012,1996,,13808,3250410,592173,,13808,3250410,592173,,0,0,0,PDN
HI023A,,2013,1996,,13808,3250410,592173,,13808,3250410,592173,,0,0,0,PDN
HI023A,,2014,1996,,13808,3250410,592173,,13808,3250410,592173,,0,0,0,PDN
HI023A,,2015,1996,,13808,3250410,592173,,13808,3250410,592173,,0,0,0,PDN
HI023A,,2016,1996,,13808,3250410,592173,,13808,3250410,592173,,0,0,0,PDN
HI023A,,2017,1996,,13808,3250410,592173,,13808,3250410,592173,,0,0,0,PDN
HI023A,,2017,1996,,13808,3250410,592173,,13808,3250410,592173,,0,0,0,PDN
HI037,,2000,1996,,161964,19862006,3696129,,0,32191,5728,,161964,19829815,3690401,PDN
HI037,,2001,1996,,107547,53687299,9660447,,25147,3671739,678481,,82400,50015560,8981966,PDN
HI037,,2002,1996,,107554,54022576,9720112,,29623,5175568,950543,,77931,48847008,8769569,PDN
HI037,,2003,1996,,93587,47153482,8483886,,44161,17255304,3114500,,49426,29898178,5369386,PDN
HI037,,2004,1996,,91901,41628389,7499088,,52659,24999258,4500926,,39242,16629131,2998162,PDN
HI037,,2005,1996,,91901,41628389,7499088,,56788,28453639,5119713,,35113,13174750,2379375,PDN
HI037,,2006,1996,,91901,41628389,7499088,,68732,32043061,5770344,,23169,9585328,1728744,PDN
HI037,,2007,1996,,91901,41628389,7499088,,71301,33496704,6031569,,20600,8131685,1467519,PDN
HI037,,2008,1996,,95560,44817773,8070253,,73759,34580404,6226856,,21801,10237369,1843397,PDN
HI037,,2009,1996,,78020,39587336,7122029,,75676,36373016,6547742,,2344,3214320,574287,PDN
HI037,,2010,1996,,78020,39587336,7122029,,76926,37792961,6801651,,1094,1794375,320378,PDN
HI037,,2011,1996,,78020,39587336,7122029,,77695,38514175,6930750,,325,1073161,191279,PDN
HI037,,2012,1996,,77926,38999413,7017323,,77728,38800684,6981764,,198,198729,35559,PDN
HI037,,2013,1996,,77926,38999413,7017323,,77926,38999413,7017323,,0,0,0,PDN
HI037,,2014,1996,,77926,38999413,7017323,,77926,38999413,7017323,,0,0,0,PDN
HI037,,2015,1996,,77926,38999413,7017323,,77926,38999413,7017323,,0,0,0,PDN
HI037,,2016,1996,,77926,38999413,7017323,,77926,38999413,7017323,,0,0,0,PDN
HI037,,2017,1996,,77926,38999413,7017323,,77926,38999413,7017323,,0,0,0,PDN
HI037,,2017,1996,,77926,38999413,7017323,,77926,38999413,7017323,,0,0,0,PDN
HI045,,1995,1982,,792721,43817661,8589458,,123553,7135121,1393147,,669168,36682540,7196311,PDN
HI045,,1996,1982,,792721,43817661,8589458,,276051,18622682,3589695,,516670,25194979,4999763,PDN
HI045,,1997,1982,,792721,43817661,8589458,,366883,29232449,5568386,,425838,14585212,3021072,PDN
HI045,,1998,1982,,792721,43817661,8589458,,430658,37566570,7115101,,362063,6251091,1474357,PDN
HI045,,1999,1982,,819926,74282859,14037517,,483533,45188800,8524245,,336393,29094059,5513272,PDN
HI045,,2000,1982,,794523,74282859,14012114,,516078,50929944,9578346,,278445,23352915,4433768,PDN
HI045,,2001,1982,,794537,74283639,14012267,,535975,54708528,10270589,,258562,19575111,3741678,PDN
HI045,,2002,1982,,794537,74283639,14012267,,549389,57476939,10776602,,245148,16806700,3235665,PDN
HI045,,2003,1982,,784130,79150428,14867836,,558455,60547507,11332033,,225675,18602921,3535803,PDN
HI045,,2004,1982,,786446,80112876,15041406,,563670,63484453,11859836,,222776,16628423,3181570,PDN
HI045,,2005,1982,,786446,80112876,15041406,,567259,65538555,12228924,,219187,14574321,2812482,PDN
HI045,,2006,1982,,786446,80112876,15041406,,569703,67043072,12499075,,216743,13069804,2542331,PDN
HI045,,2007,1982,,571639,73288100,13612226,,570341,68355608,12733261,,1298,4932492,878965,PDN
HI045,,2008,1982,,574538,73288100,13615125,,570643,69502116,12937568,,3895,3785984,677557,PDN
HI045,,2009,1982,,574538,73288100,13615125,,570957,70998147,13204079,,3581,2289953,411046,PDN
HI045,,2010,1982,,574538,73288100,13615125,,571613,71620987,13315561,,2925,1667113,299564,PDN
HI045,,2011,1982,,582072,73288100,13622659,,572240,72235484,13425529,,9832,1052616,197130,PDN
HI045,,2012,1982,,582072,73288100,13622659,,573446,72668915,13503858,,8626,619185,118801,PDN
HI045,,2013,1982,,582072,73288100,13622659,,575213,72807258,13530241,,6859,480842,92418,PDN
HI045,,2014,1982,,576049,72888534,13545539,,576049,72888534,13545539,,0,0,0,PDN
HI045,,2015,1982,,576049,72888534,13545539,,576049,72888534,13545539,,0,0,0,PDN
HI045,,2016,1982,,576049,72888534,13545539,,576049,72888534,13545539,,0,0,0,PDN
HI045,,2017,1982,,576049,72888534,13545539,,576049,72888534,13545539,,0,0,0,PDN
HI045,,2017,1982,,576049,72888534,13545539,,576049,72888534,13545539,,0,0,0,PDN
HI047,,2003,2003,,74834,35447593,6382235,,18435,3981918,726961,,56399,31465675,5655274,PDN
HI047,,2004,2003,,85108,44828917,8061784,,38731,19755452,3553936,,46377,25073465,4507848,PDN
HI047,,2005,2003,,112052,48686619,8775151,,68606,32675018,5882666,,43446,16011601,2892485,PDN
HI047,,2006,2003,,112876,59639146,10724824,,72931,39114717,7032845,,39945,20524429,3691979,PDN
HI047,,2007,2003,,92265,47805366,8598558,,77240,43307388,7783181,,15025,4497978,815377,PDN
HI047,,2008,2003,,92265,47789158,8595674,,79526,44115746,7929303,,12739,3673412,666371,PDN
HI047,,2009,2003,,90864,46319757,8332813,,86600,45736244,8224721,,4264,583513,108092,PDN
HI047,,2010,2003,,90864,46319757,8332813,,89465,46128341,8297354,,1399,191416,35459,PDN
HI047,,2011,2003,,90864,46319757,8332813,,90864,46319757,8332813,,0,0,0,PDN
HI047,,2012,2003,,90864,46319757,8332813,,90864,46319757,8332813,,0,0,0,PDN
HI047,,2013,2003,,90864,46319757,8332813,,90864,46319757,8332813,,0,0,0,PDN
HI047,,2014,2003,,90864,46319757,8332813,,90864,46319757,8332813,,0,0,0,PDN
HI047,,2015,2003,,90864,46319757,8332813,,90864,46319757,8332813,,0,0,0,PDN
HI047,,2016,2003,,90864,46319757,8332813,,90864,46319757,8332813,,0,0,0,PDN
HI047,,2017,2003,,90864,46319757,8332813,,90864,46319757,8332813,,0,0,0,PDN
HI047,,2017,2003,,90864,46319757,8332813,,90864,46319757,8332813,,0,0,0,PDN
HI052,,1975,1959,,6438977,96285260,23571586,,2704648,43470878,10439680,,3734329,52814382,13131906,PDN
HI052,,1976,1959,,6438977,96285260,23571586,,2816411,46200758,11037186,,3622566,50084502,12534400,PDN
HI052,,1977,1959,,6439107,96287153,23572052,,2906876,48978023,11621827,,3532231,47309130,11950225,PDN
HI052,,1978,1959,,6439107,96287153,23572052,,2961571,49591793,11785733,,3477536,46695360,11786319,PDN
HI052,,1979,1959,,4841137,96633089,22035637,,2445120,52455749,11778883,,2396017,44177340,10256754,PDN
HI052,,1980,1959,,4841137,96633089,22035637,,2479454,53740991,12041908,,2361683,42892098,9993729,PDN
HI052,,1981,1959,,3854063,77817864,17700658,,2508607,54047240,12125554,,1345456,23770624,5575104,PDN
HI052,,1982,1959,,3903919,81787864,18456920,,2536980,54788837,12285883,,1366939,26999027,6171037,PDN
HI052,,1983,1959,,4228919,81980914,18816270,,2562861,55042211,12356849,,1666058,26938703,6459421,PDN
HI052,,1984,1959,,4459274,104403650,23036436,,2590925,56609351,12663763,,1868349,47794299,10372673,PDN
HI052,,1985,1959,,4854049,166260914,34437842,,2812135,84863852,17912465,,2041914,81397062,16525377,PDN
HI052,,1986,1959,,4589612,139973495,29495928,,2910073,102619672,21169801,,1679539,37353823,8326127,PDN
HI052,,1987,1959,,4333032,140610562,29352705,,2951251,105216521,21673052,,1381781,35394041,7679653,PDN
HI052,,1988,1959,,4296093,133084820,27976666,,2985197,106594604,21952208,,1310896,26490216,6024458,PDN
HI052,,1989,1959,,4237357,129588564,27295820,,3007699,107314811,22102861,,1229658,22273753,5192959,PDN
HI052,,1990,1959,,3721690,129542037,26771875,,3019601,107596329,22164855,,702089,21945708,4607020,PDN
HI052,,1991,1959,,3737406,129485577,26777544,,3020153,107868554,22213846,,717253,21617023,4563698,PDN
HI052,,1992,1959,,3238505,117354233,24120041,,3031463,109174592,22457547,,207042,8179641,1662494,PDN
HI052,,1993,1959,,3321433,117279924,24189747,,3046097,110409284,22691877,,275336,6870640,1497870,PDN
HI052,,1994,1959,,3321419,117273643,24188615,,3063301,111909492,22976022,,258118,5364151,1212593,PDN
HI052,,1995,1959,,3320805,117249302,24183670,,3077431,113026221,23188858,,243374,4223081,994812,PDN
HI052,,1996,1959,,3614009,118187866,24643878,,3075669,113504647,23272225,,538340,4683219,1371653,PDN
HI052,,1997,1959,,3683091,130413087,26888267,,3112032,119416336,24360490,,571059,10996751,2527777,PDN
HI052,,1998,1959,,3677253,129962133,26802188,,3124611,121397896,24725660,,552642,8564237,2076528,PDN
HI052,,1999,1959,,5020398,129868843,28128733,,3129431,122224635,24877587,,1890967,7644208,3251146,PDN
HI052,,2000,1959,,5020871,132931533,28674169,,3130525,122536873,24934239,,1890346,10394660,3739930,PDN
HI052,,2001,1959,,5080197,129568193,28135035,,3133357,123017888,25022661,,1946840,6550305,3112374,PDN
HI052,,2002,1959,,5080226,129678387,28154672,,3165738,125264776,25454844,,1914488,4413611,2699828,PDN
HI052,,2003,1959,,5793623,171753641,36354769,,3396535,137067719,27785809,,2397088,34685922,8568960,PDN
HI052,,2004,1959,,5920373,180179785,37980833,,3656481,152980182,30877154,,2263892,27199603,7103679,PDN
HI052,,2005,1959,,6207208,195039611,40911766,,3814749,162461332,32722459,,2392459,32578279,8189307,PDN
HI052,,2006,1959,,6248984,198688909,41602883,,3999112,173311305,34837422,,2249872,25377604,6765461,PDN
HI052,,2007,1959,,4359017,196230454,39275468,,4216977,186521770,37405904,,142040,9708684,1869564,PDN
HI052,,2008,1959,,4761089,229638534,45622038,,4405149,199450221,39894512,,355940,30188313,5727526,PDN
HI052,,2009,1959,,4793375,234175118,46461544,,4545972,213663789,42564439,,247403,20511329,3897105,PDN
HI052,,2010,1959,,4793375,234175118,46461544,,4621818,220596407,43873847,,171557,13578711,2587697,PDN
HI052,,2011,1959,,4665045,224694916,44646346,,4652318,223557989,44431318,,12727,1136927,215027,PDN
HI052,,2012,1959,,4665045,224694916,44646346,,4664931,224688391,44645071,,114,6525,1275,PDN
HI052,,2013,1959,,4665045,224694916,44646346,,4665045,224694916,44646346,,0,0,0,PDN
HI052,,2014,1959,,4665045,224694916,44646346,,4665045,224694916,44646346,,0,0,0,PDN
HI052,,2015,1959,,4665045,224694916,44646346,,4665045,224694916,44646346,,0,0,0,PDN
HI052,,2016,1959,,4665045,224694916,44646346,,4665045,224694916,44646346,,0,0,0,PDN
HI052,,2017,1959,,4665045,224694916,44646346,,4665045,224694916,44646346,,0,0,0,PDN
HI052,,2017,1959,,4665045,224694916,44646346,,4665045,224694916,44646346,,0,0,0,PDN
HI064A,,2005,2006,,326,3255662,579625,,0,0,0,,326,3255662,579625,PDN
HI064A,,2006,2006,,325,3247448,578163,,0,0,0,,325,3247448,578163,PDN
HI064A,,2007,2006,,85973,3247448,663811,,12097,429330,88490,,73876,2818118,575321,PDN
HI064A,,2008,2006,,85973,3247448,663811,,79334,2928215,600369,,6639,319233,63442,PDN
HI064A,,2009,2006,,80359,3009588,615873,,80359,3009588,615873,,0,0,0,PDN
HI064A,,2010,2006,,80359,3009588,615873,,80359,3009588,615873,,0,0,0,PDN
HI064A,,2011,2006,,80359,3009588,615873,,80359,3009588,615873,,0,0,0,PDN
HI064A,,2012,2006,,80359,3009588,615873,,80359,3009588,615873,,0,0,0,PDN
HI064A,,2013,2006,,80359,3009588,615873,,80359,3009588,615873,,0,0,0,PDN
HI064A,,2014,2006,,80359,3009588,615873,,80359,3009588,615873,,0,0,0,PDN
HI064A,,2015,2006,,80359,3009588,615873,,80359,3009588,615873,,0,0,0,PDN
HI064A,,2016,2006,,80359,3009588,615873,,80359,3009588,615873,,0,0,0,PDN
HI064A,,2017,2006,,80359,3009588,615873,,80359,3009588,615873,,0,0,0,PDN
HI064A,,2017,2006,,80359,3009588,615873,,80359,3009588,615873,,0,0,0,PDN
HI071A,,1989,1988,,175095,16797056,3163895,,132,964196,171697,,174963,15832860,2992198,PDN
HI071A,,1990,1988,,2928,24765280,4409561,,776,7250146,1290838,,2152,17515134,3118723,PDN
HI071A,,1991,1988,,2928,24765280,4409561,,1080,13434286,2391522,,1848,11330994,2018039,PDN
HI071A,,1992,1988,,2928,24765280,4409561,,1353,17390488,3095746,,1575,7374792,1313815,PDN
HI071A,,1993,1988,,1390,17545505,3123366,,1390,17545505,3123366,,0,0,0,PDN
HI071A,,1994,1988,,1391,17545505,3123367,,1391,17545505,3123367,,0,0,0,PDN
HI071A,,1995,1988,,1391,17545505,3123367,,1391,17545505,3123367,,0,0,0,PDN
HI071A,,1996,1988,,1391,17545505,3123367,,1391,17545505,3123367,,0,0,0,PDN
HI071A,,1997,1988,,1391,17545505,3123367,,1391,17545505,3123367,,0,0,0,PDN
HI071A,,1998,1988,,1391,17545505,3123367,,1391,17545505,3123367,,0,0,0,PDN
HI071A,,1999,1988,,1391,17545505,3123367,,1391,17545505,3123367,,0,0,0,PDN
HI071A,,2000,1988,,1391,17545505,3123367,,1391,17545505,3123367,,0,0,0,PDN
HI071A,,2001,1988,,1391,17545505,3123367,,1391,17545505,3123367,,0,0,0,PDN
HI071A,,2002,1988,,1391,17545505,3123367,,1391,17545505,3123367,,0,0,0,PDN
HI071A,,2003,1988,,1391,17545505,3123367,,1391,17545505,3123367,,0,0,0,PDN
HI071A,,2004,1988,,1391,17545505,3123367,,1391,17545505,3123367,,0,0,0,PDN
HI071A,,2005,1988,,1391,17545505,3123367,,1391,17545505,3123367,,0,0,0,PDN
HI071A,,2006,1988,,1391,17545505,3123367,,1391,17545505,3123367,,0,0,0,PDN
HI071A,,2007,1988,,1391,17545505,3123367,,1391,17545505,3123367,,0,0,0,PDN
HI071A,,2008,1988,,1391,17545505,3123367,,1391,17545505,3123367,,0,0,0,PDN
HI071A,,2009,1988,,1390,17896894,3185891,,1390,17896894,3185891,,0,0,0,PDN
HI071A,,2010,1988,,1390,17896894,3185891,,1390,17896894,3185891,,0,0,0,PDN
HI071A,,2011,1988,,1390,17896894,3185891,,1390,17896894,3185891,,0,0,0,PDN
HI071A,,2012,1988,,1390,17896894,3185891,,1390,17896894,3185891,,0,0,0,PDN
HI071A,,2013,1988,,1390,17896894,3185891,,1390,17896894,3185891,,0,0,0,PDN
HI071A,,2014,1988,,1390,17896894,3185891,,1390,17896894,3185891,,0,0,0,PDN
HI071A,,2015,1988,,1390,17896894,3185891,,1390,17896894,3185891,,0,0,0,PDN
HI071A,,2016,1988,,1390,17896894,3185891,,1390,17896894,3185891,,0,0,0,PDN
HI071A,,2017,1988,,1390,17896894,3185891,,1390,17896894,3185891,,0,0,0,PDN
HI071A,,2017,1988,,1390,17896894,3185891,,1390,17896894,3185891,,0,0,0,PDN
HI074,,1987,1968,,20041,2744449,508377,,0,0,0,,20041,2744449,508377,PDN
HI074,,1996,1968,,49199,9212550,1688443,,6664,1259243,230729,,42535,7953307,1457714,PDN
HI074,,1997,1968,,49199,9212550,1688443,,20886,4784257,872177,,28313,4428293,816266,PDN
HI074,,1998,1968,,22610,5233839,953898,,22610,5233839,953898,,0,0,0,PDN
HI074,,1999,1968,,22610,5233839,953898,,22610,5233839,953898,,0,0,0,PDN
HI074,,2000,1968,,22610,5233839,953898,,22610,5233839,953898,,0,0,0,PDN
HI074,,2001,1968,,124572,13916372,2600795,,22610,5233839,953898,,101962,8682533,1646897,PDN
HI074,,2002,1968,,219475,41474645,7599305,,59980,10004583,1840155,,159495,31470062,5759150,PDN
HI074,,2003,1968,,219502,41479711,7600234,,147412,22989434,4238059,,72090,18490277,3362175,PDN
HI074,,2004,1968,,358423,44401791,8259098,,241453,31262304,5804141,,116970,13139487,2454957,PDN
HI074,,2005,1968,,365437,45076189,8386111,,273203,34952407,6492493,,92234,10123782,1893618,PDN
HI074,,2006,1968,,299826,39356078,7302687,,294269,37930806,7043523,,5557,1425272,259164,PDN
HI074,,2007,1968,,296683,38329288,7116841,,296481,38305858,7112470,,202,23430,4371,PDN
HI074,,2008,1968,,296683,38329366,7116855,,296683,38329366,7116855,,0,0,0,PDN
HI074,,2009,1968,,296683,38434183,7135506,,296683,38434183,7135506,,0,0,0,PDN
HI074,,2010,1968,,296683,38434183,7135506,,296683,38434183,7135506,,0,0,0,PDN
HI074,,2011,1968,,296683,38434183,7135506,,296683,38434183,7135506,,0,0,0,PDN
HI074,,2012,1968,,296683,38434183,7135506,,296683,38434183,7135506,,0,0,0,PDN
HI074,,2013,1968,,296683,38434183,7135506,,296683,38434183,7135506,,0,0,0,PDN
HI074,,2014,1968,,296683,38434183,7135506,,296683,38434183,7135506,,0,0,0,PDN
HI074,,2015,1968,,296683,38434183,7135506,,296683,38434183,7135506,,0,0,0,PDN
HI074,,2016,1968,,296683,38434183,7135506,,296683,38434183,7135506,,0,0,0,PDN
HI074,,2017,1968,,296683,38434183,7135506,,296683,38434183,7135506,,0,0,0,PDN
HI074,,2017,1968,,296683,38434183,7135506,,296683,38434183,7135506,,0,0,0,PDN
HI083A,,1988,1985,,0,44858273,7981899,,0,5963505,1061122,,0,38894768,6920777,PDN
HI083A,,1989,1985,,3946,129145434,22983561,,55,17158874,3053235,,3891,111986560,19930326,PDN
HI083A,,1990,1985,,1580,129145434,22981195,,439,37460708,6666045,,1141,91684726,16315150,PDN
HI083A,,1991,1985,,2156,129145434,22981771,,746,63068281,11222860,,1410,66077153,11758911,PDN
HI083A,,1992,1985,,2156,129145434,22981771,,572,84816390,15092456,,1584,44329044,7889315,PDN
HI083A,,1993,1985,,2156,129145434,22981771,,572,103116679,18348736,,1584,26028755,4633035,PDN
HI083A,,1994,1985,,2156,137857543,24531968,,573,117350482,20881442,,1583,20507061,3650526,PDN
HI083A,,1995,1985,,591,154883594,27559949,,572,128367047,22841684,,19,26516547,4718265,PDN
HI083A,,1996,1985,,591,154883594,27559949,,572,137406371,24450104,,19,17477223,3109845,PDN
HI083A,,1997,1985,,591,156045544,27766702,,572,141294490,25141940,,19,14751054,2624762,PDN
HI083A,,1998,1985,,572,150017226,26694029,,572,143805717,25588778,,0,6211509,1105251,PDN
HI083A,,1999,1985,,572,146633712,26091980,,572,144845048,25773712,,0,1788664,318268,PDN
HI083A,,2000,1985,,572,147113251,26177307,,572,145640440,25915241,,0,1472811,262066,PDN
HI083A,,2001,1985,,572,147323215,26214667,,572,146321554,26036436,,0,1001661,178231,PDN
HI083A,,2002,1985,,572,147332804,26216373,,572,146788736,26119564,,0,544068,96809,PDN
HI083A,,2003,1985,,572,147332804,26216373,,572,146843949,26129389,,0,488855,86984,PDN
HI083A,,2004,1985,,572,146843949,26129389,,572,146843949,26129389,,0,0,0,PDN
HI083A,,2005,1985,,572,146843949,26129389,,572,146843949,26129389,,0,0,0,PDN
HI083A,,2006,1985,,572,146843949,26129389,,572,146843949,26129389,,0,0,0,PDN
HI083A,,2007,1985,,572,146843949,26129389,,572,146843949,26129389,,0,0,0,PDN
HI083A,,2008,1985,,572,146843949,26129389,,572,146843949,26129389,,0,0,0,PDN
HI083A,,2009,1985,,572,149711853,26639691,,572,149711853,26639691,,0,0,0,PDN
HI083A,,2010,1985,,572,149711853,26639691,,572,149711853,26639691,,0,0,0,PDN
HI083A,,2011,1985,,572,149711853,26639691,,572,149711853,26639691,,0,0,0,PDN
HI083A,,2012,1985,,572,149711853,26639691,,572,149711853,26639691,,0,0,0,PDN
HI083A,,2013,1985,,572,149711853,26639691,,572,149711853,26639691,,0,0,0,PDN
HI083A,,2014,1985,,572,149711853,26639691,,572,149711853,26639691,,0,0,0,PDN
HI083A,,2015,1985,,572,149711853,26639691,,572,149711853,26639691,,0,0,0,PDN
HI083A,,2016,1985,,572,149711853,26639691,,572,149711853,26639691,,0,0,0,PDN
HI083A,,2017,1985,,572,149711853,26639691,,572,149711853,26639691,,0,0,0,PDN
HI083A,,2017,1985,,572,149711853,26639691,,572,149711853,26639691,,0,0,0,PDN
HI086,,1987,1969,,83294,15409508,2825199,,726,133042,24399,,82568,15276466,2800800,PDN
HI086,,1988,1969,,83294,15409508,2825199,,2548,410581,75605,,80746,14998927,2749594,PDN
HI086,,1989,1969,,74290,13224182,2427347,,4174,804223,147274,,70116,12419959,2280073,PDN
HI086,,1990,1969,,74290,13224182,2427347,,6356,962138,177555,,67934,12262044,2249792,PDN
HI086,,1991,1969,,39475,5836598,1078016,,6356,962138,177555,,33119,4874460,900461,PDN
HI086,,1992,1969,,6356,962138,177555,,6356,962138,177555,,0,0,0,PDN
HI086,,1993,1969,,6356,962138,177555,,6356,962138,177555,,0,0,0,PDN
HI086,,1994,1969,,6356,962138,177555,,6356,962138,177555,,0,0,0,PDN
HI086,,1995,1969,,6137,962138,177336,,6137,962138,177336,,0,0,0,PDN
HI086,,1996,1969,,6137,962138,177336,,6137,962138,177336,,0,0,0,PDN
HI086,,1997,1969,,88907,13625981,2513459,,6233,978660,180372,,82674,12647321,2333087,PDN
HI086,,1998,1969,,88907,13625981,2513459,,55140,9239667,1699209,,33767,4386314,814250,PDN
HI086,,1999,1969,,261715,46727259,8576174,,75965,14430749,2643714,,185750,32296510,5932460,PDN
HI086,,2000,1969,,276925,49666192,9114326,,95048,17945468,3288192,,181877,31720724,5826134,PDN
HI086,,2001,1969,,246620,44297760,8128784,,104994,20102840,3682012,,141626,24194920,4446772,PDN
HI086,,2002,1969,,246620,44403131,8147533,,108561,20940650,3834655,,138059,23462481,4312878,PDN
HI086,,2003,1969,,246620,44403131,8147533,,108561,21055832,3855150,,138059,23347299,4292383,PDN
HI086,,2004,1969,,108561,21055832,3855150,,108561,21055832,3855150,,0,0,0,PDN
HI086,,2005,1969,,108561,21055832,3855150,,108561,21055832,3855150,,0,0,0,PDN
HI086,,2006,1969,,108561,21055832,3855150,,108561,21055832,3855150,,0,0,0,PDN
HI086,,2007,1969,,108561,21055832,3855150,,108561,21055832,3855150,,0,0,0,PDN
HI086,,2008,1969,,108561,21055832,3855150,,108561,21055832,3855150,,0,0,0,PDN
HI086,,2009,1969,,108561,21184882,3878113,,108561,21184882,3878113,,0,0,0,PDN
HI086,,2010,1969,,108561,21184882,3878113,,108561,21184882,3878113,,0,0,0,PDN
HI086,,2011,1969,,108561,21184882,3878113,,108561,21184882,3878113,,0,0,0,PDN
HI086,,2012,1969,,108561,21184882,3878113,,108561,21184882,3878113,,0,0,0,PDN
HI086,,2013,1969,,108561,21184882,3878113,,108561,21184882,3878113,,0,0,0,PDN
HI086,,2014,1969,,108561,21184882,3878113,,108561,21184882,3878113,,0,0,0,PDN
HI086,,2015,1969,,108561,21184882,3878113,,108561,21184882,3878113,,0,0,0,PDN
HI086,,2016,1969,,108561,21184882,3878113,,108561,21184882,3878113,,0,0,0,PDN
HI086,,2017,1969,,108561,21184882,3878113,,108561,21184882,3878113,,0,0,0,PDN
HI086,,2017,1969,,108561,21184882,3878113,,108561,21184882,3878113,,0,0,0,PDN
HI088,,1975,1969,,518602,103170250,18876298,,159724,44769263,8125785,,358878,58400987,10750513,PDN
HI088,,1976,1969,,518602,103170250,18876298,,173666,51708973,9374551,,344936,51461277,9501747,PDN
HI088,,1977,1969,,518602,103170250,18876298,,185094,59380314,10750986,,333508,43789936,8125312,PDN
HI088,,1978,1969,,518602,103170250,18876298,,192980,65192325,11793038,,325622,37977925,7083260,PDN
HI088,,1979,1969,,518602,103170250,18876298,,176725,68810667,12420616,,341877,34359583,6455682,PDN
HI088,,1980,1969,,518602,103170250,18876298,,178156,70562019,12733675,,340446,32608231,6142623,PDN
HI088,,1981,1969,,518602,103170250,18876298,,178336,71107515,12830919,,340266,32062735,6045379,PDN
HI088,,1982,1969,,179959,72074403,13004586,,178748,71520676,12904847,,1211,553727,99739,PDN
HI088,,1983,1969,,190555,75678003,13656392,,158898,65623077,11835602,,31657,10054926,1820790,PDN
HI088,,1984,1969,,190555,75678003,13656392,,159208,66193319,11937379,,31347,9484684,1719013,PDN
HI088,,1985,1969,,206647,80148627,14467969,,159208,66751900,12036770,,47439,13396727,2431199,PDN
HI088,,1986,1969,,206647,80148627,14467969,,163784,68463135,12345836,,42863,11685492,2122133,PDN
HI088,,1987,1969,,206515,82388627,14866413,,169199,70374897,12691423,,37316,12013730,2174990,PDN
HI088,,1988,1969,,179288,75022725,13528527,,172018,72073764,12996531,,7270,2948961,531996,PDN
HI088,,1989,1969,,179288,75022725,13528527,,172465,72499159,13072671,,6823,2523566,455856,PDN
HI088,,1990,1969,,179288,75022725,13528527,,173020,73177261,13193885,,6268,1845464,334642,PDN
HI088,,1991,1969,,181480,76611096,13813348,,176076,74113375,13363509,,5404,2497721,449839,PDN
HI088,,1992,1969,,181480,76611096,13813348,,177893,74983412,13520137,,3587,1627684,293211,PDN
HI088,,1993,1969,,182124,76611096,13813992,,179817,75742947,13657210,,2307,868149,156782,PDN
HI088,,1994,1969,,224078,90457616,16319739,,184410,77209962,13922837,,39668,13247654,2396902,PDN
HI088,,1995,1969,,231326,95730142,17265159,,187458,80254149,14467556,,43868,15475993,2797603,PDN
HI088,,1996,1969,,212040,87082546,15707155,,194067,81613961,14716124,,17973,5468585,991031,PDN
HI088,,1997,1969,,221198,90544205,16332267,,195645,82555157,14885175,,25553,7989048,1447092,PDN
HI088,,1998,1969,,221198,90544205,16332267,,196958,83139569,14990476,,24240,7404636,1341791,PDN
HI088,,1999,1969,,236263,94917358,17125473,,202883,84907682,15311011,,33380,10009676,1814462,PDN
HI088,,2000,1969,,259546,98719206,17825241,,209806,86994188,15689199,,49740,11725018,2136042,PDN
HI088,,2001,1969,,268511,93726775,16945873,,214318,87986755,15870324,,54193,5740020,1075549,PDN
HI088,,2002,1969,,268511,93726775,16945873,,222153,88788391,16020799,,46358,4938384,925074,PDN
HI088,,2003,1969,,280583,95692989,17307805,,255828,91878048,16604235,,24755,3814941,703570,PDN
HI088,,2004,1969,,293423,97034922,17559423,,274231,94472330,17084254,,19192,2562592,475169,PDN
HI088,,2005,1969,,285038,97791976,17685745,,278771,95302762,17236558,,6267,2489214,449187,PDN
HI088,,2006,1969,,285996,98851962,17875313,,281626,97513284,17632744,,4370,1338678,242569,PDN
HI088,,2007,1969,,283038,98374042,17787316,,282483,98206357,17756924,,555,167685,30392,PDN
HI088,,2008,1969,,356706,110814870,20074654,,286369,99377300,17969163,,70337,11437570,2105491,PDN
HI088,,2009,1969,,334640,109687465,19851981,,288098,101445777,18338947,,46542,8241688,1513034,PDN
HI088,,2010,1969,,334640,109687465,19851981,,289092,101608484,18368892,,45548,8078981,1483089,PDN
HI088,,2011,1969,,314037,105609255,19105718,,303886,104132368,18832775,,10151,1476887,272943,PDN
HI088,,2012,1969,,314037,105609255,19105718,,311665,105170219,19025226,,2372,439036,80492,PDN
HI088,,2013,1969,,314037,105609255,19105718,,314037,105609255,19105718,,0,0,0,PDN
HI088,,2014,1969,,314037,105611375,19106095,,314037,105611375,19106095,,0,0,0,PDN
HI088,,2015,1969,,314037,105611375,19106095,,314037,105611375,19106095,,0,0,0,PDN
HI088,,2016,1969,,314037,105611375,19106095,,314037,105611375,19106095,,0,0,0,PDN
HI088,,2017,1969,,314037,105611375,19106095,,314037,105611375,19106095,,0,0,0,PDN
HI088,,2017,1969,,314037,105611375,19106095,,314037,105611375,19106095,,0,0,0,PDN
HI093,,1994,1993,,277053,17712288,3428706,,70475,4976914,956047,,206578,12735374,2472659,PDN
HI093,,1995,1993,,277146,17718224,3429855,,100047,9030531,1706903,,177099,8687693,1722952,PDN
HI093,,1996,1993,,101829,9329897,1761953,,101829,9329897,1761953,,0,0,0,PDN
HI093,,1997,1993,,101065,9226440,1742780,,101065,9226440,1742780,,0,0,0,PDN
HI093,,1998,1993,,101065,9226440,1742780,,101065,9226440,1742780,,0,0,0,PDN
HI093,,1999,1993,,101065,9226440,1742780,,101065,9226440,1742780,,0,0,0,PDN
HI093,,2000,1993,,101065,9226440,1742780,,101065,9226440,1742780,,0,0,0,PDN
HI093,,2001,1993,,101065,9226440,1742780,,101065,9226440,1742780,,0,0,0,PDN
HI093,,2002,1993,,101065,9226440,1742780,,101065,9226440,1742780,,0,0,0,PDN
HI093,,2003,1993,,101065,9226440,1742780,,101065,9226440,1742780,,0,0,0,PDN
HI093,,2004,1993,,101065,9226440,1742780,,101065,9226440,1742780,,0,0,0,PDN
HI093,,2005,1993,,101065,9226440,1742780,,101065,9226440,1742780,,0,0,0,PDN
HI093,,2006,1993,,101065,9226440,1742780,,101065,9226440,1742780,,0,0,0,PDN
HI093,,2007,1993,,101065,9226440,1742780,,101065,9226440,1742780,,0,0,0,PDN
HI093,,2008,1993,,101065,9226440,1742780,,101065,9226440,1742780,,0,0,0,PDN
HI093,,2009,1993,,101065,9411222,1775660,,101065,9411222,1775660,,0,0,0,PDN
HI093,,2010,1993,,101065,9411222,1775660,,101065,9411222,1775660,,0,0,0,PDN
HI093,,2011,1993,,101065,9411222,1775660,,101065,9411222,1775660,,0,0,0,PDN
HI093,,2012,1993,,101065,9411222,1775660,,101065,9411222,1775660,,0,0,0,PDN
HI093,,2013,1993,,101065,9411222,1775660,,101065,9411222,1775660,,0,0,0,PDN
HI093,,2014,1993,,101065,9411222,1775660,,101065,9411222,1775660,,0,0,0,PDN
HI093,,2015,1993,,101065,9411222,1775660,,101065,9411222,1775660,,0,0,0,PDN
HI093,,2016,1993,,101065,9411222,1775660,,101065,9411222,1775660,,0,0,0,PDN
HI093,,2017,1993,,101065,9411222,1775660,,101065,9411222,1775660,,0,0,0,PDN
HI093,,2017,1993,,101065,9411222,1775660,,101065,9411222,1775660,,0,0,0,PDN
HI105,,1986,1984,,2256109,41958787,9722085,,0,0,0,,2256109,41958787,9722085,PDN
HI105,,1987,1984,,2256109,41958787,9722085,,1026,41357,8385,,2255083,41917430,9713700,PDN
HI105,,1988,1984,,2308875,51890545,11542068,,63147,4924274,939352,,2245728,46966271,10602716,PDN
HI105,,1989,1984,,590574,27616908,5504615,,164915,10349173,2006405,,425659,17267735,3498210,PDN
HI105,,1990,1984,,748002,30839074,6235382,,204760,11840840,2311671,,543242,18998234,3923711,PDN
HI105,,1991,1984,,881366,41382113,8244731,,485310,27033054,5295462,,396056,14349059,2949269,PDN
HI105,,1992,1984,,905430,44530008,8828919,,558632,33873948,6586025,,346798,10656060,2242894,PDN
HI105,,1993,1984,,905430,44530008,8828919,,590605,38555852,7451077,,314825,5974156,1377842,PDN
HI105,,1994,1984,,905430,44530000,8828918,,610583,41796166,8047623,,294847,2733834,781295,PDN
HI105,,1995,1984,,653378,49103707,9390692,,623654,44172990,8483617,,29724,4930717,907075,PDN
HI105,,1996,1984,,653378,49103707,9390692,,631166,45760174,8773546,,22212,3343533,617146,PDN
HI105,,1997,1984,,653378,49103707,9390692,,634074,46348689,8881172,,19304,2755018,509520,PDN
HI105,,1998,1984,,634074,46348689,8881172,,634074,46348689,8881172,,0,0,0,PDN
HI105,,1999,1984,,634074,46348689,8881172,,634074,46348689,8881172,,0,0,0,PDN
HI105,,2000,1984,,634074,46348689,8881172,,634074,46348689,8881172,,0,0,0,PDN
HI105,,2001,1984,,634074,46348689,8881172,,634074,46348689,8881172,,0,0,0,PDN
HI105,,2002,1984,,634074,46348689,8881172,,634074,46348689,8881172,,0,0,0,PDN
HI105,,2003,1984,,634074,46348689,8881172,,634074,46348689,8881172,,0,0,0,PDN
HI105,,2004,1984,,634074,46348689,8881172,,634074,46348689,8881172,,0,0,0,PDN
HI105,,2005,1984,,634074,46348689,8881172,,634074,46348689,8881172,,0,0,0,PDN
HI105,,2006,1984,,634074,46348689,8881172,,634074,46348689,8881172,,0,0,0,PDN
HI105,,2007,1984,,634074,46348689,8881172,,634074,46348689,8881172,,0,0,0,PDN
HI105,,2008,1984,,634074,46348689,8881172,,634074,46348689,8881172,,0,0,0,PDN
HI105,,2009,1984,,634074,47276919,9046336,,634074,47276919,9046336,,0,0,0,PDN
HI105,,2010,1984,,634074,47276919,9046336,,634074,47276919,9046336,,0,0,0,PDN
HI105,,2011,1984,,634074,47276919,9046336,,634074,47276919,9046336,,0,0,0,PDN
HI105,,2012,1984,,634074,47276919,9046336,,634074,47276919,9046336,,0,0,0,PDN
HI105,,2013,1984,,634074,47276919,9046336,,634074,47276919,9046336,,0,0,0,PDN
HI105,,2014,1984,,634074,47276919,9046336,,634074,47276919,9046336,,0,0,0,PDN
HI105,,2015,1984,,634074,47276919,9046336,,634074,47276919,9046336,,0,0,0,PDN
HI105,,2016,1984,,634074,47276919,9046336,,634074,47276919,9046336,,0,0,0,PDN
HI105,,2017,1984,,634074,47276919,9046336,,634074,47276919,9046336,,0,0,0,PDN
HI105,,2017,1984,,634074,47276919,9046336,,634074,47276919,9046336,,0,0,0,PDN
HI108,,1996,1996,,31201,4868271,897441,,0,0,0,,31201,4868271,897441,PDN
HI108,,1997,1996,,30060,4715925,869193,,24997,3986073,734263,,5063,729852,134930,PDN
HI108,,1998,1996,,24997,3986073,734263,,24997,3986073,734263,,0,0,0,PDN
HI108,,1999,1996,,24997,3986073,734263,,24997,3986073,734263,,0,0,0,PDN
HI108,,2000,1996,,24997,3986073,734263,,24997,3986073,734263,,0,0,0,PDN
HI108,,2001,1996,,24997,3986073,734263,,24997,3986073,734263,,0,0,0,PDN
HI108,,2002,1996,,24997,3986073,734263,,24997,3986073,734263,,0,0,0,PDN
HI108,,2003,1996,,24997,3986073,734263,,24997,3986073,734263,,0,0,0,PDN
HI108,,2004,1996,,24997,3986073,734263,,24997,3986073,734263,,0,0,0,PDN
HI108,,2005,1996,,24997,3986073,734263,,24997,3986073,734263,,0,0,0,PDN
HI108,,2006,1996,,24997,3986073,734263,,24997,3986073,734263,,0,0,0,PDN
HI108,,2007,1996,,24997,3986073,734263,,24997,3986073,734263,,0,0,0,PDN
HI108,,2008,1996,,24997,3986073,734263,,24997,3986073,734263,,0,0,0,PDN
HI108,,2009,1996,,24997,4065901,748467,,24997,4065901,748467,,0,0,0,PDN
HI108,,2010,1996,,24997,4065901,748467,,24997,4065901,748467,,0,0,0,PDN
HI108,,2011,1996,,24997,4065901,748467,,24997,4065901,748467,,0,0,0,PDN
HI108,,2012,1996,,24997,4065901,748467,,24997,4065901,748467,,0,0,0,PDN
HI108,,2013,1996,,24997,4065901,748467,,24997,4065901,748467,,0,0,0,PDN
HI108,,2014,1996,,24997,4065901,748467,,24997,4065901,748467,,0,0,0,PDN
HI108,,2015,1996,,24997,4065901,748467,,24997,4065901,748467,,0,0,0,PDN
HI108,,2016,1996,,24997,4065901,748467,,24997,4065901,748467,,0,0,0,PDN
HI108,,2017,1996,,24997,4065901,748467,,24997,4065901,748467,,0,0,0,PDN
HI108,,2017,1996,,24997,4065901,748467,,24997,4065901,748467,,0,0,0,PDN
HI111,,1975,1973,,10207,187188714,33317807,,0,0,0,,10207,187188714,33317807,PDP
HI111,,1976,1973,,10207,187188714,33317807,,0,0,0,,10207,187188714,33317807,PDP
HI111,,1977,1973,,10207,187188714,33317807,,0,0,0,,10207,187188714,33317807,PDP
HI111,,1978,1973,,1730019,186899105,34986088,,116703,20129905,3698537,,1613316,166769200,31287551,PDP
HI111,,1979,1973,,1819812,197106517,36892146,,216100,31547225,5829485,,1603712,165559292,31062661,PDP
HI111,,1980,1973,,1819812,197106517,36892146,,478326,68412335,12651339,,1341486,128694182,24240807,PDP
HI111,,1981,1973,,1819812,197106517,36892146,,556350,79218400,14652151,,1263462,117888117,22239995,PDP
HI111,,1982,1973,,1497732,218148038,40314109,,796025,110720581,20497196,,701707,107427457,19816913,PDP
HI111,,1983,1973,,1501695,222111231,41023266,,967038,135259809,25034620,,534657,86851422,15988646,PDP
HI111,,1984,1973,,1570079,229254516,42362698,,1198818,162878067,30180680,,371261,66376449,12182018,PDP
HI111,,1985,1973,,2779761,358864397,66634636,,1386741,184008961,34128549,,1393020,174855436,32506087,PDP
HI111,,1986,1973,,2823220,361068021,67070199,,1579322,203381240,37768155,,1243898,157686781,29302044,PDP
HI111,,1987,1973,,2922680,368465220,68485886,,1797510,228163819,42396054,,1125170,140301401,26089832,PDP
HI111,,1988,1973,,3309202,402288986,74890872,,2033855,254659084,47346859,,1275347,147629902,27544013,PDP
HI111,,1989,1973,,3309202,402288986,74890872,,2109011,263449178,48986089,,1200191,138839808,25904783,PDP
HI111,,1990,1973,,3118816,383726746,71397596,,2234158,278366324,51765532,,884658,105360422,19632064,PDP
HI111,,1991,1973,,3173225,397312615,73869420,,2322152,290005756,53924600,,851073,107306859,19944820,PDP
HI111,,1992,1973,,2811707,347481014,64641069,,2379798,297408442,55299450,,431909,50072572,9341619,PDP
HI111,,1993,1973,,2868139,351618671,65433739,,2425806,302496532,56250812,,442333,49122139,9182927,PDP
HI111,,1994,1973,,2979243,351573211,65536754,,2543049,311644117,57995739,,436194,39929094,7541015,PDP
HI111,,1995,1973,,3036722,356090802,66398075,,2698369,324167334,60379389,,338353,31923468,6018686,PDP
HI111,,1996,1973,,3105528,357867720,66783058,,2792547,329827671,61480745,,312981,28040049,5302313,PDP
HI111,,1997,1973,,3210162,362533320,67717870,,2916469,333817979,62314686,,293693,28715341,5403184,PDP
HI111,,1998,1973,,3528994,369642737,69301723,,3167919,341175800,63875357,,361075,28466937,5426366,PDP
HI111,,1999,1973,,3577765,374334305,70185292,,3295089,347525195,65132312,,282676,26809110,5052980,PDP
HI111,,2000,1973,,3585490,376237855,70531727,,3373281,352792919,66147822,,212209,23444936,4383905,PDP
HI111,,2001,1973,,3756207,387443103,72696261,,3431197,357505703,67044311,,325010,29937400,5651950,PDP
HI111,,2002,1973,,3776177,389064311,73004702,,3477463,361816745,67857667,,298714,27247566,5147035,PDP
HI111,,2003,1973,,3776177,389064311,73004702,,3519459,366526711,68737735,,256718,22537600,4266967,PDP
HI111,,2004,1973,,3867066,398125872,74707968,,3604552,374348700,70214641,,262514,23777172,4493327,PDP
HI111,,2005,1973,,3851907,396484158,74400690,,3645689,378065679,70917162,,206218,18418479,3483528,PDP
HI111,,2006,1973,,4121378,407631626,76653696,,3734392,382030375,71711327,,386986,25601251,4942369,PDP
HI111,,2007,1973,,4265360,416986198,78462192,,3805309,385378350,72377969,,460051,31607848,6084223,PDP
HI111,,2008,1973,,4725209,444538911,83824659,,3855561,388167280,72924472,,869648,56371631,10900187,PDP
HI111,,2009,1973,,4726081,467289668,87873710,,3978219,405120224,76063669,,747862,62169444,11810042,PDP
HI111,,2010,1973,,4760474,469176628,88243861,,4108152,416863655,78283179,,652322,52312973,9960679,PDP
HI111,,2011,1973,,4658250,462721137,86992972,,4265110,430967748,80949761,,393140,31753389,6043208,PDP
HI111,,2012,1973,,4658250,462721137,86992972,,4356655,441040785,82833663,,301595,21680352,4159309,PDP
HI111,,2013,1973,,4695161,465801506,87577992,,4452654,450313358,84579587,,242507,15488148,2998407,PDP
HI111,,2014,1973,,4677735,462973270,87057322,,4508478,454563798,85391716,,169257,8409472,1665604,PDP
HI111,,2015,1973,,4677735,462973270,87057322,,4552756,456950293,85860638,,124979,6022977,1196684,PDP
HI111,,2016,1973,,4656185,459121155,86350342,,4591738,457774184,86046220,,64447,1346971,304122,PDP
HI111,,2017,1973,,4656185,459121140,86350339,,4614145,458133061,86132484,,42040,988079,217855,PDP
HI111,,2017,1973,,4656185,459121140,86350339,,4614145,458133061,86132484,,42040,988079,217855,PDP
HI116,,1986,1984,,249275,35108774,6496388,,46777,7889593,1450619,,202498,27219181,5045769,PDN
HI116,,1987,1984,,774149,143247331,26262998,,210786,45070958,8230529,,563363,98176373,18032469,PDN
HI116,,1988,1984,,644304,162445800,29549251,,288293,71872791,13077046,,356011,90573009,16472205,PDN
HI116,,1989,1984,,383436,115201665,20881953,,310178,80339857,14605526,,73258,34861808,6276427,PDN
HI116,,1990,1984,,383436,115201665,20881953,,325643,86992958,15804817,,57793,28208707,5077136,PDN
HI116,,1991,1984,,367956,114057875,20662952,,336672,95133903,17264413,,31284,18923972,3398539,PDN
HI116,,1992,1984,,367956,114057780,20662935,,341831,100384297,18203806,,26125,13673483,2459129,PDN
HI116,,1993,1984,,362381,112789907,20431759,,343671,102565059,18593681,,18710,10224848,1838078,PDN
HI116,,1994,1984,,349594,105032677,19038682,,346368,103556973,18772876,,3226,1475704,265806,PDN
HI116,,1995,1984,,349594,105032677,19038682,,346567,104394250,18922056,,3027,638427,116626,PDN
HI116,,1996,1984,,941551,160111409,29431126,,445644,109967891,20012884,,495907,50143518,9418242,PDN
HI116,,1997,1984,,941551,160111409,29431126,,702719,123936008,22755389,,238832,36175401,6675737,PDN
HI116,,1998,1984,,990152,174153459,31978312,,793755,133737325,24590432,,196397,40416134,7387880,PDN
HI116,,1999,1984,,1257034,175191997,32429987,,855496,137547778,25330190,,401538,37644219,7099797,PDN
HI116,,2000,1984,,1263449,176678625,32700927,,982759,147525274,27232808,,280690,29153351,5468119,PDN
HI116,,2001,1984,,1248833,170759291,31633049,,1140990,162118845,29987760,,107843,8640446,1645289,PDN
HI116,,2002,1984,,1256948,171152825,31711187,,1223390,168462713,31198962,,33558,2690112,512225,PDN
HI116,,2003,1984,,1395215,180939673,33590887,,1326804,176438195,32721501,,68411,4501478,869386,PDN
HI116,,2004,1984,,1370057,180343813,33459704,,1352940,178567169,33126458,,17117,1776644,333246,PDN
HI116,,2005,1984,,1405176,183823859,34114048,,1375087,180131587,33426971,,30089,3692272,687077,PDN
HI116,,2006,1984,,1397651,182719604,33910036,,1387266,181265297,33640878,,10385,1454307,269158,PDN
HI116,,2007,1984,,1618069,208087222,38644265,,1404729,183716402,34094480,,213340,24370820,4549785,PDN
HI116,,2008,1984,,1537382,201489016,37389520,,1413088,184839463,34302672,,124294,16649553,3086848,PDN
HI116,,2009,1984,,1539990,204471254,37922772,,1453471,192976093,35790851,,86519,11495161,2131921,PDN
HI116,,2010,1984,,1552224,206090496,38223127,,1459738,193392203,35871158,,92486,12698293,2351968,PDN
HI116,,2011,1984,,1474251,195400516,36243022,,1461412,193657815,35920094,,12839,1742701,322928,PDN
HI116,,2012,1984,,1474251,195400516,36243022,,1462017,193781274,35942667,,12234,1619242,300355,PDN
HI116,,2013,1984,,1472639,195197606,36205305,,1469129,194892906,36147578,,3510,304700,57727,PDN
HI116,,2014,1984,,1472639,195197606,36205305,,1472639,195197606,36205305,,0,0,0,PDN
HI116,,2015,1984,,1472639,195197606,36205305,,1472639,195197606,36205305,,0,0,0,PDN
HI116,,2016,1984,,1472639,195197606,36205305,,1472639,195197606,36205305,,0,0,0,PDN
HI116,,2017,1984,,1472639,195197606,36205305,,1472639,195197606,36205305,,0,0,0,PDN
HI116,,2017,1984,,1472639,195197606,36205305,,1472639,195197606,36205305,,0,0,0,PDN
HI117,,2014,2013,,1617,2275790,406562,,321,422937,75577,,1296,1852853,330985,PDN
HI117,,2015,2013,,7399,5192290,931294,,2331,1904366,341186,,5068,3287924,590108,PDN
HI117,,2016,2013,,7276,5119840,918280,,2938,2729084,488540,,4338,2390756,429739,PDN
HI117,,2017,2013,,7276,5119840,918280,,2938,2729083,488540,,4338,2390757,429740,PDN
HI117,,2017,2013,,7276,5119840,918280,,2938,2729083,488540,,4338,2390757,429740,PDN
HI126A,,1989,1988,,801,9021467,1606044,,36,770966,137219,,765,8250501,1468825,PDN
HI126A,,1990,1988,,687,10959376,1950754,,183,4069527,724298,,504,6889849,1226456,PDN
HI126A,,1991,1988,,687,10959376,1950754,,312,6895079,1227194,,375,4064297,723560,PDN
HI126A,,1992,1988,,392,14392771,2561383,,312,9313178,1657461,,80,5079593,903922,PDN
HI126A,,1993,1988,,392,14392771,2561383,,312,11007517,1958945,,80,3385254,602438,PDN
HI126A,,1994,1988,,392,14392771,2561383,,312,11892895,2116485,,80,2499876,444898,PDN
HI126A,,1995,1988,,352,14392771,2561343,,312,12403131,2207275,,40,1989640,354068,PDN
HI126A,,1996,1988,,312,13010329,2315317,,312,12755177,2269916,,0,255152,45401,PDN
HI126A,,1997,1988,,372,14242841,2534685,,312,12911954,2297813,,60,1330887,236872,PDN
HI126A,,1998,1988,,372,14242841,2534685,,312,13389732,2382827,,60,853109,151858,PDN
HI126A,,1999,1988,,372,14937007,2658202,,312,13757250,2448221,,60,1179757,209981,PDN
HI126A,,2000,1988,,372,14937007,2658202,,312,14090950,2507598,,60,846057,150604,PDN
HI126A,,2001,1988,,312,14243369,2534719,,312,14243369,2534719,,0,0,0,PDN
HI126A,,2002,1988,,312,14243369,2534719,,312,14243369,2534719,,0,0,0,PDN
HI126A,,2003,1988,,312,14243369,2534719,,312,14243369,2534719,,0,0,0,PDN
HI126A,,2004,1988,,312,14243369,2534719,,312,14243369,2534719,,0,0,0,PDN
HI126A,,2005,1988,,312,14243369,2534719,,312,14243369,2534719,,0,0,0,PDN
HI126A,,2006,1988,,312,14243369,2534719,,312,14243369,2534719,,0,0,0,PDN
HI126A,,2007,1988,,312,14243369,2534719,,312,14243369,2534719,,0,0,0,PDN
HI126A,,2008,1988,,312,14243369,2534719,,312,14243369,2534719,,0,0,0,PDN
HI126A,,2009,1988,,312,14507827,2581776,,312,14507827,2581776,,0,0,0,PDN
HI126A,,2010,1988,,312,14507827,2581776,,312,14507827,2581776,,0,0,0,PDN
HI126A,,2011,1988,,312,14507827,2581776,,312,14507827,2581776,,0,0,0,PDN
HI126A,,2012,1988,,312,14507827,2581776,,312,14507827,2581776,,0,0,0,PDN
HI126A,,2013,1988,,312,14507827,2581776,,312,14507827,2581776,,0,0,0,PDN
HI126A,,2014,1988,,312,14507827,2581776,,312,14507827,2581776,,0,0,0,PDN
HI126A,,2015,1988,,312,14507827,2581776,,312,14507827,2581776,,0,0,0,PDN
HI126A,,2016,1988,,312,14507827,2581776,,312,14507827,2581776,,0,0,0,PDN
HI126A,,2017,1988,,312,14507827,2581776,,312,14507827,2581776,,0,0,0,PDN
HI126A,,2017,1988,,312,14507827,2581776,,312,14507827,2581776,,0,0,0,PDN
HI128,,1988,1987,,305864,32393787,6069883,,0,0,0,,305864,32393787,6069883,PDN
HI128,,1989,1987,,305864,32393787,6069883,,32280,4929532,909421,,273584,27464255,5160462,PDN
HI128,,1990,1987,,137377,41908005,7594317,,64924,14827651,2703296,,72453,27080354,4891021,PDN
HI128,,1991,1987,,137377,41908005,7594317,,82396,23511382,4265916,,54981,18396623,3328401,PDN
HI128,,1992,1987,,119995,50894412,9175940,,95936,33960114,6138661,,24059,16934298,3037279,PDN
HI128,,1993,1987,,119690,58836602,10588836,,103882,42136584,7601495,,15808,16700018,2987341,PDN
HI128,,1994,1987,,119674,58833568,10588280,,105335,45354533,8175537,,14339,13479035,2412743,PDN
HI128,,1995,1987,,119674,58833568,10588280,,106075,48506350,8737098,,13599,10327218,1851182,PDN
HI128,,1996,1987,,121026,58485403,10527681,,106816,51382233,9249562,,14210,7103170,1278119,PDN
HI128,,1997,1987,,123837,58223238,10483844,,108168,52722257,9489353,,15669,5500981,994491,PDN
HI128,,1998,1987,,113635,55904967,10061138,,108507,53389877,9608485,,5128,2515090,452653,PDN
HI128,,1999,1987,,111347,55452746,9978384,,109009,54033025,9723426,,2338,1419721,254958,PDN
HI128,,2000,1987,,111347,55452746,9978384,,109234,54600224,9824576,,2113,852522,153808,PDN
HI128,,2001,1987,,109234,54911158,9879903,,109234,54911158,9879903,,0,0,0,PDN
HI128,,2002,1987,,109234,54911158,9879903,,109234,54911158,9879903,,0,0,0,PDN
HI128,,2003,1987,,109234,54911158,9879903,,109234,54911158,9879903,,0,0,0,PDN
HI128,,2004,1987,,109234,54911158,9879903,,109234,54911158,9879903,,0,0,0,PDN
HI128,,2005,1987,,109234,54911158,9879903,,109234,54911158,9879903,,0,0,0,PDN
HI128,,2006,1987,,109234,54911158,9879903,,109234,54911158,9879903,,0,0,0,PDN
HI128,,2007,1987,,109234,54911158,9879903,,109234,54911158,9879903,,0,0,0,PDN
HI128,,2008,1987,,109234,54911158,9879903,,109234,54911158,9879903,,0,0,0,PDN
HI128,,2009,1987,,109233,55972455,10068743,,109233,55972455,10068743,,0,0,0,PDN
HI128,,2010,1987,,109233,55972455,10068743,,109233,55972455,10068743,,0,0,0,PDN
HI128,,2011,1987,,109233,55972455,10068743,,109233,55972455,10068743,,0,0,0,PDN
HI128,,2012,1987,,109233,55972455,10068743,,109233,55972455,10068743,,0,0,0,PDN
HI128,,2013,1987,,109233,55972455,10068743,,109233,55972455,10068743,,0,0,0,PDN
HI128,,2014,1987,,109233,55972455,10068743,,109233,55972455,10068743,,0,0,0,PDN
HI128,,2015,1987,,109233,55972455,10068743,,109233,55972455,10068743,,0,0,0,PDN
HI128,,2016,1987,,109233,55972455,10068743,,109233,55972455,10068743,,0,0,0,PDN
HI128,,2017,1987,,109233,55972455,10068743,,109233,55972455,10068743,,0,0,0,PDN
HI128,,2017,1987,,109233,55972455,10068743,,109233,55972455,10068743,,0,0,0,PDN
HI129,,1975,1968,,2562522,104528200,21161846,,327494,14648241,2933943,,2235028,89879959,18227903,PDP
HI129,,1976,1968,,2562522,104528200,21161846,,362786,19827177,3890753,,2199736,84701023,17271093,PDP
HI129,,1977,1968,,2569615,106378200,21498120,,388886,22574556,4405711,,2180729,83803644,17092409,PDP
HI129,,1978,1968,,2569615,106378200,21498120,,307282,12501939,2531826,,2262333,93876261,18966294,PDP
HI129,,1979,1968,,1067380,106218361,19967444,,229353,27174466,5064667,,838027,79043895,14902777,PDP
HI129,,1980,1968,,1067380,106218361,19967444,,251367,29343554,5472640,,816013,76874807,14494804,PDP
HI129,,1981,1968,,509305,48100544,9068121,,275909,32000734,5969990,,233396,16099810,3098131,PDP
HI129,,1982,1968,,513101,56265901,10524827,,291429,34053486,6350768,,221672,22212415,4174059,PDP
HI129,,1983,1968,,513101,56265901,10524827,,296359,35620330,6634496,,216742,20645571,3890331,PDP
HI129,,1984,1968,,573927,62348567,11667978,,308804,38057859,7080665,,265123,24290708,4587313,PDP
HI129,,1985,1968,,805146,87054732,16295312,,334250,41530314,7723986,,470896,45524418,8571326,PDP
HI129,,1986,1968,,748250,96344064,17891321,,360602,45328807,8426226,,387648,51015257,9465095,PDP
HI129,,1987,1968,,748250,96344064,17891321,,370974,47004812,8734820,,377276,49339252,9156501,PDP
HI129,,1988,1968,,925132,115455156,21468754,,410286,50966666,9479088,,514846,64488490,11989666,PDP
HI129,,1989,1968,,1073431,127246055,23715078,,533789,64605099,12029358,,539642,62640956,11685720,PDP
HI129,,1990,1968,,906025,119425151,22156052,,613330,78743606,14624648,,292695,40681545,7531404,PDP
HI129,,1991,1968,,843569,111725708,20723588,,638501,84210951,15622656,,205068,27514757,5100932,PDP
HI129,,1992,1968,,742924,106459996,19685984,,655769,88303063,16368058,,87155,18156933,3317926,PDP
HI129,,1993,1968,,948237,129215783,23940369,,695826,94505125,17511685,,252411,34710658,6428684,PDP
HI129,,1994,1968,,959784,131249950,24313868,,725580,99051013,18350315,,234204,32198937,5963553,PDP
HI129,,1995,1968,,935515,129747644,24022284,,730968,99784832,18486276,,204547,29962812,5536008,PDP
HI129,,1996,1968,,758761,105099289,19459702,,736959,100790198,18671158,,21802,4309091,788544,PDP
HI129,,1997,1968,,758761,105099289,19459702,,739467,101289599,18762527,,19294,3809690,697175,PDP
HI129,,1998,1968,,758761,105099289,19459702,,743668,102609533,19001592,,15093,2489756,458110,PDP
HI129,,1999,1968,,892871,127214965,23528986,,748248,104145754,19279521,,144623,23069211,4249465,PDP
HI129,,2000,1968,,892769,127198271,23525913,,753110,105964085,19607929,,139659,21234186,3917984,PDP
HI129,,2001,1968,,888782,126263788,23355648,,757877,107480810,19882576,,130905,18782978,3473072,PDP
HI129,,2002,1968,,888782,126263788,23355648,,759853,108107937,19996141,,128929,18155851,3359507,PDP
HI129,,2003,1968,,1077482,215819321,39479496,,779543,110876364,20508433,,297939,104942957,18971063,PDP
HI129,,2004,1968,,1466535,171181760,31925923,,862337,119409259,22109536,,604198,51772501,9816387,PDP
HI129,,2005,1968,,1337781,160782509,29946768,,1023999,131541292,24429923,,313782,29241217,5516845,PDP
HI129,,2006,1968,,1460041,169342312,31592125,,1195979,144510769,26909639,,264062,24831543,4682486,PDP
HI129,,2007,1968,,1514159,166761367,31187000,,1284613,151157424,28180952,,229546,15603943,3006048,PDP
HI129,,2008,1968,,1687257,182756486,34206205,,1339686,154543221,28838480,,347571,28213265,5367725,PDP
HI129,,2009,1968,,1716397,186347423,34874301,,1371777,158870942,29640629,,344620,27476481,5233672,PDP
HI129,,2010,1968,,1716397,186347423,34874301,,1428046,163079263,30445708,,288351,23268160,4428594,PDP
HI129,,2011,1968,,1657866,183584628,34324169,,1470121,167101939,31203563,,187745,16482689,3120607,PDP
HI129,,2012,1968,,1657866,183584628,34324169,,1494502,169187989,31599127,,163364,14396639,2725043,PDP
HI129,,2013,1968,,1583647,176143794,32925959,,1510984,170598645,31866615,,72663,5545149,1059344,PDP
HI129,,2014,1968,,1566237,174807897,32670844,,1521774,171470912,32032613,,44463,3336985,638233,PDP
HI129,,2015,1968,,1566237,174810886,32671376,,1524590,171675101,32071761,,41647,3135785,599616,PDP
HI129,,2016,1968,,1608099,177209319,33140007,,1542459,172847558,32298252,,65640,4361761,841753,PDP
HI129,,2017,1968,,1628551,179873509,33634514,,1563268,174850895,32675527,,65283,5022614,958986,PDP
HI129,,2017,1968,,1628551,179873509,33634514,,1563268,174850895,32675527,,65283,5022614,958986,PDP
HI129A,,1989,1986,,15279,23727839,4237314,,791,1228381,219364,,14488,22499458,4017950,PDN
HI129A,,1990,1986,,15279,23727839,4237314,,6223,6324212,1131528,,9056,17403627,3105786,PDN
HI129A,,1991,1986,,24300,22441391,4017430,,11216,11103901,1986999,,13084,11337490,2030431,PDN
HI129A,,1992,1986,,24300,22441391,4017430,,14928,15734291,2814624,,9372,6707100,1202806,PDN
HI129A,,1993,1986,,24300,22441391,4017430,,18061,17132331,3066518,,6239,5309060,950912,PDN
HI129A,,1994,1986,,37065,23056087,4139572,,22742,18485986,3312063,,14323,4570101,827509,PDN
HI129A,,1995,1986,,37065,23056087,4139572,,25002,19364004,3470554,,12063,3692083,669018,PDN
HI129A,,1996,1986,,37065,23056087,4139572,,26778,19882143,3564526,,10287,3173944,575046,PDN
HI129A,,1997,1986,,37065,23056087,4139572,,26960,19896303,3567227,,10105,3159784,572345,PDN
HI129A,,1998,1986,,37065,23056087,4139572,,26960,19913715,3570326,,10105,3142372,569246,PDN
HI129A,,1999,1986,,30819,21191304,3801514,,26960,19920115,3571464,,3859,1271189,230050,PDN
HI129A,,2000,1986,,30819,21191304,3801514,,26960,19931521,3573494,,3859,1259783,228020,PDN
HI129A,,2001,1986,,26960,19936757,3574426,,26960,19936757,3574426,,0,0,0,PDN
HI129A,,2002,1986,,26960,19936757,3574426,,26960,19936757,3574426,,0,0,0,PDN
HI129A,,2003,1986,,26960,19936757,3574426,,26960,19936757,3574426,,0,0,0,PDN
HI129A,,2004,1986,,26960,19936757,3574426,,26960,19936757,3574426,,0,0,0,PDN
HI129A,,2005,1986,,26960,19936757,3574426,,26960,19936757,3574426,,0,0,0,PDN
HI129A,,2006,1986,,26960,19936757,3574426,,26960,19936757,3574426,,0,0,0,PDN
HI129A,,2007,1986,,26960,19936757,3574426,,26960,19936757,3574426,,0,0,0,PDN
HI129A,,2008,1986,,26960,19936757,3574426,,26960,19936757,3574426,,0,0,0,PDN
HI129A,,2009,1986,,26960,20335525,3645381,,26960,20335525,3645381,,0,0,0,PDN
HI129A,,2010,1986,,26960,20335525,3645381,,26960,20335525,3645381,,0,0,0,PDN
HI129A,,2011,1986,,26960,20335525,3645381,,26960,20335525,3645381,,0,0,0,PDN
HI129A,,2012,1986,,26960,20335525,3645381,,26960,20335525,3645381,,0,0,0,PDN
HI129A,,2013,1986,,26960,20335525,3645381,,26960,20335525,3645381,,0,0,0,PDN
HI129A,,2014,1986,,26960,20335525,3645381,,26960,20335525,3645381,,0,0,0,PDN
HI129A,,2015,1986,,26960,20335525,3645381,,26960,20335525,3645381,,0,0,0,PDN
HI129A,,2016,1986,,26960,20335525,3645381,,26960,20335525,3645381,,0,0,0,PDN
HI129A,,2017,1986,,26960,20335525,3645381,,26960,20335525,3645381,,0,0,0,PDN
HI129A,,2017,1986,,26960,20335525,3645381,,26960,20335525,3645381,,0,0,0,PDN
HI131,,1998,1998,,11889,4296597,776408,,0,0,0,,11889,4296597,776408,PDN
HI131,,1999,1998,,12521,3763265,682141,,4268,1265337,229417,,8253,2497928,452724,PDN
HI131,,2000,1998,,15314,4357022,790585,,8819,2990104,540866,,6495,1366918,249719,PDN
HI131,,2001,1998,,10635,3214276,582570,,10635,3214276,582570,,0,0,0,PDN
HI131,,2002,1998,,10635,3214276,582570,,10635,3214276,582570,,0,0,0,PDN
HI131,,2003,1998,,10635,3214276,582570,,10635,3214276,582570,,0,0,0,PDN
HI131,,2004,1998,,10635,3214276,582570,,10635,3214276,582570,,0,0,0,PDN
HI131,,2005,1998,,436214,95357980,17403826,,10635,3214276,582570,,425579,92143704,16821256,PDN
HI131,,2006,1998,,436286,95376147,17407131,,30019,8003956,1454210,,406267,87372191,15952921,PDN
HI131,,2007,1998,,276566,63611739,11595381,,127939,28756290,5244717,,148627,34855449,6350664,PDN
HI131,,2008,1998,,276516,63601887,11593578,,160453,34551607,6308426,,116063,29050280,5285152,PDN
HI131,,2009,1998,,193256,39770483,7269855,,179793,37778343,6901919,,13463,1992140,367936,PDN
HI131,,2010,1998,,193256,39770483,7269855,,181943,38046293,6951747,,11313,1724190,318108,PDN
HI131,,2011,1998,,184633,38473331,7030422,,183128,38239641,6987335,,1505,233690,43086,PDN
HI131,,2012,1998,,184633,38473331,7030422,,183732,38321035,7002422,,901,152296,28000,PDN
HI131,,2013,1998,,184633,38473331,7030422,,184633,38473331,7030422,,0,0,0,PDN
HI131,,2014,1998,,184633,38473331,7030422,,184633,38473331,7030422,,0,0,0,PDN
HI131,,2015,1998,,184633,38473331,7030422,,184633,38473331,7030422,,0,0,0,PDN
HI131,,2016,1998,,184633,38473331,7030422,,184633,38473331,7030422,,0,0,0,PDN
HI131,,2017,1998,,184633,38473331,7030422,,184633,38473331,7030422,,0,0,0,PDN
HI131,,2017,1998,,184633,38473331,7030422,,184633,38473331,7030422,,0,0,0,PDN
HI133,,1999,1999,,166305,53444130,9675937,,20733,5577131,1013105,,145572,47866999,8662832,PDN
HI133,,2000,1999,,947649,58107304,11287027,,34215,9911110,1797758,,913434,48196194,9489269,PDN
HI133,,2001,1999,,254811,20358744,3877363,,163209,16507423,3100473,,91602,3851321,776890,PDN
HI133,,2002,1999,,236909,20095225,3812572,,219653,18360146,3486583,,17256,1735079,325989,PDN
HI133,,2003,1999,,252448,35754969,6614542,,234168,20566271,3893647,,18280,15188698,2720895,PDN
HI133,,2004,1999,,251453,29426065,5487408,,242600,28438100,5302760,,8853,987965,184648,PDN
HI133,,2005,1999,,246220,28891836,5387116,,245464,28586827,5332088,,756,305009,55028,PDN
HI133,,2006,1999,,246220,28891836,5387116,,245464,28795081,5369144,,756,96755,17972,PDN
HI133,,2007,1999,,254084,33345574,6187460,,247583,29022847,5411791,,6501,4322727,775669,PDN
HI133,,2008,1999,,254084,33355133,6189161,,249859,30543734,5684687,,4225,2811399,504474,PDN
HI133,,2009,1999,,255531,35670309,6602560,,252626,31428929,5844961,,2905,4241380,757599,PDN
HI133,,2010,1999,,255531,35670309,6602560,,252631,32106492,5965529,,2900,3563817,637031,PDN
HI133,,2011,1999,,253795,33693842,6249140,,253409,33160778,6153902,,386,533064,95237,PDN
HI133,,2012,1999,,253795,33693842,6249140,,253795,33693559,6249089,,0,283,50,PDN
HI133,,2013,1999,,253795,33693842,6249140,,253795,33693842,6249140,,0,0,0,PDN
HI133,,2014,1999,,253795,33693842,6249140,,253795,33693842,6249140,,0,0,0,PDN
HI133,,2015,1999,,253795,33693842,6249140,,253795,33693842,6249140,,0,0,0,PDN
HI133,,2016,1999,,253795,33693842,6249140,,253795,33693842,6249140,,0,0,0,PDN
HI133,,2017,1999,,253795,33693842,6249140,,253795,33693842,6249140,,0,0,0,PDN
HI133,,2017,1999,,253795,33693842,6249140,,253795,33693842,6249140,,0,0,0,PDN
HI140,,1975,1958,,699732,142957000,26136921,,546668,87641089,16141168,,153064,55315911,9995753,PDN
HI140,,1976,1958,,699732,142957000,26136921,,586512,98426005,18100036,,113220,44530995,8036885,PDN
HI140,,1977,1958,,812428,171169000,31269545,,623764,108578316,19943749,,188664,62590684,11325796,PDN
HI140,,1978,1958,,844047,178805000,32659883,,638430,112884273,20724600,,205617,65920727,11935283,PDN
HI140,,1979,1958,,851020,180147000,32905646,,650833,117774028,21607066,,200187,62372972,11298580,PDN
HI140,,1980,1958,,943906,203147000,37091059,,694976,128044474,23478690,,248930,75102526,13612369,PDN
HI140,,1981,1958,,1190928,245042100,44792725,,792405,144346290,26476798,,398523,100695810,18315927,PDN
HI140,,1982,1958,,1427080,294241000,53783130,,884714,162042419,29717885,,542366,132198581,24065245,PDN
HI140,,1983,1958,,1280575,262485643,47986205,,953914,175759536,32227853,,326661,86726107,15758352,PDN
HI140,,1984,1958,,1365430,277881973,50810621,,1014506,184663349,33872753,,350924,93218624,16937868,PDN
HI140,,1985,1958,,1329594,254051968,46534571,,1033280,186989946,34305512,,296314,67062022,12229059,PDN
HI140,,1986,1958,,1333790,254861991,46682899,,1082609,195796394,35921825,,251181,59065597,10761074,PDN
HI140,,1987,1958,,1585302,243320966,44880848,,1144886,206566666,37900521,,440416,36754300,6980327,PDN
HI140,,1988,1958,,1650764,259413322,47809718,,1227524,217404135,39911534,,423240,42009187,7898184,PDN
HI140,,1989,1958,,1647848,266482777,49064712,,1332785,225908262,41529985,,315063,40574515,7534727,PDN
HI140,,1990,1958,,1579431,246293207,45403845,,1386696,229409538,42206898,,192735,16883669,3196947,PDN
HI140,,1991,1958,,1680426,246827404,45599893,,1465500,233661249,43042235,,214926,13166155,2557658,PDN
HI140,,1992,1958,,1680993,247614353,45740486,,1537271,237587481,43812623,,143722,10026872,1927863,PDN
HI140,,1993,1958,,1720571,255074301,47107457,,1629701,241398552,44583180,,90870,13675749,2524277,PDN
HI140,,1994,1958,,2481032,294137735,54818707,,1913567,260285400,48227695,,567465,33852335,6591012,PDN
HI140,,1995,1958,,2574335,323928394,60212839,,1986481,277287402,51325876,,587854,46640992,8886963,PDN
HI140,,1996,1958,,3892783,335680206,63622357,,2142153,286649193,53147347,,1750630,49031013,10475010,PDN
HI140,,1997,1958,,3892593,335655819,63617828,,2377874,296103391,55065310,,1514719,39552428,8552518,PDN
HI140,,1998,1958,,4137509,330067729,62868422,,2556828,297806292,55547271,,1580681,32261437,7321151,PDN
HI140,,1999,1958,,3699177,312589810,59320140,,2804642,299415692,56081456,,894535,13174118,3238684,PDN
HI140,,2000,1958,,3716902,314788573,59729104,,2966155,301841530,56674612,,750747,12947043,3054492,PDN
HI140,,2001,1958,,3526580,320172452,60496767,,3055074,304057692,57157866,,471506,16114760,3338901,PDN
HI140,,2002,1958,,3396649,316709051,59750573,,3145369,307247236,57815696,,251280,9461815,1934877,PDN
HI140,,2003,1958,,3379898,321263080,60544147,,3093570,307754176,57854100,,286328,13508904,2690047,PDN
HI140,,2004,1958,,3259936,322926871,60720233,,3118221,311146800,58482420,,141715,11780071,2237813,PDN
HI140,,2005,1958,,3152342,316049572,59388921,,3122450,312321032,58695587,,29892,3728540,693334,PDN
HI140,,2006,1958,,3326379,323549926,60897540,,3123699,312475107,58724252,,202680,11074819,2173288,PDN
HI140,,2007,1958,,3317398,322044255,60620646,,3130751,313684931,58946575,,186647,8359324,1674071,PDN
HI140,,2008,1958,,3509924,336536581,63391878,,3325147,318399652,59979889,,184777,18136929,3411989,PDN
HI140,,2009,1958,,3441196,343897961,64633001,,3364583,327711247,61676190,,76613,16186714,2956811,PDN
HI140,,2010,1958,,3441196,343897961,64633001,,3373831,329820791,62060801,,67365,14077170,2572200,PDN
HI140,,2011,1958,,3452641,345465228,64923319,,3390853,333002688,62643997,,61788,12462540,2279322,PDN
HI140,,2012,1958,,3452641,345465228,64923319,,3395053,333796110,62789376,,57588,11669118,2133943,PDN
HI140,,2013,1958,,3452641,345465228,64923319,,3399326,334408621,62902637,,53315,11056607,2020683,PDN
HI140,,2014,1958,,3400208,334616810,62940563,,3400208,334616810,62940563,,0,0,0,PDN
HI140,,2015,1958,,3400208,334616810,62940563,,3400208,334616810,62940563,,0,0,0,PDN
HI140,,2016,1958,,3400208,334616810,62940563,,3400208,334616810,62940563,,0,0,0,PDN
HI140,,2017,1958,,3400208,334616810,62940563,,3400208,334616810,62940563,,0,0,0,PDN
HI140,,2017,1958,,3400208,334616810,62940563,,3400208,334616810,62940563,,0,0,0,PDN
HI153A,,1999,1999,,249,2487911,442938,,0,0,0,,249,2487911,442938,PDN
HI153A,,2000,1999,,249,2487537,442871,,0,0,0,,249,2487537,442871,PDN
HI153A,,2001,1999,,249,2487348,442838,,0,72767,12948,,249,2414581,429890,PDN
HI153A,,2002,1999,,41,2689088,478526,,0,1505951,267963,,41,1183137,210563,PDN
HI153A,,2003,1999,,41,2893490,514897,,0,2132246,379403,,41,761244,135494,PDN
HI153A,,2004,1999,,0,2485612,442280,,0,2299702,409200,,0,185910,33080,PDN
HI153A,,2005,1999,,0,2326126,413901,,0,2326126,413901,,0,0,0,PDN
HI153A,,2006,1999,,0,2326126,413901,,0,2326126,413901,,0,0,0,PDN
HI153A,,2007,1999,,0,2326126,413901,,0,2326126,413901,,0,0,0,PDN
HI153A,,2008,1999,,0,2333342,415185,,0,2333342,415185,,0,0,0,PDN
HI153A,,2009,1999,,0,2333342,415185,,0,2333342,415185,,0,0,0,PDN
HI153A,,2010,1999,,0,2333342,415185,,0,2333342,415185,,0,0,0,PDN
HI153A,,2011,1999,,0,2333342,415185,,0,2333342,415185,,0,0,0,PDN
HI153A,,2012,1999,,0,2333342,415185,,0,2333342,415185,,0,0,0,PDN
HI153A,,2013,1999,,0,2333342,415185,,0,2333342,415185,,0,0,0,PDN
HI153A,,2014,1999,,0,2333342,415185,,0,2333342,415185,,0,0,0,PDN
HI153A,,2015,1999,,0,2333342,415185,,0,2333342,415185,,0,0,0,PDN
HI153A,,2016,1999,,0,2333342,415185,,0,2333342,415185,,0,0,0,PDN
HI153A,,2017,1999,,0,2333342,415185,,0,2333342,415185,,0,0,0,PDN
HI153A,,2017,1999,,0,2333342,415185,,0,2333342,415185,,0,0,0,PDN
HI154,,1975,1974,,0,101400100,18042722,,0,0,0,,0,101400100,18042722,PDN
HI154,,1976,1974,,0,101400100,18042722,,0,0,0,,0,101400100,18042722,PDN
HI154,,1977,1974,,0,101400100,18042722,,0,0,0,,0,101400100,18042722,PDN
HI154,,1978,1974,,5089397,106939110,24117708,,55883,4766257,903971,,5033514,102172853,23213737,PDN
HI154,,1979,1974,,5169397,106939110,24197708,,832094,22940412,4914018,,4337303,83998698,19283690,PDN
HI154,,1980,1974,,5169397,106939110,24197708,,1112458,30258599,6496550,,4056939,76680511,17701158,PDN
HI154,,1981,1974,,5212626,110586100,24889868,,1424912,38443903,8265464,,3787714,72142197,16624404,PDN
HI154,,1982,1974,,5212626,110586100,24889868,,1656776,44114902,9506403,,3555850,66471198,15383465,PDN
HI154,,1983,1974,,5125828,106661239,24104696,,1777199,47124413,10162326,,3348629,59536826,13942370,PDN
HI154,,1984,1974,,5126885,107391198,24235639,,1879097,50083639,10790777,,3247788,57307559,13444862,PDN
HI154,,1985,1974,,2203318,62122658,13257172,,1943929,51511824,11109734,,259389,10610834,2147438,PDN
HI154,,1986,1974,,2203318,62122658,13257172,,2070275,53951306,11670152,,133043,8171352,1587020,PDN
HI154,,1987,1974,,2904188,75325332,16307272,,2365919,60639286,13155828,,538269,14686046,3151444,PDN
HI154,,1988,1974,,2945181,80226897,17220430,,2479587,64339009,13927809,,465594,15887888,3292621,PDN
HI154,,1989,1974,,7245556,154101920,34665826,,2697163,71048054,15339165,,4548393,83053866,19326661,PDN
HI154,,1990,1974,,6193646,186194634,39324364,,3219734,99337389,20895426,,2973912,86857245,18428938,PDN
HI154,,1991,1974,,5769729,156525610,33621261,,3374738,105778825,22196593,,2394991,50746785,11424668,PDN
HI154,,1992,1974,,4240732,127679631,26959528,,3493027,108743569,22842417,,747705,18936062,4117111,PDN
HI154,,1993,1974,,3977154,121117400,25528293,,3557688,109832224,23100788,,419466,11285176,2427505,PDN
HI154,,1994,1974,,3818352,114856004,24255363,,3628728,110554959,23300429,,189624,4301045,954934,PDN
HI154,,1995,1974,,3931268,115409399,24466748,,3678919,111708263,23555834,,252349,3701136,910914,PDN
HI154,,1996,1974,,4260454,115149373,24749666,,3895651,112292700,23876558,,364803,2856673,873108,PDN
HI154,,1997,1974,,4307862,115149373,24797074,,4061783,112529786,24084877,,246079,2619587,712197,PDN
HI154,,1998,1974,,4795531,128397167,27642002,,4223438,116770660,25001136,,572093,11626507,2640866,PDN
HI154,,1999,1974,,6577744,146680393,32677458,,4318879,118440806,25393756,,2258865,28239587,7283702,PDN
HI154,,2000,1974,,6889567,162777430,35853523,,4674062,121034094,26210378,,2215505,41743336,9643145,PDN
HI154,,2001,1974,,6829574,157498518,34854221,,5166033,128107399,27960944,,1663541,29391119,6893277,PDN
HI154,,2002,1974,,6694655,165622659,36164879,,5537835,138586299,30197319,,1156820,27036360,5967560,PDN
HI154,,2003,1974,,6899454,165921356,36422827,,5727487,142320886,31051488,,1171967,23600470,5371339,PDN
HI154,,2004,1974,,6907803,165966177,36439152,,5860319,143752995,31439144,,1047484,22213182,5000008,PDN
HI154,,2005,1974,,6907803,165966177,36439152,,5958749,144629850,31693598,,949054,21336327,4745554,PDN
HI154,,2006,1974,,6964207,168080328,36871739,,6041579,145800188,31984673,,922628,22280140,4887066,PDN
HI154,,2007,1974,,6286412,149961620,32969974,,6120529,147943359,32444970,,165883,2018261,525004,PDN
HI154,,2008,1974,,6526748,152209609,33610308,,6182582,148829342,32664671,,344166,3380267,945637,PDN
HI154,,2009,1974,,6515630,152953421,33731541,,6237438,151909941,33267677,,278192,1043480,463865,PDN
HI154,,2010,1974,,6515630,152954250,33731688,,6322090,152505054,33458220,,193540,449196,273468,PDN
HI154,,2011,1974,,6515630,152954250,33731688,,6393094,152864868,33593247,,122536,89382,138440,PDN
HI154,,2012,1974,,6515630,152954250,33731688,,6416369,152885248,33620149,,99261,69002,111539,PDN
HI154,,2013,1974,,6515630,152954250,33731688,,6416369,152885248,33620149,,99261,69002,111539,PDN
HI154,,2014,1974,,6515630,152954250,33731688,,6472020,152915284,33681144,,43610,38966,50543,PDN
HI154,,2015,1974,,6652333,153015945,33879368,,6536121,152951093,33751617,,116212,64852,127752,PDN
HI154,,2016,1974,,6551008,152969008,33769692,,6551008,152969008,33769692,,0,0,0,PDN
HI154,,2017,1974,,6551008,152969467,33769773,,6551008,152969467,33769773,,0,0,0,PDN
HI154,,2017,1974,,6551008,152969467,33769773,,6551008,152969467,33769773,,0,0,0,PDN
HI160,,1975,1961,,1470857,417118560,75691241,,966446,287838433,52183249,,504411,129280127,23507992,PDN
HI160,,1976,1961,,1470857,417118560,75691241,,994014,298473712,54103215,,476843,118644848,21588026,PDN
HI160,,1977,1961,,1566460,450290062,81689247,,1028928,312316418,56601244,,537532,137973644,25088003,PDN
HI160,,1978,1961,,1577017,454502960,82449430,,1044584,321237329,58204251,,532433,133265631,24245179,PDN
HI160,,1979,1961,,1592421,464172474,84185388,,1175108,352320147,63865526,,417313,111852327,20319862,PDN
HI160,,1980,1961,,1509846,438513074,79537083,,1188298,357338020,64771576,,321548,81175054,14765507,PDN
HI160,,1981,1961,,1337841,396106920,71819499,,1200750,362717596,65741248,,137091,33389324,6078251,PDN
HI160,,1982,1961,,1350721,405831462,73562725,,1216656,368318217,66753705,,134065,37513245,6809020,PDN
HI160,,1983,1961,,1398272,422301471,76540882,,1222425,371910447,67398661,,175847,50391024,9142221,PDN
HI160,,1984,1961,,1399165,422301471,76541775,,1225051,374724165,67901949,,174114,47577306,8639826,PDN
HI160,,1985,1961,,1423481,427651744,77518097,,1231069,377233700,68354503,,192412,50418044,9163594,PDN
HI160,,1986,1961,,1492895,445971686,80847288,,1262054,385616443,69877079,,230841,60355243,10970209,PDN
HI160,,1987,1961,,1558150,464364114,84185217,,1296323,395100393,71598884,,261827,69263721,12586333,PDN
HI160,,1988,1961,,1669575,473021179,85837045,,1331581,406372338,73639826,,337994,66648841,12197219,PDN
HI160,,1989,1961,,1493297,471190488,85335021,,1369548,422196794,76493533,,123749,48993694,8841488,PDN
HI160,,1990,1961,,1506440,479971980,86910707,,1410762,437629326,79280749,,95678,42342654,7629958,PDN
HI160,,1991,1961,,1567858,496788330,89964358,,1441019,451074048,81703305,,126839,45714282,8261053,PDN
HI160,,1992,1961,,1583435,497203542,90053816,,1464568,460771831,83452438,,118867,36431711,6601378,PDN
HI160,,1993,1961,,1601644,503485461,91189804,,1481211,467075505,84590731,,120433,36409956,6599073,PDN
HI160,,1994,1961,,1601635,503482666,91189298,,1491721,472111304,85497291,,109914,31371362,5692007,PDN
HI160,,1995,1961,,1594179,529275538,95771321,,1501371,475695709,86144736,,92808,53579829,9626585,PDN
HI160,,1996,1961,,2296380,550827266,100308349,,1562571,496329671,89877459,,733809,54497595,10430890,PDN
HI160,,1997,1961,,2311457,556329630,101302494,,1627275,509349738,92258901,,684182,46979892,9043593,PDN
HI160,,1998,1961,,2288404,554944057,101032898,,1636817,514892569,93254712,,651587,40051488,7778186,PDN
HI160,,1999,1961,,1678980,530696633,96108986,,1644866,519512355,94084787,,34114,11184278,2024199,PDN
HI160,,2000,1961,,1688775,539373636,97662732,,1650790,524784400,95028797,,37985,14589236,2633935,PDN
HI160,,2001,1961,,1691784,537884787,97400821,,1665119,529870064,95948049,,26665,8014723,1452772,PDN
HI160,,2002,1961,,1692386,539481204,97685483,,1670794,531809272,96298778,,21592,7671932,1386705,PDN
HI160,,2003,1961,,1696871,541006447,97961364,,1673488,533198216,96548615,,23383,7808231,1412749,PDN
HI160,,2004,1961,,1701702,542559668,98242569,,1677675,535369180,96939095,,24027,7190488,1303474,PDN
HI160,,2005,1961,,1694467,542372693,98202064,,1681754,537283078,97283725,,12713,5089615,918339,PDN
HI160,,2006,1961,,1689715,542213602,98169004,,1683346,538908981,97574624,,6369,3304621,594380,PDN
HI160,,2007,1961,,1687208,542442729,98207267,,1685067,539851217,97744002,,2141,2591512,463265,PDN
HI160,,2008,1961,,1687208,544371056,98550385,,1685067,540427619,97846565,,2141,3943437,703820,PDN
HI160,,2009,1961,,1687619,554605768,100371918,,1685066,551178629,99759552,,2553,3427139,612364,PDN
HI160,,2010,1961,,1687619,554605768,100371918,,1685066,551576755,99830392,,2553,3029013,541523,PDN
HI160,,2011,1961,,1687619,554445168,100343342,,1685410,551881120,99884895,,2209,2564048,458445,PDN
HI160,,2012,1961,,1687619,554601942,100371238,,1685615,552224627,99946222,,2004,2377315,425014,PDN
HI160,,2013,1961,,1687619,554601942,100371238,,1685888,552452138,99986975,,1731,2149804,384259,PDN
HI160,,2014,1961,,1687619,554419571,100338787,,1685938,552519192,99998958,,1681,1900379,339828,PDN
HI160,,2015,1961,,1685938,552519192,99998958,,1685938,552519192,99998958,,0,0,0,PDN
HI160,,2016,1961,,1685938,552519192,99998958,,1685938,552519192,99998958,,0,0,0,PDN
HI160,,2017,1961,,1685938,552518604,99998854,,1685938,552518604,99998854,,0,0,0,PDN
HI160,,2017,1961,,1685938,552518604,99998854,,1685938,552518604,99998854,,0,0,0,PDN
HI163,,1985,1983,,173902,4469279,969147,,0,0,0,,173902,4469279,969147,PDN
HI163,,2004,1983,,171349,8670937,1714220,,0,0,0,,171349,8670937,1714220,PDN
HI163,,2005,1983,,171349,8670937,1714221,,0,0,0,,171349,8670937,1714221,PDN
HI163,,2006,1983,,171349,8670937,1714221,,30525,1753406,342519,,140824,6917531,1371702,PDN
HI163,,2007,1983,,87454,4425535,874916,,64995,3974623,772223,,22459,450912,102693,PDN
HI163,,2008,1983,,184958,13553758,2596659,,100291,6124672,1190090,,84667,7429086,1406569,PDN
HI163,,2009,1983,,188675,13826134,2648841,,126863,8537420,1645977,,61812,5288714,1002864,PDN
HI163,,2010,1983,,188675,13826134,2648841,,128384,8840430,1701414,,60291,4985704,947427,PDN
HI163,,2011,1983,,188675,13826134,2648841,,129718,9008104,1732583,,58957,4818030,916258,PDN
HI163,,2012,1983,,188675,13826134,2648841,,132555,9559738,1833576,,56120,4266396,815265,PDN
HI163,,2013,1983,,137961,11388643,2164410,,134129,9840603,1885126,,3832,1548040,279284,PDN
HI163,,2014,1983,,134670,10130977,1937335,,134670,10130977,1937335,,0,0,0,PDN
HI163,,2015,1983,,134670,10130977,1937335,,134670,10130977,1937335,,0,0,0,PDN
HI163,,2016,1983,,134670,10130977,1937335,,134670,10130977,1937335,,0,0,0,PDN
HI163,,2017,1983,,134670,10130977,1937335,,134670,10130977,1937335,,0,0,0,PDN
HI163,,2017,1983,,134670,10130977,1937335,,134670,10130977,1937335,,0,0,0,PDN
HI164,,1989,1988,,29717,22219696,3983400,,345,270379,48455,,29372,21949317,3934945,PDN
HI164,,1990,1988,,29717,22219696,3983400,,6210,1323542,241716,,23507,20896154,3741684,PDN
HI164,,1991,1988,,29717,22219696,3983400,,11119,2365793,432079,,18598,19853903,3551321,PDN
HI164,,1992,1988,,34789,7406569,1352684,,11396,2426182,443101,,23393,4980387,909583,PDN
HI164,,1993,1988,,11792,2749309,500993,,11483,2497139,455814,,309,252170,45179,PDN
HI164,,1994,1988,,34162,6268065,1149476,,16420,3717629,677920,,17742,2550436,471556,PDN
HI164,,1995,1988,,33879,6220927,1140806,,16601,4137736,752853,,17278,2083191,387953,PDN
HI164,,1996,1988,,16601,4137771,752859,,16601,4137771,752859,,0,0,0,PDN
HI164,,1997,1988,,16601,4137771,752859,,16601,4137771,752859,,0,0,0,PDN
HI164,,1998,1988,,16601,4137771,752859,,16601,4137771,752859,,0,0,0,PDN
HI164,,1999,1988,,16601,4137771,752859,,16601,4137771,752859,,0,0,0,PDN
HI164,,2000,1988,,16601,4137771,752859,,16601,4137771,752859,,0,0,0,PDN
HI164,,2001,1988,,16601,4137771,752859,,16601,4137771,752859,,0,0,0,PDN
HI164,,2002,1988,,16601,4137771,752859,,16601,4137771,752859,,0,0,0,PDN
HI164,,2003,1988,,16601,4137771,752859,,16601,4137771,752859,,0,0,0,PDN
HI164,,2004,1988,,16601,4137771,752859,,16601,4137771,752859,,0,0,0,PDN
HI164,,2005,1988,,16601,4137771,752859,,16601,4137771,752859,,0,0,0,PDN
HI164,,2006,1988,,16601,4137771,752859,,16601,4137771,752859,,0,0,0,PDN
HI164,,2007,1988,,16601,4137771,752859,,16601,4137771,752859,,0,0,0,PDN
HI164,,2008,1988,,16601,4137771,752859,,16601,4137771,752859,,0,0,0,PDN
HI164,,2009,1988,,16601,4220642,767605,,16601,4220642,767605,,0,0,0,PDN
HI164,,2010,1988,,16601,4220642,767605,,16601,4220642,767605,,0,0,0,PDN
HI164,,2011,1988,,16601,4220642,767605,,16601,4220642,767605,,0,0,0,PDN
HI164,,2012,1988,,16601,4220642,767605,,16601,4220642,767605,,0,0,0,PDN
HI164,,2013,1988,,16601,4220642,767605,,16601,4220642,767605,,0,0,0,PDN
HI164,,2014,1988,,16601,4220642,767605,,16601,4220642,767605,,0,0,0,PDN
HI164,,2015,1988,,16601,4220642,767605,,16601,4220642,767605,,0,0,0,PDN
HI164,,2016,1988,,16601,4220642,767605,,16601,4220642,767605,,0,0,0,PDN
HI164,,2017,1988,,16601,4220642,767605,,16601,4220642,767605,,0,0,0,PDN
HI164,,2017,1988,,16601,4220642,767605,,16601,4220642,767605,,0,0,0,PDN
HI166,,1986,1984,,255463,33540923,6223599,,0,0,0,,255463,33540923,6223599,PDN
HI166,,1987,1984,,255463,33540923,6223599,,0,0,0,,255463,33540923,6223599,PDN
HI166,,1988,1984,,255463,33540923,6223599,,0,0,0,,255463,33540923,6223599,PDN
HI166,,1989,1984,,308853,40247705,7470366,,29937,3622860,674574,,278916,36624845,6795792,PDN
HI166,,1990,1984,,308853,40247705,7470366,,70629,9154471,1699538,,238224,31093234,5770828,PDN
HI166,,1991,1984,,205091,24643660,4590084,,114571,14294479,2658073,,90520,10349181,1932011,PDN
HI166,,1992,1984,,190085,25224980,4678516,,142599,18722644,3474030,,47486,6502336,1204486,PDN
HI166,,1993,1984,,207217,27715021,5138715,,163060,21472555,3983799,,44157,6242466,1154916,PDN
HI166,,1994,1984,,207217,27715021,5138715,,177948,23456073,4351626,,29269,4258948,787089,PDN
HI166,,1995,1984,,194220,25493367,4730406,,181501,24130732,4475226,,12719,1362635,255180,PDN
HI166,,1996,1984,,251083,34751526,6434629,,187048,25229559,4676293,,64035,9521967,1758336,PDN
HI166,,1997,1984,,251083,34751526,6434629,,202370,27641194,5120732,,48713,7110332,1313897,PDN
HI166,,1998,1984,,251083,34751526,6434629,,213457,29564150,5473982,,37626,5187376,960647,PDN
HI166,,1999,1984,,289234,40031978,7412362,,221255,30972584,5732391,,67979,9059394,1679971,PDN
HI166,,2000,1984,,289192,40025980,7411253,,223235,31389591,5808571,,65957,8636389,1602682,PDN
HI166,,2001,1984,,364539,50833586,9409661,,228771,31972800,5917881,,135768,18860786,3491780,PDN
HI166,,2002,1984,,369662,49446786,9168023,,265704,35607824,6601616,,103958,13838962,2566407,PDN
HI166,,2003,1984,,369662,49446786,9168023,,285565,36481777,6776984,,84097,12965009,2391039,PDN
HI166,,2004,1984,,378808,44915714,8370928,,306924,37393592,6960588,,71884,7522122,1410340,PDN
HI166,,2005,1984,,362783,44639793,8305806,,318310,38020126,7083457,,44473,6619667,1222349,PDN
HI166,,2006,1984,,362783,44639793,8305806,,322405,38348681,7146014,,40378,6291112,1159792,PDN
HI166,,2007,1984,,322614,38407702,7156725,,322614,38407702,7156725,,0,0,0,PDN
HI166,,2008,1984,,322614,38407702,7156725,,322614,38407702,7156725,,0,0,0,PDN
HI166,,2009,1984,,322614,38988329,7260039,,322614,38988329,7260039,,0,0,0,PDN
HI166,,2010,1984,,322614,38988329,7260039,,322614,38988329,7260039,,0,0,0,PDN
HI166,,2011,1984,,322614,38988329,7260039,,322614,38988329,7260039,,0,0,0,PDN
HI166,,2012,1984,,336210,42359908,7873560,,322614,39003920,7262813,,13596,3355988,610747,PDN
HI166,,2013,1984,,326482,39947530,7434583,,326482,39947530,7434583,,0,0,0,PDN
HI166,,2014,1984,,326482,39947530,7434583,,326482,39947530,7434583,,0,0,0,PDN
HI166,,2015,1984,,326482,39947530,7434583,,326482,39947530,7434583,,0,0,0,PDN
HI166,,2016,1984,,326482,39947530,7434583,,326482,39947530,7434583,,0,0,0,PDN
HI166,,2017,1984,,326482,39947530,7434583,,326482,39947530,7434583,,0,0,0,PDN
HI166,,2017,1984,,326482,39947530,7434583,,326482,39947530,7434583,,0,0,0,PDN
HI167,,1988,1987,,613471,40268275,7778644,,0,0,0,,613471,40268275,7778644,PDN
HI167,,1989,1987,,613471,40268275,7778644,,58130,6423652,1201129,,555341,33844623,6577515,PDN
HI167,,1990,1987,,613471,40268275,7778644,,94617,10685383,1995931,,518854,29582892,5782713,PDN
HI167,,1991,1987,,613471,40268275,7778644,,127736,16229834,3015607,,485735,24038441,4763037,PDN
HI167,,1992,1987,,613471,40268275,7778644,,163199,24293058,4485807,,450272,15975217,3292837,PDN
HI167,,1993,1987,,224981,37935737,6975112,,179194,28040439,5168596,,45787,9895298,1806516,PDN
HI167,,1994,1987,,224981,37935737,6975112,,192670,31079322,5722798,,32311,6856415,1252314,PDN
HI167,,1995,1987,,224062,37780638,6946595,,198505,33011951,6072518,,25557,4768687,874077,PDN
HI167,,1996,1987,,318382,49111348,9057056,,204346,34103480,6272581,,114036,15007868,2784475,PDN
HI167,,1997,1987,,318382,49111348,9057056,,214692,35641611,6556616,,103690,13469737,2500440,PDN
HI167,,1998,1987,,215883,36201201,6657378,,215791,36180641,6653627,,92,20560,3751,PDN
HI167,,1999,1987,,215883,36201201,6657378,,215883,36201201,6657378,,0,0,0,PDN
HI167,,2000,1987,,215883,36201201,6657378,,215883,36201201,6657378,,0,0,0,PDN
HI167,,2001,1987,,228290,37657969,6928996,,215883,36201201,6657378,,12407,1456768,271618,PDN
HI167,,2002,1987,,228290,37657969,6928996,,228290,37657969,6928996,,0,0,0,PDN
HI167,,2003,1987,,228290,37657969,6928996,,228290,37657969,6928996,,0,0,0,PDN
HI167,,2004,1987,,228290,37657969,6928996,,228290,37657969,6928996,,0,0,0,PDN
HI167,,2005,1987,,228290,37657970,6928996,,228290,37657970,6928996,,0,0,0,PDN
HI167,,2006,1987,,228290,37657970,6928996,,228290,37657970,6928996,,0,0,0,PDN
HI167,,2007,1987,,228290,37657970,6928996,,228290,37657970,6928996,,0,0,0,PDN
HI167,,2008,1987,,228290,37657970,6928996,,228290,37657970,6928996,,0,0,0,PDN
HI167,,2009,1987,,228290,38379237,7057337,,228290,38379237,7057337,,0,0,0,PDN
HI167,,2010,1987,,228290,38379237,7057337,,228290,38379237,7057337,,0,0,0,PDN
HI167,,2011,1987,,228290,38379237,7057337,,228290,38379237,7057337,,0,0,0,PDN
HI167,,2012,1987,,228290,38379237,7057337,,228290,38379237,7057337,,0,0,0,PDN
HI167,,2013,1987,,228290,38379237,7057337,,228290,38379237,7057337,,0,0,0,PDN
HI167,,2014,1987,,228290,38379237,7057337,,228290,38379237,7057337,,0,0,0,PDN
HI167,,2015,1987,,228290,38379237,7057337,,228290,38379237,7057337,,0,0,0,PDN
HI167,,2016,1987,,228290,38379237,7057337,,228290,38379237,7057337,,0,0,0,PDN
HI167,,2017,1987,,228290,38379237,7057337,,228290,38379237,7057337,,0,0,0,PDN
HI167,,2017,1987,,228290,38379237,7057337,,228290,38379237,7057337,,0,0,0,PDN
HI169,,1998,1998,,69663,15650772,2854498,,2963,619780,113244,,66700,15030992,2741254,PDN
HI169,,1999,1998,,111338,20056248,3680065,,31285,7059302,1287389,,80053,12996946,2392676,PDN
HI169,,2000,1998,,111338,20056248,3680065,,64878,12212768,2237968,,46460,7843480,1442097,PDN
HI169,,2001,1998,,119709,21141864,3881607,,67846,12522543,2296056,,51863,8619321,1585551,PDN
HI169,,2002,1998,,121452,22389381,4105328,,70401,13256832,2429268,,51051,9132549,1676060,PDN
HI169,,2003,1998,,121452,22389381,4105328,,85834,15762137,2890485,,35618,6627244,1214843,PDN
HI169,,2004,1998,,127885,23644640,4335116,,101479,18948156,3473037,,26406,4696484,862079,PDN
HI169,,2005,1998,,131965,25225302,4620453,,101991,19298830,3535947,,29974,5926472,1084506,PDN
HI169,,2006,1998,,131965,25225302,4620453,,112841,21288634,3900854,,19124,3936668,719599,PDN
HI169,,2007,1998,,131456,24043087,4409585,,128926,23522136,4314359,,2530,520951,95226,PDN
HI169,,2008,1998,,136408,24235412,4448759,,130668,23880485,4379865,,5740,354927,68894,PDN
HI169,,2009,1998,,136408,24235412,4448759,,136408,24235412,4448759,,0,0,0,PDN
HI169,,2010,1998,,136408,24235412,4448759,,136408,24235412,4448759,,0,0,0,PDN
HI169,,2011,1998,,136408,24235412,4448759,,136408,24235412,4448759,,0,0,0,PDN
HI169,,2012,1998,,136408,24235412,4448759,,136408,24235412,4448759,,0,0,0,PDN
HI169,,2013,1998,,136408,24235412,4448759,,136408,24235412,4448759,,0,0,0,PDN
HI169,,2014,1998,,136408,24235412,4448759,,136408,24235412,4448759,,0,0,0,PDN
HI169,,2015,1998,,136408,24235412,4448759,,136408,24235412,4448759,,0,0,0,PDN
HI169,,2016,1998,,136408,24235412,4448759,,136408,24235412,4448759,,0,0,0,PDN
HI169,,2017,1998,,136408,24235412,4448759,,136408,24235412,4448759,,0,0,0,PDN
HI169,,2017,1998,,136408,24235412,4448759,,136408,24235412,4448759,,0,0,0,PDN
HI170,,2004,2003,,793140,91243985,17028725,,48350,5376222,1004973,,744790,85867763,16023752,PDP
HI170,,2005,2003,,804555,93355858,17415918,,218266,24275027,4537666,,586289,69080831,12878252,PDP
HI170,,2006,2003,,733201,82742912,15456139,,385096,44081688,8228813,,348105,38661224,7227326,PDP
HI170,,2007,2003,,760582,84245133,15750819,,435764,48533844,9071679,,324818,35711289,6679140,PDP
HI170,,2008,2003,,2046519,164197954,31263237,,474130,51127400,9571532,,1572389,113070554,21691705,PDP
HI170,,2009,2003,,1638901,127304454,24290940,,703669,65190105,12303332,,935232,62114349,11987608,PDP
HI170,,2010,2003,,1405556,121042699,22943403,,881428,76324603,14462318,,524128,44718096,8481084,PDP
HI170,,2011,2003,,1404879,120148623,22783637,,989614,83462002,15840505,,415265,36686621,6943133,PDP
HI170,,2012,2003,,1404879,120148623,22783637,,1027169,86658926,16446907,,377710,33489697,6336731,PDP
HI170,,2013,2003,,1404879,120148623,22783637,,1038514,87636634,16632221,,366365,32511989,6151416,PDP
HI170,,2014,2003,,1079209,90558889,17192890,,1045402,88144012,16729390,,33807,2414877,463500,PDP
HI170,,2015,2003,,1079209,90558889,17192890,,1048640,88666941,16825676,,30569,1891948,367214,PDP
HI170,,2016,2003,,1050957,89666146,17005787,,1049345,88970859,16880459,,1612,695287,125329,PDP
HI170,,2017,2003,,1050957,89666146,17005787,,1049427,89204438,16922103,,1530,461708,83684,PDP
HI170,,2017,2003,,1050957,89666146,17005787,,1049427,89204438,16922103,,1530,461708,83684,PDP
HI171A,,1988,1987,,1,23418661,4167023,,1,3142100,559094,,0,20276561,3607929,PDN
HI171A,,1989,1987,,51,41567993,7396491,,17,15327691,2727364,,34,26240302,4669127,PDN
HI171A,,1990,1987,,51,45719345,8135166,,17,26378869,4693766,,34,19340476,3441400,PDN
HI171A,,1991,1987,,32,44148615,7855657,,17,33046134,5880112,,15,11102481,1975545,PDN
HI171A,,1992,1987,,32,44148615,7855657,,17,37741451,6715578,,15,6407164,1140079,PDN
HI171A,,1993,1987,,17,49027117,8723703,,17,40560001,7217099,,0,8467116,1506604,PDN
HI171A,,1994,1987,,18,49027117,8723704,,18,41852721,7447121,,0,7174396,1276583,PDN
HI171A,,1995,1987,,18,49014040,8721377,,18,42975203,7646851,,0,6038837,1074526,PDN
HI171A,,1996,1987,,18,43266479,7698680,,18,43266479,7698680,,0,0,0,PDN
HI171A,,1997,1987,,18,43266479,7698680,,18,43266479,7698680,,0,0,0,PDN
HI171A,,1998,1987,,18,43266479,7698680,,18,43266479,7698680,,0,0,0,PDN
HI171A,,1999,1987,,18,43266479,7698680,,18,43266479,7698680,,0,0,0,PDN
HI171A,,2000,1987,,18,43266479,7698680,,18,43266479,7698680,,0,0,0,PDN
HI171A,,2001,1987,,18,43266479,7698680,,18,43266479,7698680,,0,0,0,PDN
HI171A,,2002,1987,,18,43266479,7698680,,18,43266479,7698680,,0,0,0,PDN
HI171A,,2003,1987,,18,43266479,7698680,,18,43266479,7698680,,0,0,0,PDN
HI171A,,2004,1987,,18,43266479,7698680,,18,43266479,7698680,,0,0,0,PDN
HI171A,,2005,1987,,18,43266479,7698680,,18,43266479,7698680,,0,0,0,PDN
HI171A,,2006,1987,,18,43266479,7698680,,18,43266479,7698680,,0,0,0,PDN
HI171A,,2007,1987,,18,43266479,7698680,,18,43266479,7698680,,0,0,0,PDN
HI171A,,2008,1987,,18,43266479,7698680,,18,43266479,7698680,,0,0,0,PDN
HI171A,,2009,1987,,18,44132980,7852861,,18,44132980,7852861,,0,0,0,PDN
HI171A,,2010,1987,,17,44132979,7852861,,17,44132979,7852861,,0,0,0,PDN
HI171A,,2011,1987,,17,44132979,7852861,,17,44132979,7852861,,0,0,0,PDN
HI171A,,2012,1987,,17,44132979,7852861,,17,44132979,7852861,,0,0,0,PDN
HI171A,,2013,1987,,17,44132979,7852861,,17,44132979,7852861,,0,0,0,PDN
HI171A,,2014,1987,,17,44132979,7852861,,17,44132979,7852861,,0,0,0,PDN
HI171A,,2015,1987,,17,44132979,7852861,,17,44132979,7852861,,0,0,0,PDN
HI171A,,2016,1987,,17,44132979,7852861,,17,44132979,7852861,,0,0,0,PDN
HI171A,,2017,1987,,17,44132979,7852861,,17,44132979,7852861,,0,0,0,PDN
HI171A,,2017,1987,,17,44132979,7852861,,17,44132979,7852861,,0,0,0,PDN
HI177,,1988,1988,,405165,20220746,4003163,,0,0,0,,405165,20220746,4003163,PDN
HI177,,1989,1988,,1214098,83241187,16025697,,192964,13350345,2568470,,1021134,69890842,13457227,PDN
HI177,,1990,1988,,721514,47480296,9169965,,405342,26905375,5192775,,316172,20574921,3977190,PDN
HI177,,1991,1988,,958119,68876586,13213739,,591967,41421327,7962310,,366152,27455259,5251429,PDN
HI177,,1992,1988,,1297855,99914163,19076176,,716370,53387266,10215884,,581485,46526897,8860292,PDN
HI177,,1993,1988,,1297855,99914163,19076176,,794496,61552263,11746856,,503359,38361900,7329320,PDN
HI177,,1994,1988,,1297855,99914166,19076176,,854932,69299138,13185739,,442923,30615028,5890437,PDN
HI177,,1995,1988,,1355224,104933689,20026699,,910620,75606375,14363712,,444604,29327314,5662987,PDN
HI177,,1996,1988,,1953964,120649204,23421794,,1174203,85573634,16400828,,779761,35075570,7020966,PDN
HI177,,1997,1988,,1953964,120649204,23421794,,1205277,89043640,17049341,,748687,31605564,6372453,PDN
HI177,,1998,1988,,1498509,116133020,22162747,,1226912,91708671,17545181,,271597,24424349,4617566,PDN
HI177,,1999,1988,,1299548,100533970,19188155,,1242089,93613499,17899295,,57459,6920471,1288860,PDN
HI177,,2000,1988,,2191014,131955294,25670603,,1256908,95354283,18223862,,934106,36601011,7446741,PDN
HI177,,2001,1988,,2067619,130083655,25214177,,1545192,107241904,20627381,,522427,22841751,4586796,PDN
HI177,,2002,1988,,2347015,173375850,33196810,,1870587,127842693,24618397,,476428,45533157,8578413,PDN
HI177,,2003,1988,,2296706,178389370,34038587,,2071406,145662633,27990024,,225300,32726737,6048563,PDN
HI177,,2004,1988,,2296572,177044885,33799221,,2153725,157915254,30252525,,142847,19129631,3546696,PDN
HI177,,2005,1988,,2296572,177044885,33799221,,2190696,164282985,31422544,,105876,12761900,2376677,PDN
HI177,,2006,1988,,2291320,177859039,33938836,,2212917,168895835,32265557,,78403,8963204,1673279,PDN
HI177,,2007,1988,,2250122,176124233,33588953,,2228491,172018634,32836789,,21631,4105599,752164,PDN
HI177,,2008,1988,,2256039,176881033,33729532,,2236942,173643091,33134289,,19097,3237942,595243,PDN
HI177,,2009,1988,,2244699,176857009,33713917,,2241000,176243727,33601094,,3699,613282,112825,PDN
HI177,,2010,1988,,2244699,176857009,33713917,,2244119,176748736,33694071,,580,108273,19846,PDN
HI177,,2011,1988,,2244699,176857009,33713917,,2244699,176857009,33713917,,0,0,0,PDN
HI177,,2012,1988,,2244699,176857009,33713917,,2244699,176857009,33713917,,0,0,0,PDN
HI177,,2013,1988,,2244699,176857009,33713917,,2244699,176857009,33713917,,0,0,0,PDN
HI177,,2014,1988,,2244699,176857009,33713917,,2244699,176857009,33713917,,0,0,0,PDN
HI177,,2015,1988,,2244699,176857009,33713917,,2244699,176857009,33713917,,0,0,0,PDN
HI177,,2016,1988,,2244699,176857009,33713917,,2244699,176857009,33713917,,0,0,0,PDN
HI177,,2017,1988,,2244699,176857009,33713917,,2244699,176857009,33713917,,0,0,0,PDN
HI177,,2017,1988,,2244699,176857009,33713917,,2244699,176857009,33713917,,0,0,0,PDN
HI178A,,1988,1986,,3529,23238768,4138541,,204,1152142,205211,,3325,22086626,3933330,PDN
HI178A,,1989,1986,,3529,23238768,4138541,,588,3474425,618813,,2941,19764343,3519728,PDN
HI178A,,1990,1986,,3529,23238768,4138541,,782,3982591,709428,,2747,19256177,3429113,PDN
HI178A,,1991,1986,,800,4091450,728816,,800,4091450,728816,,0,0,0,PDN
HI178A,,1992,1986,,800,4091450,728816,,800,4091450,728816,,0,0,0,PDN
HI178A,,1993,1986,,800,4091450,728816,,800,4091450,728816,,0,0,0,PDN
HI178A,,1994,1986,,800,4091450,728816,,800,4091450,728816,,0,0,0,PDN
HI178A,,1995,1986,,800,4091450,728816,,800,4091450,728816,,0,0,0,PDN
HI178A,,1996,1986,,800,4091450,728816,,800,4091450,728816,,0,0,0,PDN
HI178A,,1997,1986,,800,4091450,728816,,800,4091450,728816,,0,0,0,PDN
HI178A,,1998,1986,,800,4091450,728816,,800,4091450,728816,,0,0,0,PDN
HI178A,,1999,1986,,800,4091450,728816,,800,4091450,728816,,0,0,0,PDN
HI178A,,2000,1986,,800,4091450,728816,,800,4091450,728816,,0,0,0,PDN
HI178A,,2001,1986,,800,4091450,728816,,800,4091450,728816,,0,0,0,PDN
HI178A,,2002,1986,,800,4091450,728816,,800,4091450,728816,,0,0,0,PDN
HI178A,,2003,1986,,800,4091450,728816,,800,4091450,728816,,0,0,0,PDN
HI178A,,2004,1986,,800,4091450,728816,,800,4091450,728816,,0,0,0,PDN
HI178A,,2005,1986,,800,4091450,728816,,800,4091450,728816,,0,0,0,PDN
HI178A,,2006,1986,,800,4091450,728816,,800,4091450,728816,,0,0,0,PDN
HI178A,,2007,1986,,800,4091450,728816,,800,4091450,728816,,0,0,0,PDN
HI178A,,2008,1986,,800,4091450,728816,,800,4091450,728816,,0,0,0,PDN
HI178A,,2009,1986,,800,4173388,743396,,800,4173388,743396,,0,0,0,PDN
HI178A,,2010,1986,,800,4173388,743396,,800,4173388,743396,,0,0,0,PDN
HI178A,,2011,1986,,800,4173388,743396,,800,4173388,743396,,0,0,0,PDN
HI178A,,2012,1986,,800,4173388,743396,,800,4173388,743396,,0,0,0,PDN
HI178A,,2013,1986,,800,4173388,743396,,800,4173388,743396,,0,0,0,PDN
HI178A,,2014,1986,,800,4173388,743396,,800,4173388,743396,,0,0,0,PDN
HI178A,,2015,1986,,800,4173388,743396,,800,4173388,743396,,0,0,0,PDN
HI178A,,2016,1986,,800,4173388,743396,,800,4173388,743396,,0,0,0,PDN
HI178A,,2017,1986,,800,4173388,743396,,800,4173388,743396,,0,0,0,PDN
HI178A,,2017,1986,,800,4173388,743396,,800,4173388,743396,,0,0,0,PDN
HI179,,1978,1976,,210000,210000000,37576548,,0,0,0,,210000,210000000,37576548,PDP
HI179,,1979,1976,,0,250000000,44483986,,0,0,0,,0,250000000,44483986,PDP
HI179,,1980,1976,,3400000,250000000,47883986,,156383,16809123,3147330,,3243617,233190877,44736656,PDP
HI179,,1981,1976,,3041612,366688200,68288623,,567536,68732530,12797524,,2474076,297955670,55491099,PDP
HI179,,1982,1976,,2937665,372848239,69280768,,897429,117007578,21717283,,2040236,255840661,47563485,PDP
HI179,,1983,1976,,3033146,388850007,72223539,,1067207,140227939,26018798,,1965939,248622068,46204741,PDP
HI179,,1984,1976,,3275354,413091793,76779232,,1289177,174615936,32359628,,1986177,238475857,44419604,PDP
HI179,,1985,1976,,3448215,453817585,84198675,,1581633,219018365,40552872,,1866582,234799220,43645803,PDP
HI179,,1986,1976,,3577858,474145515,87945387,,1849694,260307577,48167768,,1728164,213837938,39777619,PDP
HI179,,1987,1976,,3744688,509590835,94419214,,2047233,291412284,53899953,,1697455,218178551,40519261,PDP
HI179,,1988,1976,,3767566,517563867,95860781,,2227566,319833862,59137506,,1540000,197730005,36723275,PDP
HI179,,1989,1976,,3026131,453934148,83797332,,2367212,343088631,63415011,,658919,110845517,20382321,PDP
HI179,,1990,1976,,3173159,477691782,88171697,,2487282,364944494,67424025,,685877,112747288,20747672,PDP
HI179,,1991,1976,,3212876,496782032,91608255,,2569348,383869747,70873573,,643528,112912285,20734682,PDP
HI179,,1992,1976,,3363210,504428633,93119195,,2656325,400219822,73869816,,706885,104208811,19249379,PDP
HI179,,1993,1976,,3396368,492777406,91079180,,2847421,420978610,77754647,,548947,71798796,13324533,PDP
HI179,,1994,1976,,3697024,517274574,95738763,,3107415,447161821,82673575,,589609,70112753,13065188,PDP
HI179,,1995,1976,,3968920,541232978,100273720,,3307544,472407844,87365879,,661376,68825134,12907841,PDP
HI179,,1996,1976,,3996660,548685646,101627558,,3408703,491560525,90874989,,587957,57125121,10752569,PDP
HI179,,1997,1976,,4169378,563700073,104471882,,3486046,502559598,92909462,,683332,61140475,11562420,PDP
HI179,,1998,1976,,3895098,547283495,101276503,,3569496,511773413,94632381,,325602,35510082,6644122,PDP
HI179,,1999,1976,,3911862,564031526,104273344,,3636149,523207194,96733514,,275713,40824332,7539830,PDP
HI179,,2000,1976,,3961999,575091558,106291458,,3692688,536375435,99133157,,269311,38716123,7158301,PDP
HI179,,2001,1976,,3877023,568894473,105103798,,3722074,543748736,100474518,,154949,25145737,4629280,PDP
HI179,,2002,1976,,3898025,567951431,104956998,,3753727,548156899,101290542,,144298,19794532,3666456,PDP
HI179,,2003,1976,,3898025,567950239,104956786,,3780471,552199287,102036572,,117554,15750952,2920214,PDP
HI179,,2004,1976,,3882020,567235638,104813628,,3794411,555150540,102575646,,87609,12085098,2237982,PDP
HI179,,2005,1976,,3893690,569129026,105162200,,3804375,556728792,102866438,,89315,12400234,2295762,PDP
HI179,,2006,1976,,3875934,567638269,104879185,,3810254,558076680,103112154,,65680,9561589,1767031,PDP
HI179,,2007,1976,,3838701,561616043,103770381,,3817962,559188411,103317679,,20739,2427632,452702,PDP
HI179,,2008,1976,,3882149,567485574,104858230,,3825387,559818992,103437307,,56762,7666582,1420923,PDP
HI179,,2009,1976,,3872485,578436552,106797140,,3833267,571296156,105487389,,39218,7140396,1309751,PDP
HI179,,2010,1976,,3875573,578925368,106887206,,3844590,573590575,105906970,,30983,5334793,980234,PDP
HI179,,2011,1976,,3874619,580037636,107084164,,3848183,574770778,106120564,,26436,5266858,963600,PDP
HI179,,2012,1976,,3873568,581053580,107263886,,3849963,575823641,106309686,,23605,5229939,954199,PDP
HI179,,2013,1976,,3873568,581053580,107263886,,3853287,576981352,106519009,,20281,4072228,744877,PDP
HI179,,2014,1976,,3873221,581824054,107400634,,3855543,578307500,106757234,,17678,3516554,643399,PDP
HI179,,2015,1976,,3876153,581824054,107403566,,3860569,579352067,106948126,,15584,2471987,455440,PDP
HI179,,2016,1976,,3871569,581550756,107350352,,3864241,580166643,107096741,,7328,1384113,253611,PDP
HI179,,2017,1976,,3880002,581996995,107438187,,3866545,580653484,107185671,,13457,1343511,252516,PDP
HI179,,2017,1976,,3880002,581996995,107438187,,3866545,580653484,107185671,,13457,1343511,252516,PDP
HI183A,,1988,1986,,832,6222235,1107991,,44,518337,92275,,788,5703898,1015716,PDN
HI183A,,1989,1986,,636,15388223,2738754,,186,5235431,931757,,450,10152792,1806997,PDN
HI183A,,1990,1986,,331,16973699,3020562,,197,8083798,1438595,,134,8889901,1581967,PDN
HI183A,,1991,1986,,217,10954467,1949410,,198,8669405,1542797,,19,2285062,406613,PDN
HI183A,,1992,1986,,198,8669405,1542797,,198,8669405,1542797,,0,0,0,PDN
HI183A,,1993,1986,,198,8669405,1542797,,198,8669405,1542797,,0,0,0,PDN
HI183A,,1994,1986,,198,8669405,1542797,,198,8669405,1542797,,0,0,0,PDN
HI183A,,1995,1986,,198,8669405,1542797,,198,8669405,1542797,,0,0,0,PDN
HI183A,,1996,1986,,198,8669405,1542797,,198,8669405,1542797,,0,0,0,PDN
HI183A,,1997,1986,,198,8669405,1542797,,198,8669405,1542797,,0,0,0,PDN
HI183A,,1998,1986,,198,8669405,1542797,,198,8669405,1542797,,0,0,0,PDN
HI183A,,1999,1986,,198,8669405,1542797,,198,8669405,1542797,,0,0,0,PDN
HI183A,,2000,1986,,198,8669405,1542797,,198,8669405,1542797,,0,0,0,PDN
HI183A,,2001,1986,,198,8669405,1542797,,198,8669405,1542797,,0,0,0,PDN
HI183A,,2002,1986,,198,8669405,1542797,,198,8669405,1542797,,0,0,0,PDN
HI183A,,2003,1986,,198,8669405,1542797,,198,8669405,1542797,,0,0,0,PDN
HI183A,,2004,1986,,198,8669405,1542797,,198,8669405,1542797,,0,0,0,PDN
HI183A,,2005,1986,,198,8669405,1542797,,198,8669405,1542797,,0,0,0,PDN
HI183A,,2006,1986,,198,8669405,1542797,,198,8669405,1542797,,0,0,0,PDN
HI183A,,2007,1986,,198,8669405,1542797,,198,8669405,1542797,,0,0,0,PDN
HI183A,,2008,1986,,198,8669405,1542797,,198,8669405,1542797,,0,0,0,PDN
HI183A,,2009,1986,,198,8843025,1573690,,198,8843025,1573690,,0,0,0,PDN
HI183A,,2010,1986,,198,8843025,1573690,,198,8843025,1573690,,0,0,0,PDN
HI183A,,2011,1986,,198,8843025,1573690,,198,8843025,1573690,,0,0,0,PDN
HI183A,,2012,1986,,198,8843025,1573690,,198,8843025,1573690,,0,0,0,PDN
HI183A,,2013,1986,,198,8843025,1573690,,198,8843025,1573690,,0,0,0,PDN
HI183A,,2014,1986,,198,8843025,1573690,,198,8843025,1573690,,0,0,0,PDN
HI183A,,2015,1986,,198,8843025,1573690,,198,8843025,1573690,,0,0,0,PDN
HI183A,,2016,1986,,198,8843025,1573690,,198,8843025,1573690,,0,0,0,PDN
HI183A,,2017,1986,,198,8843025,1573690,,198,8843025,1573690,,0,0,0,PDN
HI183A,,2017,1986,,198,8843025,1573690,,198,8843025,1573690,,0,0,0,PDN
HI185A,,1986,1984,,450,50675831,9017502,,45,5773669,1027388,,405,44902162,7990114,PDN
HI185A,,1987,1984,,2130,51696489,9200794,,807,14141184,2517032,,1323,37555305,6683762,PDN
HI185A,,1988,1984,,4215,51696489,9202879,,2021,21185232,3771635,,2194,30511257,5431244,PDN
HI185A,,1989,1984,,5321,51696489,9203985,,3060,28253862,5030438,,2261,23442627,4173547,PDN
HI185A,,1990,1984,,4841,55403905,9863187,,3268,32004854,5698082,,1573,23399051,4165105,PDN
HI185A,,1991,1984,,3435,42449984,7556813,,3322,33801231,6017776,,113,8648753,1539037,PDN
HI185A,,1992,1984,,3398,35695590,6354926,,3380,34399860,6124352,,18,1295730,230574,PDN
HI185A,,1993,1984,,3502,35695590,6355030,,3417,34701165,6178002,,85,994425,177028,PDN
HI185A,,1994,1984,,3417,34698791,6177579,,3417,34698791,6177579,,0,0,0,PDN
HI185A,,1995,1984,,3417,34698791,6177579,,3417,34698791,6177579,,0,0,0,PDN
HI185A,,1996,1984,,3417,34698791,6177579,,3417,34698791,6177579,,0,0,0,PDN
HI185A,,1997,1984,,3417,34698791,6177579,,3417,34698791,6177579,,0,0,0,PDN
HI185A,,1998,1984,,3417,34698791,6177579,,3417,34698791,6177579,,0,0,0,PDN
HI185A,,1999,1984,,3417,34698791,6177579,,3417,34698791,6177579,,0,0,0,PDN
HI185A,,2000,1984,,3417,34698791,6177579,,3417,34698791,6177579,,0,0,0,PDN
HI185A,,2001,1984,,3417,34698791,6177579,,3417,34698791,6177579,,0,0,0,PDN
HI185A,,2002,1984,,3417,34698791,6177579,,3417,34698791,6177579,,0,0,0,PDN
HI185A,,2003,1984,,3417,34698791,6177579,,3417,34698791,6177579,,0,0,0,PDN
HI185A,,2004,1984,,3417,34698791,6177579,,3417,34698791,6177579,,0,0,0,PDN
HI185A,,2005,1984,,3417,34698791,6177579,,3417,34698791,6177579,,0,0,0,PDN
HI185A,,2006,1984,,3417,34698791,6177579,,3417,34698791,6177579,,0,0,0,PDN
HI185A,,2007,1984,,3417,34698791,6177579,,3417,34698791,6177579,,0,0,0,PDN
HI185A,,2008,1984,,3417,34698791,6177579,,3417,34698791,6177579,,0,0,0,PDN
HI185A,,2009,1984,,3417,35393712,6301231,,3417,35393712,6301231,,0,0,0,PDN
HI185A,,2010,1984,,3417,35393712,6301231,,3417,35393712,6301231,,0,0,0,PDN
HI185A,,2011,1984,,3417,35393712,6301231,,3417,35393712,6301231,,0,0,0,PDN
HI185A,,2012,1984,,3417,35393712,6301231,,3417,35393712,6301231,,0,0,0,PDN
HI185A,,2013,1984,,3417,35393712,6301231,,3417,35393712,6301231,,0,0,0,PDN
HI185A,,2014,1984,,3417,35393712,6301231,,3417,35393712,6301231,,0,0,0,PDN
HI185A,,2015,1984,,3417,35393712,6301231,,3417,35393712,6301231,,0,0,0,PDN
HI185A,,2016,1984,,3417,35393712,6301231,,3417,35393712,6301231,,0,0,0,PDN
HI185A,,2017,1984,,3417,35393712,6301231,,3417,35393712,6301231,,0,0,0,PDN
HI185A,,2017,1984,,3417,35393712,6301231,,3417,35393712,6301231,,0,0,0,PDN
HI194,,1986,1984,,40364,5674005,1049973,,0,0,0,,40364,5674005,1049973,PDN
HI194,,1987,1984,,40364,5674005,1049973,,0,0,0,,40364,5674005,1049973,PDN
HI194,,1989,1984,,163915,32390651,5927376,,1063,158798,29319,,162852,32231853,5898057,PDN
HI194,,1990,1984,,165208,45325884,8230312,,14080,2942753,537702,,151128,42383131,7692610,PDN
HI194,,1991,1984,,165208,45325884,8230312,,28455,7295026,1326502,,136753,38030858,6903810,PDN
HI194,,1992,1984,,165208,45325884,8230312,,44841,12745058,2312645,,120367,32580826,5917667,PDN
HI194,,1993,1984,,169548,49223335,8928149,,58093,18865494,3414942,,111455,30357841,5513207,PDN
HI194,,1994,1984,,125582,53550407,9654124,,65895,23082315,4173068,,59687,30468092,5481056,PDN
HI194,,1995,1984,,125582,53550407,9654124,,70856,26381335,4765044,,54726,27169072,4889080,PDN
HI194,,1996,1984,,205789,72275572,13066211,,85786,29962411,5417176,,120003,42313161,7649035,PDN
HI194,,1997,1984,,205789,72531014,13111663,,102862,38145573,6890331,,102927,34385441,6221332,PDN
HI194,,1998,1984,,586882,150603070,27384581,,212351,58169424,10562782,,374531,92433646,16821799,PDN
HI194,,1999,1984,,372857,118377661,21436498,,288580,76826119,13958708,,84277,41551542,7477790,PDN
HI194,,2000,1984,,383919,114415647,20742575,,307290,87236502,15829799,,76629,27179145,4912776,PDN
HI194,,2001,1984,,389450,121395053,21989993,,340103,101108026,18330855,,49347,20287027,3659138,PDN
HI194,,2002,1984,,391244,122989504,22275497,,356372,110121707,19950982,,34872,12867797,2324515,PDN
HI194,,2003,1984,,390215,118200007,21422245,,370126,113433664,20554052,,20089,4766343,868193,PDN
HI194,,2004,1984,,380417,120667749,21851546,,376235,114853803,20812855,,4182,5813946,1038691,PDN
HI194,,2005,1984,,380417,120667749,21851546,,376650,116086471,21032606,,3767,4581278,818940,PDN
HI194,,2006,1984,,391788,124915829,22618803,,377630,117793114,21337259,,14158,7122715,1281544,PDN
HI194,,2007,1984,,379754,120801693,21874717,,378549,119328865,21611443,,1205,1472828,263274,PDN
HI194,,2008,1984,,394711,127100596,23010475,,379509,119920946,21717756,,15202,7179650,1292719,PDN
HI194,,2009,1984,,536286,126712569,23083006,,383026,122350582,22153592,,153260,4361987,929415,PDN
HI194,,2010,1984,,387764,123899735,22433980,,384810,123259909,22317177,,2954,639826,116802,PDN
HI194,,2011,1984,,387764,123899735,22433980,,385556,123542242,22368161,,2208,357493,65819,PDN
HI194,,2012,1984,,387764,123899735,22433980,,387752,123896511,22433394,,12,3224,585,PDN
HI194,,2013,1984,,387764,123899735,22433980,,387764,123899735,22433980,,0,0,0,PDN
HI194,,2014,1984,,387764,123899735,22433980,,387764,123899735,22433980,,0,0,0,PDN
HI194,,2015,1984,,387764,123899735,22433980,,387764,123899735,22433980,,0,0,0,PDN
HI194,,2016,1984,,387764,123899735,22433980,,387764,123899735,22433980,,0,0,0,PDN
HI194,,2017,1984,,387764,123899735,22433980,,387764,123899735,22433980,,0,0,0,PDN
HI194,,2017,1984,,387764,123899735,22433980,,387764,123899735,22433980,,0,0,0,PDN
HI196,,1987,1985,,254207,26922851,5044750,,0,0,0,,254207,26922851,5044750,PDP
HI196,,1988,1985,,5866,58656160,10442905,,0,566464,100794,,5866,58089696,10342111,PDP
HI196,,1989,1985,,2671323,165351941,32093377,,606521,20896357,4324734,,2064802,144455584,27768643,PDP
HI196,,1990,1985,,1999149,167504085,31804146,,787332,34669750,6956327,,1211817,132834335,24847819,PDP
HI196,,1991,1985,,2776447,170293031,33077698,,1113798,52052045,10375728,,1662649,118240986,22701970,PDP
HI196,,1992,1985,,1754041,97992211,19190377,,1337325,66603785,13188532,,416716,31388426,6001845,PDP
HI196,,1993,1985,,1876563,114523863,22254475,,1498019,79813082,15699635,,378544,34710781,6554840,PDP
HI196,,1994,1985,,1915543,119411343,23163113,,1583842,89904602,17581102,,331701,29506741,5582011,PDP
HI196,,1995,1985,,1888697,121681955,23540290,,1644101,97504495,18993655,,244596,24177460,4546635,PDP
HI196,,1996,1985,,1913640,143811087,27502801,,1721475,108722123,21067048,,192165,35088964,6435753,PDP
HI196,,1997,1985,,2042600,203496331,38251912,,1798797,126614533,24328073,,243803,76881798,13923839,PDP
HI196,,1998,1985,,2060960,205028099,38542828,,1871432,151195630,28774569,,189528,53832469,9768259,PDP
HI196,,1999,1985,,2126729,212183169,39881741,,1919090,167971312,31807224,,207639,44211857,8074517,PDP
HI196,,2000,1985,,2193893,228910350,42925272,,2000417,183424676,34638260,,193476,45485674,8287012,PDP
HI196,,2001,1985,,3910951,287248315,55022751,,2077813,199843199,37637101,,1833138,87405116,17385650,PDP
HI196,,2002,1985,,3983794,294672096,56416551,,2544850,226754736,42892668,,1438944,67917360,13523883,PDP
HI196,,2003,1985,,3971204,294217431,56323060,,3193170,258900110,49260805,,778034,35317321,7062255,PDP
HI196,,2004,1985,,4012891,309943562,59162991,,3548378,280130790,53393714,,464513,29812772,5769277,PDP
HI196,,2005,1985,,3986574,309018783,58972123,,3693226,290357464,55358255,,293348,18661319,3613868,PDP
HI196,,2006,1985,,4020301,318474176,60688304,,3883908,302255937,57666103,,136393,16218239,3022201,PDP
HI196,,2007,1985,,4030961,318850159,60765865,,3972776,310214845,59171147,,58185,8635314,1594718,PDP
HI196,,2008,1985,,4304035,331312946,63256516,,3994809,313344274,59750018,,309226,17968672,3506498,PDP
HI196,,2009,1985,,4951483,329477583,63577389,,4010871,318623465,60705438,,940612,10854118,2871950,PDP
HI196,,2010,1985,,4951483,329477583,63577389,,4017284,319625789,60890201,,934199,9851794,2687188,PDP
HI196,,2011,1985,,4951483,329477583,63577389,,4018861,319877788,60936617,,932622,9599795,2640771,PDP
HI196,,2012,1985,,4951483,329477583,63577389,,4179186,321387434,61365564,,772297,8090149,2211825,PDP
HI196,,2013,1985,,4313559,323190374,61820744,,4223892,321832779,61489512,,89667,1357595,331232,PDP
HI196,,2014,1985,,4342209,323637784,61929004,,4236446,321989405,61529935,,105763,1648379,399068,PDP
HI196,,2015,1985,,4747228,328412995,63183705,,4355716,323559912,61928656,,391512,4853083,1255049,PDP
HI196,,2016,1985,,4747228,328412995,63183705,,4383299,324022104,62038478,,363929,4390891,1145225,PDP
HI196,,2017,1985,,4535146,326869792,62697031,,4448955,325461596,62360271,,86191,1408196,336760,PDP
HI196,,2017,1985,,4535146,326869792,62697031,,4448955,325461596,62360271,,86191,1408196,336760,PDP
HI198,,2001,2002,,1036,10359524,1844368,,0,0,0,,1036,10359524,1844368,PDN
HI198,,2002,2002,,325584,9834277,2075455,,0,0,0,,325584,9834277,2075455,PDN
HI198,,2003,2002,,325584,9834277,2075455,,0,0,0,,325584,9834277,2075455,PDN
HI198,,2004,2002,,325584,9834277,2075455,,133693,4501467,934666,,191891,5332810,1140789,PDN
HI198,,2005,2002,,325584,9834277,2075455,,147836,5109010,1056913,,177748,4725267,1018542,PDN
HI198,,2006,2002,,325584,9834277,2075455,,147836,5109010,1056913,,177748,4725267,1018542,PDN
HI198,,2007,2002,,158857,5512977,1139814,,158857,5512977,1139814,,0,0,0,PDN
HI198,,2008,2002,,158857,5502205,1137897,,158857,5502205,1137897,,0,0,0,PDN
HI198,,2009,2002,,158857,5502205,1137897,,158857,5502205,1137897,,0,0,0,PDN
HI198,,2010,2002,,158857,5502205,1137897,,158857,5502205,1137897,,0,0,0,PDN
HI198,,2011,2002,,158857,5502205,1137897,,158857,5502205,1137897,,0,0,0,PDN
HI198,,2012,2002,,158857,5502205,1137897,,158857,5502205,1137897,,0,0,0,PDN
HI198,,2013,2002,,158857,5502205,1137897,,158857,5502205,1137897,,0,0,0,PDN
HI198,,2014,2002,,158857,5502205,1137897,,158857,5502205,1137897,,0,0,0,PDN
HI198,,2015,2002,,158857,5502205,1137897,,158857,5502205,1137897,,0,0,0,PDN
HI198,,2016,2002,,158857,5502205,1137897,,158857,5502205,1137897,,0,0,0,PDN
HI198,,2017,2002,,158857,5502205,1137897,,158857,5502205,1137897,,0,0,0,PDN
HI198,,2017,2002,,158857,5502205,1137897,,158857,5502205,1137897,,0,0,0,PDN
HI199,,1982,1980,,17000,17000000,3041911,,0,0,0,,17000,17000000,3041911,PDN
HI199,,1983,1980,,77625,23062459,4181265,,0,0,0,,77625,23062459,4181265,PDN
HI199,,1984,1980,,99500,13621515,2523257,,0,0,0,,99500,13621515,2523257,PDN
HI199,,1985,1980,,99500,13621515,2523257,,0,0,0,,99500,13621515,2523257,PDN
HI199,,1986,1980,,99500,13621515,2523257,,7202,416848,81374,,92298,13204667,2441883,PDN
HI199,,1987,1980,,99500,13621515,2523257,,17300,1486784,281852,,82200,12134731,2241405,PDN
HI199,,1988,1980,,107227,15492283,2863861,,45040,5602814,1041982,,62187,9889469,1821879,PDN
HI199,,1989,1980,,106171,16773210,3090728,,52735,7229153,1339061,,53436,9544057,1751667,PDN
HI199,,1990,1980,,106171,16773210,3090728,,55687,7961856,1472387,,50484,8811354,1618341,PDN
HI199,,1991,1980,,106171,16773210,3090728,,69899,9931899,1837141,,36272,6841311,1253587,PDN
HI199,,1992,1980,,166957,31026888,5687756,,79805,11595384,2143041,,87152,19431504,3544715,PDN
HI199,,1993,1980,,220701,28478818,5288106,,95203,13896447,2567880,,125498,14582371,2720226,PDN
HI199,,1994,1980,,241355,29362707,5466036,,124268,17811357,3293549,,117087,11551350,2172487,PDN
HI199,,1995,1980,,231871,32644624,6040523,,154876,22224141,4109349,,76995,10420483,1931174,PDN
HI199,,1996,1980,,224095,29957371,5554588,,170730,25272427,4667603,,53365,4684944,886985,PDN
HI199,,1997,1980,,224095,29957371,5554588,,177474,26780648,4942714,,46621,3176723,611874,PDN
HI199,,1998,1980,,213948,31424879,5805563,,181557,27753252,5119858,,32391,3671627,685705,PDN
HI199,,1999,1980,,212118,31616401,5837812,,188356,28709918,5296882,,23762,2906483,540930,PDN
HI199,,2000,1980,,507381,99747061,18255969,,288612,50247140,9229384,,218769,49499921,9026585,PDN
HI199,,2001,1980,,873604,157805240,28952828,,535507,107051741,19583859,,338097,50753499,9368969,PDN
HI199,,2002,1980,,863737,158362185,29042062,,700816,133747434,24499292,,162921,24614751,4542770,PDN
HI199,,2003,1980,,900214,161377400,29615054,,820302,150130570,27533927,,79912,11246830,2081127,PDN
HI199,,2004,1980,,1583666,181083993,33805017,,1015365,158913664,29291818,,568301,22170329,4513199,PDN
HI199,,2005,1980,,1411437,173491056,32281732,,1256450,166974693,30967249,,154987,6516363,1314483,PDN
HI199,,2006,1980,,1392224,173886732,32332924,,1339491,171562952,31866707,,52733,2323780,466217,PDN
HI199,,2007,1980,,1388426,173350377,32233689,,1361117,172484979,32052394,,27309,865398,181295,PDN
HI199,,2008,1980,,1401459,174349714,32424540,,1373818,172887232,32136671,,27641,1462482,287869,PDN
HI199,,2009,1980,,1499628,177596833,33100486,,1382490,173821464,32311575,,117138,3775369,788912,PDN
HI199,,2010,1980,,1499628,177596833,33100486,,1386486,174042828,32354959,,113142,3554005,745527,PDN
HI199,,2011,1980,,1499628,177596833,33100486,,1401280,174527833,32456053,,98348,3069000,644433,PDN
HI199,,2012,1980,,1499628,177596833,33100486,,1426329,175313162,32620840,,73299,2283671,479646,PDN
HI199,,2013,1980,,1451556,175970633,32763055,,1447287,175804536,32729231,,4269,166097,33824,PDN
HI199,,2014,1980,,1451556,175970633,32763055,,1451556,175970633,32763055,,0,0,0,PDN
HI199,,2015,1980,,1451556,175970633,32763055,,1451556,175970633,32763055,,0,0,0,PDN
HI199,,2016,1980,,1451556,175970633,32763055,,1451556,175970633,32763055,,0,0,0,PDN
HI199,,2017,1980,,1451556,175970633,32763055,,1451556,175970633,32763055,,0,0,0,PDN
HI199,,2017,1980,,1451556,175970633,32763055,,1451556,175970633,32763055,,0,0,0,PDN
HI200A,,1990,1989,,115,7211753,1283345,,27,834755,148560,,88,6376998,1134785,PDN
HI200A,,1991,1989,,218,7211753,1283448,,100,3736667,664987,,118,3475086,618461,PDN
HI200A,,1992,1989,,269,10074239,1792838,,122,5715447,1017105,,147,4358792,775733,PDN
HI200A,,1993,1989,,277,14163503,2520473,,183,9096537,1618784,,94,5066966,901689,PDN
HI200A,,1994,1989,,277,14161181,2520060,,185,12604716,2243017,,92,1556465,277043,PDN
HI200A,,1995,1989,,277,19438233,3459037,,185,15131538,2692629,,92,4306695,766408,PDN
HI200A,,1996,1989,,192,15946782,2837698,,192,15946782,2837698,,0,0,0,PDN
HI200A,,1997,1989,,192,15946781,2837698,,192,15946781,2837698,,0,0,0,PDN
HI200A,,1998,1989,,192,15946781,2837698,,192,15946781,2837698,,0,0,0,PDN
HI200A,,1999,1989,,192,15946781,2837698,,192,15946781,2837698,,0,0,0,PDN
HI200A,,2000,1989,,192,15946781,2837698,,192,15946781,2837698,,0,0,0,PDN
HI200A,,2001,1989,,192,15946781,2837698,,192,15946781,2837698,,0,0,0,PDN
HI200A,,2002,1989,,192,15946781,2837698,,192,15946781,2837698,,0,0,0,PDN
HI200A,,2003,1989,,192,15946781,2837698,,192,15946781,2837698,,0,0,0,PDN
HI200A,,2004,1989,,192,15946781,2837698,,192,15946781,2837698,,0,0,0,PDN
HI200A,,2005,1989,,192,15946781,2837698,,192,15946781,2837698,,0,0,0,PDN
HI200A,,2006,1989,,192,15946781,2837698,,192,15946781,2837698,,0,0,0,PDN
HI200A,,2007,1989,,192,15946781,2837698,,192,15946781,2837698,,0,0,0,PDN
HI200A,,2008,1989,,192,15946781,2837698,,192,15946781,2837698,,0,0,0,PDN
HI200A,,2009,1989,,192,16266148,2894524,,192,16266148,2894524,,0,0,0,PDN
HI200A,,2010,1989,,192,16266148,2894524,,192,16266148,2894524,,0,0,0,PDN
HI200A,,2011,1989,,192,16266148,2894524,,192,16266148,2894524,,0,0,0,PDN
HI200A,,2012,1989,,192,16266148,2894524,,192,16266148,2894524,,0,0,0,PDN
HI200A,,2013,1989,,192,16266148,2894524,,192,16266148,2894524,,0,0,0,PDN
HI200A,,2014,1989,,192,16266148,2894524,,192,16266148,2894524,,0,0,0,PDN
HI200A,,2015,1989,,192,16266148,2894524,,192,16266148,2894524,,0,0,0,PDN
HI200A,,2016,1989,,192,16266148,2894524,,192,16266148,2894524,,0,0,0,PDN
HI200A,,2017,1989,,192,16266148,2894524,,192,16266148,2894524,,0,0,0,PDN
HI200A,,2017,1989,,192,16266148,2894524,,192,16266148,2894524,,0,0,0,PDN
HI202,,2000,2000,,18255,6561600,1185799,,7161,1194209,219654,,11094,5367391,966145,PDN
HI202,,2001,2000,,17615,7265947,1310488,,14795,3669504,667732,,2820,3596443,642756,PDN
HI202,,2002,2000,,21727,6293133,1141502,,16610,5132633,929890,,5117,1160500,211612,PDN
HI202,,2003,2000,,21727,6293133,1141502,,18891,5610314,1017168,,2836,682819,124334,PDN
HI202,,2004,2000,,22576,6445839,1169522,,20529,6354445,1151213,,2047,91394,18309,PDN
HI202,,2005,2000,,22576,6445839,1169522,,22576,6445839,1169522,,0,0,0,PDN
HI202,,2006,2000,,22576,6445839,1169522,,22576,6445839,1169522,,0,0,0,PDN
HI202,,2007,2000,,22576,6445839,1169522,,22576,6445839,1169522,,0,0,0,PDN
HI202,,2008,2000,,22576,6446071,1169564,,22576,6446071,1169564,,0,0,0,PDN
HI202,,2009,2000,,22576,6446071,1169563,,22576,6446071,1169563,,0,0,0,PDN
HI202,,2010,2000,,22576,6446071,1169563,,22576,6446071,1169563,,0,0,0,PDN
HI202,,2011,2000,,22576,6446071,1169563,,22576,6446071,1169563,,0,0,0,PDN
HI202,,2012,2000,,22576,6446071,1169563,,22576,6446071,1169563,,0,0,0,PDN
HI202,,2013,2000,,22576,6446071,1169563,,22576,6446071,1169563,,0,0,0,PDN
HI202,,2014,2000,,22576,6446071,1169563,,22576,6446071,1169563,,0,0,0,PDN
HI202,,2015,2000,,22576,6446071,1169563,,22576,6446071,1169563,,0,0,0,PDN
HI202,,2016,2000,,22576,6446071,1169563,,22576,6446071,1169563,,0,0,0,PDN
HI202,,2017,2000,,22576,6446071,1169563,,22576,6446071,1169563,,0,0,0,PDN
HI202,,2017,2000,,22576,6446071,1169563,,22576,6446071,1169563,,0,0,0,PDN
HI206,,1975,1968,,2067000,16459880,4995804,,0,0,0,,2067000,16459880,4995804,PDP
HI206,,1976,1968,,2067000,16459880,4995804,,0,0,0,,2067000,16459880,4995804,PDP
HI206,,1977,1968,,2440672,19936874,5988158,,59159,657392,176133,,2381513,19279482,5812025,PDP
HI206,,1978,1968,,2487341,19936874,6034827,,398713,5163152,1317423,,2088628,14773722,4717404,PDP
HI206,,1979,1968,,2487341,20729874,6175931,,1028134,8767268,2588146,,1459207,11962606,3587785,PDP
HI206,,1980,1968,,2490900,22365124,6470459,,1162665,10140809,2967079,,1328235,12224315,3503380,PDP
HI206,,1981,1968,,2494061,22365124,6473620,,1266410,11045228,3231753,,1227651,11319896,3241867,PDP
HI206,,1982,1968,,2490502,20729874,6179092,,1345283,11862649,3456075,,1145219,8867225,2723017,PDP
HI206,,1983,1968,,1967892,18711485,5297338,,1413685,12276197,3598062,,554207,6435288,1699276,PDP
HI206,,1984,1968,,2334394,25338982,6843110,,1424137,12463812,3641897,,910257,12875170,3201213,PDP
HI206,,1985,1968,,2334394,25338982,6843110,,1625260,14638158,4229914,,709134,10700824,2613196,PDP
HI206,,1986,1968,,2334394,25338982,6843110,,1762789,16057215,4619945,,571605,9281767,2223165,PDP
HI206,,1987,1968,,2334394,26910089,7122666,,1845228,16857525,4844788,,489166,10052564,2277878,PDP
HI206,,1988,1968,,2334628,22431263,6325956,,1923302,16170056,4800536,,411326,6261207,1525420,PDP
HI206,,1989,1968,,2351378,20998235,6087719,,1983014,16305636,4884373,,368364,4692599,1203346,PDP
HI206,,1990,1968,,2351378,17955121,5546239,,2072894,16396792,4990473,,278484,1558329,555766,PDP
HI206,,1991,1968,,2135458,16494951,5070503,,2135458,16494951,5070503,,0,0,0,PDP
HI206,,1992,1968,,2138097,16494951,5073142,,2138097,16494951,5073142,,0,0,0,PDP
HI206,,1993,1968,,2138097,16494951,5073142,,2138097,16494951,5073142,,0,0,0,PDP
HI206,,1994,1968,,2138097,16494951,5073142,,2138097,16494951,5073142,,0,0,0,PDP
HI206,,1995,1968,,2138097,16494951,5073142,,2138097,16494951,5073142,,0,0,0,PDP
HI206,,1996,1968,,2138098,16494951,5073143,,2138098,16494951,5073143,,0,0,0,PDP
HI206,,1997,1968,,2138098,16494951,5073143,,2138098,16494951,5073143,,0,0,0,PDP
HI206,,1998,1968,,2138098,16494951,5073143,,2138098,16494951,5073143,,0,0,0,PDP
HI206,,1999,1968,,2138098,16494951,5073143,,2138098,16494951,5073143,,0,0,0,PDP
HI206,,2000,1968,,2138098,16494951,5073143,,2138098,16494951,5073143,,0,0,0,PDP
HI206,,2001,1968,,2138098,16494951,5073143,,2138098,16494951,5073143,,0,0,0,PDP
HI206,,2002,1968,,2237432,24438082,6585845,,2138098,16494951,5073143,,99334,7943131,1512702,PDP
HI206,,2003,1968,,2319197,32327499,8071421,,2230414,24133525,6524636,,88783,8193974,1546785,PDP
HI206,,2004,1968,,2663351,84955298,17779952,,2333182,34523823,8476211,,330169,50431475,9303741,PDP
HI206,,2005,1968,,2615593,79917359,16835764,,2465172,50216004,11400404,,150421,29701355,5435360,PDP
HI206,,2006,1968,,2486786,53681072,12038578,,2485632,52919249,11901868,,1154,761823,136710,PDP
HI206,,2007,1968,,2486786,53681072,12038578,,2486467,53298820,11970243,,319,382252,68335,PDP
HI206,,2008,1968,,2519332,60254184,13240717,,2486713,53521186,12010056,,32619,6732998,1230661,PDP
HI206,,2009,1968,,2530236,57877051,12828643,,2487118,53998056,12095313,,43118,3878995,733331,PDP
HI206,,2010,1968,,2530236,57877051,12828643,,2492641,55229746,12319997,,37595,2647305,508646,PDP
HI206,,2011,1968,,2530236,57877051,12828643,,2495879,56323791,12517905,,34357,1553260,310738,PDP
HI206,,2012,1968,,2530236,57877051,12828643,,2497409,56598747,12568360,,32827,1278304,260283,PDP
HI206,,2013,1968,,2530236,57877051,12828643,,2503717,57109359,12665524,,26519,767692,163119,PDP
HI206,,2014,1968,,2515762,58295980,12888712,,2507732,57504782,12739899,,8030,791198,148813,PDP
HI206,,2015,1968,,2515762,58295980,12888712,,2510295,57747053,12785571,,5467,548927,103141,PDP
HI206,,2016,1968,,2515762,58295980,12888712,,2513413,58034824,12839894,,2349,261156,48818,PDP
HI206,,2017,1968,,2525330,58833947,12994003,,2516550,58326828,12894989,,8780,507119,99015,PDP
HI206,,2017,1968,,2525330,58833947,12994003,,2516550,58326828,12894989,,8780,507119,99015,PDP
HI233,,2000,2001,,175,1746363,310916,,0,0,0,,175,1746363,310916,PDN
HI233,,2001,2001,,5785,1745642,316397,,1046,156256,28850,,4739,1589386,287547,PDN
HI233,,2002,2001,,3921,1670864,301228,,3786,1564982,282253,,135,105882,18975,PDN
HI233,,2003,2001,,5141,2300982,414568,,5141,2300982,414568,,0,0,0,PDN
HI233,,2004,2001,,5153,2304243,415161,,5153,2304243,415161,,0,0,0,PDN
HI233,,2005,2001,,5153,2304243,415161,,5153,2304243,415161,,0,0,0,PDN
HI233,,2006,2001,,5153,2304243,415161,,5153,2304243,415161,,0,0,0,PDN
HI233,,2007,2001,,5153,2304243,415161,,5153,2304243,415161,,0,0,0,PDN
HI233,,2008,2001,,5153,2304243,415161,,5153,2304243,415161,,0,0,0,PDN
HI233,,2009,2001,,5153,2304243,415160,,5153,2304243,415160,,0,0,0,PDN
HI233,,2010,2001,,5153,2304243,415160,,5153,2304243,415160,,0,0,0,PDN
HI233,,2011,2001,,5153,2304243,415160,,5153,2304243,415160,,0,0,0,PDN
HI233,,2012,2001,,5153,2304243,415160,,5153,2304243,415160,,0,0,0,PDN
HI233,,2013,2001,,5153,2304243,415160,,5153,2304243,415160,,0,0,0,PDN
HI233,,2014,2001,,5153,2304243,415160,,5153,2304243,415160,,0,0,0,PDN
HI233,,2015,2001,,5153,2304243,415160,,5153,2304243,415160,,0,0,0,PDN
HI233,,2016,2001,,5153,2304243,415160,,5153,2304243,415160,,0,0,0,PDN
HI233,,2017,2001,,5153,2304243,415160,,5153,2304243,415160,,0,0,0,PDN
HI233,,2017,2001,,5153,2304243,415160,,5153,2304243,415160,,0,0,0,PDN
HI235,,1998,1998,,36012,6215971,1142057,,0,0,0,,36012,6215971,1142057,PDN
HI235,,1999,1998,,33573,5833651,1071589,,25758,4117740,758452,,7815,1715911,313137,PDN
HI235,,2000,1998,,43116,7742232,1420737,,42467,7625697,1399353,,649,116535,21384,PDN
HI235,,2001,1998,,46835,8413216,1543849,,46835,8413216,1543849,,0,0,0,PDN
HI235,,2002,1998,,46835,8413216,1543849,,46835,8413216,1543849,,0,0,0,PDN
HI235,,2003,1998,,46835,8413216,1543849,,46835,8413216,1543849,,0,0,0,PDN
HI235,,2004,1998,,46835,8413216,1543849,,46835,8413216,1543849,,0,0,0,PDN
HI235,,2005,1998,,46835,8413216,1543849,,46835,8413216,1543849,,0,0,0,PDN
HI235,,2006,1998,,46835,8413216,1543849,,46835,8413216,1543849,,0,0,0,PDN
HI235,,2007,1998,,46835,8413216,1543849,,46835,8413216,1543849,,0,0,0,PDN
HI235,,2008,1998,,46835,8413216,1543849,,46835,8413216,1543849,,0,0,0,PDN
HI235,,2009,1998,,46835,8413216,1543849,,46835,8413216,1543849,,0,0,0,PDN
HI235,,2010,1998,,46835,8413216,1543849,,46835,8413216,1543849,,0,0,0,PDN
HI235,,2011,1998,,46835,8413216,1543849,,46835,8413216,1543849,,0,0,0,PDN
HI235,,2012,1998,,46835,8413216,1543849,,46835,8413216,1543849,,0,0,0,PDN
HI235,,2013,1998,,46835,8413216,1543849,,46835,8413216,1543849,,0,0,0,PDN
HI235,,2014,1998,,46835,8413216,1543849,,46835,8413216,1543849,,0,0,0,PDN
HI235,,2015,1998,,46835,8413216,1543849,,46835,8413216,1543849,,0,0,0,PDN
HI235,,2016,1998,,46835,8413216,1543849,,46835,8413216,1543849,,0,0,0,PDN
HI235,,2017,1998,,46835,8413216,1543849,,46835,8413216,1543849,,0,0,0,PDN
HI235,,2017,1998,,46835,8413216,1543849,,46835,8413216,1543849,,0,0,0,PDN
HI237A,,1989,1984,,956,9560686,1702146,,33,452819,80606,,923,9107867,1621540,PDN
HI237A,,1990,1984,,512,11089612,1973753,,147,4353517,774794,,365,6736095,1198959,PDN
HI237A,,1991,1984,,559,17277016,3074761,,205,8232057,1464984,,354,9044959,1609777,PDN
HI237A,,1992,1984,,293,14321829,2548661,,205,10205281,1816091,,88,4116548,732570,PDN
HI237A,,1993,1984,,205,12697514,2259549,,205,11266232,2004873,,0,1431282,254676,PDN
HI237A,,1994,1984,,205,12697514,2259549,,205,11867193,2111805,,0,830321,147744,PDN
HI237A,,1995,1984,,205,12697514,2259549,,205,12054020,2145048,,0,643494,114501,PDN
HI237A,,1996,1984,,205,12697514,2259549,,205,12127019,2158038,,0,570495,101511,PDN
HI237A,,1997,1984,,205,12697514,2259549,,205,12167144,2165177,,0,530370,94372,PDN
HI237A,,1998,1984,,205,13031771,2319025,,205,12415136,2209304,,0,616635,109721,PDN
HI237A,,1999,1984,,205,13113264,2333526,,205,12768216,2272130,,0,345048,61396,PDN
HI237A,,2000,1984,,205,13113264,2333526,,205,13030941,2318878,,0,82323,14648,PDN
HI237A,,2001,1984,,205,13115372,2333901,,205,13115372,2333901,,0,0,0,PDN
HI237A,,2002,1984,,205,13115372,2333901,,205,13115372,2333901,,0,0,0,PDN
HI237A,,2003,1984,,205,13115372,2333901,,205,13115372,2333901,,0,0,0,PDN
HI237A,,2004,1984,,205,13115372,2333901,,205,13115372,2333901,,0,0,0,PDN
HI237A,,2005,1984,,205,13115372,2333901,,205,13115372,2333901,,0,0,0,PDN
HI237A,,2006,1984,,205,13115372,2333901,,205,13115372,2333901,,0,0,0,PDN
HI237A,,2007,1984,,205,13115372,2333901,,205,13115372,2333901,,0,0,0,PDN
HI237A,,2008,1984,,205,13115372,2333901,,205,13115372,2333901,,0,0,0,PDN
HI237A,,2009,1984,,205,13363060,2377973,,205,13363060,2377973,,0,0,0,PDN
HI237A,,2010,1984,,205,13363060,2377973,,205,13363060,2377973,,0,0,0,PDN
HI237A,,2011,1984,,205,13363060,2377973,,205,13363060,2377973,,0,0,0,PDN
HI237A,,2012,1984,,205,13363060,2377973,,205,13363060,2377973,,0,0,0,PDN
HI237A,,2013,1984,,205,13363060,2377973,,205,13363060,2377973,,0,0,0,PDN
HI237A,,2014,1984,,205,13363060,2377973,,205,13363060,2377973,,0,0,0,PDN
HI237A,,2015,1984,,205,13363060,2377973,,205,13363060,2377973,,0,0,0,PDN
HI237A,,2016,1984,,205,13363060,2377973,,205,13363060,2377973,,0,0,0,PDN
HI237A,,2017,1984,,205,13363060,2377973,,205,13363060,2377973,,0,0,0,PDN
HI237A,,2017,1984,,205,13363060,2377973,,205,13363060,2377973,,0,0,0,PDN
HI244A,,1985,1983,,34479,4721683,874636,,0,223509,39770,,34479,4498174,834866,PDN
HI244A,,1986,1983,,33531,15387829,2771579,,3292,3473818,621409,,30239,11914011,2150170,PDN
HI244A,,1987,1983,,33531,15387829,2771579,,5200,7228774,1291459,,28331,8159055,1480120,PDN
HI244A,,1988,1983,,33352,21968636,3942362,,7453,12309762,2197802,,25899,9658874,1744560,PDN
HI244A,,1989,1983,,35395,26934852,4828073,,9047,16862623,3009514,,26348,10072229,1818559,PDN
HI244A,,1990,1983,,11487,33166332,5912970,,9515,21526764,3839900,,1972,11639568,2073070,PDN
HI244A,,1991,1983,,11865,32797750,5847764,,9998,24790176,4421061,,1867,8007574,1426703,PDN
HI244A,,1992,1983,,12032,33856610,6036340,,10634,27771497,4952182,,1398,6085113,1084158,PDN
HI244A,,1993,1983,,12169,31989050,5704171,,10934,28498394,5081823,,1235,3490656,622348,PDN
HI244A,,1994,1983,,25400,38080893,6801360,,11422,29223635,5211357,,13978,8857258,1590003,PDN
HI244A,,1995,1983,,27400,40263589,7191740,,14389,32016919,5711350,,13011,8246670,1480390,PDN
HI244A,,1996,1983,,21312,43745683,7805241,,16408,34723380,6194945,,4904,9022303,1610296,PDN
HI244A,,1997,1983,,22695,45576663,8132422,,18072,36305274,6478085,,4623,9271389,1654337,PDN
HI244A,,1998,1983,,21129,43939850,7839608,,19036,37880629,6759361,,2093,6059221,1080247,PDN
HI244A,,1999,1983,,24518,44932630,8019648,,19739,39342638,7020208,,4779,5589992,999440,PDN
HI244A,,2000,1983,,27658,50055177,8934273,,22824,41994407,7495138,,4834,8060770,1439135,PDN
HI244A,,2001,1983,,26086,47079947,8403301,,23967,43617849,7785150,,2119,3462098,618151,PDN
HI244A,,2002,1983,,25895,46663571,8329022,,24593,44198814,7889151,,1302,2464757,439871,PDN
HI244A,,2003,1983,,25895,46700323,8335561,,24607,44256444,7899419,,1288,2443879,436142,PDN
HI244A,,2004,1983,,24607,44256444,7899419,,24607,44256444,7899419,,0,0,0,PDN
HI244A,,2005,1983,,24607,44256444,7899419,,24607,44256444,7899419,,0,0,0,PDN
HI244A,,2006,1983,,24607,44256444,7899419,,24607,44256444,7899419,,0,0,0,PDN
HI244A,,2007,1983,,24607,44256444,7899419,,24607,44256444,7899419,,0,0,0,PDN
HI244A,,2008,1983,,24607,44256444,7899419,,24607,44256444,7899419,,0,0,0,PDN
HI244A,,2009,1983,,24607,45004800,8032577,,24607,45004800,8032577,,0,0,0,PDN
HI244A,,2010,1983,,24607,45004800,8032577,,24607,45004800,8032577,,0,0,0,PDN
HI244A,,2011,1983,,24607,45004800,8032577,,24607,45004800,8032577,,0,0,0,PDN
HI244A,,2012,1983,,24607,45004800,8032577,,24607,45004800,8032577,,0,0,0,PDN
HI244A,,2013,1983,,24607,45004800,8032577,,24607,45004800,8032577,,0,0,0,PDN
HI244A,,2014,1983,,24607,45004800,8032577,,24607,45004800,8032577,,0,0,0,PDN
HI244A,,2015,1983,,24607,45004800,8032577,,24607,45004800,8032577,,0,0,0,PDN
HI244A,,2016,1983,,24607,45004800,8032577,,24607,45004800,8032577,,0,0,0,PDN
HI244A,,2017,1983,,24607,45004800,8032577,,24607,45004800,8032577,,0,0,0,PDN
HI244A,,2017,1983,,24607,45004800,8032577,,24607,45004800,8032577,,0,0,0,PDN
HI245A,,1994,1974,,4369,13627185,2429135,,209,483102,86170,,4160,13144083,2342965,PDN
HI245A,,1995,1974,,4369,13627185,2429135,,624,1706887,304341,,3745,11920298,2124794,PDN
HI245A,,1996,1974,,1348,4773043,850644,,624,2015213,359203,,724,2757830,491441,PDN
HI245A,,1997,1974,,1348,4773043,850644,,624,2223799,396318,,724,2549244,454326,PDN
HI245A,,1998,1974,,624,2224203,396390,,624,2224203,396390,,0,0,0,PDN
HI245A,,1999,1974,,624,2224203,396390,,624,2224203,396390,,0,0,0,PDN
HI245A,,2000,1974,,624,2224203,396390,,624,2224203,396390,,0,0,0,PDN
HI245A,,2001,1974,,624,2224203,396390,,624,2224203,396390,,0,0,0,PDN
HI245A,,2002,1974,,624,2224203,396390,,624,2224203,396390,,0,0,0,PDN
HI245A,,2003,1974,,624,2224203,396390,,624,2224203,396390,,0,0,0,PDN
HI245A,,2004,1974,,624,2224203,396390,,624,2224203,396390,,0,0,0,PDN
HI245A,,2005,1974,,624,2224203,396390,,624,2224203,396390,,0,0,0,PDN
HI245A,,2006,1974,,624,2224203,396390,,624,2224203,396390,,0,0,0,PDN
HI245A,,2007,1974,,624,2224203,396390,,624,2224203,396390,,0,0,0,PDN
HI245A,,2008,1974,,624,2224203,396390,,624,2224203,396390,,0,0,0,PDN
HI245A,,2009,1974,,624,2268744,404316,,624,2268744,404316,,0,0,0,PDN
HI245A,,2010,1974,,624,2268744,404316,,624,2268744,404316,,0,0,0,PDN
HI245A,,2011,1974,,624,2268744,404316,,624,2268744,404316,,0,0,0,PDN
HI245A,,2012,1974,,624,2268744,404316,,624,2268744,404316,,0,0,0,PDN
HI245A,,2013,1974,,624,2268744,404316,,624,2268744,404316,,0,0,0,PDN
HI245A,,2014,1974,,624,2268744,404316,,624,2268744,404316,,0,0,0,PDN
HI245A,,2015,1974,,624,2268744,404316,,624,2268744,404316,,0,0,0,PDN
HI245A,,2016,1974,,624,2268744,404316,,624,2268744,404316,,0,0,0,PDN
HI245A,,2017,1974,,624,2268744,404316,,624,2268744,404316,,0,0,0,PDN
HI245A,,2017,1974,,624,2268744,404316,,624,2268744,404316,,0,0,0,PDN
HI247A,,2007,2007,,659,7888923,1404382,,0,0,0,,659,7888923,1404382,PDN
HI247A,,2008,2007,,392,11311209,2013063,,0,0,0,,392,11311209,2013063,PDN
HI247A,,2009,2007,,76,4131123,735152,,76,961001,171073,,0,3170122,564078,PDN
HI247A,,2010,2007,,76,4131123,735152,,76,2804253,499053,,0,1326870,236097,PDN
HI247A,,2011,2007,,76,4131123,735152,,76,4131123,735152,,0,0,0,PDN
HI247A,,2012,2007,,76,4131123,735152,,76,4131123,735152,,0,0,0,PDN
HI247A,,2013,2007,,76,4131123,735152,,76,4131123,735152,,0,0,0,PDN
HI247A,,2014,2007,,76,4131123,735152,,76,4131123,735152,,0,0,0,PDN
HI247A,,2015,2007,,76,4131123,735152,,76,4131123,735152,,0,0,0,PDN
HI247A,,2016,2007,,76,4131123,735152,,76,4131123,735152,,0,0,0,PDN
HI247A,,2017,2007,,76,4131123,735152,,76,4131123,735152,,0,0,0,PDN
HI247A,,2017,2007,,76,4131123,735152,,76,4131123,735152,,0,0,0,PDN
HI253A,,1998,1994,,2962,4217606,753426,,0,0,0,,2962,4217606,753426,PDN
HI253A,,1999,1994,,2962,4217606,753426,,0,0,0,,2962,4217606,753426,PDN
HI253A,,2000,1994,,40860,2510841,487629,,34160,2408139,462654,,6700,102702,24975,PDN
HI253A,,2001,1994,,40860,2510841,487629,,40860,2510841,487629,,0,0,0,PDN
HI253A,,2002,1994,,40860,2510841,487629,,40860,2510841,487629,,0,0,0,PDN
HI253A,,2003,1994,,40860,2510841,487629,,40860,2510841,487629,,0,0,0,PDN
HI253A,,2004,1994,,40860,2510841,487629,,40860,2510841,487629,,0,0,0,PDN
HI253A,,2005,1994,,40860,2510841,487629,,40860,2510841,487629,,0,0,0,PDN
HI253A,,2006,1994,,40860,2510841,487629,,40860,2510841,487629,,0,0,0,PDN
HI253A,,2007,1994,,40860,2510841,487629,,40860,2510841,487629,,0,0,0,PDN
HI253A,,2008,1994,,40860,2510841,487629,,40860,2510841,487629,,0,0,0,PDN
HI253A,,2009,1994,,40860,2510841,487629,,40860,2510841,487629,,0,0,0,PDN
HI253A,,2010,1994,,40860,2510841,487629,,40860,2510841,487629,,0,0,0,PDN
HI253A,,2011,1994,,40860,2510841,487629,,40860,2510841,487629,,0,0,0,PDN
HI253A,,2012,1994,,40860,2510841,487629,,40860,2510841,487629,,0,0,0,PDN
HI253A,,2013,1994,,40860,2510841,487629,,40860,2510841,487629,,0,0,0,PDN
HI253A,,2014,1994,,40860,2510841,487629,,40860,2510841,487629,,0,0,0,PDN
HI253A,,2015,1994,,40860,2510841,487629,,40860,2510841,487629,,0,0,0,PDN
HI253A,,2016,1994,,40860,2510841,487629,,40860,2510841,487629,,0,0,0,PDN
HI253A,,2017,1994,,40860,2510841,487629,,40860,2510841,487629,,0,0,0,PDN
HI253A,,2017,1994,,40860,2510841,487629,,40860,2510841,487629,,0,0,0,PDN
HI260A,,2005,1989,,41475,3955287,745263,,0,0,0,,41475,3955287,745263,PDN
HI260A,,2006,1989,,41424,3950444,744350,,0,0,0,,41424,3950444,744350,PDN
HI260A,,2007,1989,,1366,3950444,704292,,0,0,0,,1366,3950444,704292,PDN
HI260A,,2008,1989,,1303,14427179,2568417,,0,83571,14870,,1303,14343608,2553547,PDN
HI260A,,2009,1989,,1303,14714573,2619554,,185,1307667,232866,,1118,13406906,2386688,PDN
HI260A,,2010,1989,,606,6165920,1097745,,209,5316763,946252,,397,849157,151493,PDN
HI260A,,2011,1989,,606,6165920,1097745,,606,6033302,1074147,,0,132618,23598,PDN
HI260A,,2012,1989,,606,6165920,1097745,,606,6165920,1097745,,0,0,0,PDN
HI260A,,2013,1989,,606,6165920,1097745,,606,6165920,1097745,,0,0,0,PDN
HI260A,,2014,1989,,606,6165920,1097745,,606,6165920,1097745,,0,0,0,PDN
HI260A,,2015,1989,,606,6165920,1097745,,606,6165920,1097745,,0,0,0,PDN
HI260A,,2016,1989,,606,6165920,1097745,,606,6165920,1097745,,0,0,0,PDN
HI260A,,2017,1989,,606,6165920,1097745,,606,6165920,1097745,,0,0,0,PDN
HI260A,,2017,1989,,606,6165920,1097745,,606,6165920,1097745,,0,0,0,PDN
HI262,,1991,1990,,94087,8005709,1518590,,17530,1376189,262403,,76557,6629520,1256187,PDN
HI262,,1992,1990,,134391,10660243,2031231,,45985,3507718,670134,,88406,7152525,1361097,PDN
HI262,,1993,1990,,134391,10660243,2031231,,63000,4840749,924343,,71391,5819494,1106888,PDN
HI262,,1994,1990,,134370,10658298,2030864,,67982,6002219,1135992,,66388,4656079,894872,PDN
HI262,,1995,1990,,91372,9715853,1820171,,70056,6868484,1292206,,21316,2847369,527965,PDN
HI262,,1996,1990,,96348,9982527,1872598,,74693,7228411,1360887,,21655,2754116,511711,PDN
HI262,,1997,1990,,96348,9982527,1872598,,78233,7555686,1422661,,18115,2426841,449937,PDN
HI262,,1998,1990,,124882,9982527,1901132,,83993,7755278,1463936,,40889,2227249,437196,PDN
HI262,,1999,1990,,124882,9982527,1901132,,84276,7796615,1471574,,40606,2185912,429558,PDN
HI262,,2000,1990,,124882,9982527,1901132,,85104,7908980,1492396,,39778,2073547,408736,PDN
HI262,,2001,1990,,87376,8159659,1539273,,87376,8159659,1539273,,0,0,0,PDN
HI262,,2002,1990,,87376,8159659,1539273,,87376,8159659,1539273,,0,0,0,PDN
HI262,,2003,1990,,87376,8159659,1539273,,87376,8159659,1539273,,0,0,0,PDN
HI262,,2004,1990,,87376,8159659,1539273,,87376,8159659,1539273,,0,0,0,PDN
HI262,,2005,1990,,87376,8159659,1539273,,87376,8159659,1539273,,0,0,0,PDN
HI262,,2006,1990,,87376,8159659,1539273,,87376,8159659,1539273,,0,0,0,PDN
HI262,,2007,1990,,87376,8159659,1539273,,87376,8159659,1539273,,0,0,0,PDN
HI262,,2008,1990,,87376,8159659,1539273,,87376,8159659,1539273,,0,0,0,PDN
HI262,,2009,1990,,87376,8314557,1566834,,87376,8314557,1566834,,0,0,0,PDN
HI262,,2010,1990,,87376,8314557,1566834,,87376,8314557,1566834,,0,0,0,PDN
HI262,,2011,1990,,87376,8314557,1566834,,87376,8314557,1566834,,0,0,0,PDN
HI262,,2012,1990,,87376,8314557,1566834,,87376,8314557,1566834,,0,0,0,PDN
HI262,,2013,1990,,87376,8314557,1566834,,87376,8314557,1566834,,0,0,0,PDN
HI262,,2014,1990,,87376,8314557,1566834,,87376,8314557,1566834,,0,0,0,PDN
HI262,,2015,1990,,87376,8314557,1566834,,87376,8314557,1566834,,0,0,0,PDN
HI262,,2016,1990,,87376,8314557,1566834,,87376,8314557,1566834,,0,0,0,PDN
HI262,,2017,1990,,87376,8314557,1566834,,87376,8314557,1566834,,0,0,0,PDN
HI262,,2017,1990,,87376,8314557,1566834,,87376,8314557,1566834,,0,0,0,PDN
HI270A,,1978,1975,,900000,27000000,5704270,,0,0,0,,900000,27000000,5704270,PDN
HI270A,,1979,1975,,0,27000000,4804270,,0,0,0,,0,27000000,4804270,PDN
HI270A,,1980,1975,,400000,40000000,7517438,,0,0,0,,400000,40000000,7517438,PDN
HI270A,,1981,1975,,400000,40000000,7517438,,183853,4963488,1067036,,216147,35036512,6450402,PDN
HI270A,,1982,1975,,1609483,61460004,12545427,,509155,21115363,4266337,,1100328,40344641,8279090,PDN
HI270A,,1983,1975,,2186418,92677902,18677148,,800569,36997166,7383695,,1385849,55680736,11293453,PDN
HI270A,,1984,1975,,3222314,154627297,30736068,,1181704,56898266,11305951,,2040610,97729031,19430117,PDN
HI270A,,1985,1975,,3222314,154627297,30736068,,1316931,66367552,13126104,,1905383,88259745,17609964,PDN
HI270A,,1986,1975,,3222314,154627297,30736068,,1398421,75354488,14806693,,1823893,79272809,15929375,PDN
HI270A,,1987,1975,,3222314,154627297,30736068,,1491016,90579168,17608306,,1731298,64048129,13127762,PDN
HI270A,,1988,1975,,3255712,161781243,32042410,,1540787,98834039,19126915,,1714925,62947204,12915495,PDN
HI270A,,1989,1975,,1995321,150958771,28856312,,1573025,103674470,20020440,,422296,47284301,8835872,PDN
HI270A,,1990,1975,,1830618,131483827,25226317,,1598606,108565184,20916254,,232012,22918643,4310063,PDN
HI270A,,1991,1975,,1831601,132215670,25357521,,1612953,112665222,21660146,,218648,19550448,3697375,PDN
HI270A,,1992,1975,,2439790,127936564,25204303,,1655156,115749250,22251108,,784634,12187314,2953195,PDN
HI270A,,1993,1975,,2439023,127970894,25209645,,1748414,117750481,22700457,,690609,10220413,2509188,PDN
HI270A,,1994,1975,,2581905,137653090,27075337,,1780320,121501432,23399792,,801585,16151658,3675545,PDN
HI270A,,1995,1975,,2719945,166534038,32352336,,1830029,134712080,25800150,,889916,31821958,6552186,PDN
HI270A,,1996,1975,,2748379,176051191,34074214,,1880945,143981789,27500480,,867434,32069402,6573734,PDN
HI270A,,1997,1975,,2050182,182848901,34585574,,1919577,150984844,28785208,,130605,31864057,5800366,PDN
HI270A,,1998,1975,,2101288,181928616,34472928,,1953241,154838633,29504599,,148047,27089983,4968329,PDN
HI270A,,1999,1975,,2052558,167038601,31774729,,1998155,157463537,30016578,,54403,9575064,1758151,PDN
HI270A,,2000,1975,,2232498,163619824,31346346,,2072428,158244317,30229780,,160070,5375507,1116566,PDN
HI270A,,2001,1975,,2153989,161049108,30810413,,2096049,159010868,30389798,,57940,2038240,420615,PDN
HI270A,,2002,1975,,2168339,160805558,30781427,,2135259,159833864,30575448,,33080,971694,205979,PDN
HI270A,,2003,1975,,2164952,160596668,30740871,,2148217,159965412,30611813,,16735,631256,129058,PDN
HI270A,,2004,1975,,2148218,160164115,30647171,,2148218,160164115,30647171,,0,0,0,PDN
HI270A,,2005,1975,,2148218,160164115,30647171,,2148218,160164115,30647171,,0,0,0,PDN
HI270A,,2006,1975,,2148218,160164115,30647171,,2148218,160164115,30647171,,0,0,0,PDN
HI270A,,2007,1975,,2148218,160164115,30647171,,2148218,160164115,30647171,,0,0,0,PDN
HI270A,,2008,1975,,2148218,160164115,30647171,,2148218,160164115,30647171,,0,0,0,PDN
HI270A,,2009,1975,,2148219,163244024,31195199,,2148219,163244024,31195199,,0,0,0,PDN
HI270A,,2010,1975,,2148219,163244024,31195199,,2148219,163244024,31195199,,0,0,0,PDN
HI270A,,2011,1975,,2148219,163244024,31195199,,2148219,163244024,31195199,,0,0,0,PDN
HI270A,,2012,1975,,2148219,163244024,31195199,,2148219,163244024,31195199,,0,0,0,PDN
HI270A,,2013,1975,,2148219,163244024,31195199,,2148219,163244024,31195199,,0,0,0,PDN
HI270A,,2014,1975,,2148219,163244024,31195199,,2148219,163244024,31195199,,0,0,0,PDN
HI270A,,2015,1975,,2148219,163244024,31195199,,2148219,163244024,31195199,,0,0,0,PDN
HI270A,,2016,1975,,2148219,163244024,31195199,,2148219,163244024,31195199,,0,0,0,PDN
HI270A,,2017,1975,,2148219,163244024,31195199,,2148219,163244024,31195199,,0,0,0,PDN
HI270A,,2017,1975,,2148219,163244024,31195199,,2148219,163244024,31195199,,0,0,0,PDN
HI271A,,1986,1974,,2162,2949728,527025,,0,0,0,,2162,2949728,527025,PDN
HI271A,,1987,1974,,2162,2949728,527025,,0,0,0,,2162,2949728,527025,PDN
HI271A,,1988,1974,,241962,11127970,2222028,,0,0,0,,241962,11127970,2222028,PDN
HI271A,,1989,1974,,241962,11127970,2222028,,621,667196,119339,,241341,10460774,2102689,PDN
HI271A,,1990,1974,,260258,11127970,2240324,,6963,2745316,495453,,253295,8382654,1744871,PDN
HI271A,,1991,1974,,249137,8748701,1805845,,7348,3626436,652621,,241789,5122265,1153224,PDN
HI271A,,1992,1974,,249428,9321923,1908133,,8075,5401109,969126,,241353,3920814,939007,PDN
HI271A,,1993,1974,,238792,10528361,2112166,,8470,6656097,1192829,,230322,3872264,919337,PDN
HI271A,,1994,1974,,239149,10525453,2112005,,8634,7119935,1275526,,230515,3405518,836479,PDN
HI271A,,1995,1974,,239441,11707222,2322577,,8881,7842501,1404344,,230560,3864721,918233,PDN
HI271A,,1996,1974,,241171,15644377,3024868,,10432,10891797,1948474,,230739,4752580,1076394,PDN
HI271A,,1997,1974,,243013,22531805,4252231,,11551,14156648,2530528,,231462,8375157,1721703,PDN
HI271A,,1998,1974,,245847,31654377,5878298,,13368,21263177,3796851,,232479,10391200,2081447,PDN
HI271A,,1999,1974,,18348,34019749,6071684,,14504,24489100,4371995,,3844,9530649,1699689,PDN
HI271A,,2000,1974,,18377,34110266,6087819,,15395,28274994,5046533,,2982,5835272,1041286,PDN
HI271A,,2001,1974,,23616,36809703,6573385,,17893,31564090,5634279,,5723,5245613,939106,PDN
HI271A,,2002,1974,,21163,35383024,6317075,,18345,32721746,5840720,,2818,2661278,476355,PDN
HI271A,,2003,1974,,21228,35698854,6373337,,18615,33402076,5962045,,2613,2296778,411292,PDN
HI271A,,2004,1974,,20886,35563736,6348953,,18668,34136549,6092787,,2218,1427187,256166,PDN
HI271A,,2005,1974,,20886,35563736,6348953,,18786,34601280,6175597,,2100,962456,173356,PDN
HI271A,,2006,1974,,20859,35550829,6346629,,18853,34887680,6226625,,2006,663149,120004,PDN
HI271A,,2007,1974,,18892,35350065,6308939,,18853,34933614,6234799,,39,416451,74140,PDN
HI271A,,2008,1974,,25571,42844503,7649148,,18866,35059241,6257165,,6705,7785262,1391983,PDN
HI271A,,2009,1974,,23140,38113456,6804894,,21201,36881431,6583733,,1939,1232025,221160,PDN
HI271A,,2010,1974,,23140,38113456,6804894,,22825,37794216,6747775,,315,319240,57119,PDN
HI271A,,2011,1974,,23140,38113456,6804894,,23137,38067447,6796705,,3,46009,8189,PDN
HI271A,,2012,1974,,23140,38113456,6804894,,23140,38113456,6804894,,0,0,0,PDN
HI271A,,2013,1974,,23140,38113456,6804894,,23140,38113456,6804894,,0,0,0,PDN
HI271A,,2014,1974,,23140,38113456,6804894,,23140,38113456,6804894,,0,0,0,PDN
HI271A,,2015,1974,,23140,38113456,6804894,,23140,38113456,6804894,,0,0,0,PDN
HI271A,,2016,1974,,23140,38113456,6804894,,23140,38113456,6804894,,0,0,0,PDN
HI271A,,2017,1974,,23140,38113456,6804894,,23140,38113456,6804894,,0,0,0,PDN
HI271A,,2017,1974,,23140,38113456,6804894,,23140,38113456,6804894,,0,0,0,PDN
HI273A,,1977,1973,,10029,10029250,1794593,,0,0,0,,10029,10029250,1794593,PDN
HI273A,,1978,1973,,22540,22540000,4033216,,0,0,0,,22540,22540000,4033216,PDN
HI273A,,1979,1973,,22540,22540000,4033216,,497,1985236,353742,,22043,20554764,3679474,PDN
HI273A,,1980,1973,,45080,45080000,8066432,,3288,12329384,2197129,,41792,32750616,5869303,PDN
HI273A,,1981,1973,,45080,45080000,8066432,,4159,19835542,3533615,,40921,25244458,4532817,PDN
HI273A,,1982,1973,,45080,45080000,8066432,,4681,24196226,4310059,,40399,20883774,3756373,PDN
HI273A,,1983,1973,,45080,45080000,8066432,,4820,26514841,4722763,,40260,18565159,3343669,PDN
HI273A,,1984,1973,,45080,45080000,8066432,,4820,27260615,4855463,,40260,17819385,3210969,PDN
HI273A,,1985,1973,,45080,45080000,8066432,,4820,27583648,4912942,,40260,17496352,3153490,PDN
HI273A,,1986,1973,,45080,45080000,8066432,,4820,27649141,4924596,,40260,17430859,3141836,PDN
HI273A,,1987,1973,,4820,27649141,4924596,,4820,27649141,4924596,,0,0,0,PDN
HI273A,,1988,1973,,4820,27649141,4924596,,4820,27649141,4924596,,0,0,0,PDN
HI273A,,1989,1973,,4820,27649141,4924596,,4820,27649141,4924596,,0,0,0,PDN
HI273A,,1990,1973,,4820,27649141,4924596,,4820,27649141,4924596,,0,0,0,PDN
HI273A,,1991,1973,,4820,27649141,4924596,,4820,27649141,4924596,,0,0,0,PDN
HI273A,,1992,1973,,4820,27649141,4924596,,4820,27649141,4924596,,0,0,0,PDN
HI273A,,1993,1973,,4820,27649141,4924596,,4820,27649141,4924596,,0,0,0,PDN
HI273A,,1994,1973,,4820,27649141,4924596,,4820,27649141,4924596,,0,0,0,PDN
HI273A,,1995,1973,,4820,27649141,4924596,,4820,27649141,4924596,,0,0,0,PDN
HI273A,,1996,1973,,4820,27649141,4924596,,4820,27649141,4924596,,0,0,0,PDN
HI273A,,1997,1973,,4820,27649141,4924596,,4820,27649141,4924596,,0,0,0,PDN
HI273A,,1998,1973,,4820,27649141,4924596,,4820,27649141,4924596,,0,0,0,PDN
HI273A,,1999,1973,,4820,27649141,4924596,,4820,27649141,4924596,,0,0,0,PDN
HI273A,,2000,1973,,4820,27649141,4924596,,4820,27649141,4924596,,0,0,0,PDN
HI273A,,2001,1973,,4820,27649141,4924596,,4820,27649141,4924596,,0,0,0,PDN
HI273A,,2002,1973,,4820,27649141,4924596,,4820,27649141,4924596,,0,0,0,PDN
HI273A,,2003,1973,,4820,27649141,4924596,,4820,27649141,4924596,,0,0,0,PDN
HI273A,,2004,1973,,4820,27649141,4924596,,4820,27649141,4924596,,0,0,0,PDN
HI273A,,2005,1973,,4820,27649141,4924596,,4820,27649141,4924596,,0,0,0,PDN
HI273A,,2006,1973,,4820,27649141,4924596,,4820,27649141,4924596,,0,0,0,PDN
HI273A,,2007,1973,,4820,27649141,4924596,,4820,27649141,4924596,,0,0,0,PDN
HI273A,,2008,1973,,4820,27649141,4924596,,4820,27649141,4924596,,0,0,0,PDN
HI273A,,2009,1973,,4820,28202876,5023125,,4820,28202876,5023125,,0,0,0,PDN
HI273A,,2010,1973,,4820,28202876,5023125,,4820,28202876,5023125,,0,0,0,PDN
HI273A,,2011,1973,,4820,28202876,5023125,,4820,28202876,5023125,,0,0,0,PDN
HI273A,,2012,1973,,4820,28202876,5023125,,4820,28202876,5023125,,0,0,0,PDN
HI273A,,2013,1973,,4820,28202876,5023125,,4820,28202876,5023125,,0,0,0,PDN
HI273A,,2014,1973,,4820,28202876,5023125,,4820,28202876,5023125,,0,0,0,PDN
HI273A,,2015,1973,,4820,28202876,5023125,,4820,28202876,5023125,,0,0,0,PDN
HI273A,,2016,1973,,4820,28202876,5023125,,4820,28202876,5023125,,0,0,0,PDN
HI273A,,2017,1973,,4820,28202876,5023125,,4820,28202876,5023125,,0,0,0,PDN
HI273A,,2017,1973,,4820,28202876,5023125,,4820,28202876,5023125,,0,0,0,PDN
HI274A,,1997,1996,,817,1018792,182097,,817,1018792,182097,,0,0,0,PDN
HI274A,,1998,1996,,817,1018792,182097,,817,1018792,182097,,0,0,0,PDN
HI274A,,1999,1996,,817,1018792,182097,,817,1018792,182097,,0,0,0,PDN
HI274A,,2000,1996,,817,1018792,182097,,817,1018792,182097,,0,0,0,PDN
HI274A,,2001,1996,,817,1018792,182097,,817,1018792,182097,,0,0,0,PDN
HI274A,,2002,1996,,817,1018792,182097,,817,1018792,182097,,0,0,0,PDN
HI274A,,2003,1996,,817,1018792,182097,,817,1018792,182097,,0,0,0,PDN
HI274A,,2004,1996,,817,1018792,182097,,817,1018792,182097,,0,0,0,PDN
HI274A,,2005,1996,,817,1018792,182097,,817,1018792,182097,,0,0,0,PDN
HI274A,,2006,1996,,817,1018792,182097,,817,1018792,182097,,0,0,0,PDN
HI274A,,2007,1996,,817,1018792,182097,,817,1018792,182097,,0,0,0,PDN
HI274A,,2008,1996,,817,1018792,182097,,817,1018792,182097,,0,0,0,PDN
HI274A,,2009,1996,,817,1039196,185727,,817,1039196,185727,,0,0,0,PDN
HI274A,,2010,1996,,817,1039196,185727,,817,1039196,185727,,0,0,0,PDN
HI274A,,2011,1996,,817,1039196,185727,,817,1039196,185727,,0,0,0,PDN
HI274A,,2012,1996,,817,1039196,185727,,817,1039196,185727,,0,0,0,PDN
HI274A,,2013,1996,,817,1039196,185727,,817,1039196,185727,,0,0,0,PDN
HI274A,,2014,1996,,817,1039196,185727,,817,1039196,185727,,0,0,0,PDN
HI274A,,2015,1996,,817,1039196,185727,,817,1039196,185727,,0,0,0,PDN
HI274A,,2016,1996,,817,1039196,185727,,817,1039196,185727,,0,0,0,PDN
HI274A,,2017,1996,,817,1039196,185727,,817,1039196,185727,,0,0,0,PDN
HI274A,,2017,1996,,817,1039196,185727,,817,1039196,185727,,0,0,0,PDN
HI279A,,1977,1974,,100000,66900000,12003915,,0,0,0,,100000,66900000,12003915,PDN
HI279A,,1978,1974,,33054,33053410,5914444,,0,0,0,,33054,33053410,5914444,PDN
HI279A,,1979,1974,,40406,33183410,5944927,,2969,3016718,539752,,37437,30166692,5405175,PDN
HI279A,,1980,1974,,44926,56273710,10058042,,12870,17735449,3168644,,32056,38538261,6889398,PDN
HI279A,,1981,1974,,73250,55146867,9885860,,21685,25217531,4508790,,51565,29929336,5377070,PDN
HI279A,,1982,1974,,73796,55146867,9886406,,30837,27938241,5002054,,42959,27208626,4884352,PDN
HI279A,,1983,1974,,97941,58100558,10436119,,31419,30116594,5390244,,66522,27983964,5045875,PDN
HI279A,,1984,1974,,96110,58100558,10434288,,32004,32214863,5764186,,64106,25885695,4670102,PDN
HI279A,,1985,1974,,145226,59716559,10770948,,34497,33525810,5999944,,110729,26190749,4771004,PDN
HI279A,,1986,1974,,145495,59716559,10771217,,38117,34372892,6154290,,107378,25343667,4616927,PDN
HI279A,,1987,1974,,148106,64530656,11630429,,41362,35327219,6327344,,106744,29203437,5303085,PDN
HI279A,,1988,1974,,148106,64530656,11630429,,42522,35692234,6393453,,105584,28838422,5236976,PDN
HI279A,,1989,1974,,42522,35692234,6393453,,42522,35692234,6393453,,0,0,0,PDN
HI279A,,1990,1974,,42522,35692234,6393453,,42522,35692234,6393453,,0,0,0,PDN
HI279A,,1991,1974,,42522,35692234,6393453,,42522,35692234,6393453,,0,0,0,PDN
HI279A,,1992,1974,,42522,35692234,6393453,,42522,35692234,6393453,,0,0,0,PDN
HI279A,,1993,1974,,42522,35692234,6393453,,42522,35692234,6393453,,0,0,0,PDN
HI279A,,1994,1974,,42523,35692234,6393454,,42523,35692234,6393454,,0,0,0,PDN
HI279A,,1995,1974,,42523,35692234,6393454,,42523,35692234,6393454,,0,0,0,PDN
HI279A,,1996,1974,,42523,35692234,6393454,,42523,35692234,6393454,,0,0,0,PDN
HI279A,,1997,1974,,55646,47767896,8555272,,47447,42796288,7662445,,8199,4971608,892827,PDN
HI279A,,1998,1974,,47447,42796288,7662445,,47447,42796288,7662445,,0,0,0,PDN
HI279A,,1999,1974,,47447,42796288,7662445,,47447,42796288,7662445,,0,0,0,PDN
HI279A,,2000,1974,,47447,42796288,7662445,,47447,42796288,7662445,,0,0,0,PDN
HI279A,,2001,1974,,47447,42796288,7662445,,47447,42796288,7662445,,0,0,0,PDN
HI279A,,2002,1974,,47447,42796288,7662445,,47447,42796288,7662445,,0,0,0,PDN
HI279A,,2003,1974,,47447,42796288,7662445,,47447,42796288,7662445,,0,0,0,PDN
HI279A,,2004,1974,,47447,42796288,7662445,,47447,42796288,7662445,,0,0,0,PDN
HI279A,,2005,1974,,47447,42796288,7662445,,47447,42796288,7662445,,0,0,0,PDN
HI279A,,2006,1974,,47447,42796288,7662445,,47447,42796288,7662445,,0,0,0,PDN
HI279A,,2007,1974,,47447,42796288,7662445,,47447,42796288,7662445,,0,0,0,PDN
HI279A,,2008,1974,,47447,42796288,7662445,,47447,42796288,7662445,,0,0,0,PDN
HI279A,,2009,1974,,47446,43653371,7814951,,47446,43653371,7814951,,0,0,0,PDN
HI279A,,2010,1974,,47446,43653371,7814951,,47446,43653371,7814951,,0,0,0,PDN
HI279A,,2011,1974,,47446,43653371,7814951,,47446,43653371,7814951,,0,0,0,PDN
HI279A,,2012,1974,,47446,43653371,7814951,,47446,43653371,7814951,,0,0,0,PDN
HI279A,,2013,1974,,47446,43653371,7814951,,47446,43653371,7814951,,0,0,0,PDN
HI279A,,2014,1974,,47446,43653371,7814951,,47446,43653371,7814951,,0,0,0,PDN
HI279A,,2015,1974,,47446,43653371,7814951,,47446,43653371,7814951,,0,0,0,PDN
HI279A,,2016,1974,,47446,43653371,7814951,,47446,43653371,7814951,,0,0,0,PDN
HI279A,,2017,1974,,47446,43653371,7814951,,47446,43653371,7814951,,0,0,0,PDN
HI279A,,2017,1974,,47446,43653371,7814951,,47446,43653371,7814951,,0,0,0,PDN
HI280A,,1977,1974,,0,15504500,2758808,,0,0,0,,0,15504500,2758808,PDN
HI280A,,1978,1974,,5000,20504500,3653488,,0,0,0,,5000,20504500,3653488,PDN
HI280A,,1979,1974,,35200,40504500,7242406,,31148,6280241,1148629,,4052,34224259,6093777,PDN
HI280A,,1980,1974,,451803,106389653,19382346,,105537,24434890,4453382,,346266,81954763,14928964,PDN
HI280A,,1981,1974,,468086,115312193,20986270,,172716,42427947,7722173,,295370,72884246,13264097,PDN
HI280A,,1982,1974,,471801,116750693,21245946,,249581,65056563,11825482,,222220,51694130,9420464,PDN
HI280A,,1983,1974,,558858,142100480,25843641,,296299,78703795,14300533,,262559,63396685,11543108,PDN
HI280A,,1984,1974,,564560,181414670,32844750,,374034,105532301,19152024,,190526,75882369,13692726,PDN
HI280A,,1985,1974,,553457,166083797,30105734,,394475,117494056,21300891,,158982,48589741,8804843,PDN
HI280A,,1986,1974,,559285,171129420,31009360,,404878,125708681,22772971,,154407,45420739,8236389,PDN
HI280A,,1987,1974,,544895,163891623,29707105,,411080,129474287,23449209,,133815,34417336,6257896,PDN
HI280A,,1988,1974,,538076,158894307,28811084,,415468,132460520,23984956,,122608,26433787,4826128,PDN
HI280A,,1989,1974,,520798,157129741,28479827,,421064,134290108,24316101,,99734,22839633,4163726,PDN
HI280A,,1990,1974,,504578,153637709,27842249,,423837,135436729,24522899,,80741,18200980,3319350,PDN
HI280A,,1991,1974,,512754,153637709,27850425,,428560,136003688,24628504,,84194,17634021,3221921,PDN
HI280A,,1992,1974,,512284,153385713,27805115,,435875,136743157,24767398,,76409,16642556,3037717,PDN
HI280A,,1993,1974,,449079,139633029,25294814,,437782,137313872,24870855,,11297,2319157,423959,PDN
HI280A,,1994,1974,,465460,152987491,27687433,,443077,139976610,25349947,,22383,13010881,2337486,PDN
HI280A,,1995,1974,,486320,153048253,27719105,,456193,143753553,26035117,,30127,9294700,1683988,PDN
HI280A,,1996,1974,,484071,152836771,27679226,,462087,144979562,26259162,,21984,7857209,1420064,PDN
HI280A,,1997,1974,,505734,149961588,27189291,,459399,139465995,25275412,,46335,10495593,1913879,PDN
HI280A,,1998,1974,,509065,153658149,27850373,,470350,144367376,26158495,,38715,9290773,1691878,PDN
HI280A,,1999,1974,,589797,156065376,28359437,,490269,145393276,26360959,,99528,10672100,1998478,PDN
HI280A,,2000,1974,,592695,157601908,28635739,,499204,145410417,26372944,,93491,12191491,2262795,PDN
HI280A,,2001,1974,,559238,162864511,29538688,,514721,150374341,27271721,,44517,12490170,2266967,PDN
HI280A,,2002,1974,,559238,162864511,29538688,,524556,152812211,27715341,,34682,10052300,1823347,PDN
HI280A,,2003,1974,,559238,162864511,29538688,,531402,155332648,28170663,,27836,7531863,1368025,PDN
HI280A,,2004,1974,,533438,155520709,28206162,,531456,155348918,28173612,,1982,171791,32550,PDN
HI280A,,2005,1974,,533438,155520709,28206162,,533438,155520709,28206162,,0,0,0,PDN
HI280A,,2006,1974,,557983,165902838,30078061,,533438,155520708,28206162,,24545,10382130,1871899,PDN
HI280A,,2007,1974,,557983,165902838,30078061,,533980,156050851,28301035,,24003,9851987,1777026,PDN
HI280A,,2008,1974,,557983,165902838,30078061,,541922,157133695,28501654,,16061,8769143,1576407,PDN
HI280A,,2009,1974,,566652,169139996,30662738,,541922,160016928,29014686,,24730,9123068,1648052,PDN
HI280A,,2010,1974,,566652,169139996,30662738,,541922,160048649,29020331,,24730,9091347,1642407,PDN
HI280A,,2011,1974,,566652,169139996,30662738,,542533,160378027,29079550,,24119,8761969,1583188,PDN
HI280A,,2012,1974,,566652,169139996,30662738,,542534,160640166,29126195,,24118,8499830,1536543,PDN
HI280A,,2013,1974,,566652,169139996,30662738,,542534,160687783,29134668,,24118,8452213,1528070,PDN
HI280A,,2014,1974,,542601,161259858,29236528,,542546,160719548,29140331,,55,540310,96195,PDN
HI280A,,2015,1974,,542548,160739246,29143839,,542548,160739246,29143839,,0,0,0,PDN
HI280A,,2016,1974,,542201,160739246,29143492,,542201,160739246,29143492,,0,0,0,PDN
HI280A,,2017,1974,,542201,160739246,29143492,,542201,160739246,29143492,,0,0,0,PDN
HI280A,,2017,1974,,542201,160739246,29143492,,542201,160739246,29143492,,0,0,0,PDN
HI283A,,1978,1973,,20000,20000000,3578719,,0,0,0,,20000,20000000,3578719,PDP
HI283A,,1979,1973,,200000,30000000,5538078,,0,0,0,,200000,30000000,5538078,PDP
HI283A,,1980,1973,,280000,60000000,10956157,,55757,14346218,2608465,,224243,45653782,8347692,PDP
HI283A,,1981,1973,,244757,62586100,11381074,,92633,16486815,3026230,,152124,46099285,8354844,PDP
HI283A,,1982,1973,,245737,62586100,11382054,,121932,23006839,4215676,,123805,39579261,7166378,PDP
HI283A,,1983,1973,,246737,64086100,11649958,,136254,26721027,4890885,,110483,37365073,6759073,PDP
HI283A,,1984,1973,,288737,75285702,13684769,,143604,29311003,5359085,,145133,45974699,8325684,PDP
HI283A,,1985,1973,,288737,75285702,13684769,,151283,31061396,5678222,,137454,44224306,8006547,PDP
HI283A,,1986,1973,,288737,75285702,13684769,,159452,33348205,6093296,,129285,41937497,7591473,PDP
HI283A,,1987,1973,,291500,75285702,13687532,,172168,39187342,7145005,,119332,36098360,6542527,PDP
HI283A,,1988,1973,,305117,79044669,14370005,,181907,43320305,7890146,,123210,35724364,6479859,PDP
HI283A,,1989,1973,,295471,76502391,13907996,,189649,45839607,8346163,,105822,30662784,5561833,PDP
HI283A,,1990,1973,,259881,76616708,13892747,,195657,47307999,8613450,,64224,29308709,5279297,PDP
HI283A,,1991,1973,,254141,71253829,12932758,,206813,50499586,9192504,,47328,20754243,3740254,PDP
HI283A,,1992,1973,,268014,68419344,12442274,,214689,52427039,9543344,,53325,15992305,2898930,PDP
HI283A,,1993,1973,,251753,67618731,12283556,,218356,55183492,10037483,,33397,12435239,2246073,PDP
HI283A,,1994,1973,,304568,80923695,14703802,,226649,59236045,10766871,,77919,21687650,3936931,PDP
HI283A,,1995,1973,,304568,80923695,14703802,,232407,62169067,11294519,,72161,18754628,3409283,PDP
HI283A,,1996,1973,,299803,79421314,14431709,,235723,63731080,11575773,,64080,15690234,2855936,PDP
HI283A,,1997,1973,,298220,79811240,14499508,,239612,65321493,11862653,,58608,14489747,2636855,PDP
HI283A,,1998,1973,,302214,81708425,14841080,,242666,67126624,12186905,,59548,14581801,2654175,PDP
HI283A,,1999,1973,,266308,78546733,14242595,,245266,68750559,12478462,,21042,9796174,1764133,PDP
HI283A,,2000,1973,,266308,78546733,14242595,,248734,70227425,12744717,,17574,8319308,1497878,PDP
HI283A,,2001,1973,,263606,77438420,14042684,,250513,71659335,13001284,,13093,5779085,1041400,PDP
HI283A,,2002,1973,,266197,78214414,14183353,,250571,72315185,13118042,,15626,5899229,1065311,PDP
HI283A,,2003,1973,,283052,91080005,16489459,,250892,73504079,13329910,,32160,17575926,3159549,PDP
HI283A,,2004,1973,,440246,104444434,19024665,,324428,89905182,16321791,,115818,14539252,2702874,PDP
HI283A,,2005,1973,,505817,105535359,19284351,,377674,96298520,17512642,,128143,9236839,1771709,PDP
HI283A,,2006,1973,,649485,111517066,20492379,,420717,98785139,17998144,,228768,12731927,2494235,PDP
HI283A,,2007,1973,,654918,114236982,20981783,,468276,103545586,18892757,,186642,10691396,2089026,PDP
HI283A,,2008,1973,,675207,125041419,22924570,,534058,107717674,19700904,,141149,17323745,3223666,PDP
HI283A,,2009,1973,,679389,126710886,23225810,,574235,112894625,20662247,,105154,13816261,2563563,PDP
HI283A,,2010,1973,,685246,126738685,23236614,,616219,115255615,21124337,,69027,11483070,2112278,PDP
HI283A,,2011,1973,,685068,127007361,23284243,,636592,116899555,21437225,,48476,10107806,1847018,PDP
HI283A,,2012,1973,,658563,120157746,22038946,,650381,117951239,21638147,,8182,2206507,400799,PDP
HI283A,,2013,1973,,662604,120543490,22111625,,656127,118780850,21791510,,6477,1762640,320114,PDP
HI283A,,2014,1973,,662604,120543490,22111625,,657097,118991957,21830043,,5507,1551533,281580,PDP
HI283A,,2015,1973,,662604,120543490,22111625,,658684,119365809,21898153,,3920,1177681,213472,PDP
HI283A,,2016,1973,,662100,120808873,22158341,,659999,119821800,21980605,,2101,987073,177737,PDP
HI283A,,2017,1973,,662100,120808873,22158341,,659999,119878151,21990631,,2101,930722,167710,PDP
HI283A,,2017,1973,,662100,120808873,22158341,,659999,119878151,21990631,,2101,930722,167710,PDP
HI285A,,1979,1978,,0,70000000,12455516,,0,0,0,,0,70000000,12455516,PDN
HI285A,,1980,1978,,194000,72500000,13094356,,15655,6155198,1110886,,178345,66344802,11983470,PDN
HI285A,,1981,1978,,955600,117343412,21835211,,281421,42235806,7796689,,674179,75107606,14038522,PDN
HI285A,,1982,1978,,1562646,117291282,22432981,,513569,49740733,9364233,,1049077,67550549,13068748,PDN
HI285A,,1983,1978,,1580346,119291282,22806553,,520742,54611487,10238088,,1059604,64679795,12568465,PDN
HI285A,,1984,1978,,1580346,119291282,22806553,,83053,58597147,10509592,,1497293,60694135,12296961,PDN
HI285A,,1985,1978,,1585662,120019283,22941406,,84453,61419295,11013153,,1501209,58599988,11928253,PDN
HI285A,,1986,1978,,1585662,120019283,22941406,,88838,66362450,11897103,,1496824,53656833,11044303,PDN
HI285A,,1987,1978,,1579865,135270169,25649290,,92361,71909375,12887623,,1487504,63360794,12761667,PDN
HI285A,,1988,1978,,1576124,140719212,26615130,,94623,74661982,13379673,,1481501,66057230,13235457,PDN
HI285A,,1989,1978,,114044,87420787,15669344,,96179,76151454,13646260,,17865,11269333,2023084,PDN
HI285A,,1990,1978,,108174,87420787,15663474,,97484,77520414,13891152,,10690,9900373,1772322,PDN
HI285A,,1991,1978,,108174,87420787,15663474,,98401,78833431,14125702,,9773,8587356,1537772,PDN
HI285A,,1992,1978,,110061,87420787,15665361,,98883,79708998,14281979,,11178,7711789,1383382,PDN
HI285A,,1993,1978,,110452,88075691,15782283,,99256,80327875,14392472,,11196,7747816,1389811,PDN
HI285A,,1994,1978,,102284,84507911,15139279,,99358,80377532,14401410,,2926,4130379,737869,PDN
HI285A,,1995,1978,,103232,85061131,15238665,,99819,81209147,14549845,,3413,3851984,688820,PDN
HI285A,,1996,1978,,103951,86669496,15525570,,100494,82206140,14727921,,3457,4463356,797649,PDN
HI285A,,1997,1978,,103951,86669496,15525570,,100566,82341165,14752019,,3385,4328331,773551,PDN
HI285A,,1998,1978,,103951,86669496,15525570,,100607,82391111,14760947,,3344,4278385,764623,PDN
HI285A,,1999,1978,,102488,84406059,15121360,,100624,82584998,14795464,,1864,1821061,325896,PDN
HI285A,,2000,1978,,100645,82726985,14820749,,100645,82726985,14820749,,0,0,0,PDN
HI285A,,2001,1978,,100645,82726985,14820749,,100645,82726985,14820749,,0,0,0,PDN
HI285A,,2002,1978,,100645,82726985,14820749,,100645,82726985,14820749,,0,0,0,PDN
HI285A,,2003,1978,,105464,87982318,15760681,,100645,82726985,14820749,,4819,5255333,939932,PDN
HI285A,,2004,1978,,139187,88025997,15802176,,100645,82726985,14820749,,38542,5299012,981427,PDN
HI285A,,2005,1978,,139187,88025997,15802176,,109795,84161786,15085202,,29392,3864211,716974,PDN
HI285A,,2006,1978,,127252,88918480,15949046,,122341,87402492,15674386,,4911,1515988,274660,PDN
HI285A,,2007,1978,,127252,88918480,15949046,,127252,88856426,15938004,,0,62054,11042,PDN
HI285A,,2008,1978,,127252,88911356,15947778,,127252,88911356,15947778,,0,0,0,PDN
HI285A,,2009,1978,,127252,90561382,16241376,,127252,90561382,16241376,,0,0,0,PDN
HI285A,,2010,1978,,127252,90561382,16241376,,127252,90561382,16241376,,0,0,0,PDN
HI285A,,2011,1978,,127252,90561382,16241376,,127252,90561382,16241376,,0,0,0,PDN
HI285A,,2012,1978,,127252,90561382,16241376,,127252,90561382,16241376,,0,0,0,PDN
HI285A,,2013,1978,,127252,90561382,16241376,,127252,90561382,16241376,,0,0,0,PDN
HI285A,,2014,1978,,127252,90561382,16241376,,127252,90561382,16241376,,0,0,0,PDN
HI285A,,2015,1978,,127252,90561382,16241376,,127252,90561382,16241376,,0,0,0,PDN
HI285A,,2016,1978,,127252,90561382,16241376,,127252,90561382,16241376,,0,0,0,PDN
HI285A,,2017,1978,,127252,90561382,16241376,,127252,90561382,16241376,,0,0,0,PDN
HI285A,,2017,1978,,127252,90561382,16241376,,127252,90561382,16241376,,0,0,0,PDN
HI290A,,1978,1976,,9952,9951700,1780717,,0,0,0,,9952,9951700,1780717,PDN
HI290A,,1979,1976,,9952,9951700,1780717,,0,0,0,,9952,9951700,1780717,PDN
HI290A,,1980,1976,,9952,9951700,1780717,,0,0,0,,9952,9951700,1780717,PDN
HI290A,,1981,1976,,14494,14493300,2593373,,0,0,0,,14494,14493300,2593373,PDN
HI290A,,1982,1976,,14494,14493302,2593373,,0,0,0,,14494,14493302,2593373,PDN
HI290A,,1983,1976,,59011,16755537,3040423,,0,0,0,,59011,16755537,3040423,PDN
HI290A,,1984,1976,,50225,22901223,4125176,,2964,2741500,490775,,47261,20159723,3634401,PDN
HI290A,,1985,1976,,50427,22901223,4125378,,4835,5740500,1026276,,45592,17160723,3099102,PDN
HI290A,,1986,1976,,50427,22901223,4125378,,7480,9718837,1736810,,42947,13182386,2388568,PDN
HI290A,,1987,1976,,39363,26899191,4825696,,9210,13531062,2416872,,30153,13368129,2408824,PDN
HI290A,,1988,1976,,41803,37176121,6656771,,10112,16374139,2923660,,31691,20801982,3733111,PDN
HI290A,,1989,1976,,20476,36309242,6481195,,10305,17744834,3167749,,10171,18564408,3313446,PDN
HI290A,,1990,1976,,11021,22912770,4088026,,10440,18709675,3339564,,581,4203095,748462,PDN
HI290A,,1991,1976,,10440,18710834,3339770,,10440,18710834,3339770,,0,0,0,PDN
HI290A,,1992,1976,,10440,18710834,3339770,,10440,18710834,3339770,,0,0,0,PDN
HI290A,,1993,1976,,10440,18710834,3339770,,10440,18710834,3339770,,0,0,0,PDN
HI290A,,1994,1976,,10440,18710834,3339770,,10440,18710834,3339770,,0,0,0,PDN
HI290A,,1995,1976,,10440,18710834,3339770,,10440,18710834,3339770,,0,0,0,PDN
HI290A,,1996,1976,,10440,18710834,3339770,,10440,18710834,3339770,,0,0,0,PDN
HI290A,,1997,1976,,10440,18710834,3339770,,10440,18710834,3339770,,0,0,0,PDN
HI290A,,1998,1976,,10440,18710834,3339770,,10440,18710834,3339770,,0,0,0,PDN
HI290A,,1999,1976,,10440,18710834,3339770,,10440,18710834,3339770,,0,0,0,PDN
HI290A,,2000,1976,,10440,18710834,3339770,,10440,18710834,3339770,,0,0,0,PDN
HI290A,,2001,1976,,10440,18710834,3339770,,10440,18710834,3339770,,0,0,0,PDN
HI290A,,2002,1976,,10440,18710834,3339770,,10440,18710834,3339770,,0,0,0,PDN
HI290A,,2003,1976,,10440,18710834,3339770,,10440,18710834,3339770,,0,0,0,PDN
HI290A,,2004,1976,,10440,18710834,3339770,,10440,18710834,3339770,,0,0,0,PDN
HI290A,,2005,1976,,10440,18710834,3339770,,10440,18710834,3339770,,0,0,0,PDN
HI290A,,2006,1976,,10440,18710834,3339770,,10440,18710834,3339770,,0,0,0,PDN
HI290A,,2007,1976,,10440,18710834,3339770,,10440,18710834,3339770,,0,0,0,PDN
HI290A,,2008,1976,,10440,18710834,3339770,,10440,18710834,3339770,,0,0,0,PDN
HI290A,,2009,1976,,10440,19085559,3406447,,10440,19085559,3406447,,0,0,0,PDN
HI290A,,2010,1976,,10440,19085559,3406447,,10440,19085559,3406447,,0,0,0,PDN
HI290A,,2011,1976,,10440,19085559,3406447,,10440,19085559,3406447,,0,0,0,PDN
HI290A,,2012,1976,,10440,19085559,3406447,,10440,19085559,3406447,,0,0,0,PDN
HI290A,,2013,1976,,10440,19085559,3406447,,10440,19085559,3406447,,0,0,0,PDN
HI290A,,2014,1976,,10440,19085559,3406447,,10440,19085559,3406447,,0,0,0,PDN
HI290A,,2015,1976,,10440,19085559,3406447,,10440,19085559,3406447,,0,0,0,PDN
HI290A,,2016,1976,,10440,19085559,3406447,,10440,19085559,3406447,,0,0,0,PDN
HI290A,,2017,1976,,10440,19085559,3406447,,10440,19085559,3406447,,0,0,0,PDN
HI290A,,2017,1976,,10440,19085559,3406447,,10440,19085559,3406447,,0,0,0,PDN
HI295A,,1992,1990,,0,24495565,4358641,,0,830212,147725,,0,23665353,4210916,PDN
HI295A,,1993,1990,,98,24495565,4358739,,20,4272318,760219,,78,20223247,3598520,PDN
HI295A,,1994,1990,,20,4642191,826033,,20,4642191,826033,,0,0,0,PDN
HI295A,,1995,1990,,20,4642191,826033,,20,4642191,826033,,0,0,0,PDN
HI295A,,1996,1990,,20,4642191,826033,,20,4642191,826033,,0,0,0,PDN
HI295A,,1997,1990,,20,4642191,826033,,20,4642191,826033,,0,0,0,PDN
HI295A,,1998,1990,,20,4642191,826033,,20,4642191,826033,,0,0,0,PDN
HI295A,,1999,1990,,20,4642191,826033,,20,4642191,826033,,0,0,0,PDN
HI295A,,2000,1990,,20,4642191,826033,,20,4642191,826033,,0,0,0,PDN
HI295A,,2001,1990,,20,4642191,826033,,20,4642191,826033,,0,0,0,PDN
HI295A,,2002,1990,,20,4642191,826033,,20,4642191,826033,,0,0,0,PDN
HI295A,,2003,1990,,20,4642191,826033,,20,4642191,826033,,0,0,0,PDN
HI295A,,2004,1990,,20,4642191,826033,,20,4642191,826033,,0,0,0,PDN
HI295A,,2005,1990,,20,4642191,826033,,20,4642191,826033,,0,0,0,PDN
HI295A,,2006,1990,,20,4642191,826033,,20,4642191,826033,,0,0,0,PDN
HI295A,,2007,1990,,20,4642191,826033,,20,4642191,826033,,0,0,0,PDN
HI295A,,2008,1990,,20,4642191,826033,,20,4642191,826033,,0,0,0,PDN
HI295A,,2009,1990,,20,4735161,842576,,20,4735161,842576,,0,0,0,PDN
HI295A,,2010,1990,,20,4735161,842576,,20,4735161,842576,,0,0,0,PDN
HI295A,,2011,1990,,20,4735161,842576,,20,4735161,842576,,0,0,0,PDN
HI295A,,2012,1990,,20,4735161,842576,,20,4735161,842576,,0,0,0,PDN
HI295A,,2013,1990,,20,4735161,842576,,20,4735161,842576,,0,0,0,PDN
HI295A,,2014,1990,,20,4735161,842576,,20,4735161,842576,,0,0,0,PDN
HI295A,,2015,1990,,20,4735161,842576,,20,4735161,842576,,0,0,0,PDN
HI295A,,2016,1990,,20,4735161,842576,,20,4735161,842576,,0,0,0,PDN
HI295A,,2017,1990,,20,4735161,842576,,20,4735161,842576,,0,0,0,PDN
HI295A,,2017,1990,,20,4735161,842576,,20,4735161,842576,,0,0,0,PDN
HI302A,,1976,1975,,0,77000000,13701068,,0,0,0,,0,77000000,13701068,PDN
HI302A,,1977,1975,,319165,319165030,57110096,,0,0,0,,319165,319165030,57110096,PDN
HI302A,,1978,1975,,319164,319163470,57109817,,0,0,0,,319164,319163470,57109817,PDN
HI302A,,1979,1975,,319164,319163470,57109817,,1207,45361310,8072614,,317957,273802160,49037203,PDN
HI302A,,1980,1975,,319980,1041163470,185580384,,2019,78030626,13886472,,317961,963132844,171693912,PDN
HI302A,,1981,1975,,9537,319194000,56805622,,2509,106610545,18972357,,7028,212583455,37833265,PDN
HI302A,,1982,1975,,9537,319194000,56805622,,2889,146289499,26033049,,6648,172904501,30772573,PDN
HI302A,,1983,1975,,9528,336879856,59952563,,2918,177569067,31598837,,6610,159310789,28353726,PDN
HI302A,,1984,1975,,9528,336879856,59952563,,2944,209853265,37343383,,6584,127026591,22609180,PDN
HI302A,,1985,1975,,9528,336879856,59952563,,2957,225172725,40069278,,6571,111707131,19883285,PDN
HI302A,,1986,1975,,9945,341046439,60694365,,2957,231699458,41230619,,6988,109346981,19463746,PDN
HI302A,,1987,1975,,9945,341046439,60694365,,2957,242069277,43075782,,6988,98977162,17618583,PDN
HI302A,,1988,1975,,9528,338099313,60169548,,2957,246125383,43797509,,6571,91973930,16372039,PDN
HI302A,,1989,1975,,3613,262540637,46719029,,2957,248348759,44193128,,656,14191878,2525901,PDN
HI302A,,1990,1975,,2957,261154961,46471811,,2957,251355918,44728209,,0,9799043,1743602,PDN
HI302A,,1991,1975,,2957,279696337,49770988,,2957,259165328,46117784,,0,20531009,3653204,PDN
HI302A,,1992,1975,,3479,281892053,50162207,,3099,264934396,47144451,,380,16957657,3017756,PDN
HI302A,,1993,1975,,3479,283796405,50501060,,3099,268801062,47832469,,380,14995343,2668591,PDN
HI302A,,1994,1975,,4284,291846023,51934181,,3155,276039562,49120515,,1129,15806461,2813666,PDN
HI302A,,1995,1975,,3731,299785912,53346420,,3313,282414363,50254979,,418,17371549,3091441,PDN
HI302A,,1996,1975,,3674,310523806,55257020,,3313,284681802,50658438,,361,25842004,4598582,PDN
HI302A,,1997,1975,,3344,309881786,55142452,,3313,286417926,50967357,,31,23463860,4175095,PDN
HI302A,,1998,1975,,3344,319444227,56843954,,3313,288297392,51301781,,31,31146835,5542173,PDN
HI302A,,1999,1975,,3313,288424232,51324351,,3313,287527706,51164827,,0,896526,159524,PDN
HI302A,,2000,1975,,3313,288426729,51324795,,3313,287554017,51169508,,0,872712,155287,PDN
HI302A,,2001,1975,,3313,287554017,51169508,,3313,287554017,51169508,,0,0,0,PDN
HI302A,,2002,1975,,3313,287554017,51169508,,3313,287554017,51169508,,0,0,0,PDN
HI302A,,2003,1975,,3313,287554017,51169508,,3313,287554017,51169508,,0,0,0,PDN
HI302A,,2004,1975,,3313,287554017,51169508,,3313,287554017,51169508,,0,0,0,PDN
HI302A,,2005,1975,,3313,287554017,51169508,,3313,287554017,51169508,,0,0,0,PDN
HI302A,,2006,1975,,3313,287554017,51169508,,3313,287554017,51169508,,0,0,0,PDN
HI302A,,2007,1975,,3313,287554017,51169508,,3313,287554017,51169508,,0,0,0,PDN
HI302A,,2008,1975,,3313,287554017,51169508,,3313,287554017,51169508,,0,0,0,PDN
HI302A,,2009,1975,,3313,293308639,52193462,,3313,293308639,52193462,,0,0,0,PDN
HI302A,,2010,1975,,3313,293308639,52193462,,3313,293308639,52193462,,0,0,0,PDN
HI302A,,2011,1975,,3313,293308639,52193462,,3313,293308639,52193462,,0,0,0,PDN
HI302A,,2012,1975,,3313,293308639,52193462,,3313,293308639,52193462,,0,0,0,PDN
HI302A,,2013,1975,,3313,293308639,52193462,,3313,293308639,52193462,,0,0,0,PDN
HI302A,,2014,1975,,3313,293308639,52193462,,3313,293308639,52193462,,0,0,0,PDN
HI302A,,2015,1975,,3313,293308639,52193462,,3313,293308639,52193462,,0,0,0,PDN
HI302A,,2016,1975,,3313,293308639,52193462,,3313,293308639,52193462,,0,0,0,PDN
HI302A,,2017,1975,,3313,293308639,52193462,,3313,293308639,52193462,,0,0,0,PDN
HI302A,,2017,1975,,3313,293308639,52193462,,3313,293308639,52193462,,0,0,0,PDN
HI309A,,1976,1974,,330000,77000000,14031068,,0,0,0,,330000,77000000,14031068,PDN
HI309A,,1977,1974,,74231,74230220,13282455,,0,0,0,,74231,74230220,13282455,PDN
HI309A,,1978,1974,,74231,74230220,13282455,,0,15764,2805,,74231,74214456,13279650,PDN
HI309A,,1979,1974,,134925,102730220,18414324,,31533,8093558,1471668,,103392,94636662,16942656,PDN
HI309A,,1980,1974,,185107,112945420,20282157,,62323,24665267,4451161,,122784,88280153,15830996,PDN
HI309A,,1981,1974,,162863,81370000,14641511,,70167,31680325,5707236,,92696,49689675,8934275,PDN
HI309A,,1982,1974,,155063,90636510,16282556,,75497,43741699,7858717,,79566,46894811,8423839,PDN
HI309A,,1983,1974,,128599,99789793,17884790,,78231,52924258,9495359,,50368,46865535,8389431,PDN
HI309A,,1984,1974,,348783,155784117,28068377,,79730,63825152,11436519,,269053,91958965,16631858,PDN
HI309A,,1985,1974,,377020,160289167,28898224,,81199,68849009,12331912,,295821,91440158,16566312,PDN
HI309A,,1986,1974,,396585,170025722,30650272,,94487,77336241,13855384,,302098,92689481,16794888,PDN
HI309A,,1987,1974,,648067,205143751,37150514,,173599,97329532,17492021,,474468,107814219,19658493,PDN
HI309A,,1988,1974,,530996,222171401,40063274,,233896,116969374,21046952,,297100,105202027,19016322,PDN
HI309A,,1989,1974,,579859,233906528,42200238,,279650,141174524,25399672,,300209,92732004,16800566,PDN
HI309A,,1990,1974,,462580,216068469,38908927,,305578,157465175,28324292,,157002,58603294,10584635,PDN
HI309A,,1991,1974,,467108,242936998,43694332,,334477,180942750,32530696,,132631,61994248,11163636,PDN
HI309A,,1992,1974,,467307,242952101,43697218,,341666,193453184,34763941,,125641,49498917,8933277,PDN
HI309A,,1993,1974,,351728,223271169,40079694,,343185,199671853,35871984,,8543,23599316,4207710,PDN
HI309A,,1994,1974,,372309,234385287,42077876,,350935,207061128,37194552,,21374,27324159,4883324,PDN
HI309A,,1995,1974,,373467,238309390,42777273,,362431,218121768,39174133,,11036,20187622,3603140,PDN
HI309A,,1996,1974,,715637,271276078,48985402,,386990,226871839,40755645,,328647,44404239,8229757,PDN
HI309A,,1997,1974,,1280201,338484671,61508790,,473755,244877073,44046188,,806446,93607598,17462602,PDN
HI309A,,1998,1974,,1192783,367478828,66580475,,492782,266169232,47853855,,700001,101309596,18726620,PDN
HI309A,,1999,1974,,520290,300963801,54072567,,500991,274229981,49296361,,19299,26733820,4776206,PDN
HI309A,,2000,1974,,525711,297612136,53481607,,504778,278300645,50024466,,20933,19311491,3457141,PDN
HI309A,,2001,1974,,523125,293523139,52751441,,506461,281822608,50652833,,16664,11700531,2098608,PDN
HI309A,,2002,1974,,522728,294079748,52850085,,507729,283052667,50872972,,14999,11027081,1977113,PDN
HI309A,,2003,1974,,517706,290912848,52281558,,508643,284218141,51081266,,9063,6694707,1200292,PDN
HI309A,,2004,1974,,513933,288978153,51933533,,509314,285206052,51257722,,4619,3772101,675811,PDN
HI309A,,2005,1974,,513416,290000496,52114928,,509695,285969199,51393894,,3721,4031297,721034,PDN
HI309A,,2006,1974,,993599,331221621,59929831,,509695,286694979,51523036,,483904,44526642,8406795,PDN
HI309A,,2007,1974,,1103201,323605412,58684235,,533238,289057183,51966900,,569963,34548229,6717335,PDN
HI309A,,2008,1974,,1196663,350987413,63649939,,733293,307012021,55361766,,463370,43975392,8288173,PDN
HI309A,,2009,1974,,972155,345072440,62372949,,843586,322067088,58150901,,128569,23005352,4222047,PDN
HI309A,,2010,1974,,980530,344158884,62218769,,857021,323796345,58472033,,123509,20362539,3746736,PDN
HI309A,,2011,1974,,980530,344158884,62218769,,889603,326517794,58988859,,90927,17641090,3229911,PDN
HI309A,,2012,1974,,980530,344158884,62218769,,902673,329476583,59528403,,77857,14682301,2690366,PDN
HI309A,,2013,1974,,980530,344158884,62218769,,908494,330613500,59736522,,72036,13545384,2482247,PDN
HI309A,,2014,1974,,911003,330976144,59803559,,911003,330976144,59803559,,0,0,0,PDN
HI309A,,2015,1974,,911003,330976144,59803559,,911003,330976144,59803559,,0,0,0,PDN
HI309A,,2016,1974,,911003,330976296,59803586,,911003,330976296,59803586,,0,0,0,PDN
HI309A,,2017,1974,,911003,330976296,59803586,,911003,330976296,59803586,,0,0,0,PDN
HI309A,,2017,1974,,911003,330976296,59803586,,911003,330976296,59803586,,0,0,0,PDN
HI313A,,1981,1974,,0,56280000,10014235,,0,8656456,1540295,,0,47623544,8473940,PDN
HI313A,,1982,1974,,0,56280000,10014235,,0,11247540,2001342,,0,45032460,8012893,PDN
HI313A,,1983,1974,,0,56280000,10014235,,0,12498652,2223959,,0,43781348,7790276,PDN
HI313A,,1984,1974,,0,32104634,5712568,,0,14795444,2632641,,0,17309190,3079927,PDN
HI313A,,1985,1974,,0,32104634,5712568,,0,16029225,2852175,,0,16075409,2860393,PDN
HI313A,,1986,1974,,0,32104634,5712568,,0,18017723,3206001,,0,14086911,2506567,PDN
HI313A,,1987,1974,,0,33478760,5957075,,0,21810163,3880812,,0,11668597,2076263,PDN
HI313A,,1988,1974,,0,37728107,6713186,,0,25970670,4621116,,0,11757437,2092070,PDN
HI313A,,1989,1974,,0,44838092,7978308,,0,28658517,5099380,,0,16179575,2878928,PDN
HI313A,,1990,1974,,0,56679993,10085408,,0,34549091,6147525,,0,22130902,3937883,PDN
HI313A,,1991,1974,,0,63209815,11247298,,0,41704969,7420813,,0,21504846,3826485,PDN
HI313A,,1992,1974,,0,67440141,12000025,,0,48275553,8589956,,0,19164588,3410069,PDN
HI313A,,1993,1974,,0,67595786,12027720,,0,54260010,9654806,,0,13335776,2372914,PDN
HI313A,,1994,1974,,0,76613174,13632237,,0,61803861,10997128,,0,14809313,2635109,PDN
HI313A,,1995,1974,,0,78197341,13914118,,0,66718169,11871560,,0,11479172,2042558,PDN
HI313A,,1996,1974,,0,78913675,14041579,,0,69158354,12305757,,0,9755321,1735822,PDN
HI313A,,1997,1974,,0,78913675,14041579,,0,70636291,12568735,,0,8277384,1472844,PDN
HI313A,,1998,1974,,0,79557922,14156214,,0,71301938,12687178,,0,8255984,1469036,PDN
HI313A,,1999,1974,,0,74723606,13296015,,0,72002526,12811837,,0,2721080,484178,PDN
HI313A,,2000,1974,,0,74723375,13295974,,0,72168513,12841372,,0,2554862,454602,PDN
HI313A,,2001,1974,,0,72168513,12841372,,0,72168513,12841372,,0,0,0,PDN
HI313A,,2002,1974,,0,72168513,12841372,,0,72168513,12841372,,0,0,0,PDN
HI313A,,2003,1974,,0,72168513,12841372,,0,72168513,12841372,,0,0,0,PDN
HI313A,,2004,1974,,0,72168513,12841372,,0,72168513,12841372,,0,0,0,PDN
HI313A,,2005,1974,,0,72168513,12841372,,0,72168513,12841372,,0,0,0,PDN
HI313A,,2006,1974,,0,72168513,12841372,,0,72168513,12841372,,0,0,0,PDN
HI313A,,2007,1974,,0,72168513,12841372,,0,72168513,12841372,,0,0,0,PDN
HI313A,,2008,1974,,0,72168513,12841372,,0,72168513,12841372,,0,0,0,PDN
HI313A,,2009,1974,,0,73593586,13094943,,0,73593586,13094943,,0,0,0,PDN
HI313A,,2010,1974,,0,73593586,13094943,,0,73593586,13094943,,0,0,0,PDN
HI313A,,2011,1974,,0,73593586,13094943,,0,73593586,13094943,,0,0,0,PDN
HI313A,,2012,1974,,0,73593586,13094943,,0,73593586,13094943,,0,0,0,PDN
HI313A,,2013,1974,,0,73593586,13094943,,0,73593586,13094943,,0,0,0,PDN
HI313A,,2014,1974,,0,73593586,13094943,,0,73593586,13094943,,0,0,0,PDN
HI313A,,2015,1974,,0,73593586,13094943,,0,73593586,13094943,,0,0,0,PDN
HI313A,,2016,1974,,0,73593586,13094943,,0,73593586,13094943,,0,0,0,PDN
HI313A,,2017,1974,,0,73593586,13094943,,0,73593586,13094943,,0,0,0,PDN
HI313A,,2017,1974,,0,73593586,13094943,,0,73593586,13094943,,0,0,0,PDN
HI317A,,1977,1974,,200000,150000000,26890391,,0,0,0,,200000,150000000,26890391,PDN
HI317A,,1978,1974,,42948,42947900,7684923,,0,0,0,,42948,42947900,7684923,PDN
HI317A,,1979,1974,,46948,55947900,10002090,,4240,11308678,2016460,,42708,44639222,7985630,PDN
HI317A,,1980,1974,,66948,78972900,14119065,,6177,26520411,4725111,,60771,52452489,9393954,PDN
HI317A,,1981,1974,,66978,79447900,14203615,,7254,41863316,7456243,,59724,37584584,6747372,PDN
HI317A,,1982,1974,,55515,96390900,17206921,,32312,69511584,12400921,,23203,26879316,4806000,PDN
HI317A,,1983,1974,,132769,188245542,33628417,,98764,90413591,16186592,,34005,97831951,17441825,PDN
HI317A,,1984,1974,,232769,188245542,33728417,,134982,104957352,18810667,,97787,83288190,14917750,PDN
HI317A,,1985,1974,,232769,188245542,33728417,,150333,112468245,20162476,,82436,75777297,13565941,PDN
HI317A,,1986,1974,,240334,199025348,35654097,,172171,119875334,21502302,,68163,79150014,14151795,PDN
HI317A,,1987,1974,,240334,213950228,38309770,,184564,126423984,22679935,,55770,87526244,15629835,PDN
HI317A,,1988,1974,,383388,215411004,38712748,,204005,134579784,24150586,,179383,80831220,14562162,PDN
HI317A,,1989,1974,,369763,210037138,37742919,,216864,141907229,25467261,,152899,68129909,12275658,PDN
HI317A,,1990,1974,,258035,189949139,34056814,,229441,149350429,26804250,,28594,40598710,7252564,PDN
HI317A,,1991,1974,,335356,189677107,34085731,,242001,153321423,27523393,,93355,36355684,6562338,PDN
HI317A,,1992,1974,,304026,179052255,32163858,,254098,156248021,28056237,,49928,22804234,4107621,PDN
HI317A,,1993,1974,,304026,180131329,32355864,,268596,158341260,28443197,,35430,21790069,3912667,PDN
HI317A,,1994,1974,,304026,180115247,32353002,,285589,160263256,28802183,,18437,19851991,3550819,PDN
HI317A,,1995,1974,,304101,183915705,33029315,,296394,162935590,29288492,,7707,20980115,3740823,PDN
HI317A,,1996,1974,,355127,198434852,35663820,,298716,166842988,29986080,,56411,31591864,5677740,PDN
HI317A,,1997,1974,,355127,199181533,35796681,,309268,171190691,30770245,,45859,27990842,5026436,PDN
HI317A,,1998,1974,,458048,225456508,40574864,,317836,175235404,31498513,,140212,50221104,9076351,PDN
HI317A,,1999,1974,,451612,199925931,36025621,,349662,185460454,33349743,,101950,14465477,2675878,PDN
HI317A,,2000,1974,,469451,199049520,35887515,,359007,187226251,33673287,,110444,11823269,2214228,PDN
HI317A,,2001,1974,,397554,202900359,36500821,,369624,188508348,33912035,,27930,14392011,2588786,PDN
HI317A,,2002,1974,,400296,201281027,36215426,,378044,190547275,34283253,,22252,10733752,1932173,PDN
HI317A,,2003,1974,,411096,201469984,36259848,,385194,193303892,34780904,,25902,8166092,1478944,PDN
HI317A,,2004,1974,,397679,193870096,34894137,,394062,193750198,34869186,,3617,119898,24951,PDN
HI317A,,2005,1974,,397679,193870096,34894137,,397679,193870096,34894137,,0,0,0,PDN
HI317A,,2006,1974,,397679,193870096,34894137,,397679,193870096,34894137,,0,0,0,PDN
HI317A,,2007,1974,,397679,193870096,34894137,,397679,193870096,34894137,,0,0,0,PDN
HI317A,,2008,1974,,397679,193808333,34883148,,397679,193808333,34883148,,0,0,0,PDN
HI317A,,2009,1974,,397679,197270028,35499109,,397679,197270028,35499109,,0,0,0,PDN
HI317A,,2010,1974,,397679,197270028,35499109,,397679,197270028,35499109,,0,0,0,PDN
HI317A,,2011,1974,,397679,197270028,35499109,,397679,197270028,35499109,,0,0,0,PDN
HI317A,,2012,1974,,401453,197525161,35548280,,401453,197525161,35548280,,0,0,0,PDN
HI317A,,2013,1974,,401453,197525161,35548280,,401453,197525161,35548280,,0,0,0,PDN
HI317A,,2014,1974,,401453,197525161,35548280,,401453,197525161,35548280,,0,0,0,PDN
HI317A,,2015,1974,,401453,197525161,35548280,,401453,197525161,35548280,,0,0,0,PDN
HI317A,,2016,1974,,401453,197525161,35548280,,401453,197525161,35548280,,0,0,0,PDN
HI317A,,2017,1974,,401453,197525161,35548280,,401453,197525161,35548280,,0,0,0,PDN
HI317A,,2017,1974,,401453,197525161,35548280,,401453,197525161,35548280,,0,0,0,PDN
HI320A,,1997,1997,,395,3954462,704036,,0,391899,69733,,395,3562563,634303,PDN
HI320A,,1998,1997,,0,3335323,593474,,0,3335323,593474,,0,0,0,PDN
HI320A,,1999,1997,,0,3335323,593474,,0,3335323,593474,,0,0,0,PDN
HI320A,,2000,1997,,0,3335323,593474,,0,3335323,593474,,0,0,0,PDN
HI320A,,2001,1997,,0,3335323,593474,,0,3335323,593474,,0,0,0,PDN
HI320A,,2002,1997,,0,3335323,593474,,0,3335323,593474,,0,0,0,PDN
HI320A,,2003,1997,,0,3335323,593474,,0,3335323,593474,,0,0,0,PDN
HI320A,,2004,1997,,0,3335323,593474,,0,3335323,593474,,0,0,0,PDN
HI320A,,2005,1997,,0,3335323,593474,,0,3335323,593474,,0,0,0,PDN
HI320A,,2006,1997,,0,3335323,593474,,0,3335323,593474,,0,0,0,PDN
HI320A,,2007,1997,,0,3335323,593474,,0,3335323,593474,,0,0,0,PDN
HI320A,,2008,1997,,0,3335323,593474,,0,3335323,593474,,0,0,0,PDN
HI320A,,2009,1997,,0,3397199,604484,,0,3397199,604484,,0,0,0,PDN
HI320A,,2010,1997,,0,3397199,604484,,0,3397199,604484,,0,0,0,PDN
HI320A,,2011,1997,,0,3397199,604484,,0,3397199,604484,,0,0,0,PDN
HI320A,,2012,1997,,0,3397199,604484,,0,3397199,604484,,0,0,0,PDN
HI320A,,2013,1997,,0,3397199,604484,,0,3397199,604484,,0,0,0,PDN
HI320A,,2014,1997,,0,3397199,604484,,0,3397199,604484,,0,0,0,PDN
HI320A,,2015,1997,,0,3397199,604484,,0,3397199,604484,,0,0,0,PDN
HI320A,,2016,1997,,0,3397199,604484,,0,3397199,604484,,0,0,0,PDN
HI320A,,2017,1997,,0,3397199,604484,,0,3397199,604484,,0,0,0,PDN
HI320A,,2017,1997,,0,3397199,604484,,0,3397199,604484,,0,0,0,PDN
HI323A,,1976,1974,,0,97600000,17366548,,0,0,0,,0,97600000,17366548,PDN
HI323A,,1977,1974,,144157,76333000,13726541,,0,0,0,,144157,76333000,13726541,PDN
HI323A,,1978,1974,,183532,138829000,24886201,,1138,1470791,262845,,182394,137358209,24623356,PDN
HI323A,,1979,1974,,183532,138829000,24886201,,35175,38946208,6965105,,148357,99882792,17921096,PDN
HI323A,,1980,1974,,183532,139984000,25091717,,40623,55714202,9954182,,142909,84269798,15137535,PDN
HI323A,,1981,1974,,183537,139984000,25091722,,46171,69656259,12440523,,137366,70327741,12651199,PDN
HI323A,,1982,1974,,179624,158816000,28438699,,54497,84306447,15055644,,125127,74509553,13383055,PDN
HI323A,,1983,1974,,89124,126629844,22621125,,59145,90522293,16166315,,29979,36107551,6454810,PDN
HI323A,,1984,1974,,89404,126629844,22621405,,64720,99062297,17691463,,24684,27567547,4929942,PDN
HI323A,,1985,1974,,90028,126629844,22622029,,67205,102099264,18234334,,22823,24530580,4387695,PDN
HI323A,,1986,1974,,90028,126629844,22622029,,67267,102780197,18355558,,22761,23849647,4266471,PDN
HI323A,,1987,1974,,99014,142914241,25528594,,71896,112035471,20007033,,27118,30878770,5521561,PDN
HI323A,,1988,1974,,100210,155072541,27693189,,75465,119424604,21325395,,24745,35647937,6367794,PDN
HI323A,,1989,1974,,100210,155072541,27693189,,78838,126281078,22548781,,21372,28791463,5144408,PDN
HI323A,,1990,1974,,97712,150430297,26864669,,82624,131734311,23522893,,15088,18695986,3341776,PDN
HI323A,,1991,1974,,90955,143083194,25550598,,85309,135636302,24219882,,5646,7446892,1330716,PDN
HI323A,,1992,1974,,93532,147527976,26344062,,88291,139527738,24915291,,5241,8000238,1428771,PDN
HI323A,,1993,1974,,95110,149231591,26648774,,90784,142867001,25511959,,4326,6364590,1136815,PDN
HI323A,,1994,1974,,109105,163068834,29124912,,98938,152204405,27181572,,10167,10864429,1943340,PDN
HI323A,,1995,1974,,109952,163703085,29238615,,105497,159555970,28496239,,4455,4147115,742376,PDN
HI323A,,1996,1974,,115198,172391615,30789863,,109150,165718307,29596393,,6048,6673308,1193470,PDN
HI323A,,1997,1974,,122828,185691638,33164045,,113272,171056303,30550337,,9556,14635335,2613708,PDN
HI323A,,1998,1974,,122828,185691638,33164045,,116803,174440149,31155975,,6025,11251489,2008070,PDN
HI323A,,1999,1974,,119988,181147115,32352571,,117357,175525838,31349713,,2631,5621277,1002858,PDN
HI323A,,2000,1974,,123099,182926635,32672322,,118412,176436097,31512735,,4687,6490538,1159587,PDN
HI323A,,2001,1974,,122294,182704882,32632060,,119400,177919252,31777630,,2894,4785630,854430,PDN
HI323A,,2002,1974,,122090,183412034,32757683,,119883,179242286,32013528,,2207,4169748,744155,PDN
HI323A,,2003,1974,,121143,182062331,32516576,,120206,180274864,32197584,,937,1787467,318992,PDN
HI323A,,2004,1974,,131207,188543266,33679831,,120417,180932295,32314776,,10790,7610971,1365055,PDN
HI323A,,2005,1974,,132240,192237356,34338175,,123788,183651784,32802041,,8452,8585572,1536134,PDN
HI323A,,2006,1974,,129263,190962572,34108368,,126830,186366194,33288074,,2433,4596378,820294,PDN
HI323A,,2007,1974,,129263,190962572,34108368,,128360,187807905,33546137,,903,3154667,562231,PDN
HI323A,,2008,1974,,128566,188471929,33664496,,128566,188291849,33632454,,0,180080,32042,PDN
HI323A,,2009,1974,,128566,191880917,34271077,,128566,191880917,34271077,,0,0,0,PDN
HI323A,,2010,1974,,128566,191880917,34271077,,128566,191880917,34271077,,0,0,0,PDN
HI323A,,2011,1974,,128566,191880917,34271077,,128566,191880917,34271077,,0,0,0,PDN
HI323A,,2012,1974,,128566,191880917,34271077,,128566,191880917,34271077,,0,0,0,PDN
HI323A,,2013,1974,,128566,191880917,34271077,,128566,191880917,34271077,,0,0,0,PDN
HI323A,,2014,1974,,128566,191880917,34271077,,128566,191880917,34271077,,0,0,0,PDN
HI323A,,2015,1974,,128566,191880917,34271077,,128566,191880917,34271077,,0,0,0,PDN
HI323A,,2016,1974,,128566,191880917,34271077,,128566,191880917,34271077,,0,0,0,PDN
HI323A,,2017,1974,,128566,191880917,34271077,,128566,191880917,34271077,,0,0,0,PDN
HI323A,,2017,1974,,128566,191880917,34271077,,128566,191880917,34271077,,0,0,0,PDN
HI327A,,1977,1973,,17299955,193500000,51730560,,0,0,0,,17299955,193500000,51730560,PDN
HI327A,,1978,1973,,5990734,155925472,33735480,,107926,534483,203030,,5882808,155390989,33532450,PDN
HI327A,,1979,1973,,5990734,155925472,33735480,,328035,22100183,4260452,,5662699,133825289,29475028,PDN
HI327A,,1980,1973,,5990734,155925472,33735480,,505893,40181316,7655593,,5484841,115744156,26079887,PDN
HI327A,,1981,1973,,4610814,157322914,32604215,,752144,55385758,10607261,,3858670,101937156,21996954,PDN
HI327A,,1982,1973,,4640914,165781268,34139360,,1008242,70812372,13608308,,3632672,94968896,20531052,PDN
HI327A,,1983,1973,,4884646,252725899,49853667,,1193348,76378087,14783755,,3691298,176347812,35069912,PDN
HI327A,,1984,1973,,4884646,252725899,49853667,,1309594,84608671,16364518,,3575052,168117228,33489149,PDN
HI327A,,1985,1973,,4890409,252725899,49859430,,1403960,90100645,17436103,,3486449,162625254,32423327,PDN
HI327A,,1986,1973,,4890409,252725899,49859430,,1520292,97452306,18860560,,3370117,155273593,30998870,PDN
HI327A,,1987,1973,,4890409,252725899,49859430,,1721995,107999200,20938935,,3168414,144726699,28920495,PDN
HI327A,,1988,1973,,4905980,239959569,47603412,,1947246,119675778,23241868,,2958734,120283791,24361544,PDN
HI327A,,1989,1973,,5259857,240490385,48051740,,2180129,129087084,25149361,,3079728,111403301,22902379,PDN
HI327A,,1990,1973,,4443094,212944225,42333525,,2403552,137350446,26843133,,2039542,75593779,15490392,PDN
HI327A,,1991,1973,,4398400,213888402,42456835,,2560533,142962680,27998732,,1837867,70925722,14458103,PDN
HI327A,,1992,1973,,4398419,186839260,37643839,,2654470,147335350,28870724,,1743949,39503910,8773115,PDN
HI327A,,1993,1973,,4471136,189833085,38249265,,2729575,151848081,29748806,,1741561,37985004,8500459,PDN
HI327A,,1994,1973,,4467835,198366785,39764416,,2823291,160225326,31333135,,1644544,38141459,8431281,PDN
HI327A,,1995,1973,,4106380,204777461,40543651,,2865174,168058362,32768797,,1241206,36719099,7774854,PDN
HI327A,,1996,1973,,4106795,189969233,37909150,,2887261,170944894,33304502,,1219534,19024339,4604648,PDN
HI327A,,1997,1973,,4106795,190000595,37914730,,2936220,172250299,33585739,,1170575,17750296,4328991,PDN
HI327A,,1998,1973,,4106795,190000595,37914730,,2989253,172670924,33713617,,1117542,17329671,4201113,PDN
HI327A,,1999,1973,,3822678,174895251,34942829,,2995148,172687368,33722438,,827530,2207883,1220391,PDN
HI327A,,2000,1973,,3822645,177636545,35430571,,2995201,173194532,33812733,,827444,4442013,1617838,PDN
HI327A,,2001,1973,,3833081,186525225,37022623,,2995240,177775273,34627851,,837841,8749952,2394772,PDN
HI327A,,2002,1973,,3833081,186525225,37022623,,2995252,181971435,35374511,,837829,4553790,1648112,PDN
HI327A,,2003,1973,,3833181,187234170,37148870,,2995260,184369348,35801194,,837921,2864822,1347676,PDN
HI327A,,2004,1973,,3833181,187714180,37234280,,2995315,185688272,36035933,,837866,2025908,1198347,PDN
HI327A,,2005,1973,,3833379,187149213,37133950,,2995316,185800137,36055839,,838063,1349076,1078111,PDN
HI327A,,2006,1973,,2995373,186381070,36159264,,2995373,186381070,36159264,,0,0,0,PDN
HI327A,,2007,1973,,2995373,186381070,36159264,,2995373,186381070,36159264,,0,0,0,PDN
HI327A,,2008,1973,,2995373,186381070,36159264,,2995373,186381070,36159264,,0,0,0,PDN
HI327A,,2009,1973,,2995373,189837998,36774372,,2995373,189837998,36774372,,0,0,0,PDN
HI327A,,2010,1973,,2995373,189837998,36774372,,2995373,189837998,36774372,,0,0,0,PDN
HI327A,,2011,1973,,2995373,189837998,36774372,,2995373,189837998,36774372,,0,0,0,PDN
HI327A,,2012,1973,,2995373,189837998,36774372,,2995373,189837998,36774372,,0,0,0,PDN
HI327A,,2013,1973,,2995373,189837998,36774372,,2995373,189837998,36774372,,0,0,0,PDN
HI327A,,2014,1973,,2995373,189837998,36774372,,2995373,189837998,36774372,,0,0,0,PDN
HI327A,,2015,1973,,2995373,189837998,36774372,,2995373,189837998,36774372,,0,0,0,PDN
HI327A,,2016,1973,,2995373,189837998,36774372,,2995373,189837998,36774372,,0,0,0,PDN
HI327A,,2017,1973,,2995373,189837998,36774372,,2995373,189837998,36774372,,0,0,0,PDN
HI327A,,2017,1973,,2995373,189837998,36774372,,2995373,189837998,36774372,,0,0,0,PDN
HI330A,,1976,1974,,1000000,560000000,100644128,,0,0,0,,1000000,560000000,100644128,PDN
HI330A,,1977,1974,,0,159059250,28302358,,0,0,0,,0,159059250,28302358,PDN
HI330A,,1978,1974,,140823,210351260,37569873,,3720,3394650,607750,,137103,206956610,36962123,PDN
HI330A,,1979,1974,,540042,231641471,41757386,,51213,38455689,6893862,,488829,193185782,34863524,PDN
HI330A,,1980,1974,,780746,267529951,48383940,,78207,95666041,17100634,,702539,171863910,31283306,PDN
HI330A,,1981,1974,,774989,294305961,53142598,,97466,147564230,26354446,,677523,146741731,26788152,PDN
HI330A,,1982,1974,,660231,318749961,57377306,,114275,178719634,31914922,,545956,140030327,25462384,PDN
HI330A,,1983,1974,,665724,342504981,61609671,,121119,199465791,35613253,,544605,143039190,25996418,PDN
HI330A,,1984,1974,,774695,367150069,66103889,,124786,214001250,38203300,,649909,153148819,27900589,PDN
HI330A,,1985,1974,,759345,382341815,68791696,,138911,225563978,40274850,,620434,156777837,28516846,PDN
HI330A,,1986,1974,,759345,382341815,68791696,,153786,235390156,42038155,,605559,146951659,26753541,PDN
HI330A,,1987,1974,,765505,384422340,69168057,,164515,243437839,43480856,,600990,140984501,25687201,PDN
HI330A,,1988,1974,,764502,393022761,70697378,,171252,249129476,44500340,,593250,143893285,26197038,PDN
HI330A,,1989,1974,,201045,300387977,53650863,,173082,254218103,45407620,,27963,46169874,8243243,PDN
HI330A,,1990,1974,,201419,301103492,53778553,,173374,256239866,45767656,,28045,44863626,8010897,PDN
HI330A,,1991,1974,,198312,298120051,53244584,,173711,257386844,45972082,,24601,40733207,7272502,PDN
HI330A,,1992,1974,,177311,277590229,49570590,,173856,258863672,46235008,,3455,18726557,3335582,PDN
HI330A,,1993,1974,,177499,275517470,49201960,,174032,259822128,46405727,,3467,15695342,2796233,PDN
HI330A,,1994,1974,,177489,275488776,49196844,,174044,260324803,46495183,,3445,15163973,2701661,PDN
HI330A,,1995,1974,,178624,277073816,49480015,,174782,260946429,46606531,,3842,16127387,2873484,PDN
HI330A,,1996,1974,,180498,282460178,50440316,,175451,262924829,46959228,,5047,19535349,3481088,PDN
HI330A,,1997,1974,,180590,283143074,50561920,,175700,263888581,47130964,,4890,19254493,3430956,PDN
HI330A,,1998,1974,,182026,283550163,50635792,,176392,265325530,47387340,,5634,18224633,3248452,PDN
HI330A,,1999,1974,,180290,296721847,52977772,,176511,266303619,47561497,,3779,30418228,5416275,PDN
HI330A,,2000,1974,,874370,317881414,57436900,,197330,267186967,47739495,,677040,50694447,9697405,PDN
HI330A,,2001,1974,,1390787,329248869,59975995,,754370,281824321,50901046,,636417,47424548,9074949,PDN
HI330A,,2002,1974,,1390787,329248869,59975995,,1071914,287131187,52162873,,318873,42117682,7813122,PDN
HI330A,,2003,1974,,1390790,329294300,59984082,,1177316,288787199,52562939,,213474,40507101,7421143,PDN
HI330A,,2004,1974,,1388151,317509990,57884591,,1189715,289014769,52615830,,198436,28495221,5268761,PDN
HI330A,,2005,1974,,1388151,317509990,57884591,,1189715,289014769,52615830,,198436,28495221,5268761,PDN
HI330A,,2006,1974,,1192436,311062948,56541715,,1189715,289014769,52615830,,2721,22048179,3925885,PDN
HI330A,,2007,1974,,1189715,290092935,52807675,,1189715,289885449,52770756,,0,207486,36919,PDN
HI330A,,2008,1974,,1189715,290095217,52808081,,1189715,290095217,52808081,,0,0,0,PDN
HI330A,,2009,1974,,1189715,295395595,53751209,,1189715,295395595,53751209,,0,0,0,PDN
HI330A,,2010,1974,,1189715,295395595,53751209,,1189715,295395595,53751209,,0,0,0,PDN
HI330A,,2011,1974,,1189715,295395595,53751209,,1189715,295395595,53751209,,0,0,0,PDN
HI330A,,2012,1974,,1189715,295395595,53751209,,1189715,295395595,53751209,,0,0,0,PDN
HI330A,,2013,1974,,1189715,295395595,53751209,,1189715,295395595,53751209,,0,0,0,PDN
HI330A,,2014,1974,,1189715,295395595,53751209,,1189715,295395595,53751209,,0,0,0,PDN
HI330A,,2015,1974,,1189715,295395595,53751209,,1189715,295395595,53751209,,0,0,0,PDN
HI330A,,2016,1974,,1189715,295395595,53751209,,1189715,295395595,53751209,,0,0,0,PDN
HI330A,,2017,1974,,1189715,295395595,53751209,,1189715,295395595,53751209,,0,0,0,PDN
HI330A,,2017,1974,,1189715,295395595,53751209,,1189715,295395595,53751209,,0,0,0,PDN
HI334A,,1976,1974,,1000000,342000000,61854093,,0,0,0,,1000000,342000000,61854093,PDN
HI334A,,1977,1974,,4579059,279777140,54361468,,0,0,0,,4579059,279777140,54361468,PDN
HI334A,,1978,1974,,4552598,248756980,48815406,,32571,11731712,2120064,,4520027,237025268,46695342,PDN
HI334A,,1979,1974,,4753598,246248980,48570142,,900262,34431636,7026888,,3853336,211817344,41543254,PDN
HI334A,,1980,1974,,4797569,246446980,48649345,,1889552,56123192,11875885,,2908017,190323788,36773460,PDN
HI334A,,1981,1974,,5060923,264505460,52125951,,2629644,77309748,16385827,,2431279,187195712,35740124,PDN
HI334A,,1982,1974,,5358225,346283460,66974499,,3503658,102297283,21706022,,1854567,243986177,45268477,PDN
HI334A,,1983,1974,,7950388,327428826,66211745,,4339955,122180284,26080219,,3610433,205248542,40131526,PDN
HI334A,,1984,1974,,8118660,327428826,66380017,,5178086,144982578,30975698,,2940574,182446248,35404319,PDN
HI334A,,1985,1974,,8106851,334031971,67543145,,6018916,162874141,35000080,,2087935,171157830,32543065,PDN
HI334A,,1986,1974,,8114053,334031971,67550347,,6876954,171387520,37372954,,1237099,162644451,30177393,PDN
HI334A,,1987,1974,,10663576,264615594,57748201,,7787895,182221445,40211640,,2875681,82394149,17536561,PDN
HI334A,,1988,1974,,10585199,278194534,60086006,,8618074,192371796,42847931,,1967125,85822738,17238075,PDN
HI334A,,1989,1974,,16154081,307200179,70816035,,9356073,206592265,46116263,,6798008,100607914,24699772,PDN
HI334A,,1990,1974,,16887240,346001568,78453355,,10082463,231358243,51249410,,6804777,114643325,27203945,PDN
HI334A,,1991,1974,,16949722,350045531,79235404,,10579549,254073441,55788346,,6370173,95972090,23447058,PDN
HI334A,,1992,1974,,16959915,349859416,79212480,,11077372,272823626,59622501,,5882543,77035790,19589979,PDN
HI334A,,1993,1974,,14144091,353922946,77119704,,11506111,286591947,62501119,,2637980,67330999,14618585,PDN
HI334A,,1994,1974,,13747313,362681999,78281477,,11998472,306204182,66483202,,1748841,56477817,11798275,PDN
HI334A,,1995,1974,,13554536,372673266,79866505,,12369663,320032041,69314866,,1184873,52641225,10551639,PDN
HI334A,,1996,1974,,13560626,402911445,85253054,,12676998,337917723,72804707,,883628,64993722,12448347,PDN
HI334A,,1997,1974,,13610210,409839239,86535341,,12886283,357979117,76583635,,723927,51860122,9951706,PDN
HI334A,,1998,1974,,13412882,401116847,84785986,,13142732,369503466,78890680,,270150,31613381,5895306,PDN
HI334A,,1999,1974,,13949027,398502583,84856960,,13371582,377413326,80526978,,577445,21089257,4329982,PDN
HI334A,,2000,1974,,13949029,398686210,84889636,,13581388,382784607,81692528,,367641,15901603,3197108,PDN
HI334A,,2001,1974,,14171489,394972002,84451205,,13772668,386735385,82586793,,398821,8236617,1864412,PDN
HI334A,,2002,1974,,14172140,394363329,84343551,,13925084,388961093,83135243,,247056,5402236,1208308,PDN
HI334A,,2003,1974,,14365649,396786006,84968141,,14068735,391352136,83704346,,296914,5433870,1263795,PDN
HI334A,,2004,1974,,14365575,396474735,84912681,,14187147,392741958,84070058,,178428,3732777,842623,PDN
HI334A,,2005,1974,,14416732,405184017,86513532,,14282200,393968327,84383326,,134532,11215690,2130206,PDN
HI334A,,2006,1974,,14416936,405185302,86513965,,14370994,397921224,85175482,,45942,7264078,1338483,PDN
HI334A,,2007,1974,,14626385,405893081,86849353,,14454952,401684161,85929002,,171433,4208920,920351,PDN
HI334A,,2008,1974,,14856291,412035290,88172179,,14519903,403194635,86262721,,336388,8840655,1909458,PDN
HI334A,,2009,1974,,14973905,417661464,89290890,,14581412,412516008,87982836,,392493,5145456,1308053,PDN
HI334A,,2010,1974,,14973905,417661464,89290890,,14655190,413662754,88260662,,318715,3998710,1030229,PDN
HI334A,,2011,1974,,14973905,417661464,89290890,,14717215,414675320,88502859,,256690,2986144,788032,PDN
HI334A,,2012,1974,,14810887,415668811,88773309,,14772090,415370568,88681444,,38797,298243,91865,PDN
HI334A,,2013,1974,,14810887,415668811,88773309,,14810887,415668811,88773309,,0,0,0,PDN
HI334A,,2014,1974,,14810887,415668811,88773309,,14810887,415668811,88773309,,0,0,0,PDN
HI334A,,2015,1974,,14810887,415668811,88773309,,14810887,415668811,88773309,,0,0,0,PDN
HI334A,,2016,1974,,14810887,415668811,88773309,,14810887,415668811,88773309,,0,0,0,PDN
HI334A,,2017,1974,,14810887,415668811,88773309,,14810887,415668811,88773309,,0,0,0,PDN
HI334A,,2017,1974,,14810887,415668811,88773309,,14810887,415668811,88773309,,0,0,0,PDN
HI340A,,1976,1974,,0,140400000,24982206,,0,0,0,,0,140400000,24982206,PDN
HI340A,,1977,1974,,376366,188047330,33836745,,0,0,0,,376366,188047330,33836745,PDN
HI340A,,1978,1974,,376366,188047330,33836745,,0,0,0,,376366,188047330,33836745,PDN
HI340A,,1979,1974,,516462,191047330,34510649,,74767,25880886,4679907,,441695,165166444,29830742,PDN
HI340A,,1980,1974,,605535,217237210,39259843,,140072,50464663,9119549,,465463,166772547,30140294,PDN
HI340A,,1981,1974,,605585,217237210,39259893,,187764,65940262,11920907,,417821,151296948,27338986,PDN
HI340A,,1982,1974,,618935,206804360,37416864,,233980,79826937,14438061,,384955,126977423,22978803,PDN
HI340A,,1983,1974,,618935,207105600,37470465,,257771,87776109,15876296,,361164,119329491,21594169,PDN
HI340A,,1984,1974,,584346,207105600,37435876,,271539,94186875,17030769,,312807,112918725,20405107,PDN
HI340A,,1985,1974,,584776,210881011,38108088,,286273,102220487,18474972,,298503,108660524,19633116,PDN
HI340A,,1986,1974,,607470,213132435,38531391,,299474,108726196,19645772,,307996,104406239,18885619,PDN
HI340A,,1987,1974,,607859,213132435,38531780,,310488,114203566,20631407,,297371,98928869,17900373,PDN
HI340A,,1988,1974,,539188,242692704,43722943,,330158,138402756,24956983,,209030,104289948,18765960,PDN
HI340A,,1989,1974,,521356,246971559,44466473,,348770,149145214,26887064,,172586,97826345,17579409,PDN
HI340A,,1990,1974,,450634,210716722,37944713,,360294,156009461,28119985,,90340,54707261,9824728,PDN
HI340A,,1991,1974,,451363,213899039,38511690,,369826,162273989,29244201,,81537,51625050,9267489,PDN
HI340A,,1992,1974,,451133,213899039,38511460,,377833,167851701,30244684,,73300,46047338,8266776,PDN
HI340A,,1993,1974,,419392,196382435,35362886,,385964,174393006,31416748,,33428,21989429,3946138,PDN
HI340A,,1994,1974,,426905,202667532,36488743,,393586,180724757,32551016,,33319,21942775,3937727,PDN
HI340A,,1995,1974,,433244,211101225,37995740,,400325,190898123,34367963,,32919,20203102,3627777,PDN
HI340A,,1996,1974,,473173,216737794,39038617,,408668,198581870,35743520,,64505,18155924,3295097,PDN
HI340A,,1997,1974,,484396,223687484,40286439,,419093,205115243,36916467,,65303,18572241,3369972,PDN
HI340A,,1998,1974,,464835,231574486,41670260,,427364,211237655,38014135,,37471,20336831,3656125,PDN
HI340A,,1999,1974,,473112,240312899,43233415,,435308,216238657,38911937,,37804,24074242,4321478,PDN
HI340A,,2000,1974,,473112,240312899,43233415,,439737,219837773,39556778,,33375,20475126,3676637,PDN
HI340A,,2001,1974,,499767,288348447,51807320,,450568,237082834,42636126,,49199,51265613,9171194,PDN
HI340A,,2002,1974,,509577,283763670,51001333,,459214,250810237,45087370,,50363,32953433,5913963,PDN
HI340A,,2003,1974,,508479,282277613,50735812,,468557,258893506,46535017,,39922,23384107,4200795,PDN
HI340A,,2004,1974,,518670,296378258,53255015,,478823,264574242,47556090,,39847,31804016,5698925,PDN
HI340A,,2005,1974,,513204,291342142,52353443,,484314,268535027,48266347,,28890,22807115,4087096,PDN
HI340A,,2006,1974,,514037,288882082,51916543,,487767,271653241,48824643,,26270,17228841,3091900,PDN
HI340A,,2007,1974,,494963,278623355,50072072,,489063,274032821,49249351,,5900,4590534,822721,PDN
HI340A,,2008,1974,,498095,280237862,50362483,,489816,275321186,49479351,,8279,4916676,883132,PDN
HI340A,,2009,1974,,496722,283508871,50943141,,491046,280860819,50466282,,5676,2648052,476861,PDN
HI340A,,2010,1974,,493985,282335582,50731634,,492377,281517135,50584395,,1608,818447,147239,PDN
HI340A,,2011,1974,,493985,282335582,50731634,,493244,281998398,50670896,,741,337184,60738,PDN
HI340A,,2012,1974,,493985,282335582,50731634,,493985,282335582,50731634,,0,0,0,PDN
HI340A,,2013,1974,,493985,282335582,50731634,,493985,282335582,50731634,,0,0,0,PDN
HI340A,,2014,1974,,493985,282335582,50731634,,493985,282335582,50731634,,0,0,0,PDN
HI340A,,2015,1974,,493985,282335582,50731634,,493985,282335582,50731634,,0,0,0,PDN
HI340A,,2016,1974,,493985,282335582,50731634,,493985,282335582,50731634,,0,0,0,PDN
HI340A,,2017,1974,,493985,282335582,50731634,,493985,282335582,50731634,,0,0,0,PDN
HI340A,,2017,1974,,493985,282335582,50731634,,493985,282335582,50731634,,0,0,0,PDN
HI341A,,1978,1975,,15000,15000000,2684039,,0,0,0,,15000,15000000,2684039,PDP
HI341A,,1979,1975,,0,80000000,14234875,,0,0,0,,0,80000000,14234875,PDP
HI341A,,1980,1975,,1600000,80000000,15834875,,0,0,0,,1600000,80000000,15834875,PDP
HI341A,,1981,1975,,1600000,80000000,15834875,,99,3344551,595215,,1599901,76655449,15239660,PDP
HI341A,,1982,1975,,28872,33639599,6014566,,396,9335973,1661601,,28476,24303626,4352965,PDP
HI341A,,1983,1975,,19584,31621335,5646156,,481,12583525,2239542,,19103,19037810,3406614,PDP
HI341A,,1984,1975,,18410,37709621,6728307,,496,15930857,2835168,,17914,21778764,3893139,PDP
HI341A,,1985,1975,,42794,41023162,7342289,,626,16965977,3019483,,42168,24057185,4322806,PDP
HI341A,,1986,1975,,756,24245816,4314958,,629,17426810,3101485,,127,6819006,1213473,PDP
HI341A,,1987,1975,,756,24245816,4314958,,642,17792104,3166497,,114,6453712,1148461,PDP
HI341A,,1988,1975,,727,26033391,4633003,,642,18426917,3279453,,85,7606474,1353550,PDP
HI341A,,1989,1975,,886,29031732,5166675,,691,19272215,3429911,,195,9759517,1736764,PDP
HI341A,,1990,1975,,774,30352698,5401610,,691,20717598,3687096,,83,9635100,1714514,PDP
HI341A,,1991,1975,,766,28086732,4998405,,691,21353192,3800191,,75,6733540,1198214,PDP
HI341A,,1992,1975,,766,28086732,4998405,,691,21913483,3899887,,75,6173249,1098518,PDP
HI341A,,1993,1975,,766,28086732,4998405,,691,22008858,3916858,,75,6077874,1081547,PDP
HI341A,,1994,1975,,691,22012148,3917443,,691,22012148,3917443,,0,0,0,PDP
HI341A,,1995,1975,,691,22012148,3917443,,691,22012148,3917443,,0,0,0,PDP
HI341A,,1996,1975,,691,22012148,3917443,,691,22012148,3917443,,0,0,0,PDP
HI341A,,1997,1975,,691,22012148,3917443,,691,22012148,3917443,,0,0,0,PDP
HI341A,,1998,1975,,691,22012148,3917443,,691,22012148,3917443,,0,0,0,PDP
HI341A,,1999,1975,,691,22012148,3917443,,691,22012148,3917443,,0,0,0,PDP
HI341A,,2000,1975,,691,22012148,3917443,,691,22012148,3917443,,0,0,0,PDP
HI341A,,2001,1975,,691,22012148,3917443,,691,22012148,3917443,,0,0,0,PDP
HI341A,,2002,1975,,691,22012148,3917443,,691,22012148,3917443,,0,0,0,PDP
HI341A,,2003,1975,,691,22012148,3917443,,691,22012148,3917443,,0,0,0,PDP
HI341A,,2004,1975,,691,22012148,3917443,,691,22012148,3917443,,0,0,0,PDP
HI341A,,2005,1975,,5788,32409172,5772545,,691,22012148,3917443,,5097,10397024,1855102,PDP
HI341A,,2006,1975,,5788,32409172,5772545,,1806,24799736,4414570,,3982,7609436,1357975,PDP
HI341A,,2007,1975,,2314,40879144,7276183,,2060,31575250,5620432,,254,9303894,1655751,PDP
HI341A,,2008,1975,,3115,50310793,8955213,,2178,35510902,6320844,,937,14799891,2634369,PDP
HI341A,,2009,1975,,3115,51316209,9134113,,2533,39662294,7059881,,582,11653915,2074233,PDP
HI341A,,2010,1975,,3115,51316209,9134113,,2650,42269913,7523987,,465,9046296,1610126,PDP
HI341A,,2011,1975,,3115,51316209,9134113,,2675,44271431,7880154,,440,7044778,1253960,PDP
HI341A,,2012,1975,,3115,51316209,9134113,,2681,45796575,8151538,,434,5519634,982575,PDP
HI341A,,2013,1975,,2746,51899954,9237613,,2705,47210284,8403111,,41,4689670,834502,PDP
HI341A,,2014,1975,,2746,51899954,9237613,,2710,48340950,8604302,,36,3559004,633310,PDP
HI341A,,2015,1975,,2746,51899954,9237613,,2710,49068440,8733749,,36,2831514,503864,PDP
HI341A,,2016,1975,,2713,51296288,9130166,,2710,49783637,8861008,,3,1512651,269158,PDP
HI341A,,2017,1975,,2713,51296288,9130166,,2710,50596610,9005666,,3,699678,124501,PDP
HI341A,,2017,1975,,2713,51296288,9130166,,2710,50596610,9005666,,3,699678,124501,PDP
HI343A,,1978,1974,,15000,261578876,46559284,,0,44741252,7961077,,15000,216837624,38598207,PDN
HI343A,,1979,1974,,0,371423610,66089610,,0,148948740,26503335,,0,222474870,39586275,PDN
HI343A,,1980,1974,,0,411502226,73221037,,0,225162644,40064527,,0,186339582,33156510,PDN
HI343A,,1981,1974,,0,411502226,73221037,,0,273370033,48642355,,0,138132193,24578682,PDN
HI343A,,1982,1974,,25,411502226,73221062,,9,293315995,52191467,,16,118186231,21029595,PDN
HI343A,,1983,1974,,25,411502226,73221062,,9,305143355,54295980,,16,106358871,18925082,PDN
HI343A,,1984,1974,,25,411502226,73221062,,9,312619047,55626174,,16,98883179,17594888,PDN
HI343A,,1985,1974,,25,411502226,73221062,,9,318328088,56642018,,16,93174138,16579044,PDN
HI343A,,1986,1974,,25,411502226,73221062,,9,319128519,56784443,,16,92373707,16436619,PDN
HI343A,,1987,1974,,9,332288002,59125988,,9,319190390,56795452,,0,13097612,2330536,PDN
HI343A,,1988,1974,,9,319190390,56795452,,9,319190390,56795452,,0,0,0,PDN
HI343A,,1989,1974,,9,319190390,56795452,,9,319190390,56795452,,0,0,0,PDN
HI343A,,1990,1974,,9,319190390,56795452,,9,319190390,56795452,,0,0,0,PDN
HI343A,,1991,1974,,9,319190390,56795452,,9,319190390,56795452,,0,0,0,PDN
HI343A,,1992,1974,,9,319190390,56795452,,9,319190390,56795452,,0,0,0,PDN
HI343A,,1993,1974,,9,319190390,56795452,,9,319190390,56795452,,0,0,0,PDN
HI343A,,1994,1974,,9,319190390,56795452,,9,319190390,56795452,,0,0,0,PDN
HI343A,,1995,1974,,9,319190390,56795452,,9,319190390,56795452,,0,0,0,PDN
HI343A,,1996,1974,,9,319190390,56795452,,9,319190390,56795452,,0,0,0,PDN
HI343A,,1997,1974,,9,319190390,56795452,,9,319190390,56795452,,0,0,0,PDN
HI343A,,1998,1974,,9,319190390,56795452,,9,319190390,56795452,,0,0,0,PDN
HI343A,,1999,1974,,9,319190390,56795452,,9,319190390,56795452,,0,0,0,PDN
HI343A,,2000,1974,,9,319190390,56795452,,9,319190390,56795452,,0,0,0,PDN
HI343A,,2001,1974,,9,331673328,59016615,,9,319190390,56795452,,0,12482938,2221163,PDN
HI343A,,2002,1974,,9,331670446,59016103,,9,319190390,56795452,,0,12480056,2220651,PDN
HI343A,,2003,1974,,9,331670446,59016103,,9,319190390,56795452,,0,12480056,2220651,PDN
HI343A,,2004,1974,,9,331670446,59016103,,9,319190390,56795452,,0,12480056,2220651,PDN
HI343A,,2005,1974,,9,340053134,60507685,,9,319928930,56926865,,0,20124204,3580820,PDN
HI343A,,2006,1974,,9,340053134,60507685,,9,323245662,57517031,,0,16807472,2990654,PDN
HI343A,,2007,1974,,9,327573078,58287034,,9,324883699,57808496,,0,2689379,478538,PDN
HI343A,,2008,1974,,9,325441887,57907818,,9,325349001,57891290,,0,92886,16528,PDN
HI343A,,2009,1974,,9,331834332,59045264,,9,331834332,59045264,,0,0,0,PDN
HI343A,,2010,1974,,9,331834332,59045264,,9,331834332,59045264,,0,0,0,PDN
HI343A,,2011,1974,,9,331834332,59045264,,9,331834332,59045264,,0,0,0,PDN
HI343A,,2012,1974,,9,331834332,59045264,,9,331834332,59045264,,0,0,0,PDN
HI343A,,2013,1974,,9,331834332,59045264,,9,331834332,59045264,,0,0,0,PDN
HI343A,,2014,1974,,9,331834332,59045264,,9,331834332,59045264,,0,0,0,PDN
HI343A,,2015,1974,,9,331834332,59045264,,9,331834332,59045264,,0,0,0,PDN
HI343A,,2016,1974,,9,331834332,59045264,,9,331834332,59045264,,0,0,0,PDN
HI343A,,2017,1974,,9,331834332,59045264,,9,331834332,59045264,,0,0,0,PDN
HI343A,,2017,1974,,9,331834332,59045264,,9,331834332,59045264,,0,0,0,PDN
HI352A,,2003,1976,,295,8122716,1445618,,126,2877604,512155,,169,5245112,933463,PDN
HI352A,,2004,1976,,294,8272282,1472230,,265,7177297,1277364,,29,1094985,194866,PDN
HI352A,,2005,1976,,298,8473438,1508027,,294,8272282,1472230,,4,201156,35797,PDN
HI352A,,2006,1976,,3847,9082831,1620009,,1184,8607090,1532695,,2663,475741,87314,PDN
HI352A,,2007,1976,,1184,8666446,1543256,,1184,8666446,1543256,,0,0,0,PDN
HI352A,,2008,1976,,1184,8666446,1543256,,1184,8666446,1543256,,0,0,0,PDN
HI352A,,2009,1976,,1184,8666446,1543257,,1184,8666446,1543257,,0,0,0,PDN
HI352A,,2010,1976,,1184,8666446,1543257,,1184,8666446,1543257,,0,0,0,PDN
HI352A,,2011,1976,,1184,8666446,1543257,,1184,8666446,1543257,,0,0,0,PDN
HI352A,,2012,1976,,1184,8666446,1543257,,1184,8666446,1543257,,0,0,0,PDN
HI352A,,2013,1976,,1184,8666446,1543257,,1184,8666446,1543257,,0,0,0,PDN
HI352A,,2014,1976,,1184,8666446,1543257,,1184,8666446,1543257,,0,0,0,PDN
HI352A,,2015,1976,,1184,8666446,1543257,,1184,8666446,1543257,,0,0,0,PDN
HI352A,,2016,1976,,1184,8666446,1543257,,1184,8666446,1543257,,0,0,0,PDN
HI352A,,2017,1976,,1184,8666446,1543257,,1184,8666446,1543257,,0,0,0,PDN
HI352A,,2017,1976,,1184,8666446,1543257,,1184,8666446,1543257,,0,0,0,PDN
HI355A,,1977,1975,,65000,65000000,11630836,,0,0,0,,65000,65000000,11630836,PDN
HI355A,,1978,1975,,37725,37724240,6750223,,0,0,0,,37725,37724240,6750223,PDN
HI355A,,1979,1975,,37725,37724240,6750223,,0,0,0,,37725,37724240,6750223,PDN
HI355A,,1980,1975,,37725,42309240,7566060,,0,3159809,562244,,37725,39149431,7003816,PDN
HI355A,,1981,1975,,30,42700000,7597895,,9,11752993,2091289,,21,30947007,5506606,PDN
HI355A,,1982,1975,,30,47940000,8530279,,17,20164361,3587982,,13,27775639,4942297,PDN
HI355A,,1983,1975,,30,47940000,8530279,,20,23356318,4155948,,10,24583682,4374331,PDN
HI355A,,1984,1975,,30,55492393,9874121,,20,28858214,5134934,,10,26634179,4739187,PDN
HI355A,,1985,1975,,30,57608799,10250706,,20,32301284,5747579,,10,25307515,4503127,PDN
HI355A,,1986,1975,,30,57608799,10250706,,20,33661728,5989651,,10,23947071,4261055,PDN
HI355A,,1987,1975,,30,63769513,11346918,,20,41528264,7389391,,10,22241249,3957527,PDN
HI355A,,1988,1975,,30,68531621,12194269,,20,45473723,8091430,,10,23057898,4102839,PDN
HI355A,,1989,1975,,30,82513767,14682195,,20,52353754,9315635,,10,30160013,5366560,PDN
HI355A,,1990,1975,,20,75746251,13478001,,20,57340245,10202911,,0,18406006,3275090,PDN
HI355A,,1991,1975,,20,84194977,14981333,,20,63815522,11355095,,0,20379455,3626238,PDN
HI355A,,1992,1975,,20,85001243,15124796,,20,70123961,12477593,,0,14877282,2647203,PDN
HI355A,,1993,1975,,20,91766414,16328563,,20,75773986,13482936,,0,15992428,2845627,PDN
HI355A,,1994,1975,,20,91762983,16327953,,20,80410931,14308015,,0,11352052,2019938,PDN
HI355A,,1995,1975,,20,93215399,16586390,,20,81745136,14545418,,0,11470263,2040972,PDN
HI355A,,1996,1975,,20,91132328,16215737,,20,82667616,14709560,,0,8464712,1506177,PDN
HI355A,,1997,1975,,20,91128554,16215065,,20,83725728,14897836,,0,7402826,1317229,PDN
HI355A,,1998,1975,,20,97344628,17321128,,20,86600254,15409318,,0,10744374,1911810,PDN
HI355A,,1999,1975,,20,99531774,17710300,,20,90124866,16036473,,0,9406908,1673827,PDN
HI355A,,2000,1975,,39685,111595286,19896497,,23852,97849431,17434783,,15833,13745855,2461714,PDN
HI355A,,2001,1975,,49289,112535466,20073393,,31056,101634075,18115411,,18233,10901391,1957982,PDN
HI355A,,2002,1975,,44268,109579445,19542390,,35011,103245380,18406075,,9257,6334065,1136315,PDN
HI355A,,2003,1975,,94893,131842466,23554406,,39831,106963048,19072402,,55062,24879418,4482004,PDN
HI355A,,2004,1975,,68044,122071737,21788993,,49986,112513389,20070162,,18058,9558348,1718831,PDN
HI355A,,2005,1975,,68044,122039423,21783243,,55018,115473220,20601854,,13026,6566203,1181389,PDN
HI355A,,2006,1975,,58575,119727405,21362383,,57006,116668115,20816457,,1569,3059290,545926,PDN
HI355A,,2007,1975,,57540,119545245,21328936,,57540,117260887,20922467,,0,2284358,406469,PDN
HI355A,,2008,1975,,57540,117879609,21032559,,57540,117487142,20962725,,0,392467,69834,PDN
HI355A,,2009,1975,,57540,119591791,21337217,,57540,119591791,21337217,,0,0,0,PDN
HI355A,,2010,1975,,57540,119591791,21337217,,57540,119591791,21337217,,0,0,0,PDN
HI355A,,2011,1975,,57540,119591791,21337217,,57540,119591791,21337217,,0,0,0,PDN
HI355A,,2012,1975,,57540,119591791,21337217,,57540,119591791,21337217,,0,0,0,PDN
HI355A,,2013,1975,,57540,119591791,21337217,,57540,119591791,21337217,,0,0,0,PDN
HI355A,,2014,1975,,57540,119591791,21337217,,57540,119591791,21337217,,0,0,0,PDN
HI355A,,2015,1975,,57540,119591791,21337217,,57540,119591791,21337217,,0,0,0,PDN
HI355A,,2016,1975,,57540,119591791,21337217,,57540,119591791,21337217,,0,0,0,PDN
HI355A,,2017,1975,,57540,119591791,21337217,,57540,119591791,21337217,,0,0,0,PDN
HI355A,,2017,1975,,57540,119591791,21337217,,57540,119591791,21337217,,0,0,0,PDN
HI367A,,2002,2002,,855,10574248,1882394,,0,0,0,,855,10574248,1882394,PDN
HI367A,,2003,2002,,178,10575660,1881968,,0,0,0,,178,10575660,1881968,PDN
HI367A,,2004,2002,,333,12459842,2217387,,106,3679789,654873,,227,8780053,1562514,PDN
HI367A,,2005,2002,,289,9414757,1675513,,159,7069819,1258134,,130,2344938,417379,PDN
HI367A,,2006,2002,,20427,11089340,1993619,,212,8051192,1432808,,20215,3038148,560811,PDN
HI367A,,2007,2002,,17095,9516147,1710360,,13549,8717628,1564728,,3546,798519,145632,PDN
HI367A,,2008,2002,,53347,12374801,2255269,,19143,9400066,1691753,,34204,2974735,563516,PDN
HI367A,,2009,2002,,81903,13673911,2514983,,19143,9400066,1691752,,62760,4273845,823231,PDN
HI367A,,2010,2002,,51940,12671936,2306732,,32890,10339180,1872601,,19050,2332756,434131,PDN
HI367A,,2011,2002,,84367,17196523,3144246,,34402,10753781,1947886,,49965,6442742,1196360,PDN
HI367A,,2012,2002,,84367,17196523,3144246,,41949,11122079,2020967,,42418,6074444,1123280,PDN
HI367A,,2013,2002,,84367,17196523,3144246,,51287,12473517,2270774,,33080,4723006,873473,PDN
HI367A,,2014,2002,,84367,17196523,3144246,,58893,13916047,2535057,,25474,3280476,609188,PDN
HI367A,,2015,2002,,59126,14034924,2556443,,59126,14034924,2556443,,0,0,0,PDN
HI367A,,2016,2002,,59126,14034924,2556443,,59126,14034924,2556443,,0,0,0,PDN
HI367A,,2017,2002,,59126,14034924,2556443,,59126,14034924,2556443,,0,0,0,PDN
HI367A,,2017,2002,,59126,14034924,2556443,,59126,14034924,2556443,,0,0,0,PDN
HI368A,,1976,1974,,0,273200000,48612100,,0,0,0,,0,273200000,48612100,PDP
HI368A,,1977,1974,,0,273200000,48612100,,0,0,0,,0,273200000,48612100,PDP
HI368A,,1978,1974,,273200,273200000,48885300,,88,683615,121728,,273112,272516385,48763572,PDP
HI368A,,1979,1974,,273200,273200000,48885300,,0,0,0,,273200,273200000,48885300,PDP
HI368A,,1980,1974,,273200,273200000,48885300,,0,0,0,,273200,273200000,48885300,PDP
HI368A,,1981,1974,,273200,273200000,48885300,,0,0,0,,273200,273200000,48885300,PDP
HI368A,,1982,1974,,273200,273200000,48885300,,0,0,0,,273200,273200000,48885300,PDP
HI368A,,1983,1974,,443262,224326140,40358945,,0,243510,43329,,443262,224082630,40315616,PDP
HI368A,,1984,1974,,443262,224326140,40358945,,764,3850040,685824,,442498,220476100,39673121,PDP
HI368A,,1985,1974,,10092,38223307,6811392,,2043,8892004,1584250,,8049,29331303,5227142,PDP
HI368A,,1986,1974,,10186,38984219,6946880,,2713,14283698,2544296,,7473,24700521,4402584,PDP
HI368A,,1987,1974,,10284,38984219,6946978,,2813,15199078,2707275,,7471,23785141,4239703,PDP
HI368A,,1988,1974,,11246,42404202,7556478,,3213,17793821,3169373,,8033,24610381,4387105,PDP
HI368A,,1989,1974,,12755,51444052,9166501,,3811,23695673,4220123,,8944,27748379,4946378,PDP
HI368A,,1990,1974,,8975,57114974,10171782,,4309,28762409,5122175,,4666,28352565,5049607,PDP
HI368A,,1991,1974,,9757,57797414,10293994,,4516,32151954,5725504,,5241,25645460,4568490,PDP
HI368A,,1992,1974,,194842,73947904,13352832,,32712,38282096,6844473,,162130,35665808,6508359,PDP
HI368A,,1993,1974,,194870,75127587,13562768,,62009,44499828,7980128,,132861,30627759,5582640,PDP
HI368A,,1994,1974,,194726,81981308,14782147,,66640,48928517,8772782,,128086,33052791,6009365,PDP
HI368A,,1995,1974,,194545,81679731,14728305,,68305,50997037,9142511,,126240,30682694,5585794,PDP
HI368A,,1996,1974,,70746,72191010,12916121,,69260,54579689,9780948,,1486,17611321,3135173,PDP
HI368A,,1997,1974,,70978,73199323,13095769,,69557,57868595,10366460,,1421,15330728,2729309,PDP
HI368A,,1998,1974,,70532,74001794,13238111,,69643,59788387,10708146,,889,14213407,2529965,PDP
HI368A,,1999,1974,,390373,127056396,22998272,,114884,67589756,12141531,,275489,59466640,10856741,PDP
HI368A,,2000,1974,,526203,176796491,31984653,,219567,110385144,19861052,,306636,66411347,12123601,PDP
HI368A,,2001,1974,,313335,203752069,36568151,,261076,153923258,27649556,,52259,49828811,8918595,PDP
HI368A,,2002,1974,,305412,204215964,36642772,,274563,170386536,30592452,,30849,33829428,6050320,PDP
HI368A,,2003,1974,,306282,205822681,36929534,,286130,180431561,32391390,,20152,25391120,4538144,PDP
HI368A,,2004,1974,,311101,217911822,39085446,,296002,188628515,33859795,,15099,29283307,5225651,PDP
HI368A,,2005,1974,,359996,228354901,40992540,,301004,196726959,35305801,,58992,31627942,5686739,PDP
HI368A,,2006,1974,,494924,278847163,50111857,,315465,206508316,37060717,,179459,72338847,13051140,PDP
HI368A,,2007,1974,,470857,281311216,50526234,,369668,225872780,40560554,,101189,55438436,9965680,PDP
HI368A,,2008,1974,,575008,310833475,55883456,,399898,241783992,43421961,,175110,69049483,12461495,PDP
HI368A,,2009,1974,,507624,311265644,55892968,,442087,261477945,46968412,,65537,49787699,8924559,PDP
HI368A,,2010,1974,,507624,311265644,55892968,,460688,272760872,48994648,,46936,38504772,6898320,PDP
HI368A,,2011,1974,,506769,308785372,55450783,,470985,280714150,50420119,,35784,28071222,5030664,PDP
HI368A,,2012,1974,,506945,308782991,55450536,,478740,286286155,51419332,,28205,22496836,4031201,PDP
HI368A,,2013,1974,,507458,308263896,55358683,,485491,291049318,52273623,,21967,17214578,3085059,PDP
HI368A,,2014,1974,,507822,308003914,55312787,,491121,295240894,53025085,,16701,12763020,2287700,PDP
HI368A,,2015,1974,,514802,309764328,55633007,,494650,298289928,53571148,,20152,11474400,2061861,PDP
HI368A,,2016,1974,,515442,309797908,55639623,,499509,301353261,54121085,,15933,8444647,1518538,PDP
HI368A,,2017,1974,,516621,310451441,55757089,,502780,303177307,54448915,,13841,7274134,1308171,PDP
HI368A,,2017,1974,,516621,310451441,55757089,,502780,303177307,54448915,,13841,7274134,1308171,PDP
HI370A,,1978,1973,,315000,315000000,56364822,,74972,53917875,9668900,,240028,261082125,46695922,PDN
HI370A,,1979,1973,,508823,356639790,63967860,,198562,174070698,31171996,,310261,182569092,32795864,PDN
HI370A,,1980,1973,,775793,538204490,96541716,,256941,266968463,47760226,,518852,271236027,48781490,PDN
HI370A,,1981,1973,,674750,814809000,145658558,,325475,354246352,63358634,,349275,460562648,82299924,PDN
HI370A,,1982,1973,,704750,837851000,149788558,,363338,425424482,76061644,,341412,412426518,73726914,PDN
HI370A,,1983,1973,,704750,837851000,149788558,,373619,463543987,82854755,,331131,374307013,66933803,PDN
HI370A,,1984,1973,,738891,837851000,149822699,,391307,499507235,89271598,,347584,338343765,60551101,PDN
HI370A,,1985,1973,,738891,837851000,149822699,,404832,526451607,94079495,,334059,311399393,55743204,PDN
HI370A,,1986,1973,,738891,837851000,149822699,,423690,550606415,98396362,,315201,287244585,51426337,PDN
HI370A,,1987,1973,,574800,680193636,121605696,,454301,571171709,102086278,,120499,109021927,19519418,PDN
HI370A,,1988,1973,,579431,692596249,123817198,,462778,590385700,105513614,,116653,102210549,18303584,PDN
HI370A,,1989,1973,,580477,693758759,124025096,,469192,606331338,108357330,,111285,87427421,15667766,PDN
HI370A,,1990,1973,,492523,695594417,124263772,,472787,619239916,110657825,,19736,76354501,13605947,PDN
HI370A,,1991,1973,,493043,697858453,124667145,,474739,631524846,112845708,,18304,66333607,11821437,PDN
HI370A,,1992,1973,,493978,707412568,126368100,,478238,646005715,115425874,,15740,61406853,10942226,PDN
HI370A,,1993,1973,,521181,710444108,126934723,,486666,662997303,118457716,,34515,47446805,8477007,PDN
HI370A,,1994,1973,,522680,716015468,127927568,,493623,680462199,121572306,,29057,35553269,6355262,PDN
HI370A,,1995,1973,,549167,724223731,129414600,,496582,692867437,123782603,,52585,31356294,5631997,PDN
HI370A,,1996,1973,,570652,735180252,131385643,,498458,703155052,125615015,,72194,32025200,5770628,PDN
HI370A,,1997,1973,,533534,735967166,131488546,,501143,711388932,127082803,,32391,24578234,4405743,PDN
HI370A,,1998,1973,,572999,765115521,136714551,,512819,722204100,129018887,,60180,42911421,7695664,PDN
HI370A,,1999,1973,,575096,765314526,136752058,,524132,733706226,131076841,,50964,31608300,5675217,PDN
HI370A,,2000,1973,,575068,765342099,136756936,,531319,743517914,132829880,,43749,21824185,3927056,PDN
HI370A,,2001,1973,,567174,766659306,136983420,,536446,750193059,134022755,,30728,16466247,2960665,PDN
HI370A,,2002,1973,,567165,766708230,136992117,,540352,754800272,134846450,,26813,11907958,2145667,PDN
HI370A,,2003,1973,,550160,774025235,138277070,,542879,758729561,135548139,,7281,15295674,2728931,PDN
HI370A,,2004,1973,,558448,788342880,140832982,,546984,765111238,136687774,,11464,23231642,4145208,PDN
HI370A,,2005,1973,,562269,794065076,141854987,,550821,774018122,138276465,,11448,20046954,3578522,PDN
HI370A,,2006,1973,,563542,794114812,141865110,,555129,781167207,139552853,,8413,12947605,2312257,PDN
HI370A,,2007,1973,,562922,792655673,141604857,,558075,786799743,140558029,,4847,5855930,1046828,PDN
HI370A,,2008,1973,,570682,808379464,144410444,,559424,789862915,141104427,,11258,18516549,3306017,PDN
HI370A,,2009,1973,,563049,820530671,146564948,,560459,807797571,144296679,,2590,12733100,2268267,PDN
HI370A,,2010,1973,,562151,814729331,145531780,,561796,810998081,144867504,,355,3731250,664280,PDN
HI370A,,2011,1973,,562151,814729331,145531780,,562130,813340623,145284657,,21,1388708,247123,PDN
HI370A,,2012,1973,,562151,814729331,145531780,,562151,814596719,145508185,,0,132612,23597,PDN
HI370A,,2013,1973,,562151,814729331,145531780,,562151,814729331,145531780,,0,0,0,PDN
HI370A,,2014,1973,,562151,814729331,145531780,,562151,814729331,145531780,,0,0,0,PDN
HI370A,,2015,1973,,562151,814729331,145531780,,562151,814729331,145531780,,0,0,0,PDN
HI370A,,2016,1973,,562151,814729331,145531780,,562151,814729331,145531780,,0,0,0,PDN
HI370A,,2017,1973,,562151,814729331,145531780,,562151,814729331,145531780,,0,0,0,PDN
HI370A,,2017,1973,,562151,814729331,145531780,,562151,814729331,145531780,,0,0,0,PDN
HI371A,,1995,1994,,4250,42496120,7565837,,0,0,0,,4250,42496120,7565837,PDN
HI371A,,1996,1994,,11416,78559553,13989984,,1065,20018602,3563094,,10351,58540951,10426890,PDN
HI371A,,1997,1994,,8903,77464714,13792660,,2746,41721942,7426579,,6157,35742772,6366081,PDN
HI371A,,1998,1994,,10007,80527344,14338716,,3635,51480455,9163858,,6372,29046889,5174858,PDN
HI371A,,1999,1994,,5190,63075768,11228637,,3947,53409747,9507461,,1243,9666021,1721176,PDN
HI371A,,2000,1994,,5205,64363952,11457866,,3980,54884311,9769872,,1225,9479641,1687994,PDN
HI371A,,2001,1994,,3980,54894558,9771695,,3980,54894558,9771695,,0,0,0,PDN
HI371A,,2002,1994,,3980,54894558,9771695,,3980,54894558,9771695,,0,0,0,PDN
HI371A,,2003,1994,,3980,54894558,9771695,,3980,54894558,9771695,,0,0,0,PDN
HI371A,,2004,1994,,3980,54894558,9771695,,3980,54894558,9771695,,0,0,0,PDN
HI371A,,2005,1994,,3980,54894558,9771695,,3980,54894558,9771695,,0,0,0,PDN
HI371A,,2006,1994,,3980,54894558,9771695,,3980,54894558,9771695,,0,0,0,PDN
HI371A,,2007,1994,,3980,54894558,9771695,,3980,54894558,9771695,,0,0,0,PDN
HI371A,,2008,1994,,3980,54894558,9771695,,3980,54894558,9771695,,0,0,0,PDN
HI371A,,2009,1994,,3980,55887567,9948389,,3980,55887567,9948389,,0,0,0,PDN
HI371A,,2010,1994,,3980,55887567,9948389,,3980,55887567,9948389,,0,0,0,PDN
HI371A,,2011,1994,,3980,55887567,9948389,,3980,55887567,9948389,,0,0,0,PDN
HI371A,,2012,1994,,3980,55887567,9948389,,3980,55887567,9948389,,0,0,0,PDN
HI371A,,2013,1994,,3980,55887567,9948389,,3980,55887567,9948389,,0,0,0,PDN
HI371A,,2014,1994,,3980,55887567,9948389,,3980,55887567,9948389,,0,0,0,PDN
HI371A,,2015,1994,,3980,55887567,9948389,,3980,55887567,9948389,,0,0,0,PDN
HI371A,,2016,1994,,3980,55887567,9948389,,3980,55887567,9948389,,0,0,0,PDN
HI371A,,2017,1994,,3980,55887567,9948389,,3980,55887567,9948389,,0,0,0,PDN
HI371A,,2017,1994,,3980,55887567,9948389,,3980,55887567,9948389,,0,0,0,PDN
HI376A,,1977,1975,,1142101,27777015,6084630,,0,0,0,,1142101,27777015,6084630,PDP
HI376A,,1978,1975,,664086,39372875,7669936,,0,0,0,,664086,39372875,7669936,PDP
HI376A,,1979,1975,,664086,39372875,7669936,,0,0,0,,664086,39372875,7669936,PDP
HI376A,,1980,1975,,664086,39372875,7669936,,0,0,0,,664086,39372875,7669936,PDP
HI376A,,1981,1975,,664086,39372875,7669936,,0,0,0,,664086,39372875,7669936,PDP
HI376A,,1982,1975,,664086,39372875,7669936,,0,0,0,,664086,39372875,7669936,PDP
HI376A,,1983,1975,,12014911,63928081,23390014,,21521,18926,24889,,11993390,63909155,23365125,PDP
HI376A,,1984,1975,,13420328,65513394,25077516,,2284523,3033152,2824230,,11135805,62480242,22253286,PDP
HI376A,,1985,1975,,16425560,75092687,29787248,,3871638,8297050,5347981,,12553922,66795637,24439267,PDP
HI376A,,1986,1975,,17757370,109340564,37212986,,5099230,13928696,7577646,,12658140,95411868,29635340,PDP
HI376A,,1987,1975,,17757366,151818007,44771246,,5851062,22013630,9768078,,11906304,129804377,35003168,PDP
HI376A,,1988,1975,,9513250,98636819,27064285,,6516688,34558456,12665879,,2996562,64078363,14398406,PDP
HI376A,,1989,1975,,9559019,81169305,24001956,,7130818,42175927,14635431,,2428201,38993378,9366525,PDP
HI376A,,1990,1975,,9502761,58502429,19912446,,7732619,46622496,16028437,,1770142,11879933,3884009,PDP
HI376A,,1991,1975,,10417849,62457715,21531321,,8631747,51471334,17790347,,1786102,10986381,3740974,PDP
HI376A,,1992,1975,,10607358,63702198,21942269,,9237184,56087872,19217232,,1370174,7614326,2725037,PDP
HI376A,,1993,1975,,10635915,66574690,22481945,,9632689,58381779,20020906,,1003226,8192911,2461039,PDP
HI376A,,1994,1975,,19712058,125374921,42020763,,9985853,64304188,21427879,,9726205,61070733,20592884,PDP
HI376A,,1995,1975,,19600717,120193236,40987414,,10701263,70877252,23312874,,8899454,49315984,17674540,PDP
HI376A,,1996,1975,,19334075,125190603,41609983,,11146676,77747636,24980775,,8187399,47442967,16629208,PDP
HI376A,,1997,1975,,18969891,144631228,44704985,,11817970,82863767,26562413,,7151921,61767461,18142572,PDP
HI376A,,1998,1975,,18176088,141603494,43372439,,12774337,89393277,28680614,,5401751,52210217,14691825,PDP
HI376A,,1999,1975,,16717898,129299851,39724989,,13466317,92239480,29879036,,3251581,37060371,9845953,PDP
HI376A,,2000,1975,,16765638,133092824,40447635,,14303682,97533674,31658428,,2461956,35559150,8789207,PDP
HI376A,,2001,1975,,16520667,128418207,39370882,,15067783,99742911,32815632,,1452884,28675296,6555250,PDP
HI376A,,2002,1975,,17432950,129625253,40497942,,15616287,101165447,33617256,,1816663,28459806,6880686,PDP
HI376A,,2003,1975,,17432950,129625253,40497942,,16076736,102318304,34282840,,1356214,27306949,6215102,PDP
HI376A,,2004,1975,,17466716,137598082,41950361,,16486133,106787396,35487449,,980583,30810686,6462912,PDP
HI376A,,2005,1975,,17466716,137598082,41950361,,16762212,110749641,36468554,,704504,26848441,5481807,PDP
HI376A,,2006,1975,,18001210,136490139,42287711,,17026963,113110783,37153437,,974247,23379356,5134274,PDP
HI376A,,2007,1975,,19180762,133921237,43010164,,17273863,114595620,37664543,,1906899,19325617,5345621,PDP
HI376A,,2008,1975,,21658292,145341242,47519723,,17461483,116025156,38106529,,4196809,29316086,9413194,PDP
HI376A,,2009,1975,,21651155,146126458,47652304,,17824353,120027858,39181626,,3826802,26098600,8470680,PDP
HI376A,,2010,1975,,21651155,146126458,47652304,,18333317,124258388,40443350,,3317838,21868070,7208955,PDP
HI376A,,2011,1975,,21651138,147276855,47856984,,19014998,127713907,41739894,,2636140,19562948,6117092,PDP
HI376A,,2012,1975,,21521869,145327427,47380842,,19560246,130291022,42743704,,1961623,15036405,4637140,PDP
HI376A,,2013,1975,,21521869,145327427,47380842,,20136406,132315987,43680177,,1385463,13011440,3700665,PDP
HI376A,,2014,1975,,21820810,144993948,47620446,,20601756,134155301,44472808,,1219054,10838647,3147640,PDP
HI376A,,2015,1975,,21835855,145040605,47643793,,20968429,135314464,45045738,,867426,9726141,2598055,PDP
HI376A,,2016,1975,,22059348,144280697,47732072,,21293626,136234742,45534686,,765722,8045955,2197386,PDP
HI376A,,2017,1975,,22206001,144843199,47978813,,21489588,136766839,45825326,,716413,8076360,2153489,PDP
HI376A,,2017,1975,,22206001,144843199,47978813,,21489588,136766839,45825326,,716413,8076360,2153489,PDP
HI384A,,1978,1976,,58657,32023000,5756700,,0,0,0,,58657,32023000,5756700,PDP
HI384A,,1979,1976,,58657,39023000,7002251,,0,0,0,,58657,39023000,7002251,PDP
HI384A,,1980,1976,,65657,39023000,7009251,,0,0,0,,65657,39023000,7009251,PDP
HI384A,,1981,1976,,65657,39023000,7009251,,0,0,0,,65657,39023000,7009251,PDP
HI384A,,1982,1976,,7000,7000000,1252552,,0,0,0,,7000,7000000,1252552,PDP
HI384A,,1983,1976,,7000,7000000,1252552,,0,0,0,,7000,7000000,1252552,PDP
HI384A,,1984,1976,,7000,7000000,1252552,,0,0,0,,7000,7000000,1252552,PDP
HI384A,,1985,1976,,936,9354967,1665521,,0,0,0,,936,9354967,1665521,PDP
HI384A,,1986,1976,,212695,29126716,5395385,,0,0,0,,212695,29126716,5395385,PDP
HI384A,,1987,1976,,212695,29126716,5395385,,0,0,0,,212695,29126716,5395385,PDP
HI384A,,1990,1976,,1182385,18218910,4424184,,198,7699,1568,,1182187,18211211,4422616,PDP
HI384A,,1991,1976,,1122742,22778960,5175938,,20575,7142240,1291436,,1102167,15636720,3884502,PDP
HI384A,,1992,1976,,1116411,31134682,6656390,,24675,13972409,2510869,,1091736,17162273,4145521,PDP
HI384A,,1993,1976,,1087840,34548329,7235230,,26523,20393869,3655325,,1061317,14154460,3579905,PDP
HI384A,,1994,1976,,4132303,37693184,10839275,,28819,23772055,4258722,,4103484,13921129,6580553,PDP
HI384A,,1995,1976,,13903378,74870425,27225518,,3404758,34079612,9468746,,10498620,40790813,17756772,PDP
HI384A,,1996,1976,,27499808,120266418,48899527,,6539672,49579215,15361596,,20960136,70687203,33537931,PDP
HI384A,,1997,1976,,36246120,151279272,63164140,,9562835,70538410,22114154,,26683285,80740862,41049986,PDP
HI384A,,1998,1976,,18387019,122479996,40180613,,11755410,79631200,25924663,,6631609,42848796,14255950,PDP
HI384A,,1999,1976,,17486052,103260949,35859886,,13047245,85814436,28316718,,4438807,17446513,7543168,PDP
HI384A,,2000,1976,,16824851,101567783,34897410,,13887272,88012375,29547837,,2937579,13555408,5349573,PDP
HI384A,,2001,1976,,16167341,97084132,33442098,,14474105,89804726,30453594,,1693236,7279406,2988504,PDP
HI384A,,2002,1976,,16139576,93646887,32802723,,15046612,91069743,31251193,,1092964,2577144,1551530,PDP
HI384A,,2003,1976,,16139576,93646887,32802723,,15467793,91885325,31817495,,671783,1761562,985228,PDP
HI384A,,2004,1976,,16110845,94948450,33005587,,15662965,92315113,32089142,,447880,2633337,916445,PDP
HI384A,,2005,1976,,16110845,94948450,33005587,,15852455,92777306,32360872,,258390,2171144,644715,PDP
HI384A,,2006,1976,,16492447,94475327,33303003,,16049779,93253129,32642862,,442668,1222198,660141,PDP
HI384A,,2007,1976,,16771398,94752955,33631354,,16299267,93575781,32949762,,472131,1177174,681592,PDP
HI384A,,2008,1976,,17504097,95440389,34486373,,16461067,93677172,33129603,,1043030,1763217,1356770,PDP
HI384A,,2009,1976,,17622921,97431613,34959505,,16637575,95415753,33615467,,985346,2015860,1344041,PDP
HI384A,,2010,1976,,17622921,97431613,34959505,,16813606,95653142,33833739,,809315,1778471,1125770,PDP
HI384A,,2011,1976,,17656995,97461522,34998901,,16967155,95867944,34025509,,689840,1593578,973396,PDP
HI384A,,2012,1976,,17656995,97461522,34998901,,17091721,95971753,34168546,,565274,1489769,830358,PDP
HI384A,,2013,1976,,17653304,97267264,34960645,,17196668,96059319,34289075,,456636,1207945,671573,PDP
HI384A,,2014,1976,,17577536,96489477,34746482,,17248348,96088482,34345944,,329188,400995,400538,PDP
HI384A,,2015,1976,,17606728,96244593,34732102,,17335136,96121336,34438576,,271592,123257,293525,PDP
HI384A,,2016,1976,,17636758,96289148,34770059,,17449802,96171010,34562081,,186956,118138,207979,PDP
HI384A,,2017,1976,,17746570,96356833,34891914,,17544616,96229415,34667286,,201954,127418,224628,PDP
HI384A,,2017,1976,,17746570,96356833,34891914,,17544616,96229415,34667286,,201954,127418,224628,PDP
HI389A,,1978,1975,,26845,26844895,4803517,,0,0,0,,26845,26844895,4803517,PDN
HI389A,,1979,1975,,26845,26844895,4803517,,0,0,0,,26845,26844895,4803517,PDN
HI389A,,1980,1975,,26845,26844895,4803517,,0,0,0,,26845,26844895,4803517,PDN
HI389A,,1981,1975,,26845,26844895,4803517,,0,0,0,,26845,26844895,4803517,PDN
HI389A,,1982,1975,,26845,26844895,4803517,,0,0,0,,26845,26844895,4803517,PDN
HI389A,,1983,1975,,80331,32193455,5808704,,0,0,0,,80331,32193455,5808704,PDN
HI389A,,1984,1975,,80331,32193455,5808704,,0,0,0,,80331,32193455,5808704,PDN
HI389A,,1985,1975,,80331,32193455,5808704,,0,0,0,,80331,32193455,5808704,PDN
HI389A,,1986,1975,,80331,32193455,5808704,,0,0,0,,80331,32193455,5808704,PDN
HI389A,,1987,1975,,80331,32193455,5808704,,0,0,0,,80331,32193455,5808704,PDN
HI389A,,1988,1975,,96286,32193454,5824659,,10590,2630527,478655,,85696,29562927,5346004,PDN
HI389A,,1989,1975,,86566,36422372,6567415,,31023,10246042,1854162,,55543,26176330,4713253,PDN
HI389A,,1990,1975,,106627,37847140,6840994,,55370,17345060,3141680,,51257,20502080,3699314,PDN
HI389A,,1991,1975,,119965,39253203,7104521,,73807,21304220,3864593,,46158,17948983,3239928,PDN
HI389A,,1992,1975,,128510,38439644,6968304,,89970,24230485,4401444,,38540,14209159,2566860,PDN
HI389A,,1993,1975,,161672,35451519,6469771,,107406,26988686,4909663,,54266,8462833,1560108,PDN
HI389A,,1994,1975,,164246,35367614,6457416,,126565,29202266,5322698,,37681,6165348,1134718,PDN
HI389A,,1995,1975,,164246,35367614,6457416,,141667,30677517,5600300,,22579,4690097,857116,PDN
HI389A,,1996,1975,,206919,35940379,6602004,,156436,31836960,5821376,,50483,4103419,780628,PDN
HI389A,,1997,1975,,206919,35940379,6602004,,167457,32742597,5993542,,39462,3197782,608462,PDN
HI389A,,1998,1975,,206919,35940379,6602004,,176752,33818565,6194290,,30167,2121814,407714,PDN
HI389A,,1999,1975,,262693,45799960,8412152,,188888,35099651,6434378,,73805,10700309,1977774,PDN
HI389A,,2000,1975,,262693,45799960,8412152,,199211,36201486,6640757,,63482,9598474,1771395,PDN
HI389A,,2001,1975,,336182,55536672,10218152,,212951,37794245,6937906,,123231,17742427,3280246,PDN
HI389A,,2002,1975,,320508,54442224,10007736,,239700,41021468,7538894,,80808,13420756,2468842,PDN
HI389A,,2003,1975,,320508,54442224,10007736,,254282,43412455,7978918,,66226,11029769,2028818,PDN
HI389A,,2004,1975,,310957,55078668,10111431,,261933,45010676,8270950,,49024,10067992,1840481,PDN
HI389A,,2005,1975,,310957,55078668,10111431,,265015,46372618,8516371,,45942,8706050,1595060,PDN
HI389A,,2006,1975,,319366,56427782,10359896,,268522,47032046,8637213,,50844,9395736,1722683,PDN
HI389A,,2007,1975,,276361,48958221,8987788,,270698,47522068,8726582,,5663,1436153,261206,PDN
HI389A,,2008,1975,,276361,48958221,8987788,,271884,47822522,8781230,,4477,1135699,206558,PDN
HI389A,,2009,1975,,272049,48548789,8910624,,271884,48493275,8900581,,165,55514,10043,PDN
HI389A,,2010,1975,,272049,48548789,8910624,,272049,48545613,8910059,,0,3176,565,PDN
HI389A,,2011,1975,,272049,48548789,8910624,,272049,48548789,8910624,,0,0,0,PDN
HI389A,,2012,1975,,272049,48548789,8910624,,272049,48548789,8910624,,0,0,0,PDN
HI389A,,2013,1975,,272049,48548789,8910624,,272049,48548789,8910624,,0,0,0,PDN
HI389A,,2014,1975,,272049,48548789,8910624,,272049,48548789,8910624,,0,0,0,PDN
HI389A,,2015,1975,,272049,48548789,8910624,,272049,48548789,8910624,,0,0,0,PDN
HI389A,,2016,1975,,272049,48548789,8910624,,272049,48548789,8910624,,0,0,0,PDN
HI389A,,2017,1975,,272049,48548789,8910624,,272049,48548789,8910624,,0,0,0,PDN
HI389A,,2017,1975,,272049,48548789,8910624,,272049,48548789,8910624,,0,0,0,PDN
HI414A,,1978,1978,,2116,2115750,378584,,0,0,0,,2116,2115750,378584,PDN
HI414A,,1979,1978,,2116,2115750,378584,,0,0,0,,2116,2115750,378584,PDN
HI414A,,1980,1978,,2116,2115750,378584,,0,0,0,,2116,2115750,378584,PDN
HI414A,,1981,1978,,2116,7335935,1307443,,1004,4517526,804834,,1112,2818409,502609,PDN
HI414A,,1982,1978,,4010,16307370,2905677,,955,4988284,888550,,3055,11319086,2017127,PDN
HI414A,,1983,1978,,4010,22307370,3973293,,1025,7196158,1281480,,2985,15111212,2691813,PDN
HI414A,,1984,1978,,19672,23873541,4267633,,1025,9215270,1640753,,18647,14658271,2626880,PDN
HI414A,,1985,1978,,19682,23873541,4267643,,1027,9973113,1775602,,18655,13900428,2492041,PDN
HI414A,,1986,1978,,19682,23873541,4267643,,1027,10319506,1837238,,18655,13554035,2430405,PDN
HI414A,,1987,1978,,19682,23873541,4267643,,1029,10483400,1866403,,18653,13390141,2401240,PDN
HI414A,,1988,1978,,19682,23873541,4267643,,1045,10664829,1898701,,18637,13208712,2368942,PDN
HI414A,,1989,1978,,19682,23873541,4267643,,1045,10747303,1913376,,18637,13126238,2354267,PDN
HI414A,,1990,1978,,1780,15760138,2806075,,1045,10923417,1944714,,735,4836721,861361,PDN
HI414A,,1991,1978,,1056,11230557,1999376,,1056,11230557,1999376,,0,0,0,PDN
HI414A,,1992,1978,,1056,11230557,1999376,,1056,11230557,1999376,,0,0,0,PDN
HI414A,,1993,1978,,1056,11230557,1999376,,1056,11230557,1999376,,0,0,0,PDN
HI414A,,1994,1978,,1056,11230557,1999376,,1056,11230557,1999376,,0,0,0,PDN
HI414A,,1995,1978,,1056,11230557,1999376,,1056,11230557,1999376,,0,0,0,PDN
HI414A,,1996,1978,,1056,11230557,1999376,,1056,11230557,1999376,,0,0,0,PDN
HI414A,,1997,1978,,1056,11230557,1999376,,1056,11230557,1999376,,0,0,0,PDN
HI414A,,1998,1978,,1056,11230557,1999376,,1056,11230557,1999376,,0,0,0,PDN
HI414A,,1999,1978,,1056,11230557,1999376,,1056,11230557,1999376,,0,0,0,PDN
HI414A,,2000,1978,,1056,11230557,1999376,,1056,11230557,1999376,,0,0,0,PDN
HI414A,,2001,1978,,1056,11230557,1999376,,1056,11230557,1999376,,0,0,0,PDN
HI414A,,2002,1978,,1056,11230557,1999376,,1056,11230557,1999376,,0,0,0,PDN
HI414A,,2003,1978,,1056,11230557,1999376,,1056,11230557,1999376,,0,0,0,PDN
HI414A,,2004,1978,,1056,11230557,1999376,,1056,11230557,1999376,,0,0,0,PDN
HI414A,,2005,1978,,1056,11230557,1999376,,1056,11230557,1999376,,0,0,0,PDN
HI414A,,2006,1978,,1056,11230557,1999376,,1056,11230557,1999376,,0,0,0,PDN
HI414A,,2007,1978,,1056,11230557,1999376,,1056,11230557,1999376,,0,0,0,PDN
HI414A,,2008,1978,,1056,11230557,1999376,,1056,11230557,1999376,,0,0,0,PDN
HI414A,,2009,1978,,1056,11455474,2039395,,1056,11455474,2039395,,0,0,0,PDN
HI414A,,2010,1978,,1056,11455474,2039395,,1056,11455474,2039395,,0,0,0,PDN
HI414A,,2011,1978,,1056,11455474,2039395,,1056,11455474,2039395,,0,0,0,PDN
HI414A,,2012,1978,,1056,11455474,2039395,,1056,11455474,2039395,,0,0,0,PDN
HI414A,,2013,1978,,1056,11455474,2039395,,1056,11455474,2039395,,0,0,0,PDN
HI414A,,2014,1978,,1056,11455474,2039395,,1056,11455474,2039395,,0,0,0,PDN
HI414A,,2015,1978,,1056,11455474,2039395,,1056,11455474,2039395,,0,0,0,PDN
HI414A,,2016,1978,,1056,11455474,2039395,,1056,11455474,2039395,,0,0,0,PDN
HI414A,,2017,1978,,1056,11455474,2039395,,1056,11455474,2039395,,0,0,0,PDN
HI414A,,2017,1978,,1056,11455474,2039395,,1056,11455474,2039395,,0,0,0,PDN
HI416A,,1978,1976,,311077,12877100,2602376,,0,0,0,,311077,12877100,2602376,PDN
HI416A,,1981,1976,,0,4169300,741868,,0,0,0,,0,4169300,741868,PDN
HI416A,,1982,1976,,0,4169300,741868,,0,0,0,,0,4169300,741868,PDN
HI416A,,1983,1976,,77589,8330870,1559950,,0,0,0,,77589,8330870,1559950,PDN
HI416A,,1984,1976,,106631,28533606,5183785,,14635,5109421,923785,,91996,23424185,4260000,PDN
HI416A,,1985,1976,,107805,32037556,5808438,,27752,11004624,1985870,,80053,21032932,3822568,PDN
HI416A,,1986,1976,,107805,32037556,5808438,,31388,12760848,2302002,,76417,19276708,3506436,PDN
HI416A,,1987,1976,,107805,32037556,5808438,,36975,15876342,2861947,,70830,16161214,2946491,PDN
HI416A,,1988,1976,,107805,32037556,5808438,,41894,19464584,3505343,,65911,12572972,2303095,PDN
HI416A,,1989,1976,,79005,41490317,7461624,,47318,23274037,4188606,,31687,18216280,3273018,PDN
HI416A,,1990,1976,,67847,30241412,5448881,,53409,26254195,4724974,,14438,3987217,723907,PDN
HI416A,,1991,1976,,67847,30241412,5448881,,56683,27547704,4958410,,11164,2693708,490471,PDN
HI416A,,1992,1976,,67847,30241412,5448881,,55862,28125177,5060342,,11985,2116235,388539,PDN
HI416A,,1993,1976,,55862,28125115,5060331,,55862,28125115,5060331,,0,0,0,PDN
HI416A,,1994,1976,,55862,28125115,5060331,,55862,28125115,5060331,,0,0,0,PDN
HI416A,,1995,1976,,55862,28125115,5060331,,55862,28125115,5060331,,0,0,0,PDN
HI416A,,1996,1976,,55862,28125115,5060331,,55862,28125115,5060331,,0,0,0,PDN
HI416A,,1997,1976,,161541,37863762,6898865,,97805,31504510,5703590,,63736,6359252,1195275,PDN
HI416A,,1998,1976,,188350,56778077,10291211,,142217,37262660,6772584,,46133,19515417,3518627,PDN
HI416A,,1999,1976,,985215,61432670,11916295,,225050,43920387,8040065,,760165,17512283,3876230,PDN
HI416A,,2000,1976,,1497809,101037617,19476032,,594955,50349913,9554014,,902854,50687704,9922018,PDN
HI416A,,2001,1976,,2133124,98247631,19614909,,1032183,56431071,11073299,,1100941,41816560,8541610,PDN
HI416A,,2002,1976,,2108151,84210339,17092197,,1402613,57744117,11677367,,705538,26466222,5414830,PDN
HI416A,,2003,1976,,2209912,79292643,16318923,,1651683,58021012,11975706,,558229,21271631,4343217,PDN
HI416A,,2004,1976,,2073993,60371890,12816322,,1851475,58182065,12204156,,222518,2189825,612166,PDN
HI416A,,2005,1976,,2054215,60659677,12847752,,1899248,58208495,12256631,,154967,2451182,591121,PDN
HI416A,,2006,1976,,2054215,60659677,12847752,,1911777,58330957,12290951,,142438,2328720,556801,PDN
HI416A,,2007,1976,,2061021,58577319,12484031,,1939529,58429276,12336197,,121492,148043,147834,PDN
HI416A,,2008,1976,,1944093,58509079,12354961,,1944093,58509079,12354961,,0,0,0,PDN
HI416A,,2009,1976,,1944093,59201130,12478104,,1944093,59201130,12478104,,0,0,0,PDN
HI416A,,2010,1976,,1944093,59201130,12478104,,1944093,59201130,12478104,,0,0,0,PDN
HI416A,,2011,1976,,1944093,59201130,12478104,,1944093,59201130,12478104,,0,0,0,PDN
HI416A,,2012,1976,,1944093,59201130,12478104,,1944093,59201130,12478104,,0,0,0,PDN
HI416A,,2013,1976,,1944093,59201130,12478104,,1944093,59201130,12478104,,0,0,0,PDN
HI416A,,2014,1976,,1944093,59201130,12478104,,1944093,59201130,12478104,,0,0,0,PDN
HI416A,,2015,1976,,1944093,59201130,12478104,,1944093,59201130,12478104,,0,0,0,PDN
HI416A,,2016,1976,,1944093,59201130,12478104,,1944093,59201130,12478104,,0,0,0,PDN
HI416A,,2017,1976,,1944093,59201130,12478104,,1944093,59201130,12478104,,0,0,0,PDN
HI416A,,2017,1976,,1944093,59201130,12478104,,1944093,59201130,12478104,,0,0,0,PDN
HI442A,,1976,1973,,0,11000000,1957295,,0,0,0,,0,11000000,1957295,PDP
HI442A,,1977,1973,,0,11000000,1957295,,0,0,0,,0,11000000,1957295,PDP
HI442A,,1978,1973,,102667,50017770,9002626,,0,0,0,,102667,50017770,9002626,PDP
HI442A,,1979,1973,,102667,69017770,12383409,,0,0,0,,102667,69017770,12383409,PDP
HI442A,,1980,1973,,5802667,79017770,19862768,,0,0,0,,5802667,79017770,19862768,PDP
HI442A,,1981,1973,,39673458,102150506,57849705,,393360,1821251,717426,,39280098,100329255,57132279,PDP
HI442A,,1982,1973,,39906656,90069595,55933274,,847826,3499285,1470475,,39058830,86570310,54462799,PDP
HI442A,,1983,1973,,4863336,28822469,9991889,,1245046,4420562,2031623,,3618290,24401907,7960266,PDP
HI442A,,1984,1973,,4970610,28418949,10027362,,1595246,5446504,2564375,,3375364,22972445,7462987,PDP
HI442A,,1985,1973,,2633561,21923997,6534628,,1707689,6950397,2944414,,925872,14973600,3590214,PDP
HI442A,,1986,1973,,2805710,24911952,7238442,,1956244,8247444,3423761,,849466,16664508,3814681,PDP
HI442A,,1987,1973,,2805710,25249842,7298564,,2193084,9084282,3809504,,612626,16165560,3489060,PDP
HI442A,,1988,1973,,3246353,28431531,8305344,,2404724,11466682,4445059,,841629,16964849,3860285,PDP
HI442A,,1989,1973,,3334034,37281892,9967823,,2483312,15662080,5270159,,850722,21619812,4697664,PDP
HI442A,,1990,1973,,3006665,41341940,10362882,,2603886,22904169,6679361,,402779,18437771,3683521,PDP
HI442A,,1991,1973,,2988299,46894953,11332597,,2702316,28411665,7757772,,285983,18483288,3574825,PDP
HI442A,,1992,1973,,3208064,46691036,11516078,,2792340,32636297,8599510,,415724,14054739,2916568,PDP
HI442A,,1993,1973,,3149654,48740863,11822405,,2856920,35294548,9137089,,292734,13446315,2685316,PDP
HI442A,,1994,1973,,3176502,49251327,11940083,,2906355,37325917,9547977,,270147,11925410,2392106,PDP
HI442A,,1995,1973,,6247660,58555314,16666755,,2991951,39852173,10083085,,3255709,18703141,6583670,PDP
HI442A,,1996,1973,,6296796,60045764,16981096,,3493920,44735119,11453906,,2802876,15310645,5527190,PDP
HI442A,,1997,1973,,5206444,64471728,16678282,,3671777,47408282,12107414,,1534667,17063446,4570868,PDP
HI442A,,1998,1973,,5191157,63611138,16509865,,3833783,49594374,12658405,,1357374,14016764,3851460,PDP
HI442A,,1999,1973,,5339196,72208672,18187715,,3955919,51119425,13051902,,1383277,21089247,5135813,PDP
HI442A,,2000,1973,,5404184,93662824,22070167,,4050196,55390173,13906099,,1353988,38272651,8164068,PDP
HI442A,,2001,1973,,5319601,99241854,22978294,,4197291,66238599,15983519,,1122310,33003255,6994775,PDP
HI442A,,2002,1973,,5415917,101135086,23411484,,4275890,73220645,17304475,,1140027,27914441,6107009,PDP
HI442A,,2003,1973,,6417296,102733062,24697201,,4383396,77723920,18213275,,2033900,25009142,6483926,PDP
HI442A,,2004,1973,,6742904,101854866,24866545,,4884969,80880919,19276592,,1857935,20973947,5589953,PDP
HI442A,,2005,1973,,6992409,101616904,25073708,,5161758,81966667,19746574,,1830651,19650237,5327134,PDP
HI442A,,2006,1973,,7408990,101956725,25550756,,5880465,82703908,20596463,,1528525,19252817,4954293,PDP
HI442A,,2007,1973,,6905959,85658962,22147767,,6314088,83825208,21229605,,591871,1833754,918162,PDP
HI442A,,2008,1973,,7096855,87487768,22664074,,6498686,84306395,21499824,,598169,3181373,1164250,PDP
HI442A,,2009,1973,,7150072,89156499,23014217,,6665910,86013096,21970730,,484162,3143403,1043488,PDP
HI442A,,2010,1973,,7262353,89251264,23143360,,6765610,86808988,22212048,,496743,2442276,931313,PDP
HI442A,,2011,1973,,7262353,89251264,23143360,,6839671,86971211,22314975,,422682,2280053,828386,PDP
HI442A,,2012,1973,,7149425,88930408,22973341,,6883537,87114506,22384337,,265888,1815902,589003,PDP
HI442A,,2013,1973,,7149425,88930408,22973341,,6955337,87285900,22486633,,194088,1644508,486706,PDP
HI442A,,2014,1973,,7072952,88325944,22789310,,6986349,87430111,22543305,,86603,895833,246004,PDP
HI442A,,2015,1973,,7155440,89946781,23160204,,7038301,87508418,22609191,,117139,2438363,551012,PDP
HI442A,,2016,1973,,7135131,92988123,23681058,,7062825,87731907,22673481,,72306,5256216,1007577,PDP
HI442A,,2017,1973,,7398340,90998105,23590171,,7145150,88477507,22888476,,253190,2520598,701695,PDP
HI442A,,2017,1973,,7398340,90998105,23590171,,7145150,88477507,22888476,,253190,2520598,701695,PDP
HI448A,,1978,1978,,1667733,50724498,10693444,,0,0,0,,1667733,50724498,10693444,PDP
HI448A,,1979,1978,,1667733,50724498,10693444,,0,0,0,,1667733,50724498,10693444,PDP
HI448A,,1980,1978,,1669281,50724498,10694992,,1272,141874,26516,,1668009,50582624,10668476,PDP
HI448A,,1981,1978,,1972744,52612498,11334398,,41431,4324919,810990,,1931313,48287579,10523408,PDP
HI448A,,1982,1978,,12680587,89943566,28684780,,2180676,13814754,4638817,,10499911,76128812,24045963,PDP
HI448A,,1983,1978,,14191838,135469549,38296740,,4835794,28978109,9992041,,9356044,106491440,28304699,PDP
HI448A,,1984,1978,,14833968,130824920,38112424,,6891889,44657448,14838054,,7942079,86167472,23274370,PDP
HI448A,,1985,1978,,15776854,132325911,39322390,,8097813,56146547,18088302,,7679041,76179364,21234088,PDP
HI448A,,1986,1978,,15556671,130254835,38733688,,8967714,66871150,20866495,,6588957,63383685,17867193,PDP
HI448A,,1987,1978,,12731316,145523198,38625123,,9713452,74486580,22967292,,3017864,71036618,15657831,PDP
HI448A,,1988,1978,,13580427,170189052,43863176,,10290043,83851886,25210307,,3290384,86337166,18652869,PDP
HI448A,,1989,1978,,13693388,124109138,35776865,,10843838,89816177,26825364,,2849550,34292961,8951501,PDP
HI448A,,1990,1978,,13839522,119793056,35155012,,11260228,94021167,27989973,,2579294,25771889,7165039,PDP
HI448A,,1991,1978,,13761726,116546320,34499505,,11577452,97405647,28909418,,2184274,19140673,5590087,PDP
HI448A,,1992,1978,,14418340,122032766,36132355,,11877890,100192686,29705770,,2540450,21840080,6426585,PDP
HI448A,,1993,1978,,13715746,110034237,33294792,,12220831,102514753,30461890,,1494915,7519484,2832902,PDP
HI448A,,1994,1978,,13723303,110001212,33296472,,12469998,103861764,30950739,,1253305,6139448,2345733,PDP
HI448A,,1995,1978,,13722922,109812726,33262553,,12694716,104770522,31337158,,1028206,5042204,1925395,PDP
HI448A,,1996,1978,,14835810,143445725,40359960,,13226115,115844685,33839048,,1609695,27601040,6520912,PDP
HI448A,,1997,1978,,14737307,143424252,40257637,,13581892,126460395,36083742,,1155415,16963857,4173895,PDP
HI448A,,1998,1978,,16967373,138248656,41566778,,14117480,127373884,36781872,,2849893,10874772,4784906,PDP
HI448A,,1999,1978,,20752238,144271222,46423274,,14735770,128356897,37575076,,6016468,15914325,8848198,PDP
HI448A,,2000,1978,,20586151,144009286,46210579,,15378799,129769995,38469545,,5207352,14239291,7741034,PDP
HI448A,,2001,1978,,18271758,140664006,43300941,,15909375,131164010,39248167,,2362383,9499996,4052774,PDP
HI448A,,2002,1978,,18272303,140711886,43310005,,16269970,132393720,39827571,,2002333,8318166,3482434,PDP
HI448A,,2003,1978,,18468189,141430888,43633827,,16565945,133018270,40234676,,1902244,8412618,3399151,PDP
HI448A,,2004,1978,,18692122,141730154,43911010,,16889335,133982211,40729586,,1802787,7747943,3181424,PDP
HI448A,,2005,1978,,18692122,141730154,43911010,,17147318,134596695,41096908,,1544804,7133459,2814102,PDP
HI448A,,2006,1978,,19420574,144066110,45055113,,17449087,135248024,41514572,,1971487,8818086,3540541,PDP
HI448A,,2007,1978,,18324366,137559866,42801210,,17699034,135696498,41844318,,625332,1863368,956892,PDP
HI448A,,2008,1978,,18903224,138302890,43512279,,17921724,136031869,42126683,,981500,2271021,1385596,PDP
HI448A,,2009,1978,,18965042,141159829,44082450,,18134241,138822411,42835738,,830801,2337418,1246713,PDP
HI448A,,2010,1978,,18978942,141807019,44211508,,18303488,139099713,43054327,,675454,2707306,1157181,PDP
HI448A,,2011,1978,,19417204,141941444,44673689,,18476776,139303171,43263818,,940428,2638273,1409872,PDP
HI448A,,2012,1978,,19407980,141514387,44588476,,18615813,139432043,43425786,,792167,2082344,1162691,PDP
HI448A,,2013,1978,,19477205,140935778,44554746,,18793871,139594332,43632722,,683334,1341446,922026,PDP
HI448A,,2014,1978,,19464259,140886071,44532956,,18968199,139720910,43829571,,496060,1165161,703383,PDP
HI448A,,2015,1978,,19212477,140657515,44240507,,19109531,139836938,43991551,,102946,820577,248956,PDP
HI448A,,2016,1978,,19212477,140657515,44240507,,19166423,139878981,44055924,,46054,778534,184583,PDP
HI448A,,2017,1978,,19315655,139987169,44224406,,19224366,139916565,44120554,,91289,70604,103852,PDP
HI448A,,2017,1978,,19315655,139987169,44224406,,19224366,139916565,44120554,,91289,70604,103852,PDP
HI451A,,1995,1995,,2965,29644479,5277783,,0,52856,9405,,2965,29591623,5268378,PDN
HI451A,,1996,1995,,2965,29644479,5277783,,0,3117916,554789,,2965,26526563,4722994,PDN
HI451A,,1997,1995,,2530,31513661,5609943,,0,5803945,1032730,,2530,25709716,4577213,PDN
HI451A,,1998,1995,,2430,35125927,6252595,,0,7526999,1339324,,2430,27598928,4913271,PDN
HI451A,,1999,1995,,0,8921117,1587387,,0,8258352,1469458,,0,662765,117929,PDN
HI451A,,2000,1995,,0,8375116,1490234,,0,8375116,1490234,,0,0,0,PDN
HI451A,,2001,1995,,0,8375116,1490234,,0,8375116,1490234,,0,0,0,PDN
HI451A,,2002,1995,,0,8375116,1490234,,0,8375116,1490234,,0,0,0,PDN
HI451A,,2003,1995,,0,8375116,1490234,,0,8375116,1490234,,0,0,0,PDN
HI451A,,2004,1995,,0,8375116,1490234,,0,8375116,1490234,,0,0,0,PDN
HI451A,,2005,1995,,0,8375116,1490234,,0,8375116,1490234,,0,0,0,PDN
HI451A,,2006,1995,,0,8375116,1490234,,0,8375116,1490234,,0,0,0,PDN
HI451A,,2007,1995,,0,8375116,1490234,,0,8375116,1490234,,0,0,0,PDN
HI451A,,2008,1995,,0,8375116,1490234,,0,8375116,1490234,,0,0,0,PDN
HI451A,,2009,1995,,0,8516604,1515410,,0,8516604,1515410,,0,0,0,PDN
HI451A,,2010,1995,,0,8516604,1515410,,0,8516604,1515410,,0,0,0,PDN
HI451A,,2011,1995,,0,8516604,1515410,,0,8516604,1515410,,0,0,0,PDN
HI451A,,2012,1995,,0,8516604,1515410,,0,8516604,1515410,,0,0,0,PDN
HI451A,,2013,1995,,0,8516604,1515410,,0,8516604,1515410,,0,0,0,PDN
HI451A,,2014,1995,,0,8516604,1515410,,0,8516604,1515410,,0,0,0,PDN
HI451A,,2015,1995,,0,8516604,1515410,,0,8516604,1515410,,0,0,0,PDN
HI451A,,2016,1995,,0,8516604,1515410,,0,8516604,1515410,,0,0,0,PDN
HI451A,,2017,1995,,0,8516604,1515410,,0,8516604,1515410,,0,0,0,PDN
HI451A,,2017,1995,,0,8516604,1515410,,0,8516604,1515410,,0,0,0,PDN
HI467A,,1978,1974,,100000,100000000,17893594,,0,0,0,,100000,100000000,17893594,PDN
HI467A,,1979,1974,,0,110000000,19572954,,0,0,0,,0,110000000,19572954,PDN
HI467A,,1980,1974,,110000,110000000,19682954,,0,0,0,,110000,110000000,19682954,PDN
HI467A,,1981,1974,,110000,110000000,19682954,,0,0,0,,110000,110000000,19682954,PDN
HI467A,,1982,1974,,1110813,63042794,12328392,,40085,7048439,1294256,,1070728,55994355,11034136,PDN
HI467A,,1983,1974,,1881058,132597146,25474856,,285951,28701603,5392998,,1595107,103895543,20081858,PDN
HI467A,,1984,1974,,2021300,141950710,27279433,,538015,51802631,9755565,,1483285,90148079,17523868,PDN
HI467A,,1985,1974,,2268440,180865268,34450872,,891043,89134726,16751315,,1377397,91730542,17699557,PDN
HI467A,,1986,1974,,2490037,217692323,41225326,,1128796,125251966,23415623,,1361241,92440357,17809703,PDN
HI467A,,1987,1974,,2374906,213188308,40308769,,1257928,144041467,26888082,,1116978,69146841,13420687,PDN
HI467A,,1988,1974,,2501567,248699806,46754202,,1380174,161811303,30172221,,1121393,86888503,16581981,PDN
HI467A,,1989,1974,,2138884,251497360,46889304,,1539430,185080619,34471924,,599454,66416741,12417380,PDN
HI467A,,1990,1974,,2032654,254340418,47288956,,1655967,203824444,37923662,,376687,50515974,9365294,PDN
HI467A,,1991,1974,,1871572,247230830,45862823,,1717584,214759058,39930940,,153988,32471772,5931883,PDN
HI467A,,1992,1974,,1897779,245841343,45641790,,1740739,220730434,41016617,,157040,25110909,4625173,PDN
HI467A,,1993,1974,,1797124,234137336,43458572,,1758246,224654701,41732392,,38878,9482635,1726180,PDN
HI467A,,1994,1974,,1867188,240330818,44630679,,1772210,227958049,42334140,,94978,12372769,2296539,PDN
HI467A,,1995,1974,,1875016,240917457,44742891,,1782710,230961212,42879011,,92306,9956245,1863880,PDN
HI467A,,1996,1974,,2056251,258143252,47989214,,1819992,235474097,43719298,,236259,22669155,4269916,PDN
HI467A,,1997,1974,,2060933,272807314,50603160,,1878242,244031302,45300182,,182691,28776012,5302978,PDN
HI467A,,1998,1974,,2035355,275240046,51010452,,1899967,255027562,47278537,,135388,20212484,3731915,PDN
HI467A,,1999,1974,,2123865,275080433,51070561,,1908602,261546003,48447037,,215263,13534430,2623524,PDN
HI467A,,2000,1974,,2166281,275221632,51138102,,1912476,263268742,48757448,,253805,11952890,2380654,PDN
HI467A,,2001,1974,,2114102,278580465,51683580,,1916079,266094189,49263799,,198023,12486276,2419781,PDN
HI467A,,2002,1974,,2115523,278431352,51658468,,1917662,267872930,49581884,,197861,10558422,2076584,PDN
HI467A,,2003,1974,,2115523,278431352,51658468,,1918233,269203480,49819208,,197290,9227872,1839260,PDN
HI467A,,2004,1974,,1922881,273119126,50520590,,1919731,269923243,49948778,,3150,3195883,571812,PDN
HI467A,,2005,1974,,1927315,273544785,50600764,,1920144,270187585,49996227,,7171,3357200,604537,PDN
HI467A,,2006,1974,,1960807,277046827,51257395,,1920144,270187585,49996227,,40663,6859242,1261168,PDN
HI467A,,2007,1974,,1958175,286925434,53012523,,1927760,273829493,50651869,,30415,13095941,2360654,PDN
HI467A,,2008,1974,,1960633,288649434,53321742,,1943183,280464317,51847866,,17450,8185117,1473876,PDN
HI467A,,2009,1974,,1964480,292583062,54025527,,1949814,288860453,53348474,,14666,3722609,677051,PDN
HI467A,,2010,1974,,1956026,291438151,53813352,,1952701,290423495,53629482,,3325,1014656,183869,PDN
HI467A,,2011,1974,,1956026,291438151,53813352,,1954414,291227623,53774278,,1612,210528,39072,PDN
HI467A,,2012,1974,,1956026,291484186,53821543,,1956026,291484186,53821543,,0,0,0,PDN
HI467A,,2013,1974,,1956026,291484186,53821543,,1956026,291484186,53821543,,0,0,0,PDN
HI467A,,2014,1974,,1956026,291484186,53821543,,1956026,291484186,53821543,,0,0,0,PDN
HI467A,,2015,1974,,1956026,291484208,53821547,,1956026,291484208,53821547,,0,0,0,PDN
HI467A,,2016,1974,,1956026,291484219,53821549,,1956026,291484219,53821549,,0,0,0,PDN
HI467A,,2017,1974,,1956026,291485932,53821854,,1956026,291485932,53821854,,0,0,0,PDN
HI467A,,2017,1974,,1956026,291485932,53821854,,1956026,291485932,53821854,,0,0,0,PDN
HI469A,,1978,1974,,15000,15000000,2684039,,0,0,0,,15000,15000000,2684039,PDP
HI469A,,1979,1974,,0,60000000,10676157,,0,0,0,,0,60000000,10676157,PDP
HI469A,,1980,1974,,60000,60000000,10736157,,1096,4555755,811729,,58904,55444245,9924428,PDP
HI469A,,1981,1974,,12000,49909540,8892701,,7083,17906488,3193291,,4917,32003052,5699410,PDP
HI469A,,1982,1974,,12000,49909540,8892701,,7231,21980274,3918312,,4769,27929266,4974389,PDP
HI469A,,1983,1974,,54244,54503923,9752451,,7248,24948954,4446564,,46996,29554969,5305887,PDP
HI469A,,1984,1974,,54244,54503923,9752451,,7508,27055297,4821618,,46736,27448626,4930833,PDP
HI469A,,1985,1974,,54244,54503923,9752451,,8220,30368778,5411917,,46024,24135145,4340534,PDP
HI469A,,1986,1974,,10266,54503923,9708473,,8603,32188038,5736012,,1663,22315885,3972461,PDP
HI469A,,1987,1974,,16155,62921332,11212122,,10500,35815926,6383441,,5655,27105406,4828681,PDP
HI469A,,1988,1974,,17098,69336231,12354506,,11224,39089586,6966666,,5874,30246645,5387840,PDP
HI469A,,1989,1974,,17098,69336231,12354506,,11330,42155903,7512380,,5768,27180328,4842126,PDP
HI469A,,1990,1974,,17098,69336231,12354506,,11330,45198862,8053832,,5768,24137369,4300674,PDP
HI469A,,1991,1974,,13462,56216126,10016331,,11869,47422486,8450034,,1593,8793640,1566297,PDP
HI469A,,1992,1974,,13462,56216126,10016331,,12234,49505822,8821099,,1228,6710304,1195232,PDP
HI469A,,1993,1974,,13603,58870341,10488753,,12607,51441603,9165917,,996,7428738,1322836,PDP
HI469A,,1994,1974,,13902,58870392,10489061,,12783,52954249,9435247,,1119,5916143,1053814,PDP
HI469A,,1995,1974,,16092,64618359,11514021,,13108,54119305,9642878,,2984,10499054,1871143,PDP
HI469A,,1996,1974,,42908,94645856,16883808,,21145,63367590,11296517,,21763,31278266,5587291,PDP
HI469A,,1997,1974,,42285,88584696,15804686,,23204,68010706,12124753,,19081,20573990,3679933,PDP
HI469A,,1998,1974,,27095,79059577,14094635,,26354,70693870,12605334,,741,8365707,1489301,PDP
HI469A,,1999,1974,,26578,90153867,16068192,,26366,74780709,13332542,,212,15373158,2735650,PDP
HI469A,,2000,1974,,26684,101045257,18006268,,26436,77766132,13863826,,248,23279125,4142442,PDP
HI469A,,2001,1974,,26835,102338686,18236566,,26472,86234135,15370624,,363,16104551,2865942,PDP
HI469A,,2002,1974,,26895,100801765,17963152,,26472,91402426,16290249,,423,9399339,1672903,PDP
HI469A,,2003,1974,,26895,100801765,17963152,,26563,94539021,16848453,,332,6262744,1114699,PDP
HI469A,,2004,1974,,26753,99854941,17794536,,26563,95269451,16978423,,190,4585490,816113,PDP
HI469A,,2005,1974,,26991,101792378,18139513,,26563,95978268,17104547,,428,5814110,1034966,PDP
HI469A,,2006,1974,,28461,101892945,18158878,,26609,96387074,17177334,,1852,5505871,981544,PDP
HI469A,,2007,1974,,27768,97000937,17287721,,27463,96794602,17250702,,305,206335,37019,PDP
HI469A,,2008,1974,,29036,103504491,18446205,,27463,96796392,17251020,,1573,6708099,1195185,PDP
HI469A,,2009,1974,,29036,104831486,18682325,,27645,98738036,17596691,,1391,6093450,1085634,PDP
HI469A,,2010,1974,,29036,104831486,18682325,,28132,99506543,17733923,,904,5324943,948402,PDP
HI469A,,2011,1974,,29036,104831486,18682325,,28349,99652412,17760095,,687,5179074,922230,PDP
HI469A,,2012,1974,,29036,104820046,18680290,,28404,99676404,17764419,,632,5143642,915871,PDP
HI469A,,2013,1974,,29036,104820046,18680290,,28404,99681332,17765296,,632,5138714,914994,PDP
HI469A,,2014,1974,,29397,108434345,19323764,,28404,99685422,17766024,,993,8748923,1557740,PDP
HI469A,,2015,1974,,48209,110605976,19728988,,28404,99685572,17766051,,19805,10920404,1962937,PDP
HI469A,,2016,1974,,47577,105431452,18807623,,40886,103460769,18450277,,6691,1970683,357346,PDP
HI469A,,2017,1974,,60862,111573383,19913778,,46076,105595773,18835361,,14786,5977610,1078418,PDP
HI469A,,2017,1974,,60862,111573383,19913778,,46076,105595773,18835361,,14786,5977610,1078418,PDP
HI474A,,1976,1973,,0,64400000,11459075,,0,0,0,,0,64400000,11459075,PDN
HI474A,,1977,1973,,11985514,117072555,32816929,,0,0,0,,11985514,117072555,32816929,PDN
HI474A,,1978,1973,,11985514,117072555,32816929,,0,0,0,,11985514,117072555,32816929,PDN
HI474A,,1979,1973,,11985531,117072555,32816946,,45682,75645,59142,,11939849,116996910,32757804,PDN
HI474A,,1980,1973,,16175348,120146379,37553707,,671086,11141771,2653608,,15504262,109004608,34900099,PDN
HI474A,,1981,1973,,17683271,178797055,49497694,,2609468,53692634,12163317,,15073803,125104421,37334377,PDN
HI474A,,1982,1973,,20686387,212809730,58552887,,4489554,98392841,21997177,,16196833,114416889,36555710,PDN
HI474A,,1983,1973,,22811903,271595475,71138500,,6502640,141381325,31659459,,16309263,130214150,39479041,PDN
HI474A,,1984,1973,,28783413,305896931,83213472,,7734421,173736030,38648305,,21048992,132160901,44565167,PDN
HI474A,,1985,1973,,28991792,347804901,90878785,,8906586,194863898,43579877,,20085206,152941003,47298908,PDN
HI474A,,1986,1973,,27916371,365283415,92913420,,10246868,215173780,48534017,,17669503,150109635,44379403,PDN
HI474A,,1987,1973,,28099483,366920194,93387774,,11143466,230643671,52183265,,16956017,136276523,41204509,PDN
HI474A,,1988,1973,,14214219,307943738,69008478,,11892174,243199750,55166151,,2322045,64743988,13842327,PDN
HI474A,,1989,1973,,14561331,309990522,69719787,,12613361,252572696,57555122,,1947970,57417826,12164665,PDN
HI474A,,1990,1973,,15433086,312982051,71123842,,13179956,257833402,59057786,,2253130,55148649,12066056,PDN
HI474A,,1991,1973,,15577083,307984052,70378516,,13632154,262795397,60392901,,1944929,45188655,9985615,PDN
HI474A,,1992,1973,,15807258,308897514,70771228,,14116355,266879708,61603848,,1690903,42017806,9167380,PDN
HI474A,,1993,1973,,16981498,314290641,72905100,,14563176,270499505,62694761,,2418322,43791136,10210339,PDN
HI474A,,1994,1973,,17577200,313440884,73349599,,15156821,273842195,63883190,,2420379,39598689,9466409,PDN
HI474A,,1995,1973,,18587249,311166657,73954982,,15670590,275663502,64721035,,2916659,35503155,9233947,PDN
HI474A,,1996,1973,,18399821,316331275,74686525,,16167258,277616124,65565145,,2232563,38715151,9121380,PDN
HI474A,,1997,1973,,18853329,317969954,75431613,,16822147,279923709,66630636,,2031182,38046245,8800977,PDN
HI474A,,1998,1973,,19572924,303782032,73626666,,17413128,281596377,67519245,,2159796,22185655,6107421,PDN
HI474A,,1999,1973,,18878191,294190957,71225336,,17802381,282542256,68076804,,1075810,11648701,3148532,PDN
HI474A,,2000,1973,,19535480,296529632,72298759,,18081766,283461032,68519672,,1453714,13068600,3779087,PDN
HI474A,,2001,1973,,19571150,298788482,72736360,,18695319,286157306,69612989,,875831,12631176,3123371,PDN
HI474A,,2002,1973,,20176972,302173377,73944477,,18963173,289946937,70555155,,1213799,12226440,3389322,PDN
HI474A,,2003,1973,,20392619,300077731,73787233,,19341810,291840010,71270637,,1050809,8237721,2516596,PDN
HI474A,,2004,1973,,20798148,300757686,74313750,,19720113,293007751,71856723,,1078035,7749935,2457027,PDN
HI474A,,2005,1973,,20807804,303958293,74892909,,20080365,294979572,72567833,,727439,8978721,2325076,PDN
HI474A,,2006,1973,,20953739,305326222,75282248,,20153339,295241333,72687384,,800400,10084889,2594864,PDN
HI474A,,2007,1973,,21491837,304049772,75593220,,20433546,297698794,73404862,,1058291,6350978,2188358,PDN
HI474A,,2008,1973,,21686403,306346273,76196416,,20681656,299269672,73932487,,1004747,7076601,2263929,PDN
HI474A,,2009,1973,,22249757,313019338,77947147,,20908720,306076088,75370656,,1341037,6943250,2576492,PDN
HI474A,,2010,1973,,22264331,313052849,77967683,,21138035,306978223,75760494,,1126296,6074626,2207191,PDN
HI474A,,2011,1973,,22409324,313216644,78141821,,21324531,307589313,76055724,,1084793,5627331,2086098,PDN
HI474A,,2012,1973,,22357738,312226766,77914100,,21566516,308238147,76413159,,791222,3988619,1500941,PDN
HI474A,,2013,1973,,22356228,311630578,77806507,,21729885,308643932,76648734,,626343,2986646,1157773,PDN
HI474A,,2014,1973,,22343156,311799199,77823437,,21855807,308974865,76833539,,487349,2824334,989900,PDN
HI474A,,2015,1973,,22493935,312013705,78012385,,22039795,309348947,77084088,,454140,2664758,928297,PDN
HI474A,,2016,1973,,22171883,309615781,77263656,,22171883,309615781,77263656,,0,0,0,PDN
HI474A,,2017,1973,,22171883,309615781,77263656,,22171883,309615781,77263656,,0,0,0,PDN
HI474A,,2017,1973,,22171883,309615781,77263656,,22171883,309615781,77263656,,0,0,0,PDN
HI480A,,1976,1973,,1481403,93314028,18085323,,0,0,0,,1481403,93314028,18085323,PDN
HI480A,,1977,1973,,1481403,93314028,18085323,,0,0,0,,1481403,93314028,18085323,PDN
HI480A,,1978,1973,,1481403,93314028,18085323,,0,0,0,,1481403,93314028,18085323,PDN
HI480A,,1979,1973,,1481403,93314028,18085323,,2024,4257392,759567,,1479379,89056636,17325756,PDN
HI480A,,1980,1973,,1421700,93314028,18025620,,7617,15806606,2820180,,1414083,77507422,15205440,PDN
HI480A,,1981,1973,,1429965,94404028,18227835,,12240,25120461,4482073,,1417725,69283567,13745762,PDN
HI480A,,1982,1973,,1429965,94404028,18227835,,14644,30340243,5413264,,1415321,64063785,12814571,PDN
HI480A,,1983,1973,,1429965,94404028,18227835,,15668,32740857,5841443,,1414297,61663171,12386392,PDN
HI480A,,1984,1973,,1429965,94404028,18227835,,16401,34506768,6156395,,1413564,59897260,12071440,PDN
HI480A,,1985,1973,,1429965,94404028,18227835,,16743,35523764,6337697,,1413222,58880264,11890138,PDN
HI480A,,1986,1973,,1429965,94404028,18227835,,17341,37106173,6619863,,1412624,57297855,11607972,PDN
HI480A,,1987,1973,,1429965,94404028,18227835,,18003,38960550,6950485,,1411962,55443478,11277350,PDN
HI480A,,1988,1973,,1429965,94404028,18227835,,18568,40302993,7189919,,1411397,54101035,11037916,PDN
HI480A,,1989,1973,,21759,49611431,8849416,,19133,41791771,7455391,,2626,7819660,1394025,PDN
HI480A,,1990,1973,,19140,42708365,7618493,,19135,41948123,7483214,,5,760242,135279,PDN
HI480A,,1991,1973,,19241,42744685,7625057,,19137,41966170,7486427,,104,778515,138630,PDN
HI480A,,1992,1973,,19241,42744685,7625057,,19137,42002416,7492877,,104,742269,132180,PDN
HI480A,,1993,1973,,19137,42010396,7494296,,19137,42010396,7494296,,0,0,0,PDN
HI480A,,1994,1973,,19137,42010396,7494296,,19137,42010396,7494296,,0,0,0,PDN
HI480A,,1995,1973,,19137,42010396,7494296,,19137,42010396,7494296,,0,0,0,PDN
HI480A,,1996,1973,,19137,42010396,7494296,,19137,42010396,7494296,,0,0,0,PDN
HI480A,,1997,1973,,19137,42010396,7494296,,19137,42010396,7494296,,0,0,0,PDN
HI480A,,1998,1973,,19137,42010396,7494296,,19137,42010396,7494296,,0,0,0,PDN
HI480A,,1999,1973,,19137,42010396,7494296,,19137,42010396,7494296,,0,0,0,PDN
HI480A,,2000,1973,,19137,42010396,7494296,,19137,42010396,7494296,,0,0,0,PDN
HI480A,,2001,1973,,19137,42010396,7494296,,19137,42010396,7494296,,0,0,0,PDN
HI480A,,2002,1973,,19137,42010396,7494296,,19137,42010396,7494296,,0,0,0,PDN
HI480A,,2003,1973,,19137,42010396,7494296,,19137,42010396,7494296,,0,0,0,PDN
HI480A,,2004,1973,,19137,42010396,7494296,,19137,42010396,7494296,,0,0,0,PDN
HI480A,,2005,1973,,19137,42010396,7494296,,19137,42010396,7494296,,0,0,0,PDN
HI480A,,2006,1973,,19137,42010396,7494296,,19137,42010396,7494296,,0,0,0,PDN
HI480A,,2007,1973,,19137,42010396,7494296,,19137,42010396,7494296,,0,0,0,PDN
HI480A,,2008,1973,,19137,42010396,7494296,,19137,42010396,7494296,,0,0,0,PDN
HI480A,,2009,1973,,19137,42851746,7644003,,19137,42851746,7644003,,0,0,0,PDN
HI480A,,2010,1973,,19137,42851746,7644003,,19137,42851746,7644003,,0,0,0,PDN
HI480A,,2011,1973,,19137,42851746,7644003,,19137,42851746,7644003,,0,0,0,PDN
HI480A,,2012,1973,,19137,42851746,7644003,,19137,42851746,7644003,,0,0,0,PDN
HI480A,,2013,1973,,19137,42851746,7644003,,19137,42851746,7644003,,0,0,0,PDN
HI480A,,2014,1973,,19137,42851746,7644003,,19137,42851746,7644003,,0,0,0,PDN
HI480A,,2015,1973,,19137,42851746,7644003,,19137,42851746,7644003,,0,0,0,PDN
HI480A,,2016,1973,,19137,42851746,7644003,,19137,42851746,7644003,,0,0,0,PDN
HI480A,,2017,1973,,19137,42851746,7644003,,19137,42851746,7644003,,0,0,0,PDN
HI480A,,2017,1973,,19137,42851746,7644003,,19137,42851746,7644003,,0,0,0,PDN
HI487A,,1984,1982,,1684613,53854899,11267335,,0,0,0,,1684613,53854899,11267335,PDN
HI487A,,1985,1982,,2073808,65347080,13701402,,44139,718449,171977,,2029669,64628631,13529425,PDN
HI487A,,1986,1982,,2335504,81819004,16894046,,192728,12387117,2396841,,2142776,69431887,14497205,PDN
HI487A,,1987,1982,,5000602,256225935,50592405,,298944,22537292,4309138,,4701658,233688643,46283267,PDN
HI487A,,1988,1982,,5000602,256225935,50592405,,423157,30716073,5888650,,4577445,225509862,44703755,PDN
HI487A,,1989,1982,,2634846,114287166,22970641,,523699,35221591,6790886,,2111147,79065575,16179755,PDN
HI487A,,1990,1982,,1781307,79981186,16012835,,764447,39940166,7871238,,1016860,40041020,8141597,PDN
HI487A,,1991,1982,,1781307,79981186,16012835,,889156,41721332,8312881,,892151,38259854,7699954,PDN
HI487A,,1992,1982,,1781307,76501946,15393753,,955298,42560030,8528257,,826009,33941916,6865496,PDN
HI487A,,1993,1982,,1574960,62113143,12627121,,1013978,43044572,8673155,,560982,19068571,3953966,PDN
HI487A,,1994,1982,,1574645,62079569,12620832,,1067642,43452001,8799315,,507003,18627568,3821517,PDN
HI487A,,1995,1982,,1231876,47318335,9651509,,1112584,43781907,8902959,,119292,3536428,748550,PDN
HI487A,,1996,1982,,1231862,47316927,9651244,,1152568,44040246,8988911,,79294,3276681,662333,PDN
HI487A,,1997,1982,,1315306,50056179,10222099,,1183327,44689433,9135183,,131979,5366746,1086916,PDN
HI487A,,1998,1982,,1287728,49754004,10140754,,1200675,45379070,9275243,,87053,4374934,865511,PDN
HI487A,,1999,1982,,1203966,45569531,9312423,,1203966,45569531,9312423,,0,0,0,PDN
HI487A,,2000,1982,,1203966,45569531,9312423,,1203966,45569531,9312423,,0,0,0,PDN
HI487A,,2001,1982,,1203966,45569531,9312423,,1203966,45569531,9312423,,0,0,0,PDN
HI487A,,2002,1982,,1203966,45569531,9312423,,1203966,45569531,9312423,,0,0,0,PDN
HI487A,,2003,1982,,1203966,45569531,9312423,,1203966,45569531,9312423,,0,0,0,PDN
HI487A,,2004,1982,,1203966,45569531,9312423,,1203966,45569531,9312423,,0,0,0,PDN
HI487A,,2005,1982,,1203966,45569531,9312423,,1203966,45569531,9312423,,0,0,0,PDN
HI487A,,2006,1982,,1203966,45569531,9312423,,1203966,45569531,9312423,,0,0,0,PDN
HI487A,,2007,1982,,1203966,45569531,9312423,,1203966,45569531,9312423,,0,0,0,PDN
HI487A,,2008,1982,,1203966,45569531,9312423,,1203966,45569531,9312423,,0,0,0,PDN
HI487A,,2009,1982,,1203966,46474595,9473469,,1203966,46474595,9473469,,0,0,0,PDN
HI487A,,2010,1982,,1203966,46474595,9473469,,1203966,46474595,9473469,,0,0,0,PDN
HI487A,,2011,1982,,1203966,46474595,9473469,,1203966,46474595,9473469,,0,0,0,PDN
HI487A,,2012,1982,,1203966,46474595,9473469,,1203966,46474595,9473469,,0,0,0,PDN
HI487A,,2013,1982,,1203966,46474595,9473469,,1203966,46474595,9473469,,0,0,0,PDN
HI487A,,2014,1982,,1203966,46474595,9473469,,1203966,46474595,9473469,,0,0,0,PDN
HI487A,,2015,1982,,1203966,46474595,9473469,,1203966,46474595,9473469,,0,0,0,PDN
HI487A,,2016,1982,,1203966,46474595,9473469,,1203966,46474595,9473469,,0,0,0,PDN
HI487A,,2017,1982,,1203966,46474595,9473469,,1203966,46474595,9473469,,0,0,0,PDN
HI487A,,2017,1982,,1203966,46474595,9473469,,1203966,46474595,9473469,,0,0,0,PDN
HI492A,,1978,1975,,1061161,186835600,34305930,,0,0,0,,1061161,186835600,34305930,PDP
HI492A,,1979,1975,,1061161,186835600,34305930,,0,0,0,,1061161,186835600,34305930,PDP
HI492A,,1980,1975,,1100725,226424590,41389798,,3295,1551761,279409,,1097430,224872829,41110389,PDP
HI492A,,1981,1975,,1109159,248216900,45275867,,31631,10160733,1839591,,1077528,238056167,43436276,PDP
HI492A,,1982,1975,,5501507,253999000,50697059,,1194965,28325979,6235175,,4306542,225673021,44461884,PDP
HI492A,,1983,1975,,6701707,293732553,58967286,,879160,36302670,7338710,,5822547,257429883,51628576,PDP
HI492A,,1984,1975,,7186313,277342038,56535430,,136272,40616274,7363367,,7050041,236725764,49172063,PDP
HI492A,,1985,1975,,7462214,285145459,58199840,,290458,48155187,8858997,,7171756,236990272,49340843,PDP
HI492A,,1986,1975,,1816510,111305187,21621703,,510864,58153111,10858393,,1305646,53152076,10763310,PDP
HI492A,,1987,1975,,3122516,114023632,23411418,,713804,68898417,12973309,,2408712,45125215,10438109,PDP
HI492A,,1988,1975,,2620250,112110003,22568649,,859811,77338319,14621078,,1760439,34771684,7947571,PDP
HI492A,,1989,1975,,2621128,128356770,25460411,,960832,82713813,15678592,,1660296,45642957,9781819,PDP
HI492A,,1990,1975,,1753686,100895444,19706612,,1029418,85269111,16201858,,724268,15626333,3504754,PDP
HI492A,,1991,1975,,1902873,101175676,19905662,,1139281,88213818,16835690,,763592,12961858,3069972,PDP
HI492A,,1992,1975,,2046792,102919802,20359924,,1168953,91974574,17534536,,877839,10945228,2825388,PDP
HI492A,,1993,1975,,1831378,104420895,20411608,,1175587,96076117,18270981,,655791,8344778,2140627,PDP
HI492A,,1994,1975,,1830979,111308707,21636799,,1180625,98969734,18790898,,650354,12338973,2845901,PDP
HI492A,,1995,1975,,1182039,110795097,20896469,,1182039,102077422,19345281,,0,8717675,1551188,PDP
HI492A,,1996,1975,,1182415,114476175,21551841,,1182040,105144815,19891082,,375,9331360,1660759,PDP
HI492A,,1997,1975,,1182415,119003414,22357400,,1182040,107821630,20367383,,375,11181784,1990017,PDP
HI492A,,1998,1975,,1220616,132403343,24779930,,1193293,112686634,21244295,,27323,19716709,3535635,PDP
HI492A,,1999,1975,,1243250,124588217,23411972,,1196964,116402906,21909225,,46286,8185311,1502747,PDP
HI492A,,2000,1975,,1245473,127914562,24006071,,1203511,119263508,22424776,,41962,8651054,1581295,PDP
HI492A,,2001,1975,,2164388,133492617,25917522,,1204405,121647839,22849928,,959983,11844778,3067594,PDP
HI492A,,2002,1975,,2306163,138747372,26994307,,1305830,125695441,23671567,,1000333,13051931,3322740,PDP
HI492A,,2003,1975,,2208600,136317661,26464411,,1403577,129732558,24487662,,805023,6585103,1976749,PDP
HI492A,,2004,1975,,1656280,141017817,26748418,,1496497,134146053,25365901,,159783,6871764,1382517,PDP
HI492A,,2005,1975,,2060061,141806546,27292542,,1573092,137113093,25970440,,486969,4693453,1322102,PDP
HI492A,,2006,1975,,2136966,144137583,27784223,,1688236,137675724,26185696,,448730,6461859,1598527,PDP
HI492A,,2007,1975,,2148874,142715308,27543057,,1853000,140814858,26909025,,295874,1900450,634032,PDP
HI492A,,2008,1975,,2412573,144238496,28077786,,1955659,141861316,27197886,,456914,2377180,879900,PDP
HI492A,,2009,1975,,2337919,145652963,28254815,,2081990,144600440,27811604,,255929,1052523,443211,PDP
HI492A,,2010,1975,,2337919,145652963,28254815,,2180205,144907394,27964436,,157714,745569,290378,PDP
HI492A,,2011,1975,,2459525,145717554,28387913,,2244700,145183369,28078037,,214825,534185,309875,PDP
HI492A,,2012,1975,,2459525,145717554,28387913,,2271340,145234495,28113775,,188185,483059,274139,PDP
HI492A,,2013,1975,,2459525,145717554,28387913,,2319495,145356619,28183660,,140030,360935,204254,PDP
HI492A,,2014,1975,,2459525,145717554,28387913,,2375574,145471673,28260211,,83951,245881,127702,PDP
HI492A,,2015,1975,,2502041,145802812,28445600,,2423433,145585573,28328337,,78608,217239,117263,PDP
HI492A,,2016,1975,,2502041,145802812,28445600,,2458908,145671614,28379122,,43133,131198,66478,PDP
HI492A,,2017,1975,,2559107,145900822,28520105,,2493092,145734845,28424558,,66015,165977,95548,PDP
HI492A,,2017,1975,,2559107,145900822,28520105,,2493092,145734845,28424558,,66015,165977,95548,PDP
HI497A,,1987,1977,,8415,41109688,7323306,,119,342334,61033,,8296,40767354,7262273,PDN
HI497A,,1988,1977,,13379,41894649,7467943,,1216,3028244,540049,,12163,38866405,6927894,PDN
HI497A,,1989,1977,,16027,42255695,7534834,,1814,7652669,1363499,,14213,34603026,6171335,PDN
HI497A,,1990,1977,,11467,42852165,7636407,,2177,12234013,2179048,,9290,30618152,5457359,PDN
HI497A,,1991,1977,,11068,42108577,7503697,,2353,14253218,2538513,,8715,27855359,4965184,PDN
HI497A,,1992,1977,,11292,41641265,7420770,,2585,16529548,2943786,,8707,25111717,4476984,PDN
HI497A,,1993,1977,,4084,33554175,5974578,,2700,17900825,3187900,,1384,15653350,2786678,PDN
HI497A,,1994,1977,,4085,33547832,5973450,,2779,18542079,3302081,,1306,15005753,2671369,PDN
HI497A,,1995,1977,,4074,33487558,5962714,,2854,19243966,3427047,,1220,14243592,2535667,PDN
HI497A,,1996,1977,,215143,46963229,8571589,,46902,21706585,3909284,,168241,25256644,4662305,PDN
HI497A,,1997,1977,,239984,48652404,8896995,,79646,24014430,4352676,,160338,24637974,4544319,PDN
HI497A,,1998,1977,,240976,44514974,8161790,,79646,24797323,4491981,,161330,19717651,3669809,PDN
HI497A,,1999,1977,,81614,26845228,4858345,,80253,24879164,4507151,,1361,1966064,351194,PDN
HI497A,,2000,1977,,80254,24924778,4515268,,80254,24924778,4515268,,0,0,0,PDN
HI497A,,2001,1977,,80254,24924778,4515268,,80254,24924778,4515268,,0,0,0,PDN
HI497A,,2002,1977,,80254,24924778,4515268,,80254,24924778,4515268,,0,0,0,PDN
HI497A,,2003,1977,,80254,24924778,4515268,,80254,24924778,4515268,,0,0,0,PDN
HI497A,,2004,1977,,80254,24924778,4515268,,80254,24924778,4515268,,0,0,0,PDN
HI497A,,2005,1977,,80254,24924778,4515268,,80254,24924778,4515268,,0,0,0,PDN
HI497A,,2006,1977,,80254,24924778,4515268,,80254,24924778,4515268,,0,0,0,PDN
HI497A,,2007,1977,,80254,24924778,4515268,,80254,24924778,4515268,,0,0,0,PDN
HI497A,,2008,1977,,80254,24924778,4515268,,80254,24924778,4515268,,0,0,0,PDN
HI497A,,2009,1977,,80254,25419975,4603382,,80254,25419975,4603382,,0,0,0,PDN
HI497A,,2010,1977,,80254,25419975,4603382,,80254,25419975,4603382,,0,0,0,PDN
HI497A,,2011,1977,,80254,25419975,4603382,,80254,25419975,4603382,,0,0,0,PDN
HI497A,,2012,1977,,80254,25419975,4603382,,80254,25419975,4603382,,0,0,0,PDN
HI497A,,2013,1977,,80254,25419975,4603382,,80254,25419975,4603382,,0,0,0,PDN
HI497A,,2014,1977,,80254,25419975,4603382,,80254,25419975,4603382,,0,0,0,PDN
HI497A,,2015,1977,,80254,25419975,4603382,,80254,25419975,4603382,,0,0,0,PDN
HI497A,,2016,1977,,80254,25419975,4603382,,80254,25419975,4603382,,0,0,0,PDN
HI497A,,2017,1977,,80254,25419975,4603382,,80254,25419975,4603382,,0,0,0,PDN
HI497A,,2017,1977,,80254,25419975,4603382,,80254,25419975,4603382,,0,0,0,PDN
HI507A,,1982,1976,,30,21515728,3828451,,7,6284231,1118198,,23,15231497,2710253,PDN
HI507A,,1983,1976,,140803,84050289,15096370,,72,22680509,4035750,,140731,61369780,11060620,PDN
HI507A,,1984,1976,,200,35057870,6238255,,80,30464037,5420727,,120,4593833,817528,PDN
HI507A,,1985,1976,,120,35057870,6238175,,105,33813595,6016759,,15,1244275,221416,PDN
HI507A,,1986,1976,,120,36338460,6466038,,105,35194840,6262532,,15,1143620,203506,PDN
HI507A,,1987,1976,,105,36294261,6458159,,105,35850740,6379240,,0,443521,78919,PDN
HI507A,,1988,1976,,105,36040240,6412959,,105,36040240,6412959,,0,0,0,PDN
HI507A,,1989,1976,,105,36040240,6412959,,105,36040240,6412959,,0,0,0,PDN
HI507A,,1990,1976,,105,36040240,6412959,,105,36040240,6412959,,0,0,0,PDN
HI507A,,1991,1976,,105,36040240,6412959,,105,36040240,6412959,,0,0,0,PDN
HI507A,,1992,1976,,105,36040240,6412959,,105,36040240,6412959,,0,0,0,PDN
HI507A,,1993,1976,,202,53723978,9559629,,202,53723978,9559629,,0,0,0,PDN
HI507A,,1994,1976,,202,53723978,9559629,,202,53723978,9559629,,0,0,0,PDN
HI507A,,1995,1976,,202,53723978,9559629,,202,53723978,9559629,,0,0,0,PDN
HI507A,,1996,1976,,202,53723978,9559629,,202,53723978,9559629,,0,0,0,PDN
HI507A,,1997,1976,,202,53723978,9559629,,202,53723978,9559629,,0,0,0,PDN
HI507A,,1998,1976,,202,53723978,9559629,,202,53723978,9559629,,0,0,0,PDN
HI507A,,1999,1976,,202,53723978,9559629,,202,53723978,9559629,,0,0,0,PDN
HI507A,,2000,1976,,202,53723978,9559629,,202,53723978,9559629,,0,0,0,PDN
HI507A,,2001,1976,,202,53723978,9559629,,202,53723978,9559629,,0,0,0,PDN
HI507A,,2002,1976,,202,53723978,9559629,,202,53723978,9559629,,0,0,0,PDN
HI507A,,2003,1976,,202,53723978,9559629,,202,53723978,9559629,,0,0,0,PDN
HI507A,,2004,1976,,202,53723978,9559629,,202,53723978,9559629,,0,0,0,PDN
HI507A,,2005,1976,,202,53723978,9559629,,202,53723978,9559629,,0,0,0,PDN
HI507A,,2006,1976,,202,53723978,9559629,,202,53723978,9559629,,0,0,0,PDN
HI507A,,2007,1976,,202,53723978,9559629,,202,53723978,9559629,,0,0,0,PDN
HI507A,,2008,1976,,202,53723978,9559629,,202,53723978,9559629,,0,0,0,PDN
HI507A,,2009,1976,,202,54799912,9751076,,202,54799912,9751076,,0,0,0,PDN
HI507A,,2010,1976,,202,54799912,9751076,,202,54799912,9751076,,0,0,0,PDN
HI507A,,2011,1976,,202,54799912,9751076,,202,54799912,9751076,,0,0,0,PDN
HI507A,,2012,1976,,202,54799912,9751076,,202,54799912,9751076,,0,0,0,PDN
HI507A,,2013,1976,,202,54799912,9751076,,202,54799912,9751076,,0,0,0,PDN
HI507A,,2014,1976,,202,54799912,9751076,,202,54799912,9751076,,0,0,0,PDN
HI507A,,2015,1976,,202,54799912,9751076,,202,54799912,9751076,,0,0,0,PDN
HI507A,,2016,1976,,202,54799912,9751076,,202,54799912,9751076,,0,0,0,PDN
HI507A,,2017,1976,,202,54799912,9751076,,202,54799912,9751076,,0,0,0,PDN
HI507A,,2017,1976,,202,54799912,9751076,,202,54799912,9751076,,0,0,0,PDN
HI511A,,1976,1974,,25622,25622520,4584789,,0,0,0,,25622,25622520,4584789,PDN
HI511A,,1977,1974,,25622,25622520,4584789,,0,0,0,,25622,25622520,4584789,PDN
HI511A,,1978,1974,,25622,25622520,4584789,,0,0,0,,25622,25622520,4584789,PDN
HI511A,,1979,1974,,8400,33722520,6008848,,1414,5358621,954905,,6986,28363899,5053943,PDN
HI511A,,1980,1974,,17680,59260320,10562221,,5308,20213758,3602062,,12372,39046562,6960159,PDN
HI511A,,1981,1974,,18830,59260320,10563371,,9003,34457838,6140291,,9827,24802482,4423080,PDN
HI511A,,1982,1974,,172840,104199358,18713651,,12938,47372244,8442163,,159902,56827114,10271488,PDN
HI511A,,1983,1974,,179240,104199358,18720051,,15536,52096951,9285456,,163704,52102407,9434595,PDN
HI511A,,1984,1974,,179240,104199358,18720051,,18735,58303847,10393085,,160505,45895511,8326966,PDN
HI511A,,1985,1974,,179240,104199358,18720051,,20114,60895310,10855578,,159126,43304048,7864473,PDN
HI511A,,1986,1974,,28193,73987197,13193175,,22176,65240664,11630835,,6017,8746533,1562340,PDN
HI511A,,1987,1974,,33179,88726459,15820805,,24570,73951825,13183258,,8609,14774634,2637547,PDN
HI511A,,1988,1974,,39037,115189644,20535415,,27887,82141260,14643770,,11150,33048384,5891645,PDN
HI511A,,1989,1974,,41465,117784577,20999575,,30582,89593099,15972415,,10883,28191478,5027160,PDN
HI511A,,1990,1974,,39187,113793418,20287126,,33010,95969775,17109482,,6177,17823643,3177644,PDN
HI511A,,1991,1974,,44135,115901304,20667143,,35943,100486677,17916135,,8192,15414627,2751008,PDN
HI511A,,1992,1974,,47770,120971831,21573007,,38612,105275433,18770895,,9158,15696398,2802112,PDN
HI511A,,1993,1974,,49479,123903839,22096425,,41054,110142903,19639435,,8425,13760936,2456990,PDN
HI511A,,1994,1974,,49476,123896557,22095127,,42354,114797428,20468943,,7122,9099129,1626184,PDN
HI511A,,1995,1974,,48604,128745397,22957038,,43473,117860420,21015078,,5131,10884977,1941960,PDN
HI511A,,1996,1974,,47753,130593610,23285050,,44647,121196390,21609841,,3106,9397220,1675209,PDN
HI511A,,1997,1974,,48580,131905672,23519340,,45531,122897571,21913426,,3049,9008101,1605914,PDN
HI511A,,1998,1974,,48552,132762469,23671767,,45775,123591206,22037093,,2777,9171263,1634674,PDN
HI511A,,1999,1974,,48618,132130699,23559419,,45784,123658569,22049088,,2834,8472130,1510331,PDN
HI511A,,2000,1974,,55810,142955761,25492778,,45809,124028283,22114899,,10001,18927478,3377879,PDN
HI511A,,2001,1974,,49195,139349835,24844540,,46452,126441933,22545017,,2743,12907902,2299523,PDN
HI511A,,2002,1974,,49110,139222752,24821842,,46478,128501171,22911455,,2632,10721581,1910387,PDN
HI511A,,2003,1974,,49110,141118317,25159131,,46478,130766812,23314594,,2632,10351505,1844537,PDN
HI511A,,2004,1974,,48932,140619063,25070117,,46478,132081314,23548491,,2454,8537749,1521626,PDN
HI511A,,2005,1974,,48932,140619063,25070117,,46478,132457779,23615478,,2454,8161284,1454639,PDN
HI511A,,2006,1974,,48934,139714079,24909090,,46480,132632411,23646553,,2454,7081668,1262537,PDN
HI511A,,2007,1974,,46480,132632411,23646553,,46480,132632411,23646553,,0,0,0,PDN
HI511A,,2008,1974,,46480,132632411,23646553,,46480,132632411,23646553,,0,0,0,PDN
HI511A,,2009,1974,,46480,135105698,24086641,,46480,135105698,24086641,,0,0,0,PDN
HI511A,,2010,1974,,46480,135105698,24086641,,46480,135105698,24086641,,0,0,0,PDN
HI511A,,2011,1974,,46480,135105698,24086641,,46480,135105698,24086641,,0,0,0,PDN
HI511A,,2012,1974,,46480,135105698,24086641,,46480,135105698,24086641,,0,0,0,PDN
HI511A,,2013,1974,,46480,135105698,24086641,,46480,135105698,24086641,,0,0,0,PDN
HI511A,,2014,1974,,46480,135105698,24086641,,46480,135105698,24086641,,0,0,0,PDN
HI511A,,2015,1974,,46480,135105698,24086641,,46480,135105698,24086641,,0,0,0,PDN
HI511A,,2016,1974,,46480,135105698,24086641,,46480,135105698,24086641,,0,0,0,PDN
HI511A,,2017,1974,,46480,135105698,24086641,,46480,135105698,24086641,,0,0,0,PDN
HI511A,,2017,1974,,46480,135105698,24086641,,46480,135105698,24086641,,0,0,0,PDN
HI515A,,1982,1980,,9000,9000000,1610423,,0,0,0,,9000,9000000,1610423,PDN
HI515A,,1983,1980,,9000,9000000,1610423,,0,0,0,,9000,9000000,1610423,PDN
HI515A,,1984,1980,,18452,9850655,1771238,,0,332204,59111,,18452,9518451,1712127,PDN
HI515A,,1985,1980,,1480,14800000,2634932,,0,2784187,495407,,1480,12015813,2139525,PDN
HI515A,,1986,1980,,1480,14800000,2634932,,0,4122871,733607,,1480,10677129,1901325,PDN
HI515A,,1987,1980,,0,20058288,3569090,,0,4405769,783945,,0,15652519,2785145,PDN
HI515A,,1988,1980,,0,20058288,3569090,,0,6025273,1072113,,0,14033015,2496977,PDN
HI515A,,1989,1980,,0,20058288,3569090,,0,8535820,1518829,,0,11522468,2050261,PDN
HI515A,,1990,1980,,0,20058288,3569090,,0,10453719,1860092,,0,9604569,1708998,PDN
HI515A,,1991,1980,,0,13348700,2375214,,0,11120243,1978691,,0,2228457,396523,PDN
HI515A,,1992,1980,,0,15332295,2728166,,0,12235005,2177047,,0,3097290,551119,PDN
HI515A,,1993,1980,,0,15332295,2728166,,0,13555872,2412077,,0,1776423,316089,PDN
HI515A,,1994,1980,,0,15241573,2712024,,0,13892130,2471909,,0,1349443,240115,PDN
HI515A,,1995,1980,,0,15241573,2712024,,0,14077851,2504956,,0,1163722,207068,PDN
HI515A,,1996,1980,,0,15241573,2712024,,0,14140427,2516090,,0,1101146,195934,PDN
HI515A,,1997,1980,,0,14140427,2516090,,0,14140427,2516090,,0,0,0,PDN
HI515A,,1998,1980,,0,14140427,2516090,,0,14140427,2516090,,0,0,0,PDN
HI515A,,1999,1980,,0,14140427,2516090,,0,14140427,2516090,,0,0,0,PDN
HI515A,,2000,1980,,0,14140427,2516090,,0,14140427,2516090,,0,0,0,PDN
HI515A,,2001,1980,,0,14140427,2516090,,0,14140427,2516090,,0,0,0,PDN
HI515A,,2002,1980,,0,14140427,2516090,,0,14140427,2516090,,0,0,0,PDN
HI515A,,2003,1980,,0,14140427,2516090,,0,14140427,2516090,,0,0,0,PDN
HI515A,,2004,1980,,0,14140427,2516090,,0,14140427,2516090,,0,0,0,PDN
HI515A,,2005,1980,,0,14140427,2516090,,0,14140427,2516090,,0,0,0,PDN
HI515A,,2006,1980,,0,20566034,3659437,,0,14140427,2516090,,0,6425607,1143347,PDN
HI515A,,2007,1980,,0,20566034,3659437,,0,14722966,2619745,,0,5843068,1039692,PDN
HI515A,,2008,1980,,0,22401922,3986107,,0,17062828,3036090,,0,5339094,950017,PDN
HI515A,,2009,1980,,0,25674088,4568343,,0,19454155,3461594,,0,6219933,1106750,PDN
HI515A,,2010,1980,,0,23285235,4143281,,0,21465887,3819553,,0,1819348,323727,PDN
HI515A,,2011,1980,,0,23285235,4143281,,0,22765894,4050871,,0,519341,92409,PDN
HI515A,,2012,1980,,0,23285235,4143281,,0,23285235,4143281,,0,0,0,PDN
HI515A,,2013,1980,,0,23285235,4143281,,0,23285235,4143281,,0,0,0,PDN
HI515A,,2014,1980,,0,23285235,4143281,,0,23285235,4143281,,0,0,0,PDN
HI515A,,2015,1980,,0,23285235,4143281,,0,23285235,4143281,,0,0,0,PDN
HI515A,,2016,1980,,0,23285235,4143281,,0,23285235,4143281,,0,0,0,PDN
HI515A,,2017,1980,,0,23285235,4143281,,0,23285235,4143281,,0,0,0,PDN
HI515A,,2017,1980,,0,23285235,4143281,,0,23285235,4143281,,0,0,0,PDN
HI517A,,1978,1977,,71403,71403210,12776601,,0,0,0,,71403,71403210,12776601,PDN
HI517A,,1979,1977,,71403,71403210,12776601,,0,0,0,,71403,71403210,12776601,PDN
HI517A,,1980,1977,,71403,71403210,12776601,,3206,6915910,1233795,,68197,64487300,11542806,PDN
HI517A,,1981,1977,,71403,75980055,13590986,,8350,19923877,3553524,,63053,56056178,10037462,PDN
HI517A,,1982,1977,,77934,100980055,18045915,,13411,31651945,5645430,,64523,69328110,12400485,PDN
HI517A,,1983,1977,,83403,107980055,19296936,,18716,43736466,7801005,,64687,64243589,11495931,PDN
HI517A,,1984,1977,,92944,108934135,19476242,,22623,52907624,9436791,,70321,56026511,10039451,PDN
HI517A,,1985,1977,,92944,108934135,19476242,,25927,58848334,10497161,,67017,50085801,8979081,PDN
HI517A,,1986,1977,,90890,108934135,19474188,,28259,63833708,11386570,,62631,45100427,8087618,PDN
HI517A,,1987,1977,,90890,108934135,19474188,,30642,69089417,12324133,,60248,39844718,7150055,PDN
HI517A,,1988,1977,,80145,117870469,21053538,,33736,73252329,13067958,,46409,44618140,7985580,PDN
HI517A,,1989,1977,,80145,117870469,21053538,,35162,77027524,13741127,,44983,40842945,7312411,PDN
HI517A,,1990,1977,,80145,117870469,21053538,,35917,79674805,14212929,,44228,38195664,6840609,PDN
HI517A,,1991,1977,,65001,105446952,18827804,,37082,81377986,14517151,,27919,24068966,4310653,PDN
HI517A,,1992,1977,,50272,99064269,17677366,,37738,82468332,14711818,,12534,16595937,2965548,PDN
HI517A,,1993,1977,,50272,99064269,17677366,,38548,83333925,14866649,,11724,15730344,2810717,PDN
HI517A,,1994,1977,,50270,99058985,17676424,,38876,83994144,14984453,,11394,15064841,2691971,PDN
HI517A,,1995,1977,,50278,99066577,17677783,,39236,84642560,15100190,,11042,14424017,2577593,PDN
HI517A,,1996,1977,,49493,99073620,17678251,,39339,85018691,15167220,,10154,14054929,2511031,PDN
HI517A,,1997,1977,,49493,99073620,17678251,,39352,85116095,15184565,,10141,13957525,2493686,PDN
HI517A,,1998,1977,,51259,99708123,17792918,,39631,85337978,15224325,,11628,14370145,2568593,PDN
HI517A,,1999,1977,,55567,121744047,21718209,,41520,89608554,15986103,,14047,32135493,5732106,PDN
HI517A,,2000,1977,,76877,127674344,22794732,,48745,100124692,17864526,,28132,27549652,4930206,PDN
HI517A,,2001,1977,,58396,114609592,20451562,,51009,102084929,18215587,,7387,12524663,2235975,PDN
HI517A,,2002,1977,,58105,110062006,19642092,,51149,102602661,18307850,,6956,7459345,1334242,PDN
HI517A,,2003,1977,,56581,111909128,19969237,,52444,103607537,18487949,,4137,8301591,1481288,PDN
HI517A,,2004,1977,,56126,109580193,19554381,,53146,104876592,18714461,,2980,4703601,839920,PDN
HI517A,,2005,1977,,57053,111076584,19821570,,53518,105449657,18816802,,3535,5626927,1004768,PDN
HI517A,,2006,1977,,55420,111305060,19860591,,53583,105526825,18830598,,1837,5778235,1029993,PDN
HI517A,,2007,1977,,55420,111305060,19860591,,53704,106117732,18935863,,1716,5187328,924728,PDN
HI517A,,2008,1977,,53740,106602501,19022157,,53738,106591374,19020175,,2,11127,1982,PDN
HI517A,,2009,1977,,53740,108307924,19325613,,53740,108307924,19325613,,0,0,0,PDN
HI517A,,2010,1977,,53740,108307924,19325613,,53740,108307924,19325613,,0,0,0,PDN
HI517A,,2011,1977,,53740,108307924,19325613,,53740,108307924,19325613,,0,0,0,PDN
HI517A,,2012,1977,,53740,108307924,19325613,,53740,108307924,19325613,,0,0,0,PDN
HI517A,,2013,1977,,53740,108307924,19325613,,53740,108307924,19325613,,0,0,0,PDN
HI517A,,2014,1977,,53740,108307924,19325613,,53740,108307924,19325613,,0,0,0,PDN
HI517A,,2015,1977,,53740,108307924,19325613,,53740,108307924,19325613,,0,0,0,PDN
HI517A,,2016,1977,,53740,108307924,19325613,,53740,108307924,19325613,,0,0,0,PDN
HI517A,,2017,1977,,53740,108307924,19325613,,53740,108307924,19325613,,0,0,0,PDN
HI517A,,2017,1977,,53740,108307924,19325613,,53740,108307924,19325613,,0,0,0,PDN
HI519A,,1991,1989,,0,10142909,1804788,,0,992443,176591,,0,9150466,1628197,PDN
HI519A,,1992,1989,,0,10142909,1804788,,0,3204947,570275,,0,6937962,1234513,PDN
HI519A,,1993,1989,,0,10142909,1804788,,0,5296237,942391,,0,4846672,862397,PDN
HI519A,,1994,1989,,0,10142909,1804788,,0,6926221,1232424,,0,3216688,572364,PDN
HI519A,,1995,1989,,0,10131898,1802829,,0,8932806,1589467,,0,1199092,213362,PDN
HI519A,,1996,1989,,200,14392107,2561073,,0,11079304,1971406,,200,3312803,589667,PDN
HI519A,,1997,1989,,285,15665630,2787764,,165,13422422,2388496,,120,2243208,399268,PDN
HI519A,,1998,1989,,526,15665630,2788005,,229,13862896,2466936,,297,1802734,321069,PDN
HI519A,,1999,1989,,155060,23240283,4290342,,115401,17586367,3244648,,39659,5653916,1045694,PDN
HI519A,,2000,1989,,155060,22780053,4208450,,125501,19564989,3606816,,29559,3215064,601634,PDN
HI519A,,2001,1989,,125501,19602958,3613572,,125501,19576532,3608870,,0,26426,4702,PDN
HI519A,,2002,1989,,125501,19602958,3613572,,125501,19602958,3613572,,0,0,0,PDN
HI519A,,2003,1989,,125501,19594282,3612028,,125501,19594282,3612028,,0,0,0,PDN
HI519A,,2004,1989,,125501,19594282,3612028,,125501,19594282,3612028,,0,0,0,PDN
HI519A,,2005,1989,,125501,19594282,3612028,,125501,19594282,3612028,,0,0,0,PDN
HI519A,,2006,1989,,125501,19594282,3612028,,125501,19594282,3612028,,0,0,0,PDN
HI519A,,2007,1989,,125501,19594282,3612028,,125501,19594282,3612028,,0,0,0,PDN
HI519A,,2008,1989,,125501,19594282,3612028,,125501,19594282,3612028,,0,0,0,PDN
HI519A,,2009,1989,,125501,19870173,3661118,,125501,19870173,3661118,,0,0,0,PDN
HI519A,,2010,1989,,125501,19870173,3661118,,125501,19870173,3661118,,0,0,0,PDN
HI519A,,2011,1989,,125501,19870173,3661118,,125501,19870173,3661118,,0,0,0,PDN
HI519A,,2012,1989,,125501,19870173,3661118,,125501,19870173,3661118,,0,0,0,PDN
HI519A,,2013,1989,,125501,19870173,3661118,,125501,19870173,3661118,,0,0,0,PDN
HI519A,,2014,1989,,125501,19870173,3661118,,125501,19870173,3661118,,0,0,0,PDN
HI519A,,2015,1989,,125501,19870173,3661118,,125501,19870173,3661118,,0,0,0,PDN
HI519A,,2016,1989,,125501,19870173,3661118,,125501,19870173,3661118,,0,0,0,PDN
HI519A,,2017,1989,,125501,19870173,3661118,,125501,19870173,3661118,,0,0,0,PDN
HI519A,,2017,1989,,125501,19870173,3661118,,125501,19870173,3661118,,0,0,0,PDN
HI523A,,1985,1980,,56012,6189364,1157322,,0,0,0,,56012,6189364,1157322,PDN
HI523A,,1986,1980,,56012,6189364,1157322,,0,0,0,,56012,6189364,1157322,PDN
HI523A,,1987,1980,,56012,6189364,1157322,,0,0,0,,56012,6189364,1157322,PDN
HI523A,,1991,1980,,2652426,27068193,7468830,,280,16676,3247,,2652146,27051517,7465583,PDN
HI523A,,1992,1980,,1102022,27419560,5980947,,144034,6611320,1320425,,957988,20808240,4660522,PDN
HI523A,,1993,1980,,900419,26530738,5621191,,192666,11716244,2277407,,707753,14814494,3343784,PDN
HI523A,,1994,1980,,900419,36269662,7354096,,233165,15552459,3000506,,667254,20717203,4353590,PDN
HI523A,,1995,1980,,900626,36288487,7357652,,279288,18258792,3528183,,621338,18029695,3829469,PDN
HI523A,,1996,1980,,892095,40261224,8056014,,314263,20677021,3993448,,577832,19584203,4062566,PDN
HI523A,,1997,1980,,893376,54973216,10675087,,341931,21489972,4165769,,551445,33483244,6509318,PDN
HI523A,,1998,1980,,941916,54510907,10641366,,375934,24457058,4727724,,565982,30053849,5913642,PDN
HI523A,,1999,1980,,520369,38339824,7342402,,403234,27060655,5218297,,117135,11279169,2124105,PDN
HI523A,,2000,1980,,520369,43220173,8210791,,423139,30305535,5815583,,97230,12914638,2395208,PDN
HI523A,,2001,1980,,469251,41619954,7874937,,438459,32912349,6294749,,30792,8707605,1580188,PDN
HI523A,,2002,1980,,469273,41624565,7875779,,448410,34654923,6614766,,20863,6969642,1261013,PDN
HI523A,,2003,1980,,487786,43907930,8300585,,460957,36501265,6955844,,26829,7406665,1344741,PDN
HI523A,,2004,1980,,488714,44385256,8386446,,471628,37829054,7202776,,17086,6556202,1183670,PDN
HI523A,,2005,1980,,578879,45192822,8620306,,479569,38982410,7415941,,99310,6210412,1204365,PDN
HI523A,,2006,1980,,578879,45192822,8620306,,499538,40287017,7668046,,79341,4905805,952260,PDN
HI523A,,2007,1980,,583915,46698750,8893301,,511866,41300243,7860664,,72049,5398507,1032637,PDN
HI523A,,2008,1980,,584032,47099469,8964720,,512866,41676224,7928564,,71166,5423245,1036156,PDN
HI523A,,2009,1980,,514819,42879558,8144632,,514354,42553712,8086187,,465,325846,58444,PDN
HI523A,,2010,1980,,514819,42879558,8144632,,514597,42823020,8134351,,222,56538,10282,PDN
HI523A,,2011,1980,,514819,42879558,8144632,,514819,42879558,8144632,,0,0,0,PDN
HI523A,,2012,1980,,514819,42879558,8144632,,514819,42879558,8144632,,0,0,0,PDN
HI523A,,2013,1980,,514819,42879558,8144632,,514819,42879558,8144632,,0,0,0,PDN
HI523A,,2014,1980,,514819,42879558,8144632,,514819,42879558,8144632,,0,0,0,PDN
HI523A,,2015,1980,,514819,42879558,8144632,,514819,42879558,8144632,,0,0,0,PDN
HI523A,,2016,1980,,514819,42879558,8144632,,514819,42879558,8144632,,0,0,0,PDN
HI523A,,2017,1980,,514819,42879558,8144632,,514819,42879558,8144632,,0,0,0,PDN
HI523A,,2017,1980,,514819,42879558,8144632,,514819,42879558,8144632,,0,0,0,PDN
HI528A,,1996,1994,,518157,52510975,9861747,,50625,2967709,578687,,467532,49543266,9283060,PDN
HI528A,,1997,1994,,518157,52510975,9861747,,86057,8749468,1642902,,432100,43761507,8218845,PDN
HI528A,,1998,1994,,518157,52510975,9861747,,67397,12616446,2312316,,450760,39894529,7549431,PDN
HI528A,,1999,1994,,100631,27977322,5078802,,73149,15419286,2816794,,27482,12558036,2262008,PDN
HI528A,,2000,1994,,100631,27977322,5078802,,77670,17334643,3162126,,22961,10642679,1916676,PDN
HI528A,,2001,1994,,77670,17334643,3162126,,77670,17334643,3162126,,0,0,0,PDN
HI528A,,2002,1994,,85320,20198195,3679305,,85203,18613109,3397144,,117,1585086,282161,PDN
HI528A,,2003,1994,,85806,20055017,3654314,,85244,19082372,3480684,,562,972645,173630,PDN
HI528A,,2004,1994,,85806,20055017,3654314,,85439,19427117,3542221,,367,627900,112093,PDN
HI528A,,2005,1994,,85909,19752858,3600652,,85647,19506146,3556491,,262,246712,44161,PDN
HI528A,,2006,1994,,85909,19752858,3600652,,85883,19742480,3598780,,26,10378,1872,PDN
HI528A,,2007,1994,,85909,19752858,3600652,,85909,19752858,3600652,,0,0,0,PDN
HI528A,,2008,1994,,85909,19752858,3600652,,85909,19752858,3600652,,0,0,0,PDN
HI528A,,2009,1994,,85909,19983331,3641662,,85909,19983331,3641662,,0,0,0,PDN
HI528A,,2010,1994,,85909,19983331,3641662,,85909,19983331,3641662,,0,0,0,PDN
HI528A,,2011,1994,,85909,19983331,3641662,,85909,19983331,3641662,,0,0,0,PDN
HI528A,,2012,1994,,85909,19983331,3641662,,85909,19983331,3641662,,0,0,0,PDN
HI528A,,2013,1994,,85909,19983331,3641662,,85909,19983331,3641662,,0,0,0,PDN
HI528A,,2014,1994,,85909,19983331,3641662,,85909,19983331,3641662,,0,0,0,PDN
HI528A,,2015,1994,,85909,19983331,3641662,,85909,19983331,3641662,,0,0,0,PDN
HI528A,,2016,1994,,85909,19983331,3641662,,85909,19983331,3641662,,0,0,0,PDN
HI528A,,2017,1994,,85909,19983331,3641662,,85909,19983331,3641662,,0,0,0,PDN
HI528A,,2017,1994,,85909,19983331,3641662,,85909,19983331,3641662,,0,0,0,PDN
HI532A,,1976,1975,,0,35000000,6227758,,0,0,0,,0,35000000,6227758,PDN
HI532A,,1977,1975,,20687,20686550,3701568,,0,0,0,,20687,20686550,3701568,PDN
HI532A,,1978,1975,,20687,20686550,3701568,,0,0,0,,20687,20686550,3701568,PDN
HI532A,,1979,1975,,75988,20829666,3782334,,6351,2286719,413241,,69637,18542947,3369093,PDN
HI532A,,1980,1975,,82000,23577350,4277258,,15923,7583694,1365335,,66077,15993656,2911923,PDN
HI532A,,1981,1975,,89533,28192950,5106072,,20994,12334959,2215827,,68539,15857991,2890245,PDN
HI532A,,1982,1975,,35580,40570100,7254459,,23823,26340479,4710741,,11757,14229621,2543718,PDN
HI532A,,1983,1975,,35580,46994000,8397502,,24904,34280298,6124601,,10676,12713702,2272901,PDN
HI532A,,1984,1975,,35580,46994000,8397502,,25643,36075376,6444749,,9937,10918624,1952753,PDN
HI532A,,1985,1975,,39501,47304001,8456583,,26759,37088681,6626168,,12742,10215320,1830415,PDN
HI532A,,1986,1975,,41159,47304001,8458241,,27767,37868832,6765993,,13392,9435169,1692248,PDN
HI532A,,1987,1975,,41056,46587739,8330689,,28237,38664285,6908003,,12819,7923454,1422686,PDN
HI532A,,1988,1975,,37586,47975532,8574158,,28670,39085317,6983353,,8916,8890215,1590805,PDN
HI532A,,1989,1975,,43559,54699242,9776520,,29236,39975110,7142245,,14323,14724132,2634275,PDN
HI532A,,1990,1975,,43559,54699242,9776520,,29826,40581124,7250667,,13733,14118118,2525853,PDN
HI532A,,1991,1975,,36726,46803286,8364713,,30539,41224078,7365784,,6187,5579208,998929,PDN
HI532A,,1992,1975,,36726,46803286,8364713,,31116,41938807,7493537,,5610,4864479,871176,PDN
HI532A,,1993,1975,,36629,29119548,5218043,,31391,24836083,4450623,,5238,4283465,767420,PDN
HI532A,,1994,1975,,36629,29119548,5218043,,31701,25165387,4509528,,4928,3954161,708515,PDN
HI532A,,1995,1975,,36629,29119548,5218043,,31975,25284157,4530935,,4654,3835391,687108,PDN
HI532A,,1996,1975,,31975,25284157,4530935,,31975,25284157,4530935,,0,0,0,PDN
HI532A,,1997,1975,,31975,25284157,4530935,,31975,25284157,4530935,,0,0,0,PDN
HI532A,,1998,1975,,31975,25284157,4530935,,31975,25284157,4530935,,0,0,0,PDN
HI532A,,1999,1975,,31975,25284157,4530935,,31975,25284157,4530935,,0,0,0,PDN
HI532A,,2000,1975,,31975,25284157,4530935,,31975,25284157,4530935,,0,0,0,PDN
HI532A,,2001,1975,,31975,25284157,4530935,,31975,25284157,4530935,,0,0,0,PDN
HI532A,,2002,1975,,31975,25284157,4530935,,31975,25284157,4530935,,0,0,0,PDN
HI532A,,2003,1975,,31975,25284157,4530935,,31975,25284157,4530935,,0,0,0,PDN
HI532A,,2004,1975,,31975,25284157,4530935,,31975,25284157,4530935,,0,0,0,PDN
HI532A,,2005,1975,,31975,25284157,4530935,,31975,25284157,4530935,,0,0,0,PDN
HI532A,,2006,1975,,31975,25284157,4530935,,31975,25284157,4530935,,0,0,0,PDN
HI532A,,2007,1975,,31975,25284157,4530935,,31975,25284157,4530935,,0,0,0,PDN
HI532A,,2008,1975,,31975,25284157,4530935,,31975,25284157,4530935,,0,0,0,PDN
HI532A,,2009,1975,,31975,25790524,4621036,,31975,25790524,4621036,,0,0,0,PDN
HI532A,,2010,1975,,31975,25790524,4621036,,31975,25790524,4621036,,0,0,0,PDN
HI532A,,2011,1975,,31975,25790524,4621036,,31975,25790524,4621036,,0,0,0,PDN
HI532A,,2012,1975,,31975,25790524,4621036,,31975,25790524,4621036,,0,0,0,PDN
HI532A,,2013,1975,,31975,25790524,4621036,,31975,25790524,4621036,,0,0,0,PDN
HI532A,,2014,1975,,31975,25790524,4621036,,31975,25790524,4621036,,0,0,0,PDN
HI532A,,2015,1975,,31975,25790524,4621036,,31975,25790524,4621036,,0,0,0,PDN
HI532A,,2016,1975,,31975,25790524,4621036,,31975,25790524,4621036,,0,0,0,PDN
HI532A,,2017,1975,,31975,25790524,4621036,,31975,25790524,4621036,,0,0,0,PDN
HI532A,,2017,1975,,31975,25790524,4621036,,31975,25790524,4621036,,0,0,0,PDN
HI537A,,1976,1974,,2000000,25000000,6448399,,0,0,0,,2000000,25000000,6448399,PDN
HI537A,,1977,1974,,2000000,25000000,6448399,,0,0,0,,2000000,25000000,6448399,PDN
HI537A,,1978,1974,,2000000,25000000,6448399,,2457,26831,7231,,1997543,24973169,6441168,PDN
HI537A,,1979,1974,,17473604,96332188,34614563,,64150,151749,91152,,17409454,96180439,34523411,PDN
HI537A,,1980,1974,,17883097,103527466,36304354,,3528177,16219881,6414277,,14354920,87307585,29890077,PDN
HI537A,,1981,1974,,21597469,105058240,40291106,,7297685,32171962,13022233,,14299784,72886278,27268873,PDN
HI537A,,1982,1974,,22483565,120821620,43982074,,9650661,50839491,18696834,,12832904,69982129,25285240,PDN
HI537A,,1983,1974,,24439116,136107898,48657603,,10853857,64654067,22358139,,13585259,71453831,26299464,PDN
HI537A,,1984,1974,,24740841,152896019,51946538,,11998870,76521066,25614718,,12741971,76374953,26331820,PDN
HI537A,,1985,1974,,26137998,165210725,55534924,,12844844,81875182,27413382,,13293154,83335543,28121542,PDN
HI537A,,1986,1974,,26291949,169833167,56511374,,14068473,89636528,30018033,,12223476,80196639,26493341,PDN
HI537A,,1987,1974,,27013994,176877857,58486922,,14857985,98928170,32460862,,12156009,77949687,26026060,PDN
HI537A,,1988,1974,,26587725,182836493,59120909,,15432615,109853563,34979512,,11155110,72982930,24141397,PDN
HI537A,,1989,1974,,17634819,142776338,43039861,,15878228,117283095,36747106,,1756591,25493243,6292755,PDN
HI537A,,1990,1974,,18263504,163862844,47420594,,16309982,128447539,39165416,,1953522,35415305,8255178,PDN
HI537A,,1991,1974,,18043892,168429211,48013502,,16750318,141627030,41950857,,1293574,26802181,6062645,PDN
HI537A,,1992,1974,,18123603,173077071,48920235,,17040556,147951129,43366380,,1083047,25125942,5553855,PDN
HI537A,,1993,1974,,18104618,176535619,49516650,,17213686,153499704,44526801,,890932,23035915,4989849,PDN
HI537A,,1994,1974,,18183516,176669212,49619319,,17399252,156766386,45293627,,784264,19902826,4325692,PDN
HI537A,,1995,1974,,20294668,189618884,54034683,,17826073,160678599,46416571,,2468595,28940285,7618112,PDN
HI537A,,1996,1974,,20603968,194648615,55238953,,18283535,165420496,47717787,,2320433,29228119,7521166,PDN
HI537A,,1997,1974,,20659906,195071898,55370208,,18597953,169411635,48742372,,2061953,25660263,6627836,PDN
HI537A,,1998,1974,,21721293,200549981,57406343,,19121441,174571532,50183991,,2599852,25978449,7222352,PDN
HI537A,,1999,1974,,21500891,194902730,56181093,,19719125,178880886,51548464,,1781766,16021844,4632629,PDN
HI537A,,2000,1974,,21501115,194903010,56181366,,20192460,182390237,52646239,,1308655,12512773,3535127,PDN
HI537A,,2001,1974,,22395312,192388313,56628108,,20815601,185217206,53772399,,1579711,7171107,2855709,PDN
HI537A,,2002,1974,,22395312,192388313,56628108,,21328918,187161365,54631652,,1066394,5226948,1996456,PDN
HI537A,,2003,1974,,22500667,195022902,57202251,,21678420,188565290,55230963,,822247,6457612,1971288,PDN
HI537A,,2004,1974,,22574595,195360007,57336162,,21961710,190661359,55887219,,612885,4698648,1448943,PDN
HI537A,,2005,1974,,22574595,195360007,57336162,,22160104,192153856,56351182,,414491,3206151,984980,PDN
HI537A,,2006,1974,,22933130,197944494,58154570,,22351579,193734521,56823914,,581551,4209973,1330656,PDN
HI537A,,2007,1974,,23046161,197435025,58176948,,22599713,194997711,57296815,,446448,2437314,880133,PDN
HI537A,,2008,1974,,26518757,202225421,62501928,,22720818,195747888,57551403,,3797939,6477533,4950525,PDN
HI537A,,2009,1974,,26448548,205958544,63095975,,22848161,200037325,58441991,,3600387,5921219,4653987,PDN
HI537A,,2010,1974,,26457138,206495349,63200082,,23161565,201095479,58943679,,3295573,5399870,4256406,PDN
HI537A,,2011,1974,,26457138,206495349,63200082,,23835162,201980859,59774815,,2621976,4514490,3425268,PDN
HI537A,,2012,1974,,26474430,206474550,63213673,,24184877,202477004,60212813,,2289553,3997546,3000861,PDN
HI537A,,2013,1974,,26474430,206474550,63213673,,24577607,203258899,60744670,,1896823,3215651,2469005,PDN
HI537A,,2014,1974,,26474430,206474550,63213673,,24880434,203776567,61139610,,1593996,2697983,2074064,PDN
HI537A,,2015,1974,,26478078,206282091,63183076,,25146096,204180971,61477230,,1331982,2101120,1705846,PDN
HI537A,,2016,1974,,25222778,204304482,61575888,,25222778,204304482,61575888,,0,0,0,PDN
HI537A,,2017,1974,,25222778,204304482,61575888,,25222778,204304482,61575888,,0,0,0,PDN
HI537A,,2017,1974,,25222778,204304482,61575888,,25222778,204304482,61575888,,0,0,0,PDN
HI538A,,2002,2002,,0,42522508,7566283,,0,0,0,,0,42522508,7566283,PDN
HI538A,,2003,2002,,0,42522508,7566283,,0,7339635,1305985,,0,35182873,6260298,PDN
HI538A,,2004,2002,,0,34010635,6051714,,0,13887731,2471127,,0,20122904,3580587,PDN
HI538A,,2005,2002,,0,34010635,6051714,,0,18753642,3336947,,0,15256993,2714767,PDN
HI538A,,2006,2002,,0,22085865,3929869,,0,21410333,3809668,,0,675532,120201,PDN
HI538A,,2007,2002,,0,22085865,3929869,,0,22085865,3929869,,0,0,0,PDN
HI538A,,2008,2002,,0,22085865,3929869,,0,22085865,3929869,,0,0,0,PDN
HI538A,,2009,2002,,0,22085865,3929868,,0,22085865,3929868,,0,0,0,PDN
HI538A,,2010,2002,,0,22085865,3929868,,0,22085865,3929868,,0,0,0,PDN
HI538A,,2011,2002,,0,22085865,3929868,,0,22085865,3929868,,0,0,0,PDN
HI538A,,2012,2002,,0,22085865,3929868,,0,22085865,3929868,,0,0,0,PDN
HI538A,,2013,2002,,0,22085865,3929868,,0,22085865,3929868,,0,0,0,PDN
HI538A,,2014,2002,,0,22085865,3929868,,0,22085865,3929868,,0,0,0,PDN
HI538A,,2015,2002,,0,22085865,3929868,,0,22085865,3929868,,0,0,0,PDN
HI538A,,2016,2002,,0,22085865,3929868,,0,22085865,3929868,,0,0,0,PDN
HI538A,,2017,2002,,0,22085865,3929868,,0,22085865,3929868,,0,0,0,PDN
HI538A,,2017,2002,,0,22085865,3929868,,0,22085865,3929868,,0,0,0,PDN
HI540A,,1978,1976,,1649940,13857951,4115768,,0,0,0,,1649940,13857951,4115768,PDN
HI540A,,1979,1976,,1649940,13857951,4115768,,0,0,0,,1649940,13857951,4115768,PDN
HI540A,,1980,1976,,1649940,13857951,4115768,,0,0,0,,1649940,13857951,4115768,PDN
HI540A,,2001,1976,,486147,1884843,821528,,0,0,0,,486147,1884843,821528,PDN
HI540A,,2002,1976,,486147,1884843,821528,,0,0,0,,486147,1884843,821528,PDN
HI540A,,2003,1976,,510408,15516958,3271432,,10028,4488428,808681,,500380,11028530,2462751,PDN
HI540A,,2004,1976,,506901,14867508,3152365,,14467,8540370,1534106,,492434,6327138,1618259,PDN
HI540A,,2005,1976,,569104,17613490,3703177,,16273,10859868,1948634,,552831,6753622,1754543,PDN
HI540A,,2006,1976,,569104,17613490,3703177,,33170,12459109,2250093,,535934,5154381,1453084,PDN
HI540A,,2007,1976,,147954,18193270,3385191,,116382,16250156,3007869,,31572,1943114,377322,PDN
HI540A,,2008,1976,,149135,19912739,3692327,,147882,17350458,3235152,,1253,2562281,457175,PDN
HI540A,,2009,1976,,148324,18260475,3397518,,148107,17981646,3347687,,217,278829,49830,PDN
HI540A,,2010,1976,,148324,18260475,3397518,,148324,18260475,3397518,,0,0,0,PDN
HI540A,,2011,1976,,148324,18260475,3397518,,148324,18260475,3397518,,0,0,0,PDN
HI540A,,2012,1976,,148324,18260475,3397518,,148324,18260475,3397518,,0,0,0,PDN
HI540A,,2013,1976,,148324,18260475,3397518,,148324,18260475,3397518,,0,0,0,PDN
HI540A,,2014,1976,,148324,18260475,3397518,,148324,18260475,3397518,,0,0,0,PDN
HI540A,,2015,1976,,148324,18260475,3397518,,148324,18260475,3397518,,0,0,0,PDN
HI540A,,2016,1976,,148324,18260475,3397518,,148324,18260475,3397518,,0,0,0,PDN
HI540A,,2017,1976,,148324,18260475,3397518,,148324,18260475,3397518,,0,0,0,PDN
HI540A,,2017,1976,,148324,18260475,3397518,,148324,18260475,3397518,,0,0,0,PDN
HI542A,,1978,1975,,20000,20000000,3578719,,0,0,0,,20000,20000000,3578719,PDN
HI542A,,1979,1975,,0,10000000,1779359,,0,0,0,,0,10000000,1779359,PDN
HI542A,,1980,1975,,120000,12000000,2255231,,0,0,0,,120000,12000000,2255231,PDN
HI542A,,1981,1975,,120000,12000000,2255231,,0,0,0,,120000,12000000,2255231,PDN
HI542A,,1982,1975,,120000,12000000,2255231,,146,6106,1232,,119854,11993894,2253999,PDN
HI542A,,1983,1975,,263915,12020013,2402707,,47009,1554076,323535,,216906,10465937,2079172,PDN
HI542A,,1984,1975,,564003,21094278,4317433,,104246,3596327,744162,,459757,17497951,3573271,PDN
HI542A,,1985,1975,,704162,41401371,8070954,,142351,5424387,1107544,,561811,35976984,6963410,PDN
HI542A,,1986,1975,,798716,44849277,8779014,,155938,6450384,1303693,,642778,38398893,7475321,PDN
HI542A,,1987,1975,,798716,44849277,8779014,,160499,6948035,1396804,,638217,37901242,7382210,PDN
HI542A,,1988,1975,,798716,44849277,8779014,,164787,7283680,1460815,,633929,37565597,7318199,PDN
HI542A,,1989,1975,,798716,44849277,8779014,,166517,7387483,1481016,,632199,37461794,7297998,PDN
HI542A,,1990,1975,,330055,28933633,5478388,,215330,9360337,1880870,,114725,19573296,3597518,PDN
HI542A,,1991,1975,,234723,9857115,1988658,,234723,9857115,1988658,,0,0,0,PDN
HI542A,,1992,1975,,234613,9857115,1988548,,234613,9857115,1988548,,0,0,0,PDN
HI542A,,1993,1975,,234616,9857115,1988551,,234616,9857115,1988551,,0,0,0,PDN
HI542A,,1994,1975,,234616,9857115,1988551,,234616,9857115,1988551,,0,0,0,PDN
HI542A,,1995,1975,,234616,9857115,1988551,,234616,9857115,1988551,,0,0,0,PDN
HI542A,,1996,1975,,234616,9857115,1988551,,234616,9857115,1988551,,0,0,0,PDN
HI542A,,1997,1975,,234616,9857115,1988551,,234616,9857115,1988551,,0,0,0,PDN
HI542A,,1998,1975,,234616,9857115,1988551,,234616,9857115,1988551,,0,0,0,PDN
HI542A,,1999,1975,,234616,9857115,1988551,,234616,9857115,1988551,,0,0,0,PDN
HI542A,,2000,1975,,234616,9857115,1988551,,234616,9857115,1988551,,0,0,0,PDN
HI542A,,2001,1975,,234616,9857115,1988551,,234616,9857115,1988551,,0,0,0,PDN
HI542A,,2002,1975,,234616,9857115,1988551,,234616,9857115,1988551,,0,0,0,PDN
HI542A,,2003,1975,,234616,9857115,1988551,,234616,9857115,1988551,,0,0,0,PDN
HI542A,,2004,1975,,234616,9857115,1988551,,234616,9857115,1988551,,0,0,0,PDN
HI542A,,2005,1975,,234616,9857115,1988551,,234616,9857115,1988551,,0,0,0,PDN
HI542A,,2006,1975,,234616,9857115,1988551,,234616,9857115,1988551,,0,0,0,PDN
HI542A,,2007,1975,,234616,9857115,1988551,,234616,9857115,1988551,,0,0,0,PDN
HI542A,,2008,1975,,234616,9857115,1988551,,234616,9857115,1988551,,0,0,0,PDN
HI542A,,2009,1975,,234616,10054525,2023677,,234616,10054525,2023677,,0,0,0,PDN
HI542A,,2010,1975,,234616,10054525,2023677,,234616,10054525,2023677,,0,0,0,PDN
HI542A,,2011,1975,,234616,10054525,2023677,,234616,10054525,2023677,,0,0,0,PDN
HI542A,,2012,1975,,234616,10054525,2023677,,234616,10054525,2023677,,0,0,0,PDN
HI542A,,2013,1975,,234616,10054525,2023677,,234616,10054525,2023677,,0,0,0,PDN
HI542A,,2014,1975,,234616,10054525,2023677,,234616,10054525,2023677,,0,0,0,PDN
HI542A,,2015,1975,,234616,10054525,2023677,,234616,10054525,2023677,,0,0,0,PDN
HI542A,,2016,1975,,234616,10054525,2023677,,234616,10054525,2023677,,0,0,0,PDN
HI542A,,2017,1975,,234616,10054525,2023677,,234616,10054525,2023677,,0,0,0,PDN
HI542A,,2017,1975,,234616,10054525,2023677,,234616,10054525,2023677,,0,0,0,PDN
HI544A,,1997,1977,,0,33898623,6031783,,0,1059473,188518,,0,32839150,5843265,PDP
HI544A,,1998,1977,,50259,34858613,6252859,,2591,3595006,642272,,47668,31263607,5610587,PDP
HI544A,,1999,1977,,50497,45371356,8123692,,14299,11325635,2029537,,36198,34045721,6094155,PDP
HI544A,,2000,1977,,50570,45689442,8180364,,28201,17792116,3194058,,22369,27897326,4986306,PDP
HI544A,,2001,1977,,45244,41654919,7457151,,39433,22822597,4100393,,5811,18832322,3356758,PDP
HI544A,,2002,1977,,98445,46633180,8396164,,83015,29898403,5403016,,15430,16734777,2993148,PDP
HI544A,,2003,1977,,98445,46633180,8396164,,94056,34052907,6153292,,4389,12580273,2242872,PDP
HI544A,,2004,1977,,120650,55695108,10030812,,111895,41696204,7531148,,8755,13998904,2499664,PDP
HI544A,,2005,1977,,120650,55695108,10030812,,116165,46213092,8339135,,4485,9482016,1691677,PDP
HI544A,,2006,1977,,230288,53946932,9829387,,155684,48126009,8719031,,74604,5820923,1110356,PDP
HI544A,,2007,1977,,229976,50126762,9149329,,189092,49121854,8929635,,40884,1004908,219694,PDP
HI544A,,2008,1977,,320497,52743284,9705423,,213311,50432215,9187015,,107186,2311069,518408,PDP
HI544A,,2009,1977,,423423,53997899,10031592,,241117,51105761,9334669,,182306,2892138,696921,PDP
HI544A,,2010,1977,,423423,53997899,10031592,,259770,51549466,9432274,,163653,2448433,599317,PDP
HI544A,,2011,1977,,423423,53997899,10031592,,287659,52040648,9547563,,135764,1957251,484029,PDP
HI544A,,2012,1977,,423423,53997899,10031592,,334278,52641116,9701026,,89145,1356783,330566,PDP
HI544A,,2013,1977,,423423,53997899,10031592,,370926,52981937,9798318,,52497,1015962,233274,PDP
HI544A,,2014,1977,,423423,53997899,10031592,,395451,53203004,9862179,,27972,794895,169413,PDP
HI544A,,2015,1977,,500194,55170275,10316970,,409822,53424427,9915949,,90372,1745848,401021,PDP
HI544A,,2016,1977,,515801,54953203,10293952,,441709,53928171,10037471,,74092,1025032,256482,PDP
HI544A,,2017,1977,,515801,54953203,10293952,,468350,54177138,10108411,,47451,776065,185541,PDP
HI544A,,2017,1977,,515801,54953203,10293952,,468350,54177138,10108411,,47451,776065,185541,PDP
HI545A,,1977,1975,,48783791,175538127,80018333,,0,0,0,,48783791,175538127,80018333,PDP
HI545A,,1978,1975,,4386230,206503820,41130682,,0,0,0,,4386230,206503820,41130682,PDP
HI545A,,1979,1975,,4386230,206503820,41130682,,0,0,0,,4386230,206503820,41130682,PDP
HI545A,,1980,1975,,4386230,206503820,41130682,,0,0,0,,4386230,206503820,41130682,PDP
HI545A,,1981,1975,,4386230,206503820,41130682,,0,0,0,,4386230,206503820,41130682,PDP
HI545A,,1982,1975,,4192811,209693920,41504896,,0,5971753,1062590,,4192811,203722167,40442306,PDP
HI545A,,1983,1975,,4192811,209693920,41504896,,0,17364347,3089741,,4192811,192329573,38415155,PDP
HI545A,,1984,1975,,4192811,209693920,41504896,,0,37615596,6693167,,4192811,172078324,34811729,PDP
HI545A,,1985,1975,,4192811,209693920,41504896,,0,53041060,9437911,,4192811,156652860,32066985,PDP
HI545A,,1986,1975,,4192811,209693920,41504896,,0,67167390,11951493,,4192811,142526530,29553403,PDP
HI545A,,1987,1975,,4192811,209693920,41504896,,0,84147681,14972897,,4192811,125546239,26531999,PDP
HI545A,,1988,1975,,4192811,209693920,41504896,,0,106325603,18919146,,4192811,103368317,22585750,PDP
HI545A,,1989,1975,,0,204784567,36438535,,0,125959368,22412699,,0,78825199,14025836,PDP
HI545A,,1990,1975,,0,204784567,36438535,,0,144691568,25745831,,0,60092999,10692704,PDP
HI545A,,1991,1975,,0,204876156,36454832,,0,160751610,28603489,,0,44124546,7851343,PDP
HI545A,,1992,1975,,0,205090114,36492903,,0,174601310,31067849,,0,30488804,5425054,PDP
HI545A,,1993,1975,,0,205090114,36492903,,0,186456916,33177387,,0,18633198,3315516,PDP
HI545A,,1994,1975,,0,224694047,39981147,,0,195000900,34697669,,0,29693147,5283478,PDP
HI545A,,1995,1975,,2596625,260478994,48945200,,140321,204164154,36468462,,2456304,56314840,12476738,PDP
HI545A,,1996,1975,,2518472,245474948,46197288,,495779,211130983,38063570,,2022693,34343965,8133718,PDP
HI545A,,1997,1975,,2530113,246794228,46443677,,785979,216497305,39308631,,1744134,30296923,7135046,PDP
HI545A,,1998,1975,,2529570,245061233,46134772,,925502,218887358,39873430,,1604068,26173875,6261342,PDP
HI545A,,1999,1975,,1634006,223150194,41340446,,1043623,220600989,40296468,,590383,2549205,1043978,PDP
HI545A,,2000,1975,,1634006,223150194,41340446,,1141623,220749565,40420905,,492383,2400629,919541,PDP
HI545A,,2001,1975,,1544726,221209013,40905760,,1242142,220894167,40547154,,302584,314846,358606,PDP
HI545A,,2002,1975,,1588649,221382153,40980491,,1341658,221045403,40673580,,246991,336750,306911,PDP
HI545A,,2003,1975,,1588649,221382153,40980491,,1424199,221140494,40773041,,164450,241659,207450,PDP
HI545A,,2004,1975,,2168730,226875813,42538091,,1487522,221200269,40847000,,681208,5675544,1691091,PDP
HI545A,,2005,1975,,2168730,226875813,42538091,,1582071,221614772,41015304,,586659,5261041,1522787,PDP
HI545A,,2006,1975,,2351803,225112079,42407333,,1977408,222620285,41589558,,374395,2491794,817775,PDP
HI545A,,2007,1975,,2488307,223381746,42235949,,2190064,222983161,41866783,,298243,398585,369166,PDP
HI545A,,2008,1975,,4268232,233480649,45812831,,2292361,223104329,41990640,,1975871,10376320,3822191,PDP
HI545A,,2009,1975,,4248258,237681773,46540388,,2412614,227552021,42902297,,1835644,10129752,3638091,PDP
HI545A,,2010,1975,,4248258,237681773,46540388,,2653667,229040297,43408168,,1594591,8641476,3132221,PDP
HI545A,,2011,1975,,4248258,237681773,46540388,,2934946,229809067,43826239,,1313312,7872706,2714150,PDP
HI545A,,2012,1975,,4042034,234458510,45760630,,3235915,230229585,44202033,,806119,4228925,1558597,PDP
HI545A,,2013,1975,,3917218,231064217,45031847,,3392274,230365445,44382566,,524944,698772,649281,PDP
HI545A,,2014,1975,,3917218,231064217,45031847,,3472252,230474065,44481873,,444966,590152,549975,PDP
HI545A,,2015,1975,,5116377,253679187,50255022,,3771083,234396618,45478666,,1345294,19282569,4776355,PDP
HI545A,,2016,1975,,5132285,254083774,50342921,,4110271,238887977,46617028,,1022014,15195797,3725893,PDP
HI545A,,2017,1975,,5047335,249380775,49421138,,4376335,242573200,47538826,,671000,6807575,1882312,PDP
HI545A,,2017,1975,,5047335,249380775,49421138,,4376335,242573200,47538826,,671000,6807575,1882312,PDP
HI549A,,1995,1983,,53,526826,93794,,0,0,0,,53,526826,93794,PDN
HI549A,,1996,1983,,20733,12866890,2310215,,174,123904,22221,,20559,12742986,2287994,PDN
HI549A,,1997,1983,,20732,12872526,2311217,,1828,2004144,358437,,18904,10868382,1952780,PDN
HI549A,,1998,1983,,8656,10558774,1887441,,3315,2301269,412793,,5341,8257505,1474648,PDN
HI549A,,1999,1983,,3317,2331870,418240,,3317,2331870,418240,,0,0,0,PDN
HI549A,,2000,1983,,3317,2331870,418240,,3317,2331870,418240,,0,0,0,PDN
HI549A,,2001,1983,,3317,2331870,418240,,3317,2331870,418240,,0,0,0,PDN
HI549A,,2002,1983,,3317,2331870,418240,,3317,2331870,418240,,0,0,0,PDN
HI549A,,2003,1983,,3317,2331870,418240,,3317,2331870,418240,,0,0,0,PDN
HI549A,,2004,1983,,3317,2331870,418240,,3317,2331870,418240,,0,0,0,PDN
HI549A,,2005,1983,,3317,2331870,418240,,3317,2331870,418240,,0,0,0,PDN
HI549A,,2006,1983,,3317,2331870,418240,,3317,2331870,418240,,0,0,0,PDN
HI549A,,2007,1983,,3317,2331870,418240,,3317,2331870,418240,,0,0,0,PDN
HI549A,,2008,1983,,3317,2331870,418240,,3317,2331870,418240,,0,0,0,PDN
HI549A,,2009,1983,,3317,2377089,426287,,3317,2377089,426287,,0,0,0,PDN
HI549A,,2010,1983,,3317,2377089,426287,,3317,2377089,426287,,0,0,0,PDN
HI549A,,2011,1983,,3317,2377089,426287,,3317,2377089,426287,,0,0,0,PDN
HI549A,,2012,1983,,3317,2377089,426287,,3317,2377089,426287,,0,0,0,PDN
HI549A,,2013,1983,,3317,2377089,426287,,3317,2377089,426287,,0,0,0,PDN
HI549A,,2014,1983,,3317,2377089,426287,,3317,2377089,426287,,0,0,0,PDN
HI549A,,2015,1983,,3317,2377089,426287,,3317,2377089,426287,,0,0,0,PDN
HI549A,,2016,1983,,3317,2377089,426287,,3317,2377089,426287,,0,0,0,PDN
HI549A,,2017,1983,,3317,2377089,426287,,3317,2377089,426287,,0,0,0,PDN
HI549A,,2017,1983,,3317,2377089,426287,,3317,2377089,426287,,0,0,0,PDN
HI552A,,1978,1974,,25000,25000000,4473399,,0,0,0,,25000,25000000,4473399,PDP
HI552A,,1979,1974,,0,25000000,4448399,,0,0,0,,0,25000000,4448399,PDP
HI552A,,1980,1974,,382000,25000000,4830399,,0,0,0,,382000,25000000,4830399,PDP
HI552A,,1981,1974,,382000,25000000,4830399,,0,0,0,,382000,25000000,4830399,PDP
HI552A,,1982,1974,,382000,25000000,4830399,,0,0,0,,382000,25000000,4830399,PDP
HI552A,,1983,1974,,336424,81990810,14925536,,0,0,0,,336424,81990810,14925536,PDP
HI552A,,1984,1974,,336424,81990810,14925536,,0,0,0,,336424,81990810,14925536,PDP
HI552A,,1985,1974,,1783426,166388948,31390000,,33565,4892147,904054,,1749861,161496801,30485946,PDP
HI552A,,1986,1974,,1682111,183274504,34293233,,106488,26941373,4900327,,1575623,156333131,29392906,PDP
HI552A,,1987,1974,,1169212,202506515,37202400,,173259,44456555,8083678,,995953,158049960,29118722,PDP
HI552A,,1988,1974,,1167248,206724579,37950981,,223880,53693767,9777931,,943368,153030812,28173050,PDP
HI552A,,1989,1974,,1251964,206312539,37962380,,263197,62752138,11429058,,988767,143560401,26533322,PDP
HI552A,,1990,1974,,1286575,185367290,34270079,,318303,78276048,14246425,,968272,107091242,20023654,PDP
HI552A,,1991,1974,,1345112,189519089,35067370,,526674,104429530,19108441,,818438,85089559,15958929,PDP
HI552A,,1992,1974,,1367516,200479437,37040014,,678396,124938221,22909396,,689120,75541216,14130618,PDP
HI552A,,1993,1974,,1325205,199223512,36774228,,741012,135804570,24905526,,584193,63418942,11868702,PDP
HI552A,,1994,1974,,1317224,200094931,36921304,,768642,140395865,25750113,,548582,59699066,11171191,PDP
HI552A,,1995,1974,,1730999,182299838,34168693,,875525,146054447,26863861,,855474,36245391,7304832,PDP
HI552A,,1996,1974,,4154489,218148344,42970920,,1198001,155545459,28875129,,2956488,62602885,14095791,PDP
HI552A,,1997,1974,,4469162,232486196,45836813,,1474068,166341484,31072197,,2995094,66144712,14764616,PDP
HI552A,,1998,1974,,7754538,304534764,61942218,,2192307,188521020,35736972,,5562231,116013744,26205246,PDP
HI552A,,1999,1974,,7370000,299803409,60715803,,3362984,213310131,41318523,,4007016,86493278,19397280,PDP
HI552A,,2000,1974,,7564253,321950578,64850833,,3930745,228801504,44642756,,3633508,93149074,20208077,PDP
HI552A,,2001,1974,,5254114,294652887,57683453,,4177824,239320770,46761591,,1076290,55332117,10921862,PDP
HI552A,,2002,1974,,5250369,288179054,56527780,,4339252,245092712,47950055,,911117,43086342,8577725,PDP
HI552A,,2003,1974,,5301572,301170555,58890638,,4463277,249722700,48897921,,838295,51447855,9992717,PDP
HI552A,,2004,1974,,5794976,316718259,62150538,,4776652,265610315,52038274,,1018324,51107944,10112264,PDP
HI552A,,2005,1974,,5826925,308478809,60716393,,5163130,280496824,55073597,,663795,27981985,5642796,PDP
HI552A,,2006,1974,,6001561,314225612,61913592,,5527329,291173072,57337484,,474232,23052540,4576108,PDP
HI552A,,2007,1974,,5978772,303978986,60067560,,5705847,295856605,58349371,,272925,8122381,1718189,PDP
HI552A,,2008,1974,,6151882,310727310,61441439,,5783469,298495836,58896607,,368413,12231474,2544832,PDP
HI552A,,2009,1974,,6018595,308654063,60939247,,5827641,303428174,59818419,,190954,5225889,1120827,PDP
HI552A,,2010,1974,,6018595,308654063,60939247,,5838894,304080359,59945721,,179701,4573704,993527,PDP
HI552A,,2011,1974,,6018595,308654063,60939247,,5853904,304488968,60033437,,164691,4165095,905810,PDP
HI552A,,2012,1974,,6018595,308654063,60939247,,5876979,305078942,60161489,,141616,3575121,777758,PDP
HI552A,,2013,1974,,6018595,308654063,60939247,,5901994,305599445,60279120,,116601,3054618,660127,PDP
HI552A,,2014,1974,,6018595,308654063,60939247,,5926231,306147118,60400808,,92364,2506945,538439,PDP
HI552A,,2015,1974,,6033461,309278361,61065198,,5944256,306626740,60504175,,89205,2651621,561023,PDP
HI552A,,2016,1974,,5980281,307585984,60710884,,5961127,307119318,60608693,,19154,466666,102191,PDP
HI552A,,2017,1974,,6011670,308629737,60927994,,5975978,307579837,60705487,,35692,1049900,222507,PDP
HI552A,,2017,1974,,6011670,308629737,60927994,,5975978,307579837,60705487,,35692,1049900,222507,PDP
HI555A,,1976,1974,,0,20000000,3558719,,0,0,0,,0,20000000,3558719,PDN
HI555A,,1977,1974,,0,20000000,3558719,,0,0,0,,0,20000000,3558719,PDN
HI555A,,1978,1974,,54745,54745000,9795848,,0,0,0,,54745,54745000,9795848,PDN
HI555A,,1979,1974,,54745,54745000,9795848,,0,1510,269,,54745,54743490,9795579,PDN
HI555A,,1980,1974,,54745,54746510,9796117,,0,1510,269,,54745,54745000,9795848,PDN
HI555A,,1981,1974,,559945,58175800,10911511,,59681,2286336,466502,,500264,55889464,10445009,PDN
HI555A,,1982,1974,,859945,57245000,11045888,,214759,9134754,1840160,,645186,48110246,9205728,PDN
HI555A,,1983,1974,,1296955,56896000,11420798,,477760,11540523,2531234,,819195,45355477,8889564,PDN
HI555A,,1984,1974,,1296955,56896000,11420798,,597128,16521022,3536812,,699827,40374978,7883986,PDN
HI555A,,1985,1974,,3758638,42818880,11377656,,712211,18677697,4035645,,3046427,24141183,7342011,PDN
HI555A,,1986,1974,,3758638,42818880,11377656,,848853,19870134,4384464,,2909785,22948746,6993192,PDN
HI555A,,1987,1974,,3758638,42818880,11377656,,1031889,24763956,5438287,,2726749,18054924,5939369,PDN
HI555A,,1988,1974,,3759206,44424528,11663926,,1269062,27610146,6181899,,2490144,16814382,5482027,PDN
HI555A,,1989,1974,,3760237,48706288,12426836,,1525742,29886881,6843692,,2234495,18819407,5583144,PDN
HI555A,,1990,1974,,3760435,48706288,12427034,,1692827,31267732,7256480,,2067608,17438556,5170554,PDN
HI555A,,1991,1974,,3818213,46481587,12088958,,1872749,32516107,7658533,,1945464,13965480,4430425,PDN
HI555A,,1992,1974,,3818213,46481587,12088958,,2034699,33522657,7999585,,1783514,12958930,4089373,PDN
HI555A,,1993,1974,,3818213,46481587,12088958,,2189375,34081300,8253663,,1628838,12400287,3835295,PDN
HI555A,,1994,1974,,3821936,46455169,12087980,,2284290,34191050,8368107,,1537646,12264119,3719873,PDN
HI555A,,1995,1974,,3876712,52056731,13139476,,2324959,34330981,8433674,,1551753,17725750,4705802,PDN
HI555A,,1996,1974,,4232362,59460514,14812525,,2455220,38051545,9225958,,1777142,21408969,5586567,PDN
HI555A,,1997,1974,,4232362,59460514,14812525,,2560592,41049626,9864796,,1671770,18410888,4947729,PDN
HI555A,,1998,1974,,4606165,61454408,15541113,,2691788,42735353,10295943,,1914377,18719055,5245170,PDN
HI555A,,1999,1974,,4608996,56093961,14590128,,2807649,44388597,10705976,,1801347,11705364,3884152,PDN
HI555A,,2000,1974,,4608996,56093961,14590128,,2901186,46145264,11112087,,1707810,9948697,3478041,PDN
HI555A,,2001,1974,,4255127,53893217,13844667,,2954506,47126205,11339952,,1300621,6767012,2504715,PDN
HI555A,,2002,1974,,4218589,54290136,13878755,,3001944,47510549,11455778,,1216645,6779587,2422977,PDN
HI555A,,2003,1974,,4210771,54903223,13980028,,3023598,47722585,11515161,,1187173,7180638,2464867,PDN
HI555A,,2004,1974,,4210771,54395095,13889614,,3023598,48072586,11577439,,1187173,6322509,2312175,PDN
HI555A,,2005,1974,,3152074,53751338,12716369,,3024091,48288212,11616300,,127983,5463126,1100069,PDN
HI555A,,2006,1974,,3152074,53751338,12716369,,3024091,48373608,11631495,,127983,5377730,1084874,PDN
HI555A,,2007,1974,,3024308,48526668,11658946,,3024308,48476403,11650002,,0,50265,8944,PDN
HI555A,,2008,1974,,3024308,48530440,11659618,,3024308,48530440,11659618,,0,0,0,PDN
HI555A,,2009,1974,,3024308,49377194,11810286,,3024308,49377194,11810286,,0,0,0,PDN
HI555A,,2010,1974,,3024308,49377194,11810286,,3024308,49377194,11810286,,0,0,0,PDN
HI555A,,2011,1974,,3024308,49377194,11810286,,3024308,49377194,11810286,,0,0,0,PDN
HI555A,,2012,1974,,3024308,49377194,11810286,,3024308,49377194,11810286,,0,0,0,PDN
HI555A,,2013,1974,,3024308,49377194,11810286,,3024308,49377194,11810286,,0,0,0,PDN
HI555A,,2014,1974,,3024308,49377194,11810286,,3024308,49377194,11810286,,0,0,0,PDN
HI555A,,2015,1974,,3024308,49377194,11810286,,3024308,49377194,11810286,,0,0,0,PDN
HI555A,,2016,1974,,3024308,49377194,11810286,,3024308,49377194,11810286,,0,0,0,PDN
HI555A,,2017,1974,,3024308,49377194,11810286,,3024308,49377194,11810286,,0,0,0,PDN
HI555A,,2017,1974,,3024308,49377194,11810286,,3024308,49377194,11810286,,0,0,0,PDN
HI557A,,1983,1979,,1636685,33778535,7647100,,0,0,0,,1636685,33778535,7647100,PDP
HI557A,,1984,1979,,4141362,44548758,12068187,,0,0,0,,4141362,44548758,12068187,PDP
HI557A,,1985,1979,,4141362,44548758,12068187,,0,0,0,,4141362,44548758,12068187,PDP
HI557A,,1986,1979,,4141362,44548758,12068187,,0,0,0,,4141362,44548758,12068187,PDP
HI557A,,1987,1979,,2221944,55569681,12109788,,0,0,0,,2221944,55569681,12109788,PDP
HI557A,,1988,1979,,2221944,55569681,12109788,,0,0,0,,2221944,55569681,12109788,PDP
HI557A,,1989,1979,,2221944,55569681,12109788,,0,0,0,,2221944,55569681,12109788,PDP
HI557A,,1990,1979,,2977503,40860734,10248096,,0,40322,7175,,2977503,40820412,10240921,PDP
HI557A,,1991,1979,,2583199,43163841,10263598,,1076108,12420807,3286216,,1507091,30743034,6977382,PDP
HI557A,,1992,1979,,3585565,45939258,11759810,,2048125,19746160,5561677,,1537440,26193098,6198133,PDP
HI557A,,1993,1979,,5456623,46912235,13803996,,2944168,23832013,7184740,,2512455,23080222,6619256,PDP
HI557A,,1994,1979,,5455647,46845693,13791180,,3773029,27422722,8652517,,1682618,19422971,5138663,PDP
HI557A,,1995,1979,,6575431,48980769,15290870,,4475298,30036003,9819783,,2100133,18944766,5471087,PDP
HI557A,,1996,1979,,6621710,53287828,16103530,,5008665,31926536,10689543,,1613045,21361292,5413987,PDP
HI557A,,1997,1979,,6916506,54089084,16540898,,5499810,33903480,11532458,,1416696,20185604,5008440,PDP
HI557A,,1998,1979,,8532368,55355403,18382084,,6020425,35487279,12334887,,2511943,19868124,6047197,PDP
HI557A,,1999,1979,,9486174,65540747,21148229,,6649611,36663922,13173441,,2836563,28876825,7974788,PDP
HI557A,,2000,1979,,9558099,64590127,21051004,,6998017,37379051,13649094,,2560082,27211076,7401910,PDP
HI557A,,2001,1979,,8839074,56482403,18889324,,7158483,37810378,13886308,,1680591,18672025,5003016,PDP
HI557A,,2002,1979,,8973542,60410579,19722756,,7428853,39436054,14445944,,1544689,20974525,5276812,PDP
HI557A,,2003,1979,,9547131,65139254,21137746,,7732226,42646314,15320538,,1814905,22492940,5817208,PDP
HI557A,,2004,1979,,9547131,65139254,21137746,,8135021,46547736,16417536,,1412110,18591518,4720210,PDP
HI557A,,2005,1979,,9547157,65143145,21138464,,8463424,49571493,17283974,,1083733,15571652,3854490,PDP
HI557A,,2006,1979,,10498378,74987617,23841371,,8687033,51466434,17844761,,1811345,23521183,5996610,PDP
HI557A,,2007,1979,,9834938,64540563,21319024,,8965527,53843567,18546233,,869411,10696996,2772791,PDP
HI557A,,2008,1979,,11070750,63633265,22393395,,9168455,55647621,19070167,,1902295,7985644,3323228,PDP
HI557A,,2009,1979,,11077192,64357852,22528766,,9464137,58678512,19905153,,1613055,5679340,2623613,PDP
HI557A,,2010,1979,,11077192,64357852,22528766,,9726124,59300697,20277849,,1351068,5057155,2250920,PDP
HI557A,,2011,1979,,11077192,64357852,22528766,,9977413,59809084,20619597,,1099779,4548768,1909169,PDP
HI557A,,2012,1979,,11462119,64569026,22951269,,10236258,60251457,20957156,,1225861,4317569,1994112,PDP
HI557A,,2013,1979,,11462119,64569026,22951269,,10491423,60758907,21302615,,970696,3810119,1648655,PDP
HI557A,,2014,1979,,11462119,64569026,22951269,,10690887,61211557,21582621,,771232,3357469,1368646,PDP
HI557A,,2015,1979,,11410847,64518531,22891013,,10860218,61562086,21814325,,550629,2956445,1076686,PDP
HI557A,,2016,1979,,11521851,65282439,23137943,,11026043,61893621,22039141,,495808,3388818,1098800,PDP
HI557A,,2017,1979,,11478238,64849790,23017345,,11156651,62167755,22218527,,321587,2682035,798818,PDP
HI557A,,2017,1979,,11478238,64849790,23017345,,11156651,62167755,22218527,,321587,2682035,798818,PDP
HI561A,,1976,1975,,628954,29372949,5855457,,0,0,0,,628954,29372949,5855457,PDN
HI561A,,1977,1975,,628954,29372949,5855457,,0,0,0,,628954,29372949,5855457,PDN
HI561A,,1978,1975,,628954,29372949,5855457,,0,0,0,,628954,29372949,5855457,PDN
HI561A,,1979,1975,,628954,29372949,5855457,,0,0,0,,628954,29372949,5855457,PDN
HI561A,,1980,1975,,628954,29372949,5855457,,0,0,0,,628954,29372949,5855457,PDN
HI561A,,1981,1975,,628954,29372949,5855457,,56772,1426279,310558,,572182,27946670,5544899,PDN
HI561A,,1982,1975,,3357480,29372949,8583983,,775311,8365364,2263810,,2582169,21007585,6320173,PDN
HI561A,,1983,1975,,5598367,32013232,11294672,,1063819,10883180,3000328,,4534548,21130052,8294344,PDN
HI561A,,1984,1975,,5598367,32013232,11294672,,1394900,13292311,3760080,,4203467,18720921,7534592,PDN
HI561A,,1985,1975,,5918239,32280117,11662032,,1926191,17720176,5079247,,3992048,14559941,6582785,PDN
HI561A,,1986,1975,,5918239,32280117,11662032,,2272297,20612834,5940061,,3645942,11667283,5721971,PDN
HI561A,,1987,1975,,6882029,36995125,13464791,,2594010,22741668,6640570,,4288019,14253457,6824221,PDN
HI561A,,1988,1975,,6698799,33162735,12599642,,2871280,24062834,7152923,,3827519,9099901,5446719,PDN
HI561A,,1989,1975,,6627379,40238566,13787266,,3095648,25151068,7570927,,3531731,15087498,6216339,PDN
HI561A,,1990,1975,,6627379,40114328,13765160,,3350071,26527268,8070225,,3277308,13587060,5694935,PDN
HI561A,,1991,1975,,6207909,40568197,13426449,,3614310,27966683,8590588,,2593599,12601514,4835861,PDN
HI561A,,1992,1975,,4736280,33766074,10744478,,3895682,29519295,9148226,,840598,4246779,1596252,PDN
HI561A,,1993,1975,,5291643,39832257,12379233,,4180145,32845354,10024514,,1111498,6986903,2354719,PDN
HI561A,,1994,1975,,5492045,43413228,13216819,,4467086,35429523,10771272,,1024959,7983705,2445547,PDN
HI561A,,1995,1975,,7289978,53321009,16777702,,4834944,39767625,11911034,,2455034,13553384,4866668,PDN
HI561A,,1996,1975,,7347209,60526823,18117106,,5541600,47252123,13949451,,1805609,13274700,4167655,PDN
HI561A,,1997,1975,,7775967,66251746,19564534,,6103258,51512742,15269226,,1672709,14739004,4295308,PDN
HI561A,,1998,1975,,8627672,75707678,22098789,,6711552,57007389,16855216,,1916120,18700289,5243573,PDN
HI561A,,1999,1975,,8410502,72805584,21365232,,7117199,61598737,18077828,,1293303,11206847,3287404,PDN
HI561A,,2000,1975,,8634744,78652914,22629924,,7389577,65334501,19014933,,1245167,13318413,3614991,PDN
HI561A,,2001,1975,,8343540,76016679,21869639,,7662551,70102714,20136344,,680989,5913965,1733295,PDN
HI561A,,2002,1975,,8388134,77302612,22143047,,7815855,71696550,20573248,,572279,5606062,1569799,PDN
HI561A,,2003,1975,,8389513,77312031,22146102,,7942629,72755392,20888428,,446884,4556639,1257674,PDN
HI561A,,2004,1975,,9076615,76189018,22633380,,8039728,73332471,21088210,,1036887,2856547,1545170,PDN
HI561A,,2005,1975,,9051597,75818510,22542435,,8198113,73707297,21313290,,853484,2111213,1229145,PDN
HI561A,,2006,1975,,9465907,76242353,23032162,,8701362,74323340,21926156,,764545,1919013,1106006,PDN
HI561A,,2007,1975,,9399663,75488960,22831862,,8880341,74676280,22167935,,519322,812680,663927,PDN
HI561A,,2008,1975,,9771068,77323385,23529677,,8974932,74887081,22300035,,796136,2436304,1229642,PDN
HI561A,,2009,1975,,9179758,76494207,22790828,,9097435,76250522,22665144,,82323,243685,125683,PDN
HI561A,,2010,1975,,9179758,76494207,22790828,,9178655,76466018,22784709,,1103,28189,6119,PDN
HI561A,,2011,1975,,9179758,76494207,22790828,,9179758,76494207,22790828,,0,0,0,PDN
HI561A,,2012,1975,,9179758,76494207,22790828,,9179758,76494207,22790828,,0,0,0,PDN
HI561A,,2013,1975,,9179758,76494207,22790828,,9179758,76494207,22790828,,0,0,0,PDN
HI561A,,2014,1975,,9179758,76494207,22790828,,9179758,76494207,22790828,,0,0,0,PDN
HI561A,,2015,1975,,9179758,76494207,22790828,,9179758,76494207,22790828,,0,0,0,PDN
HI561A,,2016,1975,,9179758,76494207,22790828,,9179758,76494207,22790828,,0,0,0,PDN
HI561A,,2017,1975,,9179758,76494207,22790828,,9179758,76494207,22790828,,0,0,0,PDN
HI561A,,2017,1975,,9179758,76494207,22790828,,9179758,76494207,22790828,,0,0,0,PDN
HI563A,,1976,1974,,500001,500000000,89467973,,0,0,0,,500001,500000000,89467973,PDP
HI563A,,1977,1974,,500001,500000000,89467973,,0,0,0,,500001,500000000,89467973,PDP
HI563A,,1978,1974,,6786257,377230525,73909126,,0,0,0,,6786257,377230525,73909126,PDP
HI563A,,1979,1974,,6786257,377230525,73909126,,0,0,0,,6786257,377230525,73909126,PDP
HI563A,,1980,1974,,6786257,377230525,73909126,,0,0,0,,6786257,377230525,73909126,PDP
HI563A,,1981,1974,,7641002,389230525,76899103,,0,0,0,,7641002,389230525,76899103,PDP
HI563A,,1982,1974,,6693095,372603230,72992602,,615294,5088194,1520667,,6077801,367515036,71471935,PDP
HI563A,,1983,1974,,16806044,588167071,121462106,,2349225,32399874,8114327,,14456819,555767197,113347779,PDP
HI563A,,1984,1974,,19556000,634885075,132524875,,3650797,75126611,17018521,,15905203,559758464,115506354,PDP
HI563A,,1985,1974,,20391164,654927013,136926220,,4905448,104802936,23553657,,15485716,550124077,113372563,PDP
HI563A,,1986,1974,,20766256,661316696,138438266,,5942845,137435126,30397494,,14823411,523881570,108040772,PDP
HI563A,,1987,1974,,11127422,432567193,88096673,,6795182,194606452,41422665,,4332240,237960741,46674008,PDP
HI563A,,1988,1974,,12671569,606370002,120566587,,7463069,261330326,53963127,,5208500,345039676,66603460,PDP
HI563A,,1989,1974,,11890446,623808247,122888355,,8010164,316668204,64356820,,3880282,307140043,58531535,PDP
HI563A,,1990,1974,,11331061,590485222,116399606,,8450588,355793749,71759084,,2880473,234691473,44640522,PDP
HI563A,,1991,1974,,12000070,576014200,114493700,,8825582,394305479,78986699,,3174488,181708721,35507001,PDP
HI563A,,1992,1974,,12026409,577452318,114775932,,9185500,428058628,85352516,,2840909,149393690,29423416,PDP
HI563A,,1993,1974,,13262672,558958724,112721520,,9604064,454593681,90492619,,3658608,104365043,22228901,PDP
HI563A,,1994,1974,,13306096,578447541,116232705,,10072373,480366874,95546906,,3233723,98080667,20685799,PDP
HI563A,,1995,1974,,13273876,573210954,115268708,,10392672,505591894,100355642,,2881204,67619060,14913066,PDP
HI563A,,1996,1974,,13447349,593331745,119022393,,10650822,526622860,104355957,,2796527,66708885,14666436,PDP
HI563A,,1997,1974,,12702365,617543718,122585589,,11093889,555014417,109850903,,1608476,62529301,12734686,PDP
HI563A,,1998,1974,,12990691,643767918,127540143,,11444389,578151049,114318241,,1546302,65616869,13221902,PDP
HI563A,,1999,1974,,14071161,631822593,126495110,,12126894,594731003,117950916,,1944267,37091590,8544194,PDP
HI563A,,2000,1974,,14504817,639056759,128215984,,12894378,608671996,121199004,,1610439,30384763,7016980,PDP
HI563A,,2001,1974,,15066048,633837725,127848562,,13616969,617806521,123546955,,1449079,16031204,4301607,PDP
HI563A,,2002,1974,,24162982,698261648,148408827,,14750879,626632275,126251284,,9412103,71629373,22157543,PDP
HI563A,,2003,1974,,24162982,698261648,148408827,,17939956,651080176,133790521,,6223026,47181472,14618306,PDP
HI563A,,2004,1974,,29912666,732839999,160311242,,20211264,670540861,139524584,,9701402,62299138,20786658,PDP
HI563A,,2005,1974,,29996248,736783239,161096468,,23207828,692943575,146507397,,6788420,43839664,14589071,PDP
HI563A,,2006,1974,,29576629,762969587,165336342,,25472408,714826235,152665688,,4104221,48143352,12670654,PDP
HI563A,,2007,1974,,29611953,760329406,164901883,,26896527,730387610,156858735,,2715426,29941796,8043148,PDP
HI563A,,2008,1974,,30048001,779478893,168745313,,27739330,738829096,159203582,,2308671,40649797,9541731,PDP
HI563A,,2009,1974,,31643997,801773661,174308351,,28536037,757964507,163405168,,3107960,43809154,10903182,PDP
HI563A,,2010,1974,,31780165,796335666,173476904,,29118288,762223334,164745219,,2661877,34112332,8731688,PDP
HI563A,,2011,1974,,31713232,796293858,173402532,,29527543,768586036,166286626,,2185689,27707822,7115906,PDP
HI563A,,2012,1974,,31713232,796293858,173402532,,29951023,772743901,167449939,,1762209,23549957,5952592,PDP
HI563A,,2013,1974,,31713232,796293858,173402532,,30252469,775549159,168250542,,1460763,20744699,5151991,PDP
HI563A,,2014,1974,,31546133,789078048,171951481,,30581126,777996068,169014591,,965007,11081980,2936890,PDP
HI563A,,2015,1974,,31546133,789078048,171951481,,30805738,779697704,169541986,,740395,9380344,2409495,PDP
HI563A,,2016,1974,,31715955,788256776,171975170,,30955685,779929276,169733137,,760270,8327500,2242030,PDP
HI563A,,2017,1974,,31755419,782112893,170921415,,31063343,780312926,169909060,,692076,1799967,1012354,PDP
HI563A,,2017,1974,,31755419,782112893,170921415,,31063343,780312926,169909060,,692076,1799967,1012354,PDP
HI568A,,1978,1975,,2614876,86138170,17941953,,0,0,0,,2614876,86138170,17941953,PDN
HI568A,,1979,1975,,2614876,86138170,17941953,,0,0,0,,2614876,86138170,17941953,PDN
HI568A,,1980,1975,,2614876,86138170,17941953,,0,0,0,,2614876,86138170,17941953,PDN
HI568A,,1981,1975,,2614876,86138170,17941953,,0,0,0,,2614876,86138170,17941953,PDN
HI568A,,1982,1975,,2614877,86140701,17942404,,0,23931,4258,,2614877,86116770,17938146,PDN
HI568A,,1983,1975,,2614877,91140701,18832084,,0,36003,6406,,2614877,91104698,18825678,PDN
HI568A,,1984,1975,,2614877,91140701,18832084,,0,52771,9390,,2614877,91087930,18822694,PDN
HI568A,,1985,1975,,2662633,92636702,19146032,,29691,3568709,664693,,2632942,89067993,18481339,PDN
HI568A,,1986,1975,,2902694,105405613,21658141,,228329,27176351,5063979,,2674365,78229262,16594162,PDN
HI568A,,1987,1975,,3142199,128701360,26042797,,490643,49319622,9266376,,2651556,79381738,16776421,PDN
HI568A,,1988,1975,,3188821,149014192,29703802,,646620,64825408,12181390,,2542201,84188784,17522412,PDN
HI568A,,1989,1975,,966085,141482099,26140836,,720660,77104255,14440278,,245425,64377844,11700558,PDN
HI568A,,1990,1975,,972225,141482099,26146976,,775231,86358198,16141458,,196994,55123901,10005518,PDN
HI568A,,1991,1975,,1135158,140242156,26089278,,814337,92999770,17362339,,320821,47242386,8726939,PDN
HI568A,,1992,1975,,1145857,135686204,25289310,,846023,97830572,18253598,,299834,37855632,7035712,PDN
HI568A,,1993,1975,,1246670,138394453,25872018,,886242,102416074,19109743,,360428,35978379,6762275,PDN
HI568A,,1994,1975,,1245644,138251069,25845478,,919901,106105585,19799898,,325743,32145484,6045580,PDN
HI568A,,1995,1975,,1245847,138181716,25833341,,948650,107726559,20117077,,297197,30455157,5716264,PDN
HI568A,,1996,1975,,1240645,139250458,26018307,,966543,109204597,20397966,,274102,30045861,5620341,PDN
HI568A,,1997,1975,,1616228,142919184,27046688,,1003285,112059124,20942631,,612943,30860060,6104057,PDN
HI568A,,1998,1975,,2085638,162174630,30942334,,1311792,123271210,23246171,,773846,38903420,7696163,PDN
HI568A,,1999,1975,,2006551,159835688,30447065,,1516763,132750903,25137920,,489788,27084785,5309145,PDN
HI568A,,2000,1975,,2006551,159835689,30447065,,1601207,138267194,26203911,,405344,21568495,4243154,PDN
HI568A,,2001,1975,,1735250,149846185,28398272,,1650918,142043138,26925498,,84332,7803047,1472774,PDN
HI568A,,2002,1975,,1742229,154726559,29273645,,1676049,144267587,27346438,,66180,10458972,1927207,PDN
HI568A,,2003,1975,,1739179,155645501,29434108,,1694428,146009331,27674736,,44751,9636170,1759372,PDN
HI568A,,2004,1975,,1731333,149414135,28317478,,1712066,147054193,27878293,,19267,2359942,439185,PDN
HI568A,,2005,1975,,1866686,157531138,29897138,,1772796,151784116,28780646,,93890,5747022,1116492,PDN
HI568A,,2006,1975,,1867287,157519188,29895612,,1818028,154160105,29248652,,49259,3359083,646960,PDN
HI568A,,2007,1975,,1833891,154619544,29346265,,1831905,154559228,29333547,,1986,60316,12718,PDN
HI568A,,2008,1975,,1833891,154619544,29346265,,1833891,154619544,29346265,,0,0,0,PDN
HI568A,,2009,1975,,1833891,157005036,29770730,,1833891,157005036,29770730,,0,0,0,PDN
HI568A,,2010,1975,,1833891,157005036,29770730,,1833891,157005036,29770730,,0,0,0,PDN
HI568A,,2011,1975,,1833891,157005036,29770730,,1833891,157005036,29770730,,0,0,0,PDN
HI568A,,2012,1975,,1833891,157005036,29770730,,1833891,157005036,29770730,,0,0,0,PDN
HI568A,,2013,1975,,1833891,157005036,29770730,,1833891,157005036,29770730,,0,0,0,PDN
HI568A,,2014,1975,,1833891,157005036,29770730,,1833891,157005036,29770730,,0,0,0,PDN
HI568A,,2015,1975,,1833891,157005036,29770730,,1833891,157005036,29770730,,0,0,0,PDN
HI568A,,2016,1975,,1833891,157005036,29770730,,1833891,157005036,29770730,,0,0,0,PDN
HI568A,,2017,1975,,1833891,157005036,29770730,,1833891,157005036,29770730,,0,0,0,PDN
HI568A,,2017,1975,,1833891,157005036,29770730,,1833891,157005036,29770730,,0,0,0,PDN
HI571A,,1977,1974,,26944047,90003788,42958956,,0,0,0,,26944047,90003788,42958956,PDP
HI571A,,1978,1974,,78925,78925000,14122519,,0,0,0,,78925,78925000,14122519,PDP
HI571A,,1979,1974,,78925,78925000,14122519,,0,0,0,,78925,78925000,14122519,PDP
HI571A,,1980,1974,,78925,78925000,14122519,,0,0,0,,78925,78925000,14122519,PDP
HI571A,,1981,1974,,1011135,81217027,15462563,,935998,7218713,2220467,,75137,73998314,13242096,PDP
HI571A,,1982,1974,,16917262,218282019,55757479,,2941739,24894607,7371384,,13975523,193387412,48386095,PDP
HI571A,,1983,1974,,19246896,237522945,61510765,,7517876,65298168,19136767,,11729020,172224777,42373998,PDP
HI571A,,1984,1974,,22813883,277670757,72221491,,12515670,115702413,33103288,,10298213,161968344,39118203,PDP
HI571A,,1985,1974,,25677546,319024913,82443545,,16777019,166275241,46363361,,8900527,152749672,36080184,PDP
HI571A,,1986,1974,,38780644,423328624,114106022,,20369348,213871432,58424763,,18411296,209457192,55681259,PDP
HI571A,,1987,1974,,40632375,432671217,117620136,,23696281,265190665,70883232,,16936094,167480552,46736904,PDP
HI571A,,1988,1974,,43094395,549982195,140955996,,26699646,318067038,83295204,,16394749,231915157,57660792,PDP
HI571A,,1989,1974,,44043552,637525600,157482271,,28779964,355405105,92019307,,15263588,282120495,65462964,PDP
HI571A,,1990,1974,,39046171,554928348,137787870,,30506902,391988998,100255834,,8539269,162939350,37532036,PDP
HI571A,,1991,1974,,39840865,571460614,141524248,,31994053,426693641,107918188,,7846812,144766973,33606060,PDP
HI571A,,1992,1974,,37306053,548413832,134888585,,33613216,461915681,115804618,,3692837,86498151,19083967,PDP
HI571A,,1993,1974,,37973278,554142497,136575146,,34879722,491273912,122295009,,3093556,62868585,14280137,PDP
HI571A,,1994,1974,,39416442,582436872,143052896,,35920151,515318899,127613905,,3496291,67117973,15438991,PDP
HI571A,,1995,1974,,38995180,592463477,144415728,,36618463,533452186,131538781,,2376717,59011291,12876947,PDP
HI571A,,1996,1974,,39433054,594882823,145284090,,37259175,550088960,135139773,,2173879,44793863,10144317,PDP
HI571A,,1997,1974,,39754100,600598962,146622243,,37665790,559339111,137192322,,2088310,41259851,9429921,PDP
HI571A,,1998,1974,,42716081,669559209,161854730,,38475949,577232041,141186277,,4240132,92327168,20668453,PDP
HI571A,,1999,1974,,37959871,607109011,145986385,,35312696,550206094,133214136,,2647175,56902917,12772249,PDP
HI571A,,2000,1974,,36676025,603261398,144017911,,35762982,564654071,136235237,,913043,38607327,7782674,PDP
HI571A,,2001,1974,,36317281,596420601,142441943,,35982226,574991640,138293906,,335055,21428961,4148037,PDP
HI571A,,2002,1974,,36317281,596420601,142441943,,36068162,580927170,139435986,,249119,15493431,3005957,PDP
HI571A,,2003,1974,,36317281,596420601,142441943,,36119144,583252976,139900812,,198137,13167625,2541131,PDP
HI571A,,2004,1974,,36317281,596420601,142441943,,36222963,585250842,140360123,,94318,11169759,2081820,PDP
HI571A,,2005,1974,,36363577,589559472,141267398,,36274313,586487833,140631579,,89264,3071639,635819,PDP
HI571A,,2006,1974,,36363577,589559472,141267398,,36299140,587389566,140816856,,64437,2169906,450542,PDP
HI571A,,2007,1974,,36363577,589559472,141267398,,36324387,588033590,140956698,,39190,1525882,310700,PDP
HI571A,,2008,1974,,36836845,592716718,142302453,,36350290,588599338,141083268,,486555,4117380,1219185,PDP
HI571A,,2009,1974,,37219596,605143801,144896429,,36378725,599502108,143051699,,840871,5641693,1844730,PDP
HI571A,,2010,1974,,37219596,605143801,144896429,,36504776,600262582,143313066,,714820,4881219,1583364,PDP
HI571A,,2011,1974,,37219596,605143801,144896429,,36627282,600735449,143519711,,592314,4408352,1376719,PDP
HI571A,,2012,1974,,37219596,605143801,144896429,,36791134,601796450,143872353,,428462,3347351,1024076,PDP
HI571A,,2013,1974,,37183453,604330838,144715631,,36914892,602710884,144158822,,268561,1619954,556810,PDP
HI571A,,2014,1974,,37320745,606135608,145174056,,37019738,603505481,144405055,,301007,2630127,769000,PDP
HI571A,,2015,1974,,37336722,607154376,145371308,,37138339,604787333,144751743,,198383,2367043,619565,PDP
HI571A,,2016,1974,,37563718,610605163,146212323,,37256134,606495001,145173394,,307584,4110162,1038930,PDP
HI571A,,2017,1974,,37599710,611157594,146346613,,37355470,608134599,145564474,,244240,3022995,782140,PDP
HI571A,,2017,1974,,37599710,611157594,146346613,,37355470,608134599,145564474,,244240,3022995,782140,PDP
HI573A,,1975,1973,,5075321,158350000,33251478,,0,0,0,,5075321,158350000,33251478,PDP
HI573A,,1976,1973,,33400000,227788000,73931673,,0,0,0,,33400000,227788000,73931673,PDP
HI573A,,1977,1973,,33400000,227788000,73931673,,0,0,0,,33400000,227788000,73931673,PDP
HI573A,,1978,1973,,32004143,139836950,56886163,,0,0,0,,32004143,139836950,56886163,PDP
HI573A,,1979,1973,,32007143,143260358,57498310,,346907,4766348,1195012,,31660236,138494010,56303298,PDP
HI573A,,1980,1973,,36631791,186487932,69814697,,2297440,44272449,10175100,,34334351,142215483,59639597,PDP
HI573A,,1981,1973,,38886422,190395365,72764601,,4637011,81958784,19220425,,34249411,108436581,53544176,PDP
HI573A,,1982,1973,,158258403,359266233,222184779,,7237929,118192248,28268578,,151020474,241073985,193916201,PDP
HI573A,,1983,1973,,56817509,285342401,107590178,,9859158,144166154,35511499,,46958351,141176247,72078679,PDP
HI573A,,1984,1973,,68179321,332991650,127430504,,13628090,174073745,44602066,,54551231,158917905,82828438,PDP
HI573A,,1985,1973,,93230822,515639807,184981677,,17745641,197177715,52830644,,75485181,318462092,132151033,PDP
HI573A,,1986,1973,,100220339,536483630,195680060,,22073721,218279230,60913442,,78146618,318204400,134766618,PDP
HI573A,,1987,1973,,115127642,604989114,222776951,,28153367,248548893,72379149,,86974275,356440221,150397802,PDP
HI573A,,1988,1973,,116345229,678764055,237121751,,35038300,284042548,85579679,,81306929,394721507,151542072,PDP
HI573A,,1989,1973,,110512167,661431570,228204617,,43823736,325927494,101817952,,66688431,335504076,126386665,PDP
HI573A,,1990,1973,,106529236,675302584,226689838,,50742684,352848041,113527033,,55786552,322454543,113162805,PDP
HI573A,,1991,1973,,93683996,643931790,208262606,,59214134,403981747,131097007,,34469862,239950043,77165599,PDP
HI573A,,1992,1973,,96713862,653907278,213067470,,66779535,459682138,148573510,,29934327,194225140,64493960,PDP
HI573A,,1993,1973,,92761985,676396448,213117225,,72900626,510352597,163710697,,19861359,166043851,49406528,PDP
HI573A,,1994,1973,,94689868,706762570,220448332,,78595462,559736426,178192691,,16094406,147026144,42255641,PDP
HI573A,,1995,1973,,99919984,795580618,241482372,,82472873,608943042,190825727,,17447111,186637576,50656645,PDP
HI573A,,1996,1973,,99787063,789632934,240291144,,86476260,660336961,203973940,,13310803,129295973,36317204,PDP
HI573A,,1997,1973,,100293071,849661618,251478412,,89596694,700437070,214229625,,10696377,149224548,37248787,PDP
HI573A,,1998,1973,,102960743,851908732,254545927,,92081394,730931836,222140440,,10879349,120976896,32405487,PDP
HI573A,,1999,1973,,106339100,874880504,262011788,,98149307,805427993,241463897,,8189793,69452511,20547891,PDP
HI573A,,2000,1973,,108452460,878419229,264754814,,100093295,817183094,245499539,,8359165,61236135,19255275,PDP
HI573A,,2001,1973,,108232815,873077276,263584643,,101870095,828295359,249253611,,6362720,44781917,14331032,PDP
HI573A,,2002,1973,,108344229,870130280,263171681,,103167164,836301132,251975195,,5177065,33829148,11196486,PDP
HI573A,,2003,1973,,108347864,870130280,263175316,,104088972,841666070,253851618,,4258892,28464210,9323698,PDP
HI573A,,2004,1973,,110995127,868091320,265459775,,105253271,844561007,255531030,,5741856,23530313,9928745,PDP
HI573A,,2005,1973,,110794781,861226201,264037878,,106649939,848486295,257626148,,4144842,12739906,6411730,PDP
HI573A,,2006,1973,,112554643,862590911,266040571,,107638994,850129131,258907523,,4915649,12461780,7133048,PDP
HI573A,,2007,1973,,111385480,856164024,263727833,,108510291,851757778,260068614,,2875189,4406246,3659219,PDP
HI573A,,2008,1973,,113324780,860888267,266507746,,109273829,853184342,261085989,,4050951,7703925,5421757,PDP
HI573A,,2009,1973,,115809227,877101421,271877098,,110321972,870046183,265134462,,5487255,7055238,6742637,PDP
HI573A,,2010,1973,,115958243,875282918,271702537,,111069964,870738735,266005681,,4888279,4544183,5696853,PDP
HI573A,,2011,1973,,116596471,875696860,272414420,,111849932,871644514,266946820,,4746539,4052346,5467597,PDP
HI573A,,2012,1973,,116807591,876413880,272753123,,112608551,872337533,267828753,,4199040,4076347,4924366,PDP
HI573A,,2013,1973,,116663434,877525893,272806831,,113242627,872964630,268574413,,3420807,4561263,4232419,PDP
HI573A,,2014,1973,,118047240,879015646,274455719,,114219689,874167154,269765445,,3827551,4848492,4690271,PDP
HI573A,,2015,1973,,118052065,879415689,274531727,,115086327,875335070,270839898,,2965738,4080619,3691827,PDP
HI573A,,2016,1973,,118290028,880603003,274980954,,115763760,876623962,271746670,,2526268,3979041,3234282,PDP
HI573A,,2017,1973,,118324695,880634121,275021157,,116328749,877594136,272484288,,1995946,3039985,2536870,PDP
HI573A,,2017,1973,,118324695,880634121,275021157,,116328749,877594136,272484288,,1995946,3039985,2536870,PDP
HI576A,,1995,1994,,7943842,56170907,17938665,,32846,254469,78125,,7910996,55916438,17860540,PDN
HI576A,,1996,1994,,8222327,62580130,19357581,,1027420,9458906,2710499,,7194907,53121224,16647082,PDN
HI576A,,1997,1994,,8222327,62580130,19357581,,1647590,21851712,5535795,,6574737,40728418,13821786,PDN
HI576A,,1998,1994,,3293616,62578696,14428615,,1873156,30831154,7359126,,1420460,31747542,7069489,PDN
HI576A,,1999,1994,,2290462,51535397,11460461,,1968044,36412033,8447053,,322418,15123364,3013408,PDN
HI576A,,2000,1994,,2290515,51536577,11460724,,2006826,39046869,8954667,,283689,12489708,2506057,PDN
HI576A,,2001,1994,,2019392,39923131,9123152,,2019392,39923131,9123152,,0,0,0,PDN
HI576A,,2002,1994,,2019392,39923131,9123152,,2019392,39923131,9123152,,0,0,0,PDN
HI576A,,2003,1994,,2019392,39923131,9123152,,2019392,39923131,9123152,,0,0,0,PDN
HI576A,,2004,1994,,2019392,39923131,9123152,,2019392,39923131,9123152,,0,0,0,PDN
HI576A,,2005,1994,,2019392,39923131,9123152,,2019392,39923131,9123152,,0,0,0,PDN
HI576A,,2006,1994,,2019392,39923131,9123152,,2019392,39923131,9123152,,0,0,0,PDN
HI576A,,2007,1994,,2019392,39923131,9123152,,2019392,39923131,9123152,,0,0,0,PDN
HI576A,,2008,1994,,2019392,39923131,9123152,,2019392,39923131,9123152,,0,0,0,PDN
HI576A,,2009,1994,,2019392,40486106,9223325,,2019392,40486106,9223325,,0,0,0,PDN
HI576A,,2010,1994,,2019392,40486106,9223325,,2019392,40486106,9223325,,0,0,0,PDN
HI576A,,2011,1994,,2019392,40486106,9223325,,2019392,40486106,9223325,,0,0,0,PDN
HI576A,,2012,1994,,2019392,40486106,9223325,,2019392,40486106,9223325,,0,0,0,PDN
HI576A,,2013,1994,,2019392,40486106,9223325,,2019392,40486106,9223325,,0,0,0,PDN
HI576A,,2014,1994,,2019392,40486106,9223325,,2019392,40486106,9223325,,0,0,0,PDN
HI576A,,2015,1994,,2019392,40486106,9223325,,2019392,40486106,9223325,,0,0,0,PDN
HI576A,,2016,1994,,2019392,40486106,9223325,,2019392,40486106,9223325,,0,0,0,PDN
HI576A,,2017,1994,,2019392,40486106,9223325,,2019392,40486106,9223325,,0,0,0,PDN
HI576A,,2017,1994,,2019392,40486106,9223325,,2019392,40486106,9223325,,0,0,0,PDN
HI587A,,1987,1985,,391565,16890928,3397068,,0,0,0,,391565,16890928,3397068,PDN
HI587A,,1990,1985,,406060,19725968,3916019,,3186,154773,30726,,402874,19571195,3885293,PDN
HI587A,,1991,1985,,406060,19725968,3916019,,130812,6846629,1349073,,275248,12879339,2566946,PDN
HI587A,,1992,1985,,406060,19725968,3916019,,210285,11494362,2255545,,195775,8231606,1660474,PDN
HI587A,,1993,1985,,406060,19725968,3916019,,227961,12827825,2510492,,178099,6898143,1405527,PDN
HI587A,,1994,1985,,406060,19725968,3916019,,237446,14002286,2728956,,168614,5723682,1187063,PDN
HI587A,,1995,1985,,407576,19799635,3930643,,240291,14775858,2869447,,167285,5023777,1061196,PDN
HI587A,,1996,1985,,240291,19572965,3723025,,240291,15459398,2991074,,0,4113567,731951,PDN
HI587A,,1997,1985,,240291,19572965,3723025,,240291,15989591,3085414,,0,3583374,637611,PDN
HI587A,,1998,1985,,240291,19572965,3723025,,240291,15989591,3085414,,0,3583374,637611,PDN
HI587A,,1999,1985,,240291,15989591,3085414,,240291,15989591,3085414,,0,0,0,PDN
HI587A,,2000,1985,,240291,15989591,3085414,,240291,15989591,3085414,,0,0,0,PDN
HI587A,,2001,1985,,240291,15989591,3085414,,240291,15989591,3085414,,0,0,0,PDN
HI587A,,2002,1985,,240291,15989591,3085414,,240291,15989591,3085414,,0,0,0,PDN
HI587A,,2003,1985,,240291,15989591,3085414,,240291,15989591,3085414,,0,0,0,PDN
HI587A,,2004,1985,,240291,15989591,3085414,,240291,15989591,3085414,,0,0,0,PDN
HI587A,,2005,1985,,240291,15989591,3085414,,240291,15989591,3085414,,0,0,0,PDN
HI587A,,2006,1985,,240291,15989591,3085414,,240291,15989591,3085414,,0,0,0,PDN
HI587A,,2007,1985,,240291,15989591,3085414,,240291,15989591,3085414,,0,0,0,PDN
HI587A,,2008,1985,,240291,15989591,3085414,,240291,15989591,3085414,,0,0,0,PDN
HI587A,,2009,1985,,240291,16309818,3142394,,240291,16309818,3142394,,0,0,0,PDN
HI587A,,2010,1985,,240291,16309818,3142394,,240291,16309818,3142394,,0,0,0,PDN
HI587A,,2011,1985,,240291,16309818,3142394,,240291,16309818,3142394,,0,0,0,PDN
HI587A,,2012,1985,,240291,16309818,3142394,,240291,16309818,3142394,,0,0,0,PDN
HI587A,,2013,1985,,240291,16309818,3142394,,240291,16309818,3142394,,0,0,0,PDN
HI587A,,2014,1985,,240291,16309818,3142394,,240291,16309818,3142394,,0,0,0,PDN
HI587A,,2015,1985,,240291,16309818,3142394,,240291,16309818,3142394,,0,0,0,PDN
HI587A,,2016,1985,,240291,16309818,3142394,,240291,16309818,3142394,,0,0,0,PDN
HI587A,,2017,1985,,240291,16309818,3142394,,240291,16309818,3142394,,0,0,0,PDN
HI587A,,2017,1985,,240291,16309818,3142394,,240291,16309818,3142394,,0,0,0,PDN
HI589A,,2008,2008,,1034912,3282741,1619030,,3643,23740,7867,,1031269,3259001,1611163,PDN
HI589A,,2009,2008,,1034912,3282741,1619030,,399110,1428970,653375,,635802,1853771,965654,PDN
HI589A,,2010,2008,,1034912,3282741,1619030,,552978,1887848,888894,,481934,1394893,730136,PDN
HI589A,,2011,2008,,1034912,3282741,1619030,,651257,2136030,1031334,,383655,1146711,587696,PDN
HI589A,,2012,2008,,1034912,3282741,1619030,,723400,2358100,1142991,,311512,924641,476039,PDN
HI589A,,2013,2008,,1034912,3282741,1619030,,754069,2453352,1190609,,280843,829389,428421,PDN
HI589A,,2014,2008,,1034912,3282741,1619030,,804149,2575145,1262360,,230763,707596,356670,PDN
HI589A,,2015,2008,,1034912,3282741,1619030,,851115,2702652,1332014,,183797,580089,287016,PDN
HI589A,,2016,2008,,871509,2760184,1362645,,871509,2760184,1362645,,0,0,0,PDN
HI589A,,2017,2008,,871509,2760184,1362645,,871509,2760184,1362645,,0,0,0,PDN
HI589A,,2017,2008,,871509,2760184,1362645,,871509,2760184,1362645,,0,0,0,PDN
KC875,,2008,2010,,89401785,139920960,114298753,,0,0,0,,89401785,139920960,114298753,PDP
KC875,,2012,2010,,21375118,30737420,26844410,,0,0,0,,21375118,30737420,26844410,PDP
KC875,,2013,2010,,89519788,129856909,112626000,,0,0,0,,89519788,129856909,112626000,PDP
KC875,,2014,2010,,86722382,94920162,103612090,,0,0,0,,86722382,94920162,103612090,PDP
KC875,,2015,2010,,140995655,151170723,167894360,,22207502,24614828,26587366,,118788153,126555895,141306996,PDP
KC875,,2016,2010,,190435568,188709194,224013716,,49148271,55007213,58936030,,141287297,133701981,165077685,PDP
KC875,,2017,2010,,158301013,172201636,188941873,,69912638,78057198,83801820,,88388375,94144438,105140056,PDP
KC875,,2017,2010,,158301013,172201636,188941873,,69912638,78057198,83801820,,88388375,94144438,105140056,PDP
KC964,,2008,2008,,41357304,295984578,94023599,,0,0,0,,41357304,295984578,94023599,PDP
KC964,,2012,2008,,28385401,291922154,80328845,,0,0,0,,28385401,291922154,80328845,PDP
KC964,,2013,2008,,28385401,291922154,80328845,,0,0,0,,28385401,291922154,80328845,PDP
KC964,,2014,2008,,28385400,291915772,80327708,,0,0,0,,28385400,291915772,80327708,PDP
KC964,,2015,2008,,28385400,291915772,80327708,,565306,79395622,14692641,,27820094,212520150,65635067,PDP
KC964,,2016,2008,,4861350,387803935,73865609,,1222443,184805531,34105989,,3638907,202998404,39759619,PDP
KC964,,2017,2008,,4861350,387803935,73865609,,1633376,253232060,46692461,,3227974,134571875,27173147,PDP
KC964,,2017,2008,,4861350,387803935,73865609,,1633376,253232060,46692461,,3227974,134571875,27173147,PDP
LL001,,2004,2005,,142375,71187674,12809221,,0,0,0,,142375,71187674,12809221,PDN
LL001,,2005,2005,,142375,71187674,12809221,,0,0,0,,142375,71187674,12809221,PDN
LL001,,2006,2005,,142358,71179326,12807718,,0,0,0,,142358,71179326,12807718,PDN
LL001,,2007,2005,,95873,76146505,13645073,,1719,4457367,794845,,94154,71689138,12850228,PDN
LL001,,2008,2005,,93724,76146505,13642924,,4391,13756189,2452111,,89333,62390316,11190813,PDN
LL001,,2009,2005,,91981,69122364,12391334,,8993,27627909,4924991,,82988,41494455,7466343,PDN
LL001,,2010,2005,,58386,72065690,12881463,,12192,41011378,7309590,,46194,31054312,5571873,PDN
LL001,,2011,2005,,30894,92243097,16444257,,14440,54165952,9652510,,16454,38077145,6791747,PDN
LL001,,2012,2005,,30894,92243097,16444257,,16182,66295528,11812539,,14712,25947569,4631718,PDN
LL001,,2013,2005,,31535,96366119,17178532,,17253,77704404,13843660,,14282,18661715,3334872,PDN
LL001,,2014,2005,,33711,110369057,19672334,,18557,87217168,15537626,,15154,23151889,4134708,PDN
LL001,,2015,2005,,33711,110369057,19672334,,18557,91414902,16284554,,15154,18954155,3387780,PDN
LL001,,2016,2005,,18557,91420925,16285626,,18557,91420925,16285626,,0,0,0,PDN
LL001,,2017,2005,,18557,91420925,16285626,,18557,91420925,16285626,,0,0,0,PDN
LL001,,2017,2005,,18557,91420925,16285626,,18557,91420925,16285626,,0,0,0,PDN
LL005,,2004,2004,,68756,34377941,6185827,,0,0,0,,68756,34377941,6185827,PDN
LL005,,2005,2004,,68756,34377941,6185827,,0,0,0,,68756,34377941,6185827,PDN
LL005,,2006,2004,,68756,34377941,6185827,,0,0,0,,68756,34377941,6185827,PDN
LL005,,2007,2004,,12782,34377941,6129853,,2848,7137232,1272818,,9934,27240709,4857035,PDN
LL005,,2008,2004,,12782,34377941,6129853,,3481,10550596,1880811,,9301,23827345,4249042,PDN
LL005,,2009,2004,,5996,18337433,3268884,,5996,18337433,3268884,,0,0,0,PDN
LL005,,2010,2004,,5996,18337433,3268884,,5996,18337433,3268884,,0,0,0,PDN
LL005,,2011,2004,,5996,18337433,3268884,,5996,18337433,3268884,,0,0,0,PDN
LL005,,2012,2004,,5996,18337433,3268884,,5996,18337433,3268884,,0,0,0,PDN
LL005,,2013,2004,,5996,18337433,3268884,,5996,18337433,3268884,,0,0,0,PDN
LL005,,2014,2004,,5996,18337433,3268884,,5996,18337433,3268884,,0,0,0,PDN
LL005,,2015,2004,,5996,18337433,3268884,,5996,18337433,3268884,,0,0,0,PDN
LL005,,2016,2004,,5996,18337433,3268884,,5996,18337433,3268884,,0,0,0,PDN
LL005,,2017,2004,,5996,18337433,3268884,,5996,18337433,3268884,,0,0,0,PDN
LL005,,2017,2004,,5996,18337433,3268884,,5996,18337433,3268884,,0,0,0,PDN
LL050,,2003,2003,,1648,16479212,2933892,,0,0,0,,1648,16479212,2933892,PDN
LL050,,2004,2003,,27712,13856051,2493202,,0,0,0,,27712,13856051,2493202,PDN
LL050,,2005,2003,,27712,13856051,2493202,,0,0,0,,27712,13856051,2493202,PDN
LL050,,2006,2003,,27712,13856051,2493202,,0,0,0,,27712,13856051,2493202,PDN
LL050,,2007,2003,,3600,9948915,1773870,,1824,4937031,880299,,1776,5011884,893571,PDN
LL050,,2008,2003,,3100,16627262,2961688,,3070,9939376,1771642,,30,6687886,1190046,PDN
LL050,,2009,2003,,3070,9941986,1772107,,3070,9941986,1772107,,0,0,0,PDN
LL050,,2010,2003,,3070,9941986,1772107,,3070,9941986,1772107,,0,0,0,PDN
LL050,,2011,2003,,3070,9941986,1772107,,3070,9941986,1772107,,0,0,0,PDN
LL050,,2012,2003,,3070,9941986,1772107,,3070,9941986,1772107,,0,0,0,PDN
LL050,,2013,2003,,3070,9941986,1772107,,3070,9941986,1772107,,0,0,0,PDN
LL050,,2014,2003,,3070,9941986,1772107,,3070,9941986,1772107,,0,0,0,PDN
LL050,,2015,2003,,3070,9941986,1772107,,3070,9941986,1772107,,0,0,0,PDN
LL050,,2016,2003,,3070,9941986,1772107,,3070,9941986,1772107,,0,0,0,PDN
LL050,,2017,2003,,3070,9941986,1772107,,3070,9941986,1772107,,0,0,0,PDN
LL050,,2017,2003,,3070,9941986,1772107,,3070,9941986,1772107,,0,0,0,PDN
LL399,,2004,2004,,183903,91951729,16545421,,0,0,0,,183903,91951729,16545421,PDN
LL399,,2005,2004,,183760,91880190,16532548,,0,0,0,,183760,91880190,16532548,PDN
LL399,,2006,2004,,183760,91880190,16532548,,0,0,0,,183760,91880190,16532548,PDN
LL399,,2007,2004,,183760,91880190,16532548,,1799,3893724,694632,,181961,87986466,15837916,PDN
LL399,,2008,2004,,90843,291359777,51934220,,11543,36187689,6450634,,79300,255172088,45483586,PDN
LL399,,2009,2004,,52705,187915207,33489575,,29424,90460577,16125612,,23281,97454630,17363962,PDN
LL399,,2010,2004,,60815,227093584,40468926,,44549,142083479,25326307,,16266,85010105,15142619,PDN
LL399,,2011,2004,,56778,210797058,37565151,,52705,187911326,33488884,,4073,22885732,4076267,PDN
LL399,,2012,2004,,56778,210797058,37565151,,54593,201384574,35888147,,2185,9412484,1677004,PDN
LL399,,2013,2004,,55530,210797058,37563903,,55530,210797058,37563903,,0,0,0,PDN
LL399,,2014,2004,,55530,210797058,37563903,,55530,210797058,37563903,,0,0,0,PDN
LL399,,2015,2004,,55530,210797058,37563903,,55530,210797058,37563903,,0,0,0,PDN
LL399,,2016,2004,,55530,210797058,37563903,,55530,210797058,37563903,,0,0,0,PDN
LL399,,2017,2004,,55530,210797058,37563903,,55530,210797058,37563903,,0,0,0,PDN
LL399,,2017,2004,,55530,210797058,37563903,,55530,210797058,37563903,,0,0,0,PDN
LP000,,1975,1958,,3000043,140000000,27911075,,1330972,72892031,14301084,,1669071,67107969,13609991,PDN
LP000,,1976,1958,,3000043,140000000,27911075,,1330972,72892031,14301084,,1669071,67107969,13609991,PDN
LP000,,1977,1958,,3000043,140000000,27911075,,2026972,72892031,14997084,,973071,67107969,12913991,PDN
LP000,,1978,1958,,3822733,232573000,45205829,,2282727,114193976,22601940,,1540006,118379024,22603889,PDN
LP000,,1979,1958,,3822733,232573000,45205829,,2325309,123677579,24331996,,1497424,108895421,20873833,PDN
LP000,,1980,1958,,4095275,251301340,48810816,,1192081,120285952,22595275,,2903194,131015388,26215541,PDN
LP000,,1981,1958,,3936109,238961340,46455920,,1240987,133166972,24936178,,2695122,105794368,21519742,PDN
LP000,,1982,1958,,3936109,238961340,46455920,,1256107,135775977,25415534,,2680002,103185363,21040386,PDN
LP000,,1983,1958,,1548875,179832819,33547597,,1287414,139917091,26183694,,261461,39915728,7363903,PDN
LP000,,1984,1958,,1571692,179832819,33570414,,1311669,143161721,26785285,,260023,36671098,6785129,PDN
LP000,,1985,1958,,1500327,171820371,32073347,,1325764,145045973,27134656,,174563,26774398,4938691,PDN
LP000,,1986,1958,,1500327,171820371,32073347,,1331067,145665020,27250110,,169260,26155351,4823237,PDN
LP000,,1987,1958,,1359979,148847311,27845266,,1331067,145665020,27250110,,28912,3182291,595156,PDN
LP000,,1988,1958,,1359979,148847311,27845266,,1331081,145666529,27250392,,28898,3180782,594874,PDN
LP000,,1989,1958,,1359979,148847311,27845266,,1331081,145666529,27250392,,28898,3180782,594874,PDN
LP000,,1990,1958,,1382012,151718015,28378100,,1336730,146348747,27377432,,45282,5369268,1000668,PDN
LP000,,1991,1958,,1382012,151718015,28378100,,1342583,146970022,27493832,,39429,4747993,884268,PDN
LP000,,1992,1958,,1382012,151718015,28378100,,1344988,147063932,27512947,,37024,4654083,865153,PDN
LP000,,1993,1958,,1388030,151718015,28384118,,1346858,147279961,27553257,,41172,4438054,830861,PDN
LP000,,1994,1958,,1388030,151718015,28384118,,1346858,147279961,27553257,,41172,4438054,830861,PDN
LP000,,1995,1958,,1388030,151718015,28384118,,1346858,147279961,27553257,,41172,4438054,830861,PDN
LP000,,1996,1958,,1387557,151642708,28370245,,1346858,147279961,27553257,,40699,4362747,816988,PDN
LP000,,1997,1958,,1387557,151642708,28370245,,1346858,147279961,27553257,,40699,4362747,816988,PDN
LP000,,1998,1958,,1387557,151642708,28370245,,1346858,147279961,27553257,,40699,4362747,816988,PDN
LP000,,1999,1958,,1374946,150313491,28121119,,1346858,147279961,27553257,,28088,3033530,567862,PDN
LP000,,2000,1958,,1374946,150313491,28121119,,1346858,147279961,27553257,,28088,3033530,567862,PDN
LP000,,2001,1958,,1374946,150313491,28121119,,1346858,147279961,27553257,,28088,3033530,567862,PDN
LP000,,2002,1958,,1374946,150313491,28121119,,1346858,147279961,27553257,,28088,3033530,567862,PDN
LP000,,2003,1958,,1374946,150313491,28121119,,1346858,147279961,27553257,,28088,3033530,567862,PDN
LP000,,2004,1958,,1374946,150313491,28121119,,1346858,147279961,27553257,,28088,3033530,567862,PDN
LP000,,2005,1958,,1374946,150313491,28121119,,1346858,147279961,27553257,,28088,3033530,567862,PDN
LP000,,2006,1958,,1374946,150313491,28121119,,1346858,147279961,27553257,,28088,3033530,567862,PDN
LP000,,2007,1958,,1374946,150313491,28121119,,1346858,147279961,27553257,,28088,3033530,567862,PDN
LP000,,2008,1958,,2777823,217679601,41510848,,1608636,160185221,30111344,,1169187,57494380,11399504,PDN
LP000,,2009,1958,,2758394,218001291,41548658,,2207413,192266157,36418473,,550981,25735134,5130186,PDN
LP000,,2010,1958,,2758394,217915809,41533448,,2317783,197276272,37420322,,440611,20639537,4113126,PDN
LP000,,2011,1958,,2758394,217915809,41533448,,2586242,210191756,39986910,,172152,7724053,1546539,PDN
LP000,,2012,1958,,1346858,150229554,28078095,,1346858,150229554,28078095,,0,0,0,PDN
LP000,,2013,1958,,1346858,150229554,28078095,,1346858,150229554,28078095,,0,0,0,PDN
LP000,,2014,1958,,1346858,150229554,28078095,,1346858,150229554,28078095,,0,0,0,PDN
LP000,,2015,1958,,1346858,150229554,28078095,,1346858,150229554,28078095,,0,0,0,PDN
LP000,,2016,1958,,1346858,150229554,28078095,,1346858,150229554,28078095,,0,0,0,PDN
LP000,,2017,1958,,1346858,150229554,28078095,,1346858,150229554,28078095,,0,0,0,PDN
LP000,,2017,1958,,1346858,150229554,28078095,,1346858,150229554,28078095,,0,0,0,PDN
MC020,,1984,1982,,60513171,68215999,72651249,,15417,7709,16789,,60497754,68208290,72634460,PDP
MC020,,1985,1982,,63720610,69432700,76075183,,1484652,940294,1651964,,62235958,68492406,74423219,PDP
MC020,,1986,1982,,22883297,46857478,31220927,,3645256,3938279,4346017,,19238041,42919199,26874910,PDP
MC020,,1987,1982,,22883297,46857478,31220927,,5377126,6800590,6587195,,17506171,40056888,24633732,PDP
MC020,,1988,1982,,23018147,47707031,31506943,,6558636,9102343,8178270,,16459511,38604688,23328673,PDP
MC020,,1989,1982,,14874779,34112875,20944686,,7448193,10684451,9349341,,7426586,23428424,11595345,PDP
MC020,,1990,1982,,14874779,34179275,20956501,,8351230,12415552,10560403,,6523549,21763723,10396098,PDP
MC020,,1991,1982,,14900303,34358713,21013953,,9076550,13629538,11501735,,5823753,20729175,9512218,PDP
MC020,,1992,1982,,15844941,35001499,22072966,,9549610,14317019,12097122,,6295331,20684480,9975844,PDP
MC020,,1993,1982,,15844941,35001499,22072966,,9915783,14732076,12537149,,5929158,20269423,9535817,PDP
MC020,,1994,1982,,16364916,36644692,22885324,,10275877,15244271,12988381,,6089039,21400421,9896943,PDP
MC020,,1995,1982,,17005872,35662691,23351547,,10639810,15687239,13431134,,6366062,19975452,9920413,PDP
MC020,,1996,1982,,17402601,35217496,23669059,,10989855,16711533,13963437,,6412746,18505963,9705622,PDP
MC020,,1997,1982,,16443438,34600348,22600084,,11347112,17184856,14404916,,5096326,17415492,8195168,PDP
MC020,,1998,1982,,16374547,35318419,22658963,,11524467,17371064,14615404,,4850080,17947355,8043559,PDP
MC020,,1999,1982,,16630604,36439520,23114504,,11703769,17630759,14840915,,4926835,18808761,8273589,PDP
MC020,,2000,1982,,17373247,32819535,23213022,,11953343,17873557,15133691,,5419904,14945978,8079331,PDP
MC020,,2001,1982,,13924619,25030964,18378527,,12422276,19283191,15853449,,1502343,5747773,2525078,PDP
MC020,,2002,1982,,15091558,29241066,20294595,,12915615,20371365,16540413,,2175943,8869701,3754182,PDP
MC020,,2003,1982,,15089272,29290577,20301118,,13443190,23261994,17582335,,1646082,6028583,2718783,PDP
MC020,,2004,1982,,15040785,29169242,20231041,,13753428,24974833,18197348,,1287357,4194409,2033693,PDP
MC020,,2005,1982,,37601642,72524387,50506337,,13753428,24974933,18197366,,23848214,47549454,32308971,PDP
MC020,,2006,1982,,24401140,54782006,34148828,,14673488,30355138,20074758,,9727652,24426868,14074070,PDP
MC020,,2007,1982,,24054382,63511517,35355363,,15987147,33868946,22013650,,8067235,29642571,13341713,PDP
MC020,,2008,1982,,10152271,32137202,15870635,,4178709,12318996,6370701,,5973562,19818206,9499934,PDP
MC020,,2009,1982,,21486017,52542053,30835139,,18398460,38878403,25316326,,3087557,13663650,5518811,PDP
MC020,,2010,1982,,23578245,56178852,33574483,,19456520,40996443,26751262,,4121725,15182409,6823220,PDP
MC020,,2011,1982,,23578245,54893221,33345724,,20260823,42399874,27805285,,3317422,12493347,5540438,PDP
MC020,,2012,1982,,23641059,55057609,33437789,,20847629,43115912,28519502,,2793430,11941697,4918288,PDP
MC020,,2013,1982,,23641059,55057609,33437789,,21351990,43684848,29125097,,2289069,11372761,4312694,PDP
MC020,,2014,1982,,23721531,54895978,33489500,,21730602,44043644,29567552,,1990929,10852334,3921950,PDP
MC020,,2015,1982,,23719543,55744597,33638510,,22214138,45000637,30221370,,1505405,10743960,3417140,PDP
MC020,,2016,1982,,23875510,56348013,33901847,,22873977,46384041,31127366,,1001533,9963972,2774480,PDP
MC020,,2017,1982,,24533033,48968661,33246319,,23445549,47326434,31866624,,1087484,1642227,1379696,PDP
MC020,,2017,1982,,24533033,48968661,33246319,,23445549,47326434,31866624,,1087484,1642227,1379696,PDP
MC026,,1994,1994,,921,9207458,1639259,,0,0,0,,921,9207458,1639259,PDN
MC026,,1995,1994,,921,9207458,1639259,,0,0,0,,921,9207458,1639259,PDN
MC026,,2015,1994,,583543,16800796,3573008,,19,4841,880,,583524,16795955,3572128,PDN
MC026,,2016,1994,,583543,16800796,3573008,,102576,2891437,617067,,480967,13909359,2955942,PDN
MC026,,2017,1994,,102576,2891437,617067,,102576,2891437,617067,,0,0,0,PDN
MC026,,2017,1994,,102576,2891437,617067,,102576,2891437,617067,,0,0,0,PDN
MC029,,2001,1998,,9845781,20693653,13527926,,0,0,0,,9845781,20693653,13527926,PDP
MC029,,2002,1998,,10987647,23495689,15168375,,766623,1338763,1004837,,10221024,22156926,14163538,PDP
MC029,,2003,1998,,10152610,21992622,14065888,,1375205,2398591,1802001,,8777405,19594031,12263887,PDP
MC029,,2004,1998,,10152610,22297771,14120185,,1920259,3506823,2544249,,8232351,18790948,11575936,PDP
MC029,,2005,1998,,8918909,20394335,12547794,,2244597,4189147,2989997,,6674312,16205188,9557797,PDP
MC029,,2006,1998,,8918909,20256963,12523351,,2529688,4631352,3353772,,6389221,15625611,9169579,PDP
MC029,,2007,1998,,8918909,20123453,12499594,,2577439,4694052,3412680,,6341470,15429401,9086914,PDP
MC029,,2008,1998,,8918909,20127315,12500282,,2748076,4919540,3623439,,6170833,15207775,8876843,PDP
MC029,,2009,1998,,7812991,19242898,11236993,,2842675,5158248,3760512,,4970316,14084650,7476480,PDP
MC029,,2010,1998,,7920134,19849184,11452016,,2993704,5530591,3977795,,4926430,14318593,7474222,PDP
MC029,,2011,1998,,8073636,20146275,11658382,,3103443,5789279,4133564,,4970193,14356996,7524818,PDP
MC029,,2012,1998,,8073636,20146275,11658382,,3182915,5965855,4244455,,4890721,14180420,7413927,PDP
MC029,,2013,1998,,8073636,20178915,11664190,,3234697,6071392,4315016,,4838939,14107523,7349173,PDP
MC029,,2014,1998,,8370746,20812322,12074006,,3572015,6645685,4754521,,4798731,14166637,7319484,PDP
MC029,,2015,1998,,12242970,23322813,16392937,,6550418,10153355,8357065,,5692552,13169458,8035872,PDP
MC029,,2016,1998,,15615054,28103688,20615710,,10909354,16317952,13812905,,4705700,11785736,6802806,PDP
MC029,,2017,1998,,16677080,29759336,21972335,,14117336,20629574,17788079,,2559744,9129762,4184256,PDP
MC029,,2017,1998,,16677080,29759336,21972335,,14117336,20629574,17788079,,2559744,9129762,4184256,PDP
MC066,,2002,2002,,960,9601906,1709484,,0,0,0,,960,9601906,1709484,PDN
MC066,,2003,2002,,423,9485158,1688174,,0,0,0,,423,9485158,1688174,PDN
MC066,,2004,2002,,423,9485158,1688174,,6,2323975,413525,,417,7161183,1274649,PDN
MC066,,2005,2002,,423,9485158,1688174,,6,2323975,413525,,417,7161183,1274649,PDN
MC066,,2006,2002,,1669,13799840,2457157,,343,3255853,579676,,1326,10543987,1877481,PDN
MC066,,2007,2002,,1396,10992396,1957339,,831,6065063,1080024,,565,4927333,877315,PDN
MC066,,2008,2002,,1537,11010090,1960628,,1133,7008023,1248112,,404,4002067,712516,PDN
MC066,,2009,2002,,2134,11142639,1984810,,1724,7111435,1267104,,410,4031204,717706,PDN
MC066,,2010,2002,,2117,11045524,1967513,,1724,7111435,1267104,,393,3934089,700409,PDN
MC066,,2011,2002,,2117,11045524,1967513,,1724,7111435,1267104,,393,3934089,700409,PDN
MC066,,2012,2002,,2117,11045524,1967513,,1724,7111435,1267104,,393,3934089,700409,PDN
MC066,,2013,2002,,2117,11045524,1967513,,1724,7111435,1267104,,393,3934089,700409,PDN
MC066,,2014,2002,,1724,7111435,1267104,,1724,7111435,1267104,,0,0,0,PDN
MC066,,2015,2002,,1724,7111435,1267104,,1724,7111435,1267104,,0,0,0,PDN
MC066,,2016,2002,,1724,7111435,1267104,,1724,7111435,1267104,,0,0,0,PDN
MC066,,2017,2002,,1724,7111435,1267104,,1724,7111435,1267104,,0,0,0,PDN
MC066,,2017,2002,,1724,7111435,1267104,,1724,7111435,1267104,,0,0,0,PDN
MC068,,2000,1975,,0,12259890,2181475,,0,0,0,,0,12259890,2181475,PDN
MC068,,2001,1975,,0,20646389,3673734,,0,4653372,828002,,0,15993017,2845732,PDN
MC068,,2002,1975,,0,24456365,4351666,,0,8160759,1452092,,0,16295606,2899574,PDN
MC068,,2003,1975,,0,19946607,3549218,,0,13072310,2326034,,0,6874297,1223184,PDN
MC068,,2004,1975,,0,19795401,3522313,,0,14848860,2642146,,0,4946541,880167,PDN
MC068,,2005,1975,,0,19795401,3522313,,0,14848860,2642146,,0,4946541,880167,PDN
MC068,,2006,1975,,0,15566496,2769839,,0,14848860,2642146,,0,717636,127693,PDN
MC068,,2007,1975,,0,15566496,2769839,,0,14848860,2642146,,0,717636,127693,PDN
MC068,,2008,1975,,0,15566496,2769839,,0,14848860,2642146,,0,717636,127693,PDN
MC068,,2009,1975,,72,15567128,2770024,,0,14848860,2642146,,72,718268,127878,PDN
MC068,,2010,1975,,0,14848860,2642146,,0,14848860,2642146,,0,0,0,PDN
MC068,,2011,1975,,0,14848860,2642146,,0,14848860,2642146,,0,0,0,PDN
MC068,,2012,1975,,0,14848860,2642146,,0,14848860,2642146,,0,0,0,PDN
MC068,,2013,1975,,0,14848860,2642146,,0,14848860,2642146,,0,0,0,PDN
MC068,,2014,1975,,0,14848860,2642146,,0,14848860,2642146,,0,0,0,PDN
MC068,,2015,1975,,0,14848860,2642146,,0,14848860,2642146,,0,0,0,PDN
MC068,,2016,1975,,0,14848860,2642146,,0,14848860,2642146,,0,0,0,PDN
MC068,,2017,1975,,0,14848860,2642146,,0,14848860,2642146,,0,0,0,PDN
MC068,,2017,1975,,0,14848860,2642146,,0,14848860,2642146,,0,0,0,PDN
MC079,,2015,2014,,5207000,76952837,18899676,,0,0,0,,5207000,76952837,18899676,PDP
MC079,,2016,2014,,8195184,77682149,22017630,,969131,9176520,2601964,,7226053,68505629,19415667,PDP
MC079,,2017,2014,,8195184,77682149,22017630,,2054754,21638542,5905028,,6140430,56043607,16112602,PDP
MC079,,2017,2014,,8195184,77682149,22017630,,2054754,21638542,5905028,,6140430,56043607,16112602,PDP
MC084,,1994,1993,,19939703,44164417,27798140,,0,0,0,,19939703,44164417,27798140,PDP
MC084,,1995,1993,,19939703,44164417,27798140,,0,0,0,,19939703,44164417,27798140,PDP
MC084,,1996,1993,,19334803,43420732,27060912,,0,0,0,,19334803,43420732,27060912,PDP
MC084,,1997,1993,,19344234,48932117,28051016,,0,0,0,,19344234,48932117,28051016,PDP
MC084,,1998,1993,,17766844,50600734,26770533,,0,0,0,,17766844,50600734,26770533,PDP
MC084,,1999,1993,,125427060,156736598,153316134,,0,0,0,,125427060,156736598,153316134,PDP
MC084,,2000,1993,,105947157,163215495,134989060,,0,0,0,,105947157,163215495,134989060,PDP
MC084,,2001,1993,,111285094,178319577,143014556,,0,0,0,,111285094,178319577,143014556,PDP
MC084,,2002,1993,,168213684,200259140,203846983,,5368099,6111968,6455638,,162845585,194147172,197391345,PDP
MC084,,2003,1993,,156868076,180255148,188941946,,38026014,37534052,44704671,,118842062,142721096,144237275,PDP
MC084,,2004,1993,,171921869,209547928,209207977,,69126932,68110629,81246261,,102794937,141437299,127961716,PDP
MC084,,2005,1993,,156082339,208938555,193260018,,91968601,94118763,108715712,,64113738,114819792,84544306,PDP
MC084,,2006,1993,,185446899,250647628,230046121,,114419469,121456613,136030966,,71027430,129191015,94015155,PDP
MC084,,2007,1993,,198352546,263414476,245223449,,131242994,142317151,156566330,,67109552,121097325,88657119,PDP
MC084,,2008,1993,,198352546,257618089,244192064,,148180048,162162875,177034652,,50172498,95455214,67157412,PDP
MC084,,2009,1993,,215972726,275877355,265061224,,162852631,179437201,194780958,,53120095,96440154,70280265,PDP
MC084,,2010,1993,,234016842,296319255,286742688,,175200587,193330087,209600958,,58816255,102989168,77141729,PDP
MC084,,2011,1993,,234016842,296319255,286742688,,184147737,204078951,220460717,,49869105,92240304,66281970,PDP
MC084,,2012,1993,,234016842,296319255,286742688,,193007109,212607137,230837560,,41009733,83712118,55905129,PDP
MC084,,2013,1993,,234016842,296319255,286742688,,202670611,222157692,242200449,,31346231,74161563,44542239,PDP
MC084,,2014,1993,,254028894,310936982,309355760,,211935388,231851302,253190068,,42093506,79085680,56165691,PDP
MC084,,2015,1993,,254028894,309231190,309052239,,219337304,240271281,262090201,,34691590,68959909,46962036,PDP
MC084,,2016,1993,,265227280,321869074,322499357,,227911398,251925721,272738039,,37315882,69943353,49761319,PDP
MC084,,2017,1993,,290261101,308928424,345230571,,236675888,261613903,283226404,,53585213,47314521,62004166,PDP
MC084,,2017,1993,,290261101,308928424,345230571,,236675888,261613903,283226404,,53585213,47314521,62004166,PDP
MC109,,1986,1983,,1613157,2097106,1986308,,0,0,0,,1613157,2097106,1986308,PDP
MC109,,1987,1983,,1613157,2097106,1986308,,0,0,0,,1613157,2097106,1986308,PDP
MC109,,1991,1983,,26982188,8375770,28472539,,65790,17898,68975,,26916398,8357872,28403564,PDP
MC109,,1992,1983,,28275389,9725120,30005837,,3986430,2246062,4386085,,24288959,7479058,25619752,PDP
MC109,,1993,1983,,31722312,19033149,35108993,,10975705,6293807,12095599,,20746607,12739342,23013394,PDP
MC109,,1994,1983,,47235865,28494716,52306099,,18012891,10788340,19932524,,29222974,17706376,32373575,PDP
MC109,,1995,1983,,49665746,31550710,55279751,,24098813,15171166,26798309,,25566933,16379544,28481442,PDP
MC109,,1996,1983,,46338051,31681141,51975265,,29016299,18677841,32339758,,17321752,13003300,19635507,PDP
MC109,,1997,1983,,43646636,29794932,48948225,,33021151,21536155,36853207,,10625485,8258777,12095018,PDP
MC109,,1998,1983,,52508135,37696273,59215657,,36410269,24784586,40820338,,16097866,12911687,18395319,PDP
MC109,,1999,1983,,52142132,37586624,58830144,,40020521,27703908,44950042,,12121611,9882716,13880102,PDP
MC109,,2000,1983,,70115940,54095546,79741482,,44447034,31387238,50031952,,25668906,22708308,29709530,PDP
MC109,,2001,1983,,75319206,72708747,88256706,,49367816,36621136,55884032,,25951390,36087611,32372674,PDP
MC109,,2002,1983,,69047678,64115111,80456061,,54079547,46052986,62274028,,14968131,18062125,18182033,PDP
MC109,,2003,1983,,71092106,67590624,83118908,,58202804,52320424,67512488,,12889302,15270200,15606420,PDP
MC109,,2004,1983,,74352549,71075382,86999414,,60794147,55632149,70693106,,13558402,15443233,16306308,PDP
MC109,,2005,1983,,75520616,72741315,88463911,,63052783,58080984,73387478,,12467833,14660331,15076433,PDP
MC109,,2006,1983,,76823162,73097836,89829894,,64213712,59015870,74714756,,12609450,14081966,15115138,PDP
MC109,,2007,1983,,74330644,74026228,87502571,,67194086,62355739,78289413,,7136558,11670489,9213158,PDP
MC109,,2008,1983,,77691721,76782162,91354028,,69031167,64740684,80550862,,8660554,12041478,10803166,PDP
MC109,,2009,1983,,76113866,76261990,89683616,,70485169,66699260,82353363,,5628697,9562730,7330252,PDP
MC109,,2010,1983,,83054295,83691814,97946077,,72793447,69055603,85080923,,10260848,14636211,12865155,PDP
MC109,,2011,1983,,87216311,86385142,102587335,,75381184,71852899,88166396,,11835127,14532243,14420937,PDP
MC109,,2012,1983,,87297111,86806654,102743136,,77495826,74380402,90730774,,9801285,12426252,12012363,PDP
MC109,,2013,1983,,87068579,88500070,102815922,,79313963,76898647,92996998,,7754616,11601423,9818929,PDP
MC109,,2014,1983,,85433322,86244335,100779288,,80797124,79034959,94860283,,4636198,7209376,5919006,PDP
MC109,,2015,1983,,85563940,86909017,101028181,,82138717,80771213,96510820,,3425223,6137804,4517359,PDP
MC109,,2016,1983,,88863843,89564353,104800560,,83626480,82438904,98295325,,5237363,7125449,6505236,PDP
MC109,,2017,1983,,89637068,90442975,105730123,,85007999,83936446,99943312,,4629069,6506529,5786815,PDP
MC109,,2017,1983,,89637068,90458665,105732915,,85007999,83936446,99943312,,4629069,6522219,5789607,PDP
MC148,,1976,1975,,0,200000000,35587189,,0,0,0,,0,200000000,35587189,PDN
MC148,,1977,1975,,130734,130731480,23392563,,0,0,0,,130734,130731480,23392563,PDN
MC148,,1978,1975,,130734,130731480,23392563,,0,0,0,,130734,130731480,23392563,PDN
MC148,,1979,1975,,130734,130731480,23392563,,0,0,0,,130734,130731480,23392563,PDN
MC148,,1980,1975,,130734,130731480,23392563,,0,0,0,,130734,130731480,23392563,PDN
MC148,,1981,1975,,130734,130731480,23392563,,1434,325575,59365,,129300,130405905,23333198,PDN
MC148,,1982,1975,,130734,130731480,23392563,,45393,12715973,2308022,,85341,118015507,21084541,PDN
MC148,,1983,1975,,840610,201009086,36607351,,198001,35997504,6603251,,642609,165011582,30004100,PDN
MC148,,1984,1975,,1002627,203150180,37150346,,393799,70560029,12948964,,608828,132590151,24201382,PDN
MC148,,1985,1975,,913204,161831032,29708761,,522837,89538923,16455030,,390367,72292109,13253731,PDN
MC148,,1986,1975,,913204,161831032,29708761,,614797,101680569,18707425,,298407,60150463,11001336,PDN
MC148,,1987,1975,,1043312,189785967,34813057,,746390,128961812,23693332,,296922,60824155,11119725,PDN
MC148,,1988,1975,,1306159,232203151,42623446,,908940,164342952,30151458,,397219,67860199,12471988,PDN
MC148,,1989,1975,,1353394,272891198,49910547,,995013,186667626,34209893,,358381,86223572,15700654,PDN
MC148,,1990,1975,,1355217,273154967,49959304,,1086465,215852910,39494456,,268752,57302057,10464848,PDN
MC148,,1991,1975,,1429910,305960634,55871304,,1150205,237959330,43491723,,279705,68001304,12379581,PDN
MC148,,1992,1975,,1429910,305960634,55871304,,1184192,249002998,45490775,,245718,56957636,10380529,PDN
MC148,,1993,1975,,1516619,333006344,60770417,,1207805,256329259,46817993,,308814,76677085,13952424,PDN
MC148,,1994,1975,,1517056,333500636,60858806,,1225396,261437638,47744549,,291660,72062998,13114257,PDN
MC148,,1995,1975,,1332648,300716182,54840865,,1225514,263715628,48150003,,107134,37000554,6690862,PDN
MC148,,1996,1975,,1345813,305145505,55642166,,1229164,265055358,48392039,,116649,40090147,7250127,PDN
MC148,,1997,1975,,1365380,332323999,60497764,,1231555,267020941,48744178,,133825,65303058,11753586,PDN
MC148,,1998,1975,,1405470,376573963,68411513,,1236965,282298507,51468016,,168505,94275456,16943497,PDN
MC148,,1999,1975,,1350959,347803450,63237694,,1256984,304500551,55438577,,93975,43302899,7799117,PDN
MC148,,2000,1975,,1334199,335908325,61104364,,1259213,309668623,56360391,,74986,26239702,4743973,PDN
MC148,,2001,1975,,1312960,323081212,58800720,,1260199,311541496,56694629,,52761,11539716,2106091,PDN
MC148,,2002,1975,,1301325,323682881,58896144,,1265433,315204195,57351589,,35892,8478686,1544555,PDN
MC148,,2003,1975,,1300553,323792903,58914949,,1265850,315860467,57468780,,34703,7932436,1446169,PDN
MC148,,2004,1975,,1297746,323114352,58791403,,1265850,316153572,57520934,,31896,6960780,1270469,PDN
MC148,,2005,1975,,1299257,323335370,58832241,,1267361,316509616,57585798,,31896,6825754,1246443,PDN
MC148,,2006,1975,,1300586,336626236,61198493,,1267361,316509616,57585798,,33225,20116620,3612695,PDN
MC148,,2007,1975,,1300586,336626236,61198493,,1267361,318652085,57967020,,33225,17974151,3231473,PDN
MC148,,2008,1975,,1300586,336626236,61198493,,1267361,321382098,58452788,,33225,15244138,2745705,PDN
MC148,,2009,1975,,1301248,342531540,62249923,,1267360,327112391,59472414,,33888,15419149,2777509,PDN
MC148,,2010,1975,,1301248,342531540,62249923,,1267360,328613241,59739469,,33888,13918299,2510454,PDN
MC148,,2011,1975,,1267360,328613309,59739481,,1267360,328613309,59739481,,0,0,0,PDN
MC148,,2012,1975,,1267360,328613309,59739481,,1267360,328613309,59739481,,0,0,0,PDN
MC148,,2013,1975,,1267360,328613309,59739481,,1267360,328613309,59739481,,0,0,0,PDN
MC148,,2014,1975,,1267360,328613309,59739481,,1267360,328613309,59739481,,0,0,0,PDN
MC148,,2015,1975,,1267360,328613309,59739481,,1267360,328613309,59739481,,0,0,0,PDN
MC148,,2016,1975,,1267360,328613309,59739481,,1267360,328613309,59739481,,0,0,0,PDN
MC148,,2017,1975,,1267360,328613309,59739481,,1267360,328613309,59739481,,0,0,0,PDN
MC148,,2017,1975,,1267360,328613309,59739481,,1267360,328613309,59739481,,0,0,0,PDN
MC161,,2004,2005,,1069,10685473,1902399,,0,0,0,,1069,10685473,1902399,PDP
MC161,,2005,2005,,1069,10685473,1902399,,0,0,0,,1069,10685473,1902399,PDP
MC161,,2006,2005,,1069,10685473,1902399,,0,0,0,,1069,10685473,1902399,PDP
MC161,,2007,2005,,1069,10685473,1902399,,0,1466,261,,1069,10684007,1902138,PDP
MC161,,2008,2005,,1069,10685473,1902399,,0,2945262,524068,,1069,7740211,1378331,PDP
MC161,,2009,2005,,1091,10900617,1940703,,0,9393124,1671374,,1091,1507493,269328,PDP
MC161,,2010,2005,,0,17699628,3149400,,0,12031633,2140860,,0,5667995,1008540,PDP
MC161,,2011,2005,,0,17699628,3149400,,0,13051484,2322328,,0,4648144,827072,PDP
MC161,,2012,2005,,0,16369115,2912654,,0,14765060,2627235,,0,1604055,285419,PDP
MC161,,2013,2005,,0,16369115,2912654,,0,16369115,2912654,,0,0,0,PDP
MC161,,2014,2005,,0,17758945,3159955,,0,17444900,3104075,,0,314045,55880,PDP
MC161,,2015,2005,,0,18292140,3254829,,0,18292140,3254829,,0,0,0,PDP
MC161,,2016,2005,,0,20469344,3642232,,0,18924842,3367410,,0,1544502,274822,PDP
MC161,,2017,2005,,0,20469344,3642232,,0,20439159,3636861,,0,30185,5371,PDP
MC161,,2017,2005,,0,20469344,3642232,,0,20439159,3636861,,0,30185,5371,PDP
MC194,,1976,1975,,65800000,258001800,111707794,,0,0,0,,65800000,258001800,111707794,PDP
MC194,,1977,1975,,116501064,595088057,222388619,,0,0,0,,116501064,595088057,222388619,PDP
MC194,,1978,1975,,116501064,595088057,222388619,,0,0,0,,116501064,595088057,222388619,PDP
MC194,,1979,1975,,116501064,595088057,222388619,,568486,387417,637421,,115932578,594700640,221751198,PDP
MC194,,1980,1975,,116501064,595088057,222388619,,5590736,3988288,6300396,,110910328,591099769,216088223,PDP
MC194,,1981,1975,,116501064,595088057,222388619,,9261017,6629556,10440653,,107240047,588458501,211947966,PDP
MC194,,1982,1975,,116501064,595088057,222388619,,22487332,22208863,26439087,,94013732,572879194,195949532,PDP
MC194,,1983,1975,,171665875,475543281,256282117,,48732229,63594247,60047931,,122933646,411949034,196234186,PDP
MC194,,1984,1975,,180795720,482995047,266737899,,72753018,101753445,90858613,,108042702,381241602,175879286,PDP
MC194,,1985,1975,,196586639,394476849,266778249,,90989796,132379566,114544879,,105596843,262097283,152233370,PDP
MC194,,1986,1975,,152878390,540559011,249063267,,103704306,161898944,132511947,,49174084,378660067,116551320,PDP
MC194,,1987,1975,,172198675,546854444,269503736,,112161946,193710874,146630073,,60036729,353143570,122873663,PDP
MC194,,1988,1975,,172349806,568390015,273486819,,117079467,214832735,155305932,,55270339,353557280,118180887,PDP
MC194,,1989,1975,,171681722,567922143,272735484,,119456675,223658994,159253649,,52225047,344263149,113481835,PDP
MC194,,1990,1975,,153421554,449543629,233411524,,117300985,220342301,156507800,,36120569,229201328,76903724,PDP
MC194,,1991,1975,,160348967,470550713,244076852,,123573196,232604459,164961890,,36775771,237946254,79114962,PDP
MC194,,1992,1975,,171299359,447051669,250845919,,132547567,260282506,178861180,,38751792,186769163,71984739,PDP
MC194,,1993,1975,,171299359,447051669,250845919,,138636188,285738308,189479303,,32663171,161313361,61366616,PDP
MC194,,1994,1975,,174370350,457617689,255796985,,146774254,314070708,202658722,,27596096,143546981,53138263,PDP
MC194,,1995,1975,,178495773,537480127,274132806,,151384259,353898947,214355602,,27111514,183581180,59777204,PDP
MC194,,1996,1975,,174674460,608556903,282958606,,155549172,396387018,226080670,,19125288,212169885,56877936,PDP
MC194,,1997,1975,,189597863,686101584,311679995,,158494674,424853708,234091419,,31103189,261247876,77588576,PDP
MC194,,1998,1975,,255414235,721839319,383855395,,161269431,460952455,243289441,,94144804,260886864,140565954,PDP
MC194,,1999,1975,,183488973,673114277,303260197,,164596450,519144846,256970978,,18892523,153969431,46289219,PDP
MC194,,2000,1975,,179269204,708520493,305340467,,167253924,579981659,270453507,,12015280,128538834,34886960,PDP
MC194,,2001,1975,,176072366,774675034,313914899,,169722011,646533992,284763647,,6350355,128141042,29151252,PDP
MC194,,2002,1975,,175265368,784755741,314901621,,171243133,689886422,293998724,,4022235,94869319,20902897,PDP
MC194,,2003,1975,,178076387,768439841,314809455,,173320728,717509270,300991417,,4755659,50930571,13818038,PDP
MC194,,2004,1975,,179899283,750093934,313367954,,175437839,732874723,305842594,,4461444,17219211,7525360,PDP
MC194,,2005,1975,,178057290,740561745,309829842,,176108673,734109772,306733188,,1948617,6451973,3096654,PDP
MC194,,2006,1975,,178773870,746575409,311616469,,176476110,737978787,307789061,,2297760,8596622,3827408,PDP
MC194,,2007,1975,,179947448,751234497,313619067,,177346632,741576637,309299770,,2600816,9657860,4319297,PDP
MC194,,2008,1975,,179947448,751234497,313619067,,177851367,743725473,310186860,,2096081,7509024,3432207,PDP
MC194,,2009,1975,,182066461,758423496,317017263,,178342263,753567332,312428980,,3724198,4856164,4588284,PDP
MC194,,2010,1975,,182066461,758423496,317017263,,179118808,754971069,313455298,,2947653,3452427,3561963,PDP
MC194,,2011,1975,,182065495,758420041,317015682,,179607884,755844284,314099752,,2457611,2575757,2915931,PDP
MC194,,2012,1975,,182065495,758420041,317015682,,179607884,755844284,314099752,,2457611,2575757,2915931,PDP
MC194,,2013,1975,,182065495,758420041,317015682,,179607884,755844284,314099752,,2457611,2575757,2915931,PDP
MC194,,2014,1975,,182061282,761043774,317478325,,179987006,756353564,314569493,,2074276,4690210,2908834,PDP
MC194,,2015,1975,,183593842,762268937,319228886,,180497728,756881272,315174115,,3096114,5387665,4054773,PDP
MC194,,2016,1975,,184744076,772194705,322145271,,181178882,759636348,316345495,,3565194,12558357,5799775,PDP
MC194,,2017,1975,,185060390,770938471,322238059,,182000328,761835293,317558212,,3060062,9103178,4679845,PDP
MC194,,2017,1975,,185060390,770938471,322238059,,182000328,761835293,317558212,,3060062,9103178,4679845,PDP
MC211,,1994,1990,,11615660,81955089,26198416,,0,0,0,,11615660,81955089,26198416,PDN
MC211,,1995,1990,,11615660,81955089,26198416,,0,0,0,,11615660,81955089,26198416,PDN
MC211,,1996,1990,,11140726,73401565,24201503,,0,0,0,,11140726,73401565,24201503,PDN
MC211,,1997,1990,,11588111,81458958,26082588,,0,0,0,,11588111,81458958,26082588,PDN
MC211,,1998,1990,,11588111,81458958,26082588,,0,0,0,,11588111,81458958,26082588,PDN
MC211,,1999,1990,,11588111,81458958,26082588,,0,0,0,,11588111,81458958,26082588,PDN
MC211,,2000,1990,,12609229,110487204,32268874,,0,52287,9304,,12609229,110434917,32259570,PDN
MC211,,2001,1990,,6244348,165046908,35612125,,1539814,22742549,5586531,,4704534,142304359,30025594,PDN
MC211,,2002,1990,,5473451,182541660,37954173,,2829228,69267999,15154495,,2644223,113273661,22799678,PDN
MC211,,2003,1990,,5177021,157397803,33183748,,3523952,119230201,24739290,,1653069,38167602,8444458,PDN
MC211,,2004,1990,,6024885,192790528,40329250,,4127771,129776978,27219760,,1897114,63013550,13109490,PDN
MC211,,2005,1990,,5505672,177659707,37117720,,4471399,145570748,30373667,,1034273,32088959,6744053,PDN
MC211,,2006,1990,,5487761,177120853,37003928,,4858052,154077651,32274004,,629709,23043202,4729924,PDN
MC211,,2007,1990,,5960838,192718935,40252464,,5460292,175420581,36673919,,500546,17298354,3578545,PDN
MC211,,2008,1990,,5973914,192727565,40267075,,5679609,185616179,38707399,,294305,7111386,1559676,PDN
MC211,,2009,1990,,5946277,192003891,40110671,,5737136,186469513,38916765,,209141,5534378,1193906,PDN
MC211,,2010,1990,,5966776,192201741,40166374,,5771012,186878068,39023337,,195764,5323673,1143037,PDN
MC211,,2011,1990,,5966776,192201741,40166374,,5805090,187312811,39134772,,161686,4888930,1031602,PDN
MC211,,2012,1990,,5987134,192479544,40236163,,5828024,187568813,39203258,,159110,4910731,1032905,PDN
MC211,,2013,1990,,5987134,192479544,40236163,,5843344,187742164,39249423,,143790,4737380,986740,PDN
MC211,,2014,1990,,5997033,192600824,40267642,,5858109,187841235,39281816,,138924,4759589,985826,PDN
MC211,,2015,1990,,5928814,189329544,39617345,,5869138,187952013,39312557,,59676,1377531,304788,PDN
MC211,,2016,1990,,5879852,187984938,39329130,,5869480,187965169,39315240,,10372,19769,13890,PDN
MC211,,2017,1990,,5869480,187964070,39315044,,5869480,187964070,39315044,,0,0,0,PDN
MC211,,2017,1990,,5879852,187983839,39328934,,5869480,187964070,39315044,,10372,19769,13890,PDN
MC214,,2015,2013,,11722096,14183736,14245892,,0,0,0,,11722096,14183736,14245892,PDP
MC214,,2016,2013,,11722096,14183736,14245892,,153937,109063,173343,,11568159,14074673,14072549,PDP
MC214,,2017,2013,,11722096,14183736,14245892,,2793601,1936949,3138254,,8928495,12246787,11107639,PDP
MC214,,2017,2013,,11722096,14183736,14245892,,2793601,1936949,3138254,,8928495,12246787,11107639,PDP
MC243,,1994,1990,,10728104,176060484,42055592,,0,0,0,,10728104,176060484,42055592,PDP
MC243,,2001,1990,,13659188,124436539,35800921,,0,0,0,,13659188,124436539,35800921,PDP
MC243,,2002,1990,,15404981,128089826,38196765,,0,0,0,,15404981,128089826,38196765,PDP
MC243,,2003,1990,,23697891,136194714,47931826,,61710,553382,160177,,23636181,135641332,47771649,PDP
MC243,,2004,1990,,23618969,135319566,47697184,,4522243,7746263,5900582,,19096726,127573303,41796602,PDP
MC243,,2005,1990,,26676142,140431263,51663912,,6431570,10961297,8381979,,20244572,129469966,43281933,PDP
MC243,,2006,1990,,25380231,139783115,50252672,,8423063,14123097,10936070,,16957168,125660018,39316602,PDP
MC243,,2007,1990,,26729728,141504093,51908393,,12485509,20737569,16175468,,14244219,120766524,35732925,PDP
MC243,,2008,1990,,26729728,141504093,51908393,,13425423,22637127,17453382,,13304305,118866966,34455011,PDP
MC243,,2009,1990,,24586903,121549129,46214862,,13912351,23445744,18084193,,10674552,98103385,28130670,PDP
MC243,,2010,1990,,23953946,124024319,46022330,,15152584,25652810,19717140,,8801362,98371509,26305189,PDP
MC243,,2011,1990,,28118517,129703432,51197419,,16170548,29063237,21341942,,11947969,100640195,29855478,PDP
MC243,,2012,1990,,34750547,136237931,58992171,,18310534,32314279,24060406,,16440013,103923652,34931764,PDP
MC243,,2013,1990,,36861767,140608457,61881065,,21864627,37654858,28564778,,14997140,102953599,33316285,PDP
MC243,,2014,1990,,37833784,149610045,64454788,,24872473,45115696,32900177,,12961311,104494349,31554611,PDP
MC243,,2015,1990,,38033987,150000334,64724438,,26670367,49535594,35484528,,11363620,100464740,29239907,PDP
MC243,,2016,1990,,35399633,145641210,61314437,,27541402,51652572,36732250,,7858231,93988638,24582188,PDP
MC243,,2017,1990,,35806930,146069449,61797933,,28300536,53179069,37763002,,7506394,92890380,24034930,PDP
MC243,,2017,1990,,35806930,146069449,61797933,,28300536,53179069,37763002,,7506394,92890380,24034930,PDP
MC252,,2001,1999,,7361,73599251,13103313,,0,0,0,,7361,73599251,13103313,PDP
MC252,,2002,1999,,7158,71581437,12744068,,0,0,0,,7158,71581437,12744068,PDP
MC252,,2003,1999,,7158,71581437,12744068,,0,0,0,,7158,71581437,12744068,PDP
MC252,,2004,1999,,7158,71581437,12744068,,0,0,0,,7158,71581437,12744068,PDP
MC252,,2005,1999,,24267,92296898,16447203,,0,0,0,,24267,92296898,16447203,PDP
MC252,,2006,1999,,51365,92296898,16474301,,15451,27296900,4872551,,35914,64999998,11601750,PDP
MC252,,2007,1999,,64776,104522417,18663071,,30525,52069350,9295534,,34251,52453067,9367537,PDP
MC252,,2008,1999,,17019179,155387195,44668146,,44766,65963517,11782047,,16974413,89423678,32886099,PDP
MC252,,2009,1999,,17020436,157064660,44967884,,52173,72240799,12906408,,16968263,84823861,32061476,PDP
MC252,,2010,1999,,17013879,148281507,43398489,,56701,74961133,13394981,,16957178,73320374,30003508,PDP
MC252,,2011,1999,,17013879,148281507,43398489,,56787,75756159,13536531,,16957092,72525348,29861958,PDP
MC252,,2012,1999,,58953,97416729,17392891,,56787,75756159,13536531,,2166,21660570,3856360,PDP
MC252,,2013,1999,,58953,97416729,17392891,,56787,75756159,13536531,,2166,21660570,3856360,PDP
MC252,,2014,1999,,58180,89689099,16017095,,56787,75756159,13536531,,1393,13932940,2480564,PDP
MC252,,2015,1999,,78896576,263494871,125781785,,6288897,91500874,22570191,,72607679,171993997,103211593,PDP
MC252,,2016,1999,,53722787,219044379,92698656,,16470862,119355962,37708578,,37251925,99688417,54990078,PDP
MC252,,2017,1999,,53722787,219044379,92698656,,23278302,137065476,47667177,,30444485,81978903,45031478,PDP
MC252,,2017,1999,,53722787,219044379,92698656,,23278302,137065476,47667177,,30444485,81978903,45031478,PDP
MC281,,1979,1976,,50000000,50000000,58896797,,0,0,0,,50000000,50000000,58896797,PDP
MC281,,1980,1976,,50000000,50000000,58896797,,0,0,0,,50000000,50000000,58896797,PDP
MC281,,1981,1976,,50000000,50000000,58896797,,0,0,0,,50000000,50000000,58896797,PDP
MC281,,1982,1976,,22018758,18036355,25228074,,0,0,0,,22018758,18036355,25228074,PDP
MC281,,1983,1976,,22018758,18036355,25228074,,0,0,0,,22018758,18036355,25228074,PDP
MC281,,1984,1976,,23632420,18648254,26950615,,726114,1074543,917314,,22906306,17573711,26033301,PDP
MC281,,1985,1976,,33072586,37703425,39781380,,2048268,2510652,2495003,,31024318,35192773,37286377,PDP
MC281,,1986,1976,,37229523,60148870,47932169,,9903699,11654659,11977482,,27325824,48494211,35954687,PDP
MC281,,1987,1976,,41869597,64692609,53380737,,18016114,23255512,22154105,,23853483,41437097,31226632,PDP
MC281,,1988,1976,,89139564,189607052,122877474,,26474052,40167315,33621261,,62665512,149439737,89256213,PDP
MC281,,1989,1976,,89738059,193040484,124086900,,31801031,55272227,41635947,,57937028,137768257,82450953,PDP
MC281,,1990,1976,,64128932,155681513,91830269,,37393191,76048579,50924967,,26735741,79632934,40905302,PDP
MC281,,1991,1976,,64128932,155681513,91830269,,40654591,91390558,56916256,,23474341,64290955,34914013,PDP
MC281,,1992,1976,,65233313,157136287,93193506,,43166661,105177624,61881541,,22066652,51958663,31311965,PDP
MC281,,1993,1976,,64447040,163772985,93588141,,45053251,118038717,66056581,,19393789,45734268,27531560,PDP
MC281,,1994,1976,,53894227,179043934,85752578,,46648496,127491245,69333771,,7245731,51552689,16418807,PDP
MC281,,1995,1976,,54519447,180269474,86595866,,48212865,136412984,72485638,,6306582,43856490,14110228,PDP
MC281,,1996,1976,,55592677,179351972,87505839,,49969864,145842518,75920490,,5622813,33509454,11585349,PDP
MC281,,1997,1976,,56023512,197834203,91225327,,52165904,159178006,80489393,,3857608,38656197,10735934,PDP
MC281,,1998,1976,,58540368,211022392,96088836,,53727244,172117236,84353087,,4813124,38905156,11735749,PDP
MC281,,1999,1976,,58697401,212633260,96532500,,54847415,183867937,87564130,,3849986,28765323,8968370,PDP
MC281,,2000,1976,,64199777,248677098,108448371,,55955881,193747296,90430489,,8243896,54929802,18017882,PDP
MC281,,2001,1976,,64557619,237540103,106824541,,56964540,202497694,92996158,,7593079,35042409,13828383,PDP
MC281,,2002,1976,,65698043,241107184,108599677,,57935499,210373022,95368421,,7762544,30734162,13231256,PDP
MC281,,2003,1976,,64864680,234997053,106679102,,58767184,217617634,97489183,,6097496,17379419,9189919,PDP
MC281,,2004,1976,,66370227,243191219,109642686,,59605645,224971939,99636239,,6764582,18219280,10006447,PDP
MC281,,2005,1976,,65930856,247495060,109969123,,60098638,229993880,101022816,,5832218,17501180,8946307,PDP
MC281,,2006,1976,,64689184,245543721,108380237,,60129289,230188721,101088136,,4559895,15355000,7292101,PDP
MC281,,2007,1976,,65520248,240516029,108316695,,60712037,233162162,102199966,,4808211,7353867,6116729,PDP
MC281,,2008,1976,,65873212,239903421,108560654,,61150629,234432779,102864647,,4722583,5470642,5696007,PDP
MC281,,2009,1976,,63551277,240325589,106313835,,61469953,238229859,103859608,,2081324,2095730,2454229,PDP
MC281,,2010,1976,,63551277,240325589,106313835,,61754037,238578825,104205786,,1797240,1746764,2108051,PDP
MC281,,2011,1976,,63762757,240276440,106516570,,62089425,238865487,104592182,,1673332,1410953,1924393,PDP
MC281,,2012,1976,,63886646,240414237,106664980,,62402263,239141300,104954096,,1484383,1272937,1710885,PDP
MC281,,2013,1976,,63852943,240410725,106630653,,62676054,239378568,105270104,,1176889,1032157,1360548,PDP
MC281,,2014,1976,,63721835,240489464,106513555,,62890225,239670680,105536254,,831610,818784,977302,PDP
MC281,,2015,1976,,64146120,240394477,106920937,,63172610,239853900,105851240,,973510,540577,1069699,PDP
MC281,,2016,1976,,65370430,241164058,108282184,,63592417,240112513,106317061,,1778013,1051545,1965122,PDP
MC281,,2017,1976,,63695151,240241379,106442725,,63650810,240177294,106386981,,44341,64085,55744,PDP
MC281,,2017,1976,,63695151,240241379,106442725,,63650810,240177294,106386981,,44341,64085,55744,PDP
MC285,,2007,1987,,36918,10131806,1839730,,0,0,0,,36918,10131806,1839730,PDN
MC285,,2008,1987,,36918,10131806,1839730,,0,0,0,,36918,10131806,1839730,PDN
MC285,,2009,1987,,37658,10334999,1876626,,0,0,0,,37658,10334999,1876626,PDN
MC285,,2010,1987,,37658,10334999,1876626,,0,0,0,,37658,10334999,1876626,PDN
MC285,,2011,1987,,37658,10334999,1876626,,0,0,0,,37658,10334999,1876626,PDN
MC285,,2012,1987,,37658,10334999,1876626,,14657,1599889,299335,,23001,8735110,1577291,PDN
MC285,,2013,1987,,79573,10334999,1918541,,35980,4469108,831195,,43593,5865891,1087346,PDN
MC285,,2014,1987,,60248,10334999,1899216,,44704,6677696,1232906,,15544,3657303,666310,PDN
MC285,,2015,1987,,44834,6690114,1235246,,44834,6690114,1235246,,0,0,0,PDN
MC285,,2016,1987,,44834,6690114,1235246,,44834,6690114,1235246,,0,0,0,PDN
MC285,,2017,1987,,44834,6690114,1235246,,44834,6690114,1235246,,0,0,0,PDN
MC285,,2017,1987,,44834,6690114,1235246,,44834,6690114,1235246,,0,0,0,PDN
MC292,,1997,1995,,16947802,197380436,52068876,,0,0,0,,16947802,197380436,52068876,PDN
MC292,,1998,1995,,18971255,267449321,66560102,,0,0,0,,18971255,267449321,66560102,PDN
MC292,,1999,1995,,19948309,319479414,76795179,,462455,26618625,5198865,,19485854,292860789,71596314,PDN
MC292,,2000,1995,,22253640,301187615,75845742,,1124098,74204124,14327679,,21129542,226983491,61518063,PDN
MC292,,2001,1995,,21717425,285859156,72582044,,1280169,91858429,17625085,,20437256,194000727,54956959,PDN
MC292,,2002,1995,,21586938,274902896,70502044,,1367501,99950049,19152207,,20219437,174952847,51349837,PDN
MC292,,2003,1995,,21476160,264803096,68594149,,1413119,104809215,20062446,,20063041,159993881,48531703,PDN
MC292,,2004,1995,,21396353,257458801,67207528,,1451043,108183537,20700783,,19945310,149275264,46506745,PDN
MC292,,2005,1995,,21572556,269962183,69608532,,1455914,109211139,20888501,,20116642,160751044,48720031,PDN
MC292,,2006,1995,,21473652,264106319,68467659,,1472554,110757744,21180338,,20001098,153348575,47287321,PDN
MC292,,2007,1995,,27193665,288203589,78475443,,1479554,112605679,21516152,,25714111,175597910,56959291,PDN
MC292,,2008,1995,,27193665,288203589,78475443,,1495577,113484394,21688530,,25698088,174719195,56786913,PDN
MC292,,2009,1995,,4251585,155057737,31841930,,1635950,124036824,23706559,,2615635,31020913,8135370,PDN
MC292,,2010,1995,,4336115,160323264,32863386,,1722252,132477176,25294703,,2613863,27846088,7568683,PDN
MC292,,2011,1995,,4336115,160323264,32863386,,1748592,136324776,26005670,,2587523,23998488,6857716,PDN
MC292,,2012,1995,,9999033,167168701,39744353,,2202235,138908848,26919112,,7796798,28259853,12825241,PDN
MC292,,2013,1995,,9999033,167168701,39744353,,2246967,139618469,27090111,,7752066,27550232,12654242,PDN
MC292,,2014,1995,,5109373,158494690,33311275,,2266773,139928745,27165126,,2842600,18565945,6146149,PDN
MC292,,2015,1995,,5086123,157197438,33057198,,2275790,140975744,27360442,,2810333,16221694,5696756,PDN
MC292,,2016,1995,,2275790,140975744,27360442,,2275790,140975744,27360442,,0,0,0,PDN
MC292,,2017,1995,,2275790,140975744,27360442,,2275790,140975744,27360442,,0,0,0,PDN
MC292,,2017,1995,,2275790,140975744,27360442,,2275790,140975744,27360442,,0,0,0,PDN
MC299,,2001,2001,,944,9433721,1679542,,0,0,0,,944,9433721,1679542,PDN
MC299,,2002,2001,,944,9437429,1680202,,0,0,0,,944,9437429,1680202,PDN
MC299,,2003,2001,,944,9437429,1680202,,0,0,0,,944,9437429,1680202,PDN
MC299,,2004,2001,,944,9437429,1680202,,0,0,0,,944,9437429,1680202,PDN
MC299,,2005,2001,,75889,64989029,11639773,,0,0,0,,75889,64989029,11639773,PDN
MC299,,2006,2001,,63830,27981387,5042724,,22713,10256785,1847764,,41117,17724602,3194960,PDN
MC299,,2007,2001,,52737,27981387,5031631,,33958,19233688,3456322,,18779,8747699,1575309,PDN
MC299,,2008,2001,,59164,27981387,5038058,,47540,23947552,4308670,,11624,4033835,729388,PDN
MC299,,2009,2001,,60341,28538046,5138285,,52969,25703994,4626633,,7372,2834052,511652,PDN
MC299,,2010,2001,,57667,28538046,5135611,,53180,26168631,4709520,,4487,2369415,426091,PDN
MC299,,2011,2001,,53180,26317338,4735980,,53180,26317338,4735980,,0,0,0,PDN
MC299,,2012,2001,,53180,26317338,4735980,,53180,26317338,4735980,,0,0,0,PDN
MC299,,2013,2001,,53180,26317338,4735980,,53180,26317338,4735980,,0,0,0,PDN
MC299,,2014,2001,,53180,26317338,4735980,,53180,26317338,4735980,,0,0,0,PDN
MC299,,2015,2001,,53180,26317338,4735980,,53180,26317338,4735980,,0,0,0,PDN
MC299,,2016,2001,,53180,26317338,4735980,,53180,26317338,4735980,,0,0,0,PDN
MC299,,2017,2001,,53180,26317338,4735980,,53180,26317338,4735980,,0,0,0,PDN
MC299,,2017,2001,,53180,26317338,4735980,,53180,26317338,4735980,,0,0,0,PDN
MC300,,2013,2012,,3768453,7691413,5137032,,0,0,0,,3768453,7691413,5137032,PDP
MC300,,2014,2012,,3768453,7691413,5137032,,0,0,0,,3768453,7691413,5137032,PDP
MC300,,2015,2012,,16440927,35676812,22789114,,4816482,10502990,6685341,,11624445,25173822,16103773,PDP
MC300,,2016,2012,,71799586,166028712,101342062,,16664640,34697682,22838605,,55134946,131331030,78503457,PDP
MC300,,2017,2012,,68743097,154788674,96285566,,29631779,61253855,40531041,,39111318,93534819,55754524,PDP
MC300,,2017,2012,,68743097,154788674,96285566,,29631779,61253855,40531041,,39111318,93534819,55754524,PDP
MC305,,1999,1999,,9942,99400850,17696926,,0,0,0,,9942,99400850,17696926,PDN
MC305,,2000,1999,,9943,99407416,17698095,,0,0,0,,9943,99407416,17698095,PDN
MC305,,2001,1999,,20518,205143295,36522884,,0,0,0,,20518,205143295,36522884,PDN
MC305,,2002,1999,,228320,239498696,42843746,,3304,7340282,1309404,,225016,232158414,41534342,PDN
MC305,,2003,1999,,252999,251713654,45041905,,87930,77562257,13889043,,165069,174151397,31152862,PDN
MC305,,2004,1999,,216581,210868290,37737629,,169473,129170549,23153556,,47108,81697741,14584073,PDN
MC305,,2005,1999,,231326,236652968,42340395,,208349,157535443,28239567,,22977,79117525,14100828,PDN
MC305,,2006,1999,,229105,236514799,42313589,,212972,173121214,31017458,,16133,63393585,11296131,PDN
MC305,,2007,1999,,233030,237643909,42518423,,222094,184466491,33045313,,10936,53177418,9473110,PDN
MC305,,2008,1999,,235806,239147307,42788708,,230686,190531274,34133048,,5120,48616033,8655660,PDN
MC305,,2009,1999,,237603,247284841,44238464,,231509,190931979,34205171,,6094,56352862,10033294,PDN
MC305,,2010,1999,,237637,247827153,44334996,,232165,194991229,34928113,,5472,52835924,9406882,PDN
MC305,,2011,1999,,238078,250277888,44771510,,232265,196927668,35272776,,5813,53350220,9498735,PDN
MC305,,2012,1999,,238167,250344507,44783453,,232538,199039226,35648771,,5629,51305281,9134682,PDN
MC305,,2013,1999,,233098,201183637,36030898,,233098,201183637,36030898,,0,0,0,PDN
MC305,,2014,1999,,233098,201183637,36030898,,233098,201183637,36030898,,0,0,0,PDN
MC305,,2015,1999,,233098,201183637,36030898,,233098,201183637,36030898,,0,0,0,PDN
MC305,,2016,1999,,233098,201183637,36030898,,233098,201183637,36030898,,0,0,0,PDN
MC305,,2017,1999,,233098,201183637,36030898,,233098,201183637,36030898,,0,0,0,PDN
MC305,,2017,1999,,233098,201183637,36030898,,233098,201183637,36030898,,0,0,0,PDN
MC311,,1975,1968,,0,28100000,5000000,,0,0,0,,0,28100000,5000000,PDP
MC311,,1976,1968,,10545713,125167000,32817421,,0,0,0,,10545713,125167000,32817421,PDP
MC311,,1977,1968,,12276840,121350864,33869520,,0,0,0,,12276840,121350864,33869520,PDP
MC311,,1978,1968,,12276840,121350864,33869520,,0,0,0,,12276840,121350864,33869520,PDP
MC311,,1979,1968,,16066870,125519897,38401371,,87106,80035,101347,,15979764,125439862,38300024,PDP
MC311,,1980,1968,,18876270,127441731,41552735,,2516579,2434359,2949739,,16359691,125007372,38602996,PDP
MC311,,1981,1968,,19889651,331028753,78791564,,6215512,11559292,8272326,,13674139,319469461,70519238,PDP
MC311,,1982,1968,,19908426,339131789,80252161,,9261614,25517618,13802115,,10646812,313614171,66450046,PDP
MC311,,1983,1968,,62041263,446752545,141534598,,15357943,53739199,24920078,,46683320,393013346,116614520,PDP
MC311,,1984,1968,,122338728,282200836,172552400,,21550674,89850797,37538360,,100788054,192350039,135014040,PDP
MC311,,1985,1968,,46091529,361759114,110461478,,25651158,122616940,47469119,,20440371,239142174,62992359,PDP
MC311,,1986,1968,,50772302,426870665,126727936,,29987576,165036324,59353470,,20784726,261834341,67374466,PDP
MC311,,1987,1968,,47142236,378280135,114451869,,33062040,209545655,70347744,,14080196,168734480,44104125,PDP
MC311,,1988,1968,,45558922,399220563,116594609,,34279938,233035489,75745328,,11278984,166185074,40849281,PDP
MC311,,1989,1968,,46063722,410320272,119074447,,35624189,261318509,82122144,,10439533,149001763,36952303,PDP
MC311,,1990,1968,,46749187,420903079,121642973,,37642998,299602359,90953026,,9106189,121300720,30689947,PDP
MC311,,1991,1968,,49909331,480965413,135490365,,39733718,336042966,99527840,,10175613,144922447,35962525,PDP
MC311,,1992,1968,,49245641,509951642,139984367,,41445687,360909606,105664478,,7799954,149042036,34319889,PDP
MC311,,1993,1968,,54451223,513490732,145819681,,43212600,381702746,111131238,,11238623,131787986,34688443,PDP
MC311,,1994,1968,,55867697,528779232,149956528,,45611696,413315462,119155373,,10256001,115463770,30801155,PDP
MC311,,1995,1968,,59112696,542834654,155702492,,47472595,438057893,125418839,,11640101,104776761,30283653,PDP
MC311,,1996,1968,,60119911,555101547,158892428,,49230046,453775060,129972939,,10889865,101326487,28919489,PDP
MC311,,1997,1968,,60282338,572628285,162173492,,50607758,473672657,134891149,,9674580,98955628,27282343,PDP
MC311,,1998,1968,,60248233,573154331,162232989,,51845932,491532093,139307159,,8402301,81622238,22925830,PDP
MC311,,1999,1968,,57280710,571829655,159029759,,52766138,499328048,141614545,,4514572,72501607,17415214,PDP
MC311,,2000,1968,,57310140,550282292,155225139,,53520474,505856839,143530588,,3789666,44425453,11694551,PDP
MC311,,2001,1968,,62860580,624823492,174039138,,54300548,514005067,145760524,,8560032,110818425,28278614,PDP
MC311,,2002,1968,,60282252,608849564,168618474,,55507311,536525807,150974536,,4774941,72323757,17643938,PDP
MC311,,2003,1968,,60639655,622810164,171459969,,56840155,563338905,157078394,,3799500,59471259,14381575,PDP
MC311,,2004,1968,,60535582,601215084,167513355,,57624709,578495125,160559785,,2910873,22719959,6953570,PDP
MC311,,2005,1968,,60375548,600086680,167152537,,57905693,582076918,161478098,,2469855,18009762,5674439,PDP
MC311,,2006,1968,,60233708,599622380,166928081,,58047835,582352965,161669359,,2185873,17269415,5258722,PDP
MC311,,2007,1968,,60810410,600974191,167745319,,58246773,583490699,162070741,,2563637,17483492,5674578,PDP
MC311,,2008,1968,,60867027,601253993,167851723,,58383684,583875865,162276187,,2483343,17378128,5575536,PDP
MC311,,2009,1968,,59581680,611317299,168356997,,58519291,594343551,164274370,,1062389,16973748,4082627,PDP
MC311,,2010,1968,,60331925,612996997,169406120,,58631761,595268863,164551486,,1700164,17728134,4854634,PDP
MC311,,2011,1968,,60369152,611211644,169125669,,58834162,595705028,164831497,,1534990,15506616,4294173,PDP
MC311,,2012,1968,,60396618,611227396,169155938,,59060597,595995607,165109637,,1336021,15231789,4046302,PDP
MC311,,2013,1968,,60450475,611330744,169228183,,59259367,596270011,165357234,,1191108,15060733,3870953,PDP
MC311,,2014,1968,,60488640,612068178,169397564,,59405794,596466320,165538589,,1082846,15601858,3858975,PDP
MC311,,2015,1968,,60352938,598229863,166799531,,59557895,596744946,165740269,,795043,1484917,1059263,PDP
MC311,,2016,1968,,60538051,598250924,166988391,,59707025,596924512,165921350,,831026,1326412,1067042,PDP
MC311,,2017,1968,,60527440,598250924,166977780,,59781319,597014912,166011730,,746121,1236012,966052,PDP
MC311,,2017,1968,,60527440,598250924,166977780,,59781319,597014912,166011730,,746121,1236012,966052,PDP
MC322,,1994,1984,,58947,3371778,658907,,0,0,0,,58947,3371778,658907,PDN
MC322,,1995,1984,,54713,3129616,611584,,0,0,0,,54713,3129616,611584,PDN
MC322,,2000,1984,,38736,3679883,693519,,0,0,0,,38736,3679883,693519,PDN
MC322,,2001,1984,,504152,58283980,10874967,,0,0,0,,504152,58283980,10874967,PDN
MC322,,2002,1984,,225462,29573351,5487624,,68681,8664624,1610429,,156781,20908727,3877195,PDN
MC322,,2003,1984,,209601,28102957,5210127,,113389,15685090,2904330,,96212,12417867,2305797,PDN
MC322,,2004,1984,,193910,25414119,4715995,,127388,18679658,3451171,,66522,6734461,1264824,PDN
MC322,,2005,1984,,311625,35631459,6651742,,136612,19814157,3662263,,175013,15817302,2989479,PDN
MC322,,2006,1984,,302642,35613979,6639649,,187063,24038714,4464414,,115579,11575265,2175235,PDN
MC322,,2007,1984,,302642,35613979,6639649,,206262,26596389,4938716,,96380,9017590,1700933,PDN
MC322,,2008,1984,,302642,35613979,6639649,,206595,27469791,5094458,,96047,8144188,1545191,PDN
MC322,,2009,1984,,206595,27469791,5094459,,206595,27469791,5094459,,0,0,0,PDN
MC322,,2010,1984,,206595,27469791,5094459,,206595,27469791,5094459,,0,0,0,PDN
MC322,,2011,1984,,206595,27469791,5094459,,206595,27469791,5094459,,0,0,0,PDN
MC322,,2012,1984,,206595,27469791,5094459,,206595,27469791,5094459,,0,0,0,PDN
MC322,,2013,1984,,206595,27469791,5094459,,206595,27469791,5094459,,0,0,0,PDN
MC322,,2014,1984,,206595,27469791,5094459,,206595,27469791,5094459,,0,0,0,PDN
MC322,,2015,1984,,206595,27469791,5094459,,206595,27469791,5094459,,0,0,0,PDN
MC322,,2016,1984,,206595,27469791,5094459,,206595,27469791,5094459,,0,0,0,PDN
MC322,,2017,1984,,206595,27469791,5094459,,206595,27469791,5094459,,0,0,0,PDN
MC322,,2017,1984,,206595,27469791,5094459,,206595,27469791,5094459,,0,0,0,PDN
MC348,,1999,1999,,12383,123830611,22046300,,0,0,0,,12383,123830611,22046300,PDN
MC348,,2000,1999,,193601,131136259,23527455,,0,0,0,,193601,131136259,23527455,PDN
MC348,,2001,1999,,176253,141267176,25312761,,0,0,0,,176253,141267176,25312761,PDN
MC348,,2002,1999,,174413,137339630,24612069,,2780,3981349,711205,,171633,133358281,23900864,PDN
MC348,,2003,1999,,194086,137339043,24631638,,51570,42811537,7669281,,142516,94527506,16962357,PDN
MC348,,2004,1999,,171679,128508829,23038018,,105801,77833671,13955209,,65878,50675158,9082809,PDN
MC348,,2005,1999,,150849,116986228,20966904,,138565,105245067,18865445,,12284,11741161,2101459,PDN
MC348,,2006,1999,,150849,117078847,20983384,,139266,106078064,19014366,,11583,11000783,1969018,PDN
MC348,,2007,1999,,153428,117293475,21024153,,141822,106283918,19053551,,11606,11009557,1970602,PDN
MC348,,2008,1999,,162284,122501613,21959724,,147711,109594387,19648492,,14573,12907226,2311232,PDN
MC348,,2009,1999,,163626,122608977,21980170,,151823,111462952,19985089,,11803,11146025,1995081,PDN
MC348,,2010,1999,,163652,122799476,22014093,,151849,111653451,20019012,,11803,11146025,1995081,PDN
MC348,,2011,1999,,163652,122799476,22014093,,151849,111653451,20019012,,11803,11146025,1995081,PDN
MC348,,2012,1999,,163652,122799476,22014093,,151849,111653451,20019012,,11803,11146025,1995081,PDN
MC348,,2013,1999,,163652,122799476,22014093,,151849,111653451,20019012,,11803,11146025,1995081,PDN
MC348,,2014,1999,,163652,122799476,22014093,,151849,111653451,20019012,,11803,11146025,1995081,PDN
MC348,,2015,1999,,163652,122799476,22014093,,151849,111653451,20019012,,11803,11146025,1995081,PDN
MC348,,2016,1999,,163652,122799476,22014093,,151849,111653451,20019012,,11803,11146025,1995081,PDN
MC348,,2017,1999,,163652,122799476,22014093,,151849,111653451,20019012,,11803,11146025,1995081,PDN
MC348,,2017,1999,,163652,122799476,22014093,,151849,111653451,20019012,,11803,11146025,1995081,PDN
MC354,,1979,1977,,0,300000000,53380783,,0,0,0,,0,300000000,53380783,PDN
MC354,,1980,1977,,300000,300000000,53680783,,0,0,0,,300000,300000000,53680783,PDN
MC354,,1981,1977,,300000,300000000,53680783,,0,0,0,,300000,300000000,53680783,PDN
MC354,,1982,1977,,300000,300000000,53680783,,0,0,0,,300000,300000000,53680783,PDN
MC354,,1983,1977,,300000,300000000,53680783,,0,0,0,,300000,300000000,53680783,PDN
MC354,,1984,1977,,300000,300000000,53680783,,0,0,0,,300000,300000000,53680783,PDN
MC354,,1985,1977,,1456152,40258263,8619544,,0,0,0,,1456152,40258263,8619544,PDN
MC354,,1986,1977,,1456152,40258263,8619544,,0,0,0,,1456152,40258263,8619544,PDN
MC354,,1987,1977,,1456152,40258263,8619544,,0,0,0,,1456152,40258263,8619544,PDN
MC354,,1991,1977,,25534,255321028,45456322,,0,0,0,,25534,255321028,45456322,PDN
MC354,,1992,1977,,25534,255321028,45456322,,0,0,0,,25534,255321028,45456322,PDN
MC354,,1993,1977,,25534,255321028,45456322,,10905,4704776,848054,,14629,250616252,44608268,PDN
MC354,,1994,1977,,399797,280189486,50255577,,60367,25278853,4558384,,339430,254910633,45697193,PDN
MC354,,1995,1977,,399797,280189486,50255577,,117733,46364497,8367643,,282064,233824989,41887934,PDN
MC354,,1996,1977,,464498,253318533,45538970,,190436,75956663,13705856,,274062,177361870,31833114,PDN
MC354,,1997,1977,,525731,286510239,51506201,,269880,115529107,20826661,,255851,170981132,30679540,PDN
MC354,,1998,1977,,499315,320560563,57538561,,329054,150896966,27179048,,170261,169663597,30359513,PDN
MC354,,1999,1977,,504607,328352695,58930353,,392018,189714845,34149108,,112589,138637850,24781245,PDN
MC354,,2000,1977,,601604,381770507,68532299,,465001,230486703,41476870,,136603,151283804,27055429,PDN
MC354,,2001,1977,,895094,471785633,84842716,,529150,267917300,48201267,,365944,203868333,36641449,PDN
MC354,,2002,1977,,895997,479474313,86211711,,590535,300669131,54090380,,305462,178805182,32121331,PDN
MC354,,2003,1977,,877704,479423630,86184400,,636045,329928853,59342247,,241659,149494777,26842153,PDN
MC354,,2004,1977,,858821,472623997,84955618,,665406,354263256,63701573,,193415,118360741,21254045,PDN
MC354,,2005,1977,,821406,462941185,83195282,,681032,369849279,66490512,,140374,93091906,16704770,PDN
MC354,,2006,1977,,824289,466941307,83909931,,692873,379768259,68267296,,131416,87173048,15642635,PDN
MC354,,2007,1977,,818685,478375363,85938856,,694573,385948317,69368651,,124112,92427046,16570205,PDN
MC354,,2008,1977,,818685,478375363,85938856,,695740,388310819,69790192,,122945,90064544,16148664,PDN
MC354,,2009,1977,,796448,458049396,82299899,,695764,391311088,70324071,,100684,66738308,11975828,PDN
MC354,,2010,1977,,796448,458049396,82299899,,695764,391312772,70324371,,100684,66736624,11975528,PDN
MC354,,2011,1977,,695764,391312772,70324371,,695764,391312772,70324371,,0,0,0,PDN
MC354,,2012,1977,,695764,391312772,70324371,,695764,391312772,70324371,,0,0,0,PDN
MC354,,2013,1977,,695764,391312772,70324371,,695764,391312772,70324371,,0,0,0,PDN
MC354,,2014,1977,,695764,391312772,70324371,,695764,391312772,70324371,,0,0,0,PDN
MC354,,2015,1977,,695764,391312772,70324371,,695764,391312772,70324371,,0,0,0,PDN
MC354,,2016,1977,,695764,391312772,70324371,,695764,391312772,70324371,,0,0,0,PDN
MC354,,2017,1977,,695764,391312772,70324371,,695764,391312772,70324371,,0,0,0,PDN
MC354,,2017,1977,,695764,391312772,70324371,,695764,391312772,70324371,,0,0,0,PDN
MC365,,1986,1976,,56993,3260044,637072,,0,0,0,,56993,3260044,637072,PDN
MC365,,1987,1976,,515313,26074770,5154952,,0,0,0,,515313,26074770,5154952,PDN
MC365,,1990,1976,,1723293,145915354,27686879,,0,0,0,,1723293,145915354,27686879,PDN
MC365,,1991,1976,,1723293,145915354,27686879,,0,0,0,,1723293,145915354,27686879,PDN
MC365,,1992,1976,,1724652,153915354,29111726,,14533,20436165,3650861,,1710119,133479189,25460865,PDN
MC365,,1993,1976,,149453,187488891,33510466,,28354,49975273,8920751,,121099,137513618,24589715,PDN
MC365,,1994,1976,,150339,187587561,33528909,,41222,66844605,11935280,,109117,120742956,21593629,PDN
MC365,,1995,1976,,150272,187581308,33527729,,43020,69541708,12416989,,107252,118039600,21110740,PDN
MC365,,1996,1976,,133295,185971723,33224349,,47908,74295405,13267731,,85387,111676318,19956618,PDN
MC365,,1997,1976,,133295,185971723,33224349,,53365,80291733,14340150,,79930,105679990,18884199,PDN
MC365,,1998,1976,,126866,171142261,30579226,,55174,82682359,14767338,,71692,88459902,15811888,PDN
MC365,,1999,1976,,116533,170359672,30429642,,55174,82826055,14792906,,61359,87533617,15636736,PDN
MC365,,2000,1976,,3561600,207681578,40515617,,55174,83599421,14930516,,3506426,124082157,25585101,PDN
MC365,,2001,1976,,963941,195865057,35815375,,113023,85612686,15346597,,850918,110252371,20468778,PDN
MC365,,2002,1976,,1017962,200062341,36616243,,173288,89027187,16014424,,844674,111035154,20601819,PDN
MC365,,2003,1976,,1014808,199790657,36564747,,352963,95078321,17270814,,661845,104712336,19293933,PDN
MC365,,2004,1976,,793365,194275934,35362036,,454151,99922248,18233910,,339214,94353686,17128126,PDN
MC365,,2005,1976,,987379,200568813,36675779,,491530,101504034,18552746,,495849,99064779,18123033,PDN
MC365,,2006,1976,,977323,199954924,36556491,,548193,103702635,19000619,,429130,96252289,17555872,PDN
MC365,,2007,1976,,989176,199954924,36568344,,602432,105696769,19409686,,386744,94258155,17158658,PDN
MC365,,2008,1976,,782228,111069971,20545568,,638367,106890493,19658028,,143861,4179478,887540,PDN
MC365,,2009,1976,,794456,113097702,20918602,,645632,108750323,19996223,,148824,4347379,922379,PDN
MC365,,2010,1976,,645632,108750323,19996223,,645632,108750323,19996223,,0,0,0,PDN
MC365,,2011,1976,,645632,108750323,19996223,,645632,108750323,19996223,,0,0,0,PDN
MC365,,2012,1976,,645632,108750323,19996223,,645632,108750323,19996223,,0,0,0,PDN
MC365,,2013,1976,,645632,108750323,19996223,,645632,108750323,19996223,,0,0,0,PDN
MC365,,2014,1976,,645632,108750323,19996223,,645632,108750323,19996223,,0,0,0,PDN
MC365,,2015,1976,,645632,108750323,19996223,,645632,108750323,19996223,,0,0,0,PDN
MC365,,2016,1976,,645632,108750323,19996223,,645632,108750323,19996223,,0,0,0,PDN
MC365,,2017,1976,,645632,108750323,19996223,,645632,108750323,19996223,,0,0,0,PDN
MC365,,2017,1976,,645632,108750323,19996223,,645632,108750323,19996223,,0,0,0,PDN
MC383,,1993,1987,,62811715,62811715,73988177,,0,0,0,,62811715,62811715,73988177,PDP
MC383,,1994,1987,,48434633,48434633,57052895,,0,0,0,,48434633,48434633,57052895,PDP
MC383,,1995,1987,,48434633,48434633,57052895,,0,0,0,,48434633,48434633,57052895,PDP
MC383,,1996,1987,,48434633,48434633,57052895,,0,0,0,,48434633,48434633,57052895,PDP
MC383,,1997,1987,,45351004,45351004,53420578,,0,0,0,,45351004,45351004,53420578,PDP
MC383,,1998,1987,,45351004,45351004,53420578,,0,0,0,,45351004,45351004,53420578,PDP
MC383,,1999,1987,,45351004,45351004,53420578,,0,0,0,,45351004,45351004,53420578,PDP
MC383,,2000,1987,,45397548,45397548,53475403,,0,0,0,,45397548,45397548,53475403,PDP
MC383,,2001,1987,,61410053,61410053,72337108,,0,0,0,,61410053,61410053,72337108,PDP
MC383,,2002,1987,,71806512,71806512,84583472,,0,0,0,,71806512,71806512,84583472,PDP
MC383,,2003,1987,,71806512,71806512,84583472,,0,0,0,,71806512,71806512,84583472,PDP
MC383,,2004,1987,,74601604,80196725,88871484,,7600058,9026588,9206212,,67001546,71170137,79665272,PDP
MC383,,2005,1987,,116052550,138462698,140690041,,24512996,26908131,29300920,,91539554,111554567,111389121,PDP
MC383,,2006,1987,,116052550,133638113,139831574,,41776160,47151754,50166152,,74276390,86486359,89665422,PDP
MC383,,2007,1987,,116052550,131774069,139499893,,57205835,64643324,68708206,,58846715,67130745,70791687,PDP
MC383,,2008,1987,,116052550,127826681,138797511,,69328109,77654049,83145555,,46724441,50172632,55651956,PDP
MC383,,2009,1987,,109649655,118311978,130701608,,80148603,89089773,96000876,,29501052,29222205,34700733,PDP
MC383,,2010,1987,,109649655,118311978,130701608,,89313029,98129328,106773764,,20336626,20182650,23927845,PDP
MC383,,2011,1987,,109649655,118311978,130701608,,94834176,102610676,113092303,,14815479,15701302,17609305,PDP
MC383,,2012,1987,,109649655,118311978,130701608,,97292363,104313848,115853546,,12357292,13998130,14848062,PDP
MC383,,2013,1987,,109649655,118311978,130701608,,100197854,105736875,119012245,,9451801,12575103,11689364,PDP
MC383,,2014,1987,,114716692,122624026,136535913,,105206309,109825077,124748137,,9510383,12798949,11787776,PDP
MC383,,2015,1987,,123886004,131151548,147222578,,109697598,114338424,130042513,,14188406,16813124,17180065,PDP
MC383,,2016,1987,,125425924,132101297,148931493,,112891780,116976552,133706113,,12534144,15124745,15225379,PDP
MC383,,2017,1987,,125425924,132101297,148931493,,116664571,121547988,138292327,,8761353,10553309,10639166,PDP
MC383,,2017,1987,,125425924,132101297,148931493,,116664571,121547988,138292327,,8761353,10553309,10639166,PDP
MC397,,1984,1982,,24528,2452781,460966,,0,0,0,,24528,2452781,460966,PDP
MC397,,1985,1982,,24528,2452781,460966,,0,0,0,,24528,2452781,460966,PDP
MC397,,1986,1982,,1204418,52356146,10520458,,0,0,0,,1204418,52356146,10520458,PDP
MC397,,1987,1982,,1180763,49903365,10060365,,0,0,0,,1180763,49903365,10060365,PDP
MC397,,1991,1982,,2569214,137816679,27091755,,0,0,0,,2569214,137816679,27091755,PDP
MC397,,1992,1982,,3838490,138094087,28410392,,123497,6932227,1356989,,3714993,131161860,27053403,PDP
MC397,,1993,1982,,11002217,389656368,80336090,,675454,40972432,7965922,,10326763,348683936,72370168,PDP
MC397,,1994,1982,,13401851,408390491,86069198,,1606733,90754023,17755136,,11795118,317636468,68314062,PDP
MC397,,1995,1982,,11843411,338337255,72045770,,3239257,137498299,27705147,,8604154,200838956,44340623,PDP
MC397,,1996,1982,,10473603,392596831,80330690,,4290564,185138601,37233376,,6183039,207458230,43097314,PDP
MC397,,1997,1982,,9833564,439377497,88014613,,5149089,231635213,46365319,,4684475,207742284,41649294,PDP
MC397,,1998,1982,,10057460,443205256,88919605,,5741483,266347045,53134196,,4315977,176858211,35785409,PDP
MC397,,1999,1982,,10141409,433476907,87272531,,6160261,292661385,58235241,,3981148,140815522,29037290,PDP
MC397,,2000,1982,,10220096,440311706,88567375,,6668960,322103607,63982769,,3551136,118208099,24584606,PDP
MC397,,2001,1982,,7967003,398976685,78959296,,7081497,346108749,68666684,,885506,52867936,10292612,PDP
MC397,,2002,1982,,7880607,393716704,77936960,,7325696,363097962,71933874,,554911,30618742,6003086,PDP
MC397,,2003,1982,,7867717,391227904,77481223,,7435925,371412136,73523494,,431792,19815768,3957729,PDP
MC397,,2004,1982,,7712569,389095861,76946708,,7495675,374885749,74201324,,216894,14210112,2745384,PDP
MC397,,2005,1982,,8033958,389601488,77358066,,7582581,377272543,74712927,,451377,12328945,2645139,PDP
MC397,,2006,1982,,8210349,391517443,77875374,,7867392,379649987,75420770,,342957,11867456,2454604,PDP
MC397,,2007,1982,,8369335,391061386,77953212,,8026797,381290571,75872094,,342538,9770815,2081118,PDP
MC397,,2008,1982,,8369284,390551201,77862380,,8111849,381690830,76028367,,257435,8860371,1834013,PDP
MC397,,2009,1982,,8679112,397270358,79367787,,8204872,387635829,77179218,,474240,9634529,2188569,PDP
MC397,,2010,1982,,8658198,397070483,79311308,,8245084,387899514,77266349,,413114,9170969,2044959,PDP
MC397,,2011,1982,,8658198,397070483,79311308,,8333143,388043301,77379993,,325055,9027182,1931315,PDP
MC397,,2012,1982,,8656033,395828372,79088127,,8403216,388290763,77494098,,252817,7537609,1594029,PDP
MC397,,2013,1982,,8656033,395828372,79088127,,8446018,388291715,77537070,,210015,7536657,1551057,PDP
MC397,,2014,1982,,8656033,395828372,79088127,,8483708,388291855,77574785,,172325,7536517,1513342,PDP
MC397,,2015,1982,,8656033,395828372,79088127,,8543054,388292053,77634166,,112979,7536319,1453961,PDP
MC397,,2016,1982,,8656033,395828372,79088127,,8600280,388292258,77691428,,55753,7536114,1396699,PDP
MC397,,2017,1982,,8656033,395828372,79088127,,8631018,388292612,77722229,,25015,7535760,1365898,PDP
MC397,,2017,1982,,8656033,395828372,79088127,,8631018,388292612,77722229,,25015,7535760,1365898,PDP
MC427,,2004,2004,,78811,15762221,2883477,,0,0,0,,78811,15762221,2883477,PU
MC427,,2005,2004,,78811,15762221,2883477,,0,0,0,,78811,15762221,2883477,PU
MC427,,2006,2004,,78811,15762221,2883477,,0,0,0,,78811,15762221,2883477,PU
MC427,,2007,2004,,78811,15762221,2883477,,0,0,0,,78811,15762221,2883477,PU
MC427,,2017,2004,,18723357,21299511,22513306,,0,0,0,,18723357,21299511,22513306,PU
MC427,,2017,2004,,18723357,21299511,22513306,,0,0,0,,18723357,21299511,22513306,PU
MC429,,1996,1995,,20536830,16429465,23460222,,0,0,0,,20536830,16429465,23460222,PDP
MC429,,1997,1995,,19379418,15503536,22138054,,0,0,0,,19379418,15503536,22138054,PDP
MC429,,1998,1995,,19379418,15503536,22138054,,0,0,0,,19379418,15503536,22138054,PDP
MC429,,1999,1995,,19379418,15503536,22138054,,0,0,0,,19379418,15503536,22138054,PDP
MC429,,2000,1995,,39826013,31860812,45495196,,0,0,0,,39826013,31860812,45495196,PDP
MC429,,2001,1995,,39864975,31891981,45539705,,0,0,0,,39864975,31891981,45539705,PDP
MC429,,2002,1995,,39864975,31891981,45539705,,0,0,0,,39864975,31891981,45539705,PDP
MC429,,2003,1995,,37004305,48388269,45614317,,0,0,0,,37004305,48388269,45614317,PDP
MC429,,2004,1995,,41327177,63414647,52610922,,4615972,7127490,5884209,,36711205,56287157,46726713,PDP
MC429,,2005,1995,,45709612,59933818,56373992,,13948053,20418681,17581270,,31761559,39515137,38792722,PDP
MC429,,2006,1995,,43504317,57530088,53740987,,23311278,31912685,28989692,,20193039,25617403,24751295,PDP
MC429,,2007,1995,,46605298,61728664,57589046,,29218601,39702291,36283066,,17386697,22026373,21305980,PDP
MC429,,2008,1995,,46243091,61121896,57118873,,33747361,45106252,41773384,,12495730,16015644,15345489,PDP
MC429,,2009,1995,,48718810,63865184,60082722,,37629377,49810987,46492542,,11089433,14054197,13590180,PDP
MC429,,2010,1995,,51898656,66640236,63756349,,40777095,53599841,50314433,,11121561,13040395,13441916,PDP
MC429,,2011,1995,,51478239,66342224,63282905,,43077598,56332644,53101200,,8400641,10009580,10181705,PDP
MC429,,2012,1995,,51478239,66342224,63282905,,45463321,58532152,55878295,,6014918,7810072,7404610,PDP
MC429,,2013,1995,,51796652,66028078,63545420,,46969803,60500644,57735042,,4826849,5527434,5810378,PDP
MC429,,2014,1995,,55261548,70108789,67736421,,50595744,64479528,62068970,,4665804,5629261,5667451,PDP
MC429,,2015,1995,,57507709,72878705,70475450,,54433176,68987495,66708531,,3074533,3891210,3766919,PDP
MC429,,2016,1995,,65637487,80647277,79987536,,57922788,72231127,70775302,,7714699,8416150,9212234,PDP
MC429,,2017,1995,,71968699,87671596,87568627,,60951316,75367089,74361830,,11017383,12304507,13206797,PDP
MC429,,2017,1995,,71968699,87671596,87568627,,60951316,75367089,74361830,,11017383,12304507,13206797,PDP
MC431,,2013,2012,,1584805,1603485,1870123,,0,0,0,,1584805,1603485,1870123,PDP
MC431,,2014,2012,,1584805,1603485,1870123,,0,0,0,,1584805,1603485,1870123,PDP
MC431,,2015,2012,,1584805,1603485,1870123,,1322309,999217,1500106,,262496,604268,370017,PDP
MC431,,2016,2012,,5256502,4318967,6025002,,2889807,2192104,3279861,,2366695,2126863,2745141,PDP
MC431,,2017,2012,,10962028,8424740,12461092,,5799469,4282646,6561506,,5162559,4142094,5899587,PDP
MC431,,2017,2012,,10962028,8424740,12461092,,5799469,4282646,6561506,,5162559,4142094,5899587,PDP
MC445,,1994,1992,,549342,92240036,16962160,,67212,11899647,2184587,,482130,80340389,14777573,PDN
MC445,,1995,1992,,351480,67835711,12421891,,103736,20639538,3776252,,247744,47196173,8645639,PDN
MC445,,1996,1992,,160327,33508385,6122673,,131959,26984908,4933544,,28368,6523477,1189129,PDN
MC445,,1997,1992,,168686,35255461,6441900,,142443,29228445,5343234,,26243,6027016,1098666,PDN
MC445,,1998,1992,,168686,35255461,6441900,,154877,31439492,5749093,,13809,3815969,692807,PDN
MC445,,1999,1992,,156025,31654443,5788488,,156025,31654443,5788488,,0,0,0,PDN
MC445,,2000,1992,,156025,31654443,5788488,,156025,31654443,5788488,,0,0,0,PDN
MC445,,2001,1992,,156025,31654443,5788488,,156025,31654443,5788488,,0,0,0,PDN
MC445,,2002,1992,,156025,31654443,5788488,,156025,31654443,5788488,,0,0,0,PDN
MC445,,2003,1992,,156025,31654443,5788488,,156025,31654443,5788488,,0,0,0,PDN
MC445,,2004,1992,,156025,31654443,5788488,,156025,31654443,5788488,,0,0,0,PDN
MC445,,2005,1992,,156025,31654443,5788488,,156025,31654443,5788488,,0,0,0,PDN
MC445,,2006,1992,,156025,31654443,5788488,,156025,31654443,5788488,,0,0,0,PDN
MC445,,2007,1992,,156025,31654443,5788488,,156025,31654443,5788488,,0,0,0,PDN
MC445,,2008,1992,,156025,31654443,5788488,,156025,31654443,5788488,,0,0,0,PDN
MC445,,2009,1992,,156025,32271375,5898263,,156025,32271375,5898263,,0,0,0,PDN
MC445,,2010,1992,,156025,32271375,5898263,,156025,32271375,5898263,,0,0,0,PDN
MC445,,2011,1992,,156025,32271375,5898263,,156025,32271375,5898263,,0,0,0,PDN
MC445,,2012,1992,,156025,32271375,5898263,,156025,32271375,5898263,,0,0,0,PDN
MC445,,2013,1992,,156025,32271375,5898263,,156025,32271375,5898263,,0,0,0,PDN
MC445,,2014,1992,,156025,32271375,5898263,,156025,32271375,5898263,,0,0,0,PDN
MC445,,2015,1992,,156025,32271375,5898263,,156025,32271375,5898263,,0,0,0,PDN
MC445,,2016,1992,,156025,32271375,5898263,,156025,32271375,5898263,,0,0,0,PDN
MC445,,2017,1992,,156025,32271375,5898263,,156025,32271375,5898263,,0,0,0,PDN
MC445,,2017,1992,,156025,32271375,5898263,,156025,32271375,5898263,,0,0,0,PDN
MC486,,1980,1978,,5000000,76000000,18523132,,0,0,0,,5000000,76000000,18523132,PDN
MC486,,1981,1978,,5000000,76000000,18523132,,0,0,0,,5000000,76000000,18523132,PDN
MC486,,1982,1978,,5000000,76000000,18523132,,0,0,0,,5000000,76000000,18523132,PDN
MC486,,1983,1978,,5000000,76000000,18523132,,0,0,0,,5000000,76000000,18523132,PDN
MC486,,1990,1978,,6989,69877693,12440742,,0,0,0,,6989,69877693,12440742,PDN
MC486,,1991,1978,,1159835,69877693,13593588,,154251,9073161,1768692,,1005584,60804532,11824896,PDN
MC486,,1992,1978,,1159835,69877693,13593588,,339192,21266353,4123241,,820643,48611340,9470347,PDN
MC486,,1993,1978,,2212695,149968068,28897405,,617797,40400390,7806478,,1594898,109567678,21090927,PDN
MC486,,1994,1978,,2212695,149968068,28897405,,755159,51276489,9879089,,1457536,98691579,19018316,PDN
MC486,,1995,1978,,3932926,100226761,21766869,,863735,59643996,11476546,,3069191,40582765,10290323,PDN
MC486,,1996,1978,,4119425,119528963,25387924,,999995,70184531,13488346,,3119430,49344432,11899578,PDN
MC486,,1997,1978,,4115707,119212199,25327842,,1120083,80276481,15404154,,2995624,38935718,9923688,PDN
MC486,,1998,1978,,4661520,164498075,33931640,,1231404,91358084,17487291,,3430116,73139991,16444349,PDN
MC486,,1999,1978,,4661520,164498075,33931640,,1318657,102265396,19515347,,3342863,62232679,14416293,PDN
MC486,,2000,1978,,5313691,165384514,34741540,,1404387,113794042,21652437,,3909304,51590472,13089103,PDN
MC486,,2001,1978,,5231206,156901981,33149708,,1471036,122423509,23254579,,3760170,34478472,9895129,PDN
MC486,,2002,1978,,5219278,157587448,33259749,,1502786,127490513,24187931,,3716492,30096935,9071818,PDN
MC486,,2003,1978,,5218142,157598084,33260505,,1513049,129819674,24612635,,3705093,27778410,8647870,PDN
MC486,,2004,1978,,5222634,161794780,34011740,,1520561,131550950,24928203,,3702073,30243830,9083537,PDN
MC486,,2005,1978,,5381597,163163235,34414201,,1524768,132474937,25096821,,3856829,30688298,9317380,PDN
MC486,,2006,1978,,5349245,160546474,33916234,,1530080,133454356,25276407,,3819165,27092118,8639827,PDN
MC486,,2007,1978,,5339805,157641044,33389813,,1542766,135198599,25599456,,3797039,22442445,7790357,PDN
MC486,,2008,1978,,1555408,136984528,25929879,,1547892,135879554,25725749,,7516,1104974,204130,PDN
MC486,,2009,1978,,1547892,137635568,26038206,,1547892,137635568,26038206,,0,0,0,PDN
MC486,,2010,1978,,1547892,137635568,26038206,,1547892,137635568,26038206,,0,0,0,PDN
MC486,,2011,1978,,1547892,137635568,26038206,,1547892,137635568,26038206,,0,0,0,PDN
MC486,,2012,1978,,1547892,137635568,26038206,,1547892,137635568,26038206,,0,0,0,PDN
MC486,,2013,1978,,1547892,137635568,26038206,,1547892,137635568,26038206,,0,0,0,PDN
MC486,,2014,1978,,1547892,137635568,26038206,,1547892,137635568,26038206,,0,0,0,PDN
MC486,,2015,1978,,1547892,137635568,26038206,,1547892,137635568,26038206,,0,0,0,PDN
MC486,,2016,1978,,1547892,137635568,26038206,,1547892,137635568,26038206,,0,0,0,PDN
MC486,,2017,1978,,1547892,137635568,26038206,,1547892,137635568,26038206,,0,0,0,PDN
MC486,,2017,1978,,1547892,137635568,26038206,,1547892,137635568,26038206,,0,0,0,PDN
MC503,,2007,2007,,69107,105874066,18907909,,0,0,0,,69107,105874066,18907909,PDP
MC503,,2008,2007,,157690,100448561,18031099,,0,0,0,,157690,100448561,18031099,PDP
MC503,,2009,2007,,7027,54746188,9748342,,0,0,0,,7027,54746188,9748342,PDP
MC503,,2010,2007,,19880085,48158931,28449290,,2802,0,2802,,19877283,48158931,28446488,PDP
MC503,,2011,2007,,10900803,27216812,15743652,,1350788,1584626,1632750,,9550015,25632186,14110902,PDP
MC503,,2012,2007,,10900803,27216812,15743652,,3550871,6355102,4681672,,7349932,20861710,11061980,PDP
MC503,,2013,2007,,11154721,27546412,16056217,,5454242,11926756,7576441,,5700479,15619656,8479777,PDP
MC503,,2014,2007,,12724878,38036894,19493009,,8325508,19656201,11823052,,4399370,18380693,7669956,PDP
MC503,,2015,2007,,22746938,55683030,32654950,,10907847,26059620,15544789,,11839091,29623410,17110160,PDP
MC503,,2016,2007,,18030315,47821742,26539522,,12880348,31558746,18495784,,5149967,16262996,8043738,PDP
MC503,,2017,2007,,19331364,55361588,29182180,,14081296,37386710,20733735,,5250068,17974878,8448443,PDP
MC503,,2017,2007,,19331364,55361588,29182180,,14081296,37386710,20733735,,5250068,17974878,8448443,PDP
MC506,,2005,2005,,17365,173651682,30916241,,0,0,0,,17365,173651682,30916241,PDP
MC506,,2006,2005,,288347,173345572,31132755,,0,0,0,,288347,173345572,31132755,PDP
MC506,,2007,2005,,288347,173345572,31132755,,7713,4810118,863606,,280634,168535454,30269149,PDP
MC506,,2008,2005,,288347,173345572,31132755,,25883,15517394,2786985,,262464,157828178,28345770,PDP
MC506,,2009,2005,,304306,85895642,15588228,,38467,23142080,4156275,,265839,62753562,11431953,PDP
MC506,,2010,2005,,77842,45070744,8097547,,56809,33512897,6019958,,21033,11557847,2077589,PDP
MC506,,2011,2005,,77842,45070744,8097547,,77842,45070744,8097547,,0,0,0,PDP
MC506,,2012,2005,,77842,45070744,8097547,,77842,45070744,8097547,,0,0,0,PDP
MC506,,2013,2005,,77842,45070744,8097547,,77842,45070744,8097547,,0,0,0,PDP
MC506,,2014,2005,,110302,75790273,13596116,,79616,46744796,8397195,,30686,29045477,5198920,PDP
MC506,,2015,2005,,110302,75790273,13596116,,87660,52100177,9358154,,22642,23690096,4237962,PDP
MC506,,2016,2005,,102089,60632218,10890740,,93904,55407226,9952841,,8185,5224992,937899,PDP
MC506,,2017,2005,,102089,60632218,10890740,,95910,56721484,10188701,,6179,3910734,702039,PDP
MC506,,2017,2005,,102089,60632218,10890740,,95910,56721484,10188701,,6179,3910734,702039,PDP
MC522,,1993,1989,,8162972,167014326,37880824,,0,0,0,,8162972,167014326,37880824,PDP
MC522,,1994,1989,,7117608,166172733,36685710,,0,0,0,,7117608,166172733,36685710,PDP
MC522,,1995,1989,,7117608,166172733,36685710,,0,0,0,,7117608,166172733,36685710,PDP
MC522,,1996,1989,,5860780,208932393,43037362,,0,0,0,,5860780,208932393,43037362,PDP
MC522,,1997,1989,,5753517,215563088,44109938,,0,0,0,,5753517,215563088,44109938,PDP
MC522,,1998,1989,,5760165,215160551,44044961,,0,0,0,,5760165,215160551,44044961,PDP
MC522,,1999,1989,,5760165,215160551,44044961,,0,0,0,,5760165,215160551,44044961,PDP
MC522,,2000,1989,,5759260,215343707,44076646,,0,0,0,,5759260,215343707,44076646,PDP
MC522,,2001,1989,,5759260,215343707,44076646,,0,0,0,,5759260,215343707,44076646,PDP
MC522,,2002,1989,,5759260,215343707,44076646,,0,0,0,,5759260,215343707,44076646,PDP
MC522,,2003,1989,,17351551,238060971,59711155,,0,10374,1846,,17351551,238050597,59709309,PDP
MC522,,2004,1989,,32158282,303841759,86222652,,8510822,45922337,16682056,,23647460,257919422,69540596,PDP
MC522,,2005,1989,,32158282,303841759,86222652,,16111651,83597494,30986650,,16046631,220244265,55236002,PDP
MC522,,2006,1989,,37984490,312755857,93634999,,21326580,110368487,40965101,,16657910,202387370,52669898,PDP
MC522,,2007,1989,,38312135,318063710,94907102,,25293625,131406319,48675532,,13018510,186657391,46231570,PDP
MC522,,2008,1989,,65050749,397799071,135833501,,31457095,169259130,61574378,,33593654,228539941,74259123,PDP
MC522,,2009,1989,,71795856,254714528,117118726,,38166006,198210060,73434700,,33629850,56504468,43684026,PDP
MC522,,2010,1989,,78233019,277417614,127595584,,45084621,225182735,85152723,,33148398,52234879,42442861,PDP
MC522,,2011,1989,,70585089,302718979,124449676,,48688085,233602248,90254321,,21897004,69116731,34195355,PDP
MC522,,2012,1989,,70939180,302719660,124803888,,51325171,239995527,94029001,,19614009,62724133,30774887,PDP
MC522,,2013,1989,,70881169,301082060,124454489,,54476905,253054544,99504404,,16404264,48027516,24950085,PDP
MC522,,2014,1989,,77442941,320014483,134385020,,57812690,272433891,106288471,,19630251,47580592,28096549,PDP
MC522,,2015,1989,,70968271,329270020,129557243,,60692947,289121538,112138061,,10275324,40148482,17419182,PDP
MC522,,2016,1989,,68449837,336308605,128291225,,62634510,300275902,116064386,,5815327,36032703,12226839,PDP
MC522,,2017,1989,,74718802,337838943,134832492,,65932652,307787980,120699197,,8786150,30050963,14133297,PDP
MC522,,2017,1989,,74718802,337838943,134832492,,65932652,307787980,120699197,,8786150,30050963,14133297,PDP
MC546,,1998,1986,,35483789,141935157,60739155,,0,0,0,,35483789,141935157,60739155,PDP
MC546,,1999,1986,,35080945,164654759,64378945,,0,0,0,,35080945,164654759,64378945,PDP
MC546,,2000,1986,,35080945,164654759,64378945,,0,0,0,,35080945,164654759,64378945,PDP
MC546,,2001,1986,,38251039,146680163,64350712,,0,0,0,,38251039,146680163,64350712,PDP
MC546,,2002,1986,,38251039,146680163,64350712,,0,0,0,,38251039,146680163,64350712,PDP
MC546,,2007,1986,,8242162,329608243,66891316,,0,0,0,,8242162,329608243,66891316,PDP
MC546,,2008,1986,,36952958,461761984,119117012,,0,0,0,,36952958,461761984,119117012,PDP
MC546,,2009,1986,,5964583,282347549,56204360,,249000,9056648,1860503,,5715583,273290901,54343857,PDP
MC546,,2010,1986,,10585143,285642008,61411123,,1857162,73990713,15022769,,8727981,211651295,46388354,PDP
MC546,,2011,1986,,23749660,342376075,84670669,,3119488,136461395,27400875,,20630172,205914680,57269793,PDP
MC546,,2012,1986,,66035566,376648386,133054851,,7453805,175288513,38643931,,58581761,201359873,94410920,PDP
MC546,,2013,1986,,68249926,379175510,135718878,,16405451,218345698,55256998,,51844475,160829812,80461879,PDP
MC546,,2014,1986,,74466974,409954286,147412575,,28744421,264040529,75726721,,45722553,145913757,71685855,PDP
MC546,,2015,1986,,63667196,446435973,143104200,,39539386,299292848,92794342,,24127810,147143125,50309860,PDP
MC546,,2016,1986,,84876898,448461436,164674306,,48933142,334425559,108439469,,35943756,114035877,56234836,PDP
MC546,,2017,1986,,84876898,448461729,164674358,,56524306,365315606,121527082,,28352592,83146123,43147276,PDP
MC546,,2017,1986,,84876898,448461729,164674358,,56524306,365315606,121527082,,28352592,83146123,43147276,PDP
MC582,,1999,1998,,132483133,134907901,156488098,,0,0,0,,132483133,134907901,156488098,PDP
MC582,,2000,1998,,138884070,142988668,164326893,,0,0,0,,138884070,142988668,164326893,PDP
MC582,,2001,1998,,134110814,138096993,158683233,,0,0,0,,134110814,138096993,158683233,PDP
MC582,,2002,1998,,134110814,138096993,158683233,,0,0,0,,134110814,138096993,158683233,PDP
MC582,,2003,1998,,109907668,114091856,130208710,,1030773,1292471,1260750,,108876895,112799385,128947960,PDP
MC582,,2004,1998,,80647524,89603263,96591165,,11273882,13100669,13604962,,69373642,76502594,82986203,PDP
MC582,,2005,1998,,82393190,90737946,98538732,,21410404,24777566,25819224,,60982786,65960380,72719508,PDP
MC582,,2006,1998,,87114985,94916920,104004117,,31365990,36684858,37893545,,55748995,58232062,66110572,PDP
MC582,,2007,1998,,68723514,77972795,82597677,,37075383,43717942,44854376,,31648131,34254853,37743301,PDP
MC582,,2008,1998,,75315451,85710115,90566361,,41439311,48184493,50013064,,33876140,37525622,40553297,PDP
MC582,,2009,1998,,81192906,92668936,97682041,,46202243,53314105,55688739,,34990663,39354831,41993302,PDP
MC582,,2010,1998,,79690128,89259658,95572630,,50183379,57723786,60454513,,29506749,31535872,35118114,PDP
MC582,,2011,1998,,79690128,89259658,95572630,,54282094,62438390,65392128,,25408034,26821268,30180502,PDP
MC582,,2012,1998,,79690128,89259658,95572630,,57227437,65673577,68913127,,22462691,23586081,26659504,PDP
MC582,,2013,1998,,79690128,89259658,95572630,,59390430,67856879,71464607,,20299698,21402779,24108022,PDP
MC582,,2014,1998,,81922458,91248303,98158810,,61541808,70140862,74022391,,20380650,21107441,24136422,PDP
MC582,,2015,1998,,84532971,92682587,101024531,,64234382,72397802,77116552,,20298589,20284785,23907977,PDP
MC582,,2016,1998,,84494345,91373310,100752938,,67794847,76334988,81377586,,16699498,15038322,19375353,PDP
MC582,,2017,1998,,86242549,93893205,102949523,,69431468,77877086,83288599,,16811081,16016119,19660922,PDP
MC582,,2017,1998,,86242549,93893205,102949523,,69431468,77877086,83288599,,16811081,16016119,19660922,PDP
MC607,,1998,1997,,6243,62437197,11116065,,0,0,0,,6243,62437197,11116065,PDP
MC607,,1999,1997,,1633,16336374,2908461,,0,0,0,,1633,16336374,2908461,PDP
MC607,,2000,1997,,2103,21031402,3744345,,0,0,0,,2103,21031402,3744345,PDP
MC607,,2001,1997,,6713,67132225,11951949,,0,0,0,,6713,67132225,11951949,PDP
MC607,,2002,1997,,6713,67132225,11951949,,0,0,0,,6713,67132225,11951949,PDP
MC607,,2003,1997,,38532,88549691,15794705,,814,3211954,572336,,37718,85337737,15222369,PDP
MC607,,2004,1997,,27779,197380139,35148800,,11922,49119302,8752011,,15857,148260837,26396789,PDP
MC607,,2005,1997,,40557,158950887,28323633,,15750,89963650,16023517,,24807,68987237,12300116,PDP
MC607,,2006,1997,,40557,158950887,28323633,,29570,113399374,20207395,,10987,45551513,8116238,PDP
MC607,,2007,1997,,21839726,190612748,55756585,,29666,113554774,20235142,,21810060,77057974,35521443,PDP
MC607,,2008,1997,,21839726,190612748,55756585,,30370,113647370,20252322,,21809356,76965378,35504263,PDP
MC607,,2009,1997,,32499,119338697,21267143,,30762,113808874,20281451,,1737,5529823,985692,PDP
MC607,,2010,1997,,37003444,151979065,64045982,,31966,114005548,20317651,,36971478,37973517,43728331,PDP
MC607,,2011,1997,,47969123,155967152,75721285,,31966,114005548,20317651,,47937157,41961604,55403634,PDP
MC607,,2012,1997,,47969123,155967152,75721285,,8509617,121729957,30169752,,39459506,34237195,45551533,PDP
MC607,,2013,1997,,64496301,172462097,95183507,,22019028,134349280,45924594,,42477273,38112817,49258913,PDP
MC607,,2014,1997,,68322647,176712225,99766103,,34958794,146846477,61088060,,33363853,29865748,38678043,PDP
MC607,,2015,1997,,68322647,176712657,99766180,,43041791,155071802,70634638,,25280856,21640855,29131542,PDP
MC607,,2016,1997,,63414059,185483410,96418224,,49579196,161654656,78343370,,13834863,23828754,18074854,PDP
MC607,,2017,1997,,65942372,187617306,99326234,,54958672,166280250,84545906,,10983700,21337056,14780330,PDP
MC607,,2017,1997,,65942372,187617306,99326234,,54958672,166280250,84545906,,10983700,21337056,14780330,PDP
MC609,,2016,2016,,2039151,2086051,2410334,,0,0,0,,2039151,2086051,2410334,RJD
MC609,,2017,2016,,2039151,2086051,2410334,,0,0,0,,2039151,2086051,2410334,RJD
MC609,,2017,2016,,2039151,2086051,2410334,,0,0,0,,2039151,2086051,2410334,RJD
MC657,,1993,1987,,12075921,12075921,14224661,,0,0,0,,12075921,12075921,14224661,PDP
MC657,,1994,1987,,10039467,10039467,11825849,,0,0,0,,10039467,10039467,11825849,PDP
MC657,,1995,1987,,10039467,10039467,11825849,,0,0,0,,10039467,10039467,11825849,PDP
MC657,,1996,1987,,9155359,9155359,10784426,,0,0,0,,9155359,9155359,10784426,PDP
MC657,,1997,1987,,31542231,55006601,41329882,,0,0,0,,31542231,55006601,41329882,PDP
MC657,,1998,1987,,31542231,55006601,41329882,,0,0,0,,31542231,55006601,41329882,PDP
MC657,,1999,1987,,26993001,108298857,46263260,,0,0,0,,26993001,108298857,46263260,PDP
MC657,,2000,1987,,26993001,108298857,46263260,,0,0,0,,26993001,108298857,46263260,PDP
MC657,,2001,1987,,26993001,108298857,46263260,,0,0,0,,26993001,108298857,46263260,PDP
MC657,,2002,1987,,784322,326900800,58951724,,0,0,0,,784322,326900800,58951724,PDP
MC657,,2003,1987,,34417924,326900800,92585326,,0,0,0,,34417924,326900800,92585326,PDP
MC657,,2004,1987,,11539206,186380096,44702924,,1030230,12067514,3177474,,10508976,174312582,41525450,PDP
MC657,,2005,1987,,13811660,166716792,43476569,,3811122,44636502,11753560,,10000538,122080290,31723009,PDP
MC657,,2006,1987,,13811660,166716792,43476569,,6163681,75676221,19629201,,7647979,91040571,23847368,PDP
MC657,,2007,1987,,13811660,166716792,43476569,,8984696,103259322,27358241,,4826964,63457470,16118328,PDP
MC657,,2008,1987,,22369400,358166733,86100135,,10933067,129375636,33953643,,11436333,228791097,52146492,PDP
MC657,,2009,1987,,21342821,256260512,66940777,,12547100,156183331,40337728,,8795721,100077181,26603049,PDP
MC657,,2010,1987,,17910078,258989434,63993608,,14198457,182977486,46756729,,3711621,76011948,17236879,PDP
MC657,,2011,1987,,22920556,271618752,71251296,,15661352,201091792,51442810,,7259204,70526960,19808486,PDP
MC657,,2012,1987,,25907035,289105044,77349214,,18160008,215476257,56500979,,7747027,73628787,20848234,PDP
MC657,,2013,1987,,25907035,289105044,77349214,,20078808,228001600,60648488,,5828227,61103444,16700726,PDP
MC657,,2014,1987,,29176646,299822841,82525906,,22289838,239625420,64927813,,6886808,60197421,17598092,PDP
MC657,,2015,1987,,29176646,299822841,82525906,,24534398,245941002,68296142,,4642248,53881839,14229764,PDP
MC657,,2016,1987,,26717227,277989213,76181499,,26171385,249445652,70556732,,545842,28543561,5624767,PDP
MC657,,2017,1987,,29421453,313184062,85148155,,26816266,255563367,72290174,,2605187,57620695,12857979,PDP
MC657,,2017,1987,,29421453,313184062,85148155,,26816266,255563367,72290174,,2605187,57620695,12857979,PDP
MC682,,2003,2003,,22652631,33978948,28698707,,0,0,0,,22652631,33978948,28698707,PDP
MC682,,2004,2003,,22652631,33978948,28698707,,0,0,0,,22652631,33978948,28698707,PDP
MC682,,2005,2003,,220869229,331303847,279820091,,0,0,0,,220869229,331303847,279820091,PDP
MC682,,2006,2003,,178645984,450653730,258833480,,0,0,0,,178645984,450653730,258833480,PDP
MC682,,2007,2003,,224412058,556204923,323380906,,0,0,0,,224412058,556204923,323380906,PDP
MC682,,2008,2003,,224412058,556204923,323380906,,0,0,0,,224412058,556204923,323380906,PDP
MC682,,2011,2003,,224412058,556204923,323380906,,0,0,0,,224412058,556204923,323380906,PDP
MC682,,2012,2003,,224412058,556204923,323380906,,0,0,0,,224412058,556204923,323380906,PDP
MC682,,2013,2003,,224412058,556204923,323380906,,0,0,0,,224412058,556204923,323380906,PDP
MC682,,2014,2003,,194948338,539187976,290889257,,245066,393167,315025,,194703272,538794809,290574232,PDP
MC682,,2015,2003,,76590556,165519386,106042404,,9710932,21250644,13492186,,66879624,144268742,92550219,PDP
MC682,,2016,2003,,103323155,222212146,142862682,,13948655,30543815,19383498,,89374500,191668331,123479186,PDP
MC682,,2017,2003,,39746713,128822805,62668921,,21770102,53234214,31242383,,17976611,75588591,31426538,PDP
MC682,,2017,2003,,39746713,128822805,62668921,,21770102,53234214,31242383,,17976611,75588591,31426538,PDP
MC696,,2001,2001,,22890521,34335783,29000091,,0,0,0,,22890521,34335783,29000091,PDP
MC696,,2002,2001,,22890521,34335783,29000091,,0,0,0,,22890521,34335783,29000091,PDP
MC696,,2003,2001,,22890521,34335783,29000091,,0,0,0,,22890521,34335783,29000091,PDP
MC696,,2004,2001,,22890521,34335783,29000091,,0,0,0,,22890521,34335783,29000091,PDP
MC696,,2005,2001,,140192356,102425288,158417496,,0,0,0,,140192356,102425288,158417496,PDP
MC696,,2006,2001,,142723563,103690891,161173899,,0,0,0,,142723563,103690891,161173899,PDP
MC696,,2007,2001,,142723563,103690891,161173899,,0,1541,274,,142723563,103689350,161173625,PDP
MC696,,2008,2001,,115662440,94439276,132466582,,1090735,886355,1248449,,114571705,93552921,131218133,PDP
MC696,,2009,2001,,115662440,94439276,132466581,,19559713,15428631,22305021,,96102727,79010645,110161560,PDP
MC696,,2010,2001,,122583142,94534269,139404186,,36924326,28721984,42034999,,85658816,65812285,97369187,PDP
MC696,,2011,2001,,122583142,94534269,139404186,,50595626,39127428,57557802,,71987516,55406841,81846384,PDP
MC696,,2012,2001,,122583142,94534269,139404186,,60237657,46315807,68478904,,62345485,48218462,70925282,PDP
MC696,,2013,2001,,122583142,94603204,139416452,,65108065,49936403,73993546,,57475077,44666801,65422905,PDP
MC696,,2014,2001,,126942310,98260546,144426393,,68395175,52459291,77729568,,58547135,45801255,66696824,PDP
MC696,,2015,2001,,125615917,97550305,142973622,,70942783,54478391,80636447,,54673134,43071914,62337175,PDP
MC696,,2016,2001,,128161424,100058710,145965464,,72728739,55965019,82686927,,55432685,44093691,63278537,PDP
MC696,,2017,2001,,127457220,99720531,145201086,,76235457,58562648,86655857,,51221763,41157883,58545229,PDP
MC696,,2017,2001,,127457220,99720531,145201086,,76235457,58562648,86655857,,51221763,41157883,58545229,PDP
MC698,,2014,2012,,11875675,5937838,12932230,,0,0,0,,11875675,5937838,12932230,PDP
MC698,,2015,2012,,11875675,5937838,12932230,,1194155,543672,1290894,,10681520,5394166,11641336,PDP
MC698,,2016,2012,,21402322,10875145,23337401,,7268180,3561760,7901945,,14134142,7313385,15435456,PDP
MC698,,2017,2012,,21402322,10875145,23337401,,12244519,6337952,13372268,,9157803,4537193,9965133,PDP
MC698,,2017,2012,,21402322,10875145,23337401,,12244519,6337952,13372268,,9157803,4537193,9965133,PDP
MC705,,1995,1992,,8038467,124686258,30224634,,0,0,0,,8038467,124686258,30224634,PDP
MC705,,1999,1992,,1444181,57760529,11721855,,0,0,0,,1444181,57760529,11721855,PDP
MC705,,2000,1992,,1444293,58881378,11921407,,0,0,0,,1444293,58881378,11921407,PDP
MC705,,2001,1992,,7736744,57466109,17962030,,41014,794335,182355,,7695730,56671774,17779675,PDP
MC705,,2002,1992,,6163786,70735042,18750092,,1600780,14397206,4162560,,4563006,56337836,14587532,PDP
MC705,,2003,1992,,6163786,70735042,18750092,,3094978,30520692,8525706,,3068808,40214350,10224386,PDP
MC705,,2004,1992,,6163261,70724552,18747701,,3883195,39372639,10889003,,2280066,31351913,7858698,PDP
MC705,,2005,1992,,6163261,70724552,18747701,,4040580,40943691,11325934,,2122681,29780861,7421767,PDP
MC705,,2006,1992,,4041828,46834120,12375301,,4040580,40943691,11325934,,1248,5890429,1049367,PDP
MC705,,2007,1992,,4041828,46834120,12375301,,4040580,40943691,11325934,,1248,5890429,1049367,PDP
MC705,,2008,1992,,4040580,40943691,11325934,,4040580,40943691,11325934,,0,0,0,PDP
MC705,,2009,1992,,4040580,40943691,11325934,,4040580,40943691,11325934,,0,0,0,PDP
MC705,,2010,1992,,4040580,40943691,11325934,,4040580,40943691,11325934,,0,0,0,PDP
MC705,,2011,1992,,4040580,40943691,11325934,,4040580,40943691,11325934,,0,0,0,PDP
MC705,,2012,1992,,4040580,40943691,11325934,,4040580,40943691,11325934,,0,0,0,PDP
MC705,,2013,1992,,4040580,40943691,11325935,,4040580,40943691,11325935,,0,0,0,PDP
MC705,,2014,1992,,6135065,54507569,15833921,,4252109,42301118,11778999,,1882956,12206451,4054922,PDP
MC705,,2015,1992,,6135065,54507569,15833921,,4324186,42851651,11949036,,1810879,11655918,3884885,PDP
MC705,,2016,1992,,6135065,54507569,15833921,,4543566,44741019,12504602,,1591499,9766550,3329319,PDP
MC705,,2017,1992,,6135065,54507569,15833921,,4717035,46511210,12993051,,1418030,7996359,2840870,PDP
MC705,,2017,1992,,6135065,54507569,15833921,,4717035,46511210,12993051,,1418030,7996359,2840870,PDP
MC707,,2007,2007,,1745592,7055683,3001052,,2896,0,2896,,1742696,7055683,2998156,PDP
MC707,,2008,2007,,1824308,14927288,4480409,,153922,629333,265903,,1670386,14297955,4214506,PDP
MC707,,2009,2007,,3879382,11748320,5969831,,799371,3546498,1430420,,3080011,8201822,4539410,PDP
MC707,,2010,2007,,3879382,11748320,5969831,,1707187,5972558,2769920,,2172195,5775762,3199911,PDP
MC707,,2011,2007,,3879382,11748320,5969831,,2422256,7843063,3817819,,1457126,3905257,2152012,PDP
MC707,,2012,2007,,3879382,11748320,5969831,,2882133,8840616,4455197,,997249,2907704,1514634,PDP
MC707,,2013,2007,,8580326,16919358,11590889,,3296844,9730926,5028326,,5283482,7188432,6562563,PDP
MC707,,2014,2007,,8580326,16919358,11590889,,3561890,10283967,5391777,,5018436,6635391,6199110,PDP
MC707,,2015,2007,,8580326,16919358,11590889,,3727523,10594745,5612709,,4852803,6324613,5978179,PDP
MC707,,2016,2007,,8580326,16919358,11590889,,4068079,11233410,6066907,,4512247,5685948,5523982,PDP
MC707,,2017,2007,,8580326,16919358,11590889,,4077063,11249448,6078744,,4503263,5669910,5512144,PDP
MC707,,2017,2007,,8580326,16919358,11590889,,4077063,11249448,6078744,,4503263,5669910,5512144,PDP
MC718,,1996,1995,,18616999,45074078,26637298,,0,0,0,,18616999,45074078,26637298,PDN
MC718,,1997,1995,,18623105,45684677,26752051,,0,0,0,,18623105,45684677,26752051,PDN
MC718,,1998,1995,,18623082,45682378,26751619,,0,0,0,,18623082,45682378,26751619,PDN
MC718,,1999,1995,,18629493,93299674,35230859,,24815,115757,45412,,18604678,93183917,35185447,PDN
MC718,,2000,1995,,18629493,93299674,35230859,,2913309,14345358,5465864,,15716184,78954316,29764995,PDN
MC718,,2001,1995,,14553164,130720350,37813012,,4609197,27372464,9479742,,9943967,103347886,28333270,PDN
MC718,,2002,1995,,6504013,93618608,23162128,,5307403,33790139,11319883,,1196610,59828469,11842245,PDN
MC718,,2003,1995,,6504013,93618608,23162128,,5467964,34991974,11694294,,1036049,58626634,11467834,PDN
MC718,,2004,1995,,6512502,93675673,23180771,,5520750,35442471,11827240,,991752,58233202,11353531,PDN
MC718,,2005,1995,,6524382,100049548,24326792,,5520750,35442471,11827240,,1003632,64607077,12499552,PDN
MC718,,2006,1995,,6898977,99702509,24639636,,5521696,39924227,12625651,,1377281,59778282,12013985,PDN
MC718,,2007,1995,,6948561,99737412,24695431,,5939464,48206451,14517124,,1009097,51530961,10178307,PDN
MC718,,2008,1995,,6963333,100366273,24822101,,6469210,51754129,15678130,,494123,48612144,9143971,PDN
MC718,,2009,1995,,6485991,53735879,16047535,,6469210,51754129,15678130,,16781,1981750,369406,PDN
MC718,,2010,1995,,6469210,51754129,15678130,,6469210,51754129,15678130,,0,0,0,PDN
MC718,,2011,1995,,6469210,51754129,15678130,,6469210,51754129,15678130,,0,0,0,PDN
MC718,,2012,1995,,6469210,51754129,15678130,,6469210,51754129,15678130,,0,0,0,PDN
MC718,,2013,1995,,6469210,51754129,15678130,,6469210,51754129,15678130,,0,0,0,PDN
MC718,,2014,1995,,6469210,51754129,15678130,,6469210,51754129,15678130,,0,0,0,PDN
MC718,,2015,1995,,6469210,51754129,15678130,,6469210,51754129,15678130,,0,0,0,PDN
MC718,,2016,1995,,6469210,51754129,15678130,,6469210,51754129,15678130,,0,0,0,PDN
MC718,,2017,1995,,6469210,51754129,15678130,,6469210,51754129,15678130,,0,0,0,PDN
MC718,,2017,1995,,6469210,51754129,15678130,,6469210,51754129,15678130,,0,0,0,PDN
MC731,,1993,1986,,6653939,618170880,116648758,,0,0,0,,6653939,618170880,116648758,PDN
MC731,,1994,1986,,6653939,618170880,116648758,,0,0,0,,6653939,618170880,116648758,PDN
MC731,,1995,1986,,6658424,618587537,116727381,,0,0,0,,6658424,618587537,116727381,PDN
MC731,,1996,1986,,1505377,788222763,141758538,,0,0,0,,1505377,788222763,141758538,PDN
MC731,,1997,1986,,978701,782960640,140295541,,20925,16769626,3004844,,957776,766191014,137290697,PDN
MC731,,1998,1986,,978701,782960640,140295541,,99608,60632236,10888262,,879093,722328404,129407279,PDN
MC731,,1999,1986,,963976,650684060,116744058,,235750,153245935,27503710,,728226,497438125,89240348,PDN
MC731,,2000,1986,,915150,606743891,108876696,,348730,231241790,41494956,,566420,375502101,67381740,PDN
MC731,,2001,1986,,1087157,725132943,130114371,,460547,306933063,55074971,,626610,418199880,75039400,PDN
MC731,,2002,1986,,1087157,725132943,130114371,,574290,383111940,68743674,,512867,342021003,61370697,PDN
MC731,,2003,1986,,1113517,739931577,132773940,,716153,477096537,85608775,,397364,262835040,47165165,PDN
MC731,,2004,1986,,1188377,784327470,140748425,,839670,558524537,100221260,,348707,225802933,40527165,PDN
MC731,,2005,1986,,1188377,784327470,140748425,,926243,613269461,110048923,,262134,171058009,30699502,PDN
MC731,,2006,1986,,1188377,784327470,140748425,,1022691,673730063,120903485,,165686,110597407,19844940,PDN
MC731,,2007,1986,,1419710,937007713,168147061,,1121313,737172652,132290824,,298397,199835061,35856237,PDN
MC731,,2008,1986,,1419710,937007713,168147061,,1215038,798603642,143315330,,204672,138404071,24831731,PDN
MC731,,2009,1986,,1740485,895124455,161015299,,1260917,828755423,148726295,,479568,66369032,12289004,PDN
MC731,,2010,1986,,1355485,895124455,160630299,,1288993,847998574,152178419,,66492,47125881,8451880,PDN
MC731,,2011,1986,,1317838,869178819,155975991,,1303207,859996343,154327467,,14631,9182476,1648524,PDN
MC731,,2012,1986,,1317838,869178819,155975991,,1308105,864042444,155052312,,9733,5136375,923679,PDN
MC731,,2013,1986,,1309833,864904063,155207353,,1309833,864904063,155207353,,0,0,0,PDN
MC731,,2014,1986,,1309833,864904063,155207353,,1309833,864904063,155207353,,0,0,0,PDN
MC731,,2015,1986,,1309833,864904436,155207419,,1309833,864904436,155207419,,0,0,0,PDN
MC731,,2016,1986,,1309833,864904436,155207419,,1309833,864904436,155207419,,0,0,0,PDN
MC731,,2017,1986,,1309833,864904436,155207419,,1309833,864904436,155207419,,0,0,0,PDN
MC731,,2017,1986,,1309833,864904436,155207419,,1309833,864904436,155207419,,0,0,0,PDN
MC751,,2002,2002,,6173715,16350042,9082975,,0,0,0,,6173715,16350042,9082975,PDP
MC751,,2003,2002,,6173715,16350042,9082975,,0,0,0,,6173715,16350042,9082975,PDP
MC751,,2004,2002,,6173715,16350042,9082975,,0,0,0,,6173715,16350042,9082975,PDP
MC751,,2005,2002,,6173715,16350042,9082975,,0,0,0,,6173715,16350042,9082975,PDP
MC751,,2006,2002,,6173715,16350042,9082975,,0,0,0,,6173715,16350042,9082975,PDP
MC751,,2007,2002,,6173715,16350042,9082975,,0,0,0,,6173715,16350042,9082975,PDP
MC751,,2009,2002,,5104579,7656869,6467011,,0,0,0,,5104579,7656869,6467011,PDP
MC751,,2010,2002,,5104579,7656869,6467011,,0,0,0,,5104579,7656869,6467011,PDP
MC751,,2011,2002,,5104579,7656869,6467011,,1004,0,1004,,5103575,7656869,6466007,PDP
MC751,,2012,2002,,5104579,7656869,6467011,,78994,403472,150786,,5025585,7253397,6316225,PDP
MC751,,2013,2002,,5104579,7656869,6467011,,549682,1937175,894375,,4554897,5719694,5572636,PDP
MC751,,2014,2002,,5104579,7656869,6467011,,849716,2599449,1312251,,4254863,5057420,5154760,PDP
MC751,,2015,2002,,5104579,7656869,6467011,,915615,2729210,1401240,,4188964,4927659,5065772,PDP
MC751,,2016,2002,,5104579,7656869,6467011,,1029119,2942931,1552772,,4075460,4713938,4914239,PDP
MC751,,2017,2002,,5104579,7656869,6467011,,1184669,3261972,1765091,,3919910,4394897,4701920,PDP
MC751,,2017,2002,,5104579,7656869,6467011,,1184669,3261972,1765091,,3919910,4394897,4701920,PDP
MC755,,1997,1986,,25364302,17273090,28437806,,0,0,0,,25364302,17273090,28437806,PDN
MC755,,1998,1986,,25364302,17273090,28437806,,0,0,0,,25364302,17273090,28437806,PDN
MC755,,1999,1986,,25364302,17273090,28437806,,0,0,0,,25364302,17273090,28437806,PDN
MC755,,2000,1986,,25364302,17273090,28437806,,0,0,0,,25364302,17273090,28437806,PDN
MC755,,2001,1986,,25364302,17273090,28437806,,0,0,0,,25364302,17273090,28437806,PDN
MC755,,2002,1986,,25364302,17273090,28437806,,0,0,0,,25364302,17273090,28437806,PDN
MC755,,2003,1986,,25364302,17273090,28437806,,0,0,0,,25364302,17273090,28437806,PDN
MC755,,2004,1986,,25339472,44169661,33198842,,0,0,0,,25339472,44169661,33198842,PDN
MC755,,2005,1986,,25339472,44169661,33198842,,0,0,0,,25339472,44169661,33198842,PDN
MC755,,2006,1986,,27298709,60608341,38083111,,2794028,7388452,4108699,,24504681,53219889,33974412,PDN
MC755,,2007,1986,,27810837,57832137,38101253,,6752973,21689905,10612387,,21057864,36142232,27488866,PDN
MC755,,2008,1986,,19578942,52226216,28871863,,10744114,33228127,16656592,,8834828,18998089,12215271,PDN
MC755,,2009,1986,,23611140,76534327,37229348,,13425913,40698303,20667604,,10185227,35836024,16561744,PDN
MC755,,2010,1986,,23980224,75765510,37461630,,16085587,49158561,24832663,,7894637,26606949,12628969,PDN
MC755,,2011,1986,,23980224,75765510,37461630,,18323447,59171365,28852159,,5656777,16594145,8609472,PDN
MC755,,2012,1986,,19876704,64312993,31320298,,19571721,63728625,30911334,,304983,584368,408964,PDN
MC755,,2013,1986,,19876704,64312994,31320298,,19876704,64312994,31320298,,0,0,0,PDN
MC755,,2014,1986,,19876704,64312994,31320298,,19876704,64312994,31320298,,0,0,0,PDN
MC755,,2015,1986,,19876704,64312994,31320298,,19876704,64312994,31320298,,0,0,0,PDN
MC755,,2016,1986,,19876704,64312994,31320298,,19876704,64312994,31320298,,0,0,0,PDN
MC755,,2017,1986,,19876704,64312994,31320298,,19876704,64312994,31320298,,0,0,0,PDN
MC755,,2017,1986,,19876704,64312994,31320298,,19876704,64312994,31320298,,0,0,0,PDN
MC768,,2017,2014,,149242848,152675434,176409295,,0,0,0,,149242848,152675434,176409295,RJD
MC768,,2017,2014,,149242848,152675434,176409295,,0,0,0,,149242848,152675434,176409295,RJD
MC773,,1999,1999,,24750797,49501593,33558910,,0,0,0,,24750797,49501593,33558910,PDP
MC773,,2000,1999,,24750421,49500842,33558400,,0,0,0,,24750421,49500842,33558400,PDP
MC773,,2001,1999,,24750421,49500842,33558400,,0,0,0,,24750421,49500842,33558400,PDP
MC773,,2002,1999,,45314050,64923565,56866286,,0,0,0,,45314050,64923565,56866286,PDP
MC773,,2003,1999,,57015971,57446358,67237743,,0,0,0,,57015971,57446358,67237743,PDP
MC773,,2004,1999,,53548405,53197239,63014106,,3039582,3192830,3607701,,50508823,50004409,59406405,PDP
MC773,,2005,1999,,76521786,80640411,90870614,,8455598,9228060,10097602,,68066188,71412351,80773012,PDP
MC773,,2006,1999,,81507737,83021684,96280279,,20691974,20867227,24405004,,60815763,62154457,71875275,PDP
MC773,,2007,1999,,94613248,92624006,111094388,,34761660,31684352,40399445,,59851588,60939654,70694943,PDP
MC773,,2008,1999,,96105314,85820562,111375877,,43393216,39000475,50332802,,52712098,46820087,61043075,PDP
MC773,,2009,1999,,90371280,77043615,104080107,,50462201,44456187,58372555,,39909079,32587428,45707554,PDP
MC773,,2010,1999,,85200927,73587034,98294702,,56714988,49287803,65485059,,28485939,24299231,32809644,PDP
MC773,,2011,1999,,94916119,79273478,109021716,,61891043,53540119,71417753,,33025076,25733359,37603965,PDP
MC773,,2012,1999,,98255981,81717420,112796443,,67867471,57563271,78110044,,30388510,24154149,34686402,PDP
MC773,,2013,1999,,98264232,81392498,112746884,,72324392,60507337,83090821,,25939840,20885161,29656061,PDP
MC773,,2014,1999,,99030496,81583326,113547102,,75922139,63207528,87169030,,23108357,18375798,26378072,PDP
MC773,,2015,1999,,103444253,85373141,118635203,,79201247,65781658,90906167,,24243006,19591483,27729036,PDP
MC773,,2016,1999,,120442524,98311775,137935720,,84608487,70373955,97130542,,35834037,27937820,40805179,PDP
MC773,,2017,1999,,114214604,91757173,130541505,,89300874,74801812,102610806,,24913730,16955361,27930699,PDP
MC773,,2017,1999,,114214604,91757173,130541505,,89300874,74801812,102610806,,24913730,16955361,27930699,PDP
MC776,,2000,2000,,505845939,604648158,613434579,,0,0,0,,505845939,604648158,613434579,PDP
MC776,,2001,2000,,505683651,604469642,613240527,,0,0,0,,505683651,604469642,613240527,PDP
MC776,,2002,2000,,505683651,604469642,613240527,,0,0,0,,505683651,604469642,613240527,PDP
MC776,,2003,2000,,347076258,396791116,417679659,,0,0,0,,347076258,396791116,417679659,PDP
MC776,,2004,2000,,364530383,411436761,437739771,,0,0,0,,364530383,411436761,437739771,PDP
MC776,,2005,2000,,550249172,596867260,656453310,,0,0,0,,550249172,596867260,656453310,PDP
MC776,,2006,2000,,533974880,565198951,634544088,,0,0,0,,533974880,565198951,634544088,PDP
MC776,,2007,2000,,429857043,490985668,517221041,,0,0,0,,429857043,490985668,517221041,PDP
MC776,,2008,2000,,429857043,490985668,517221041,,0,0,0,,429857043,490985668,517221041,PDP
MC776,,2009,2000,,391209122,392371384,461026094,,36790317,34017169,42843194,,354418805,358354215,418182900,PDP
MC776,,2010,2000,,322862624,315659898,379029866,,93353857,87000023,108834288,,229508767,228659875,270195577,PDP
MC776,,2011,2000,,322052397,304262812,376191687,,126853633,118983734,148025116,,195198764,185279078,228166570,PDP
MC776,,2012,2000,,269783387,262264091,316449595,,149089546,139924950,173987223,,120693841,122339141,142462370,PDP
MC776,,2013,2000,,273790514,265977267,321117430,,161857612,152567161,189004794,,111932902,113410106,132112638,PDP
MC776,,2014,2000,,282395854,273247416,331016391,,177896527,168611021,207898489,,104499327,104636395,123117903,PDP
MC776,,2015,2000,,273228269,259663747,319431783,,194925307,184570627,227767055,,78302962,75093120,91664727,PDP
MC776,,2016,2000,,289954762,279655824,339715584,,218581699,209085192,255785470,,71373063,70570632,83930116,PDP
MC776,,2017,2000,,289954545,279655824,339715367,,244697472,237223471,286908054,,45257073,42432353,52807315,PDP
MC776,,2017,2000,,289954545,279655824,339715367,,244697472,237223471,286908054,,45257073,42432353,52807315,PDP
MC778,,1999,1999,,597038627,669625447,716189062,,0,0,0,,597038627,669625447,716189062,PDP
MC778,,2000,1999,,757403033,757963257,892271940,,0,0,0,,757403033,757963257,892271940,PDP
MC778,,2001,1999,,757904721,758464945,892862896,,0,0,0,,757904721,758464945,892862896,PDP
MC778,,2002,1999,,757351516,757927195,892214006,,0,0,0,,757351516,757927195,892214006,PDP
MC778,,2003,1999,,653089335,518327066,745318350,,0,0,0,,653089335,518327066,745318350,PDP
MC778,,2004,1999,,653089335,518327066,745318350,,0,0,0,,653089335,518327066,745318350,PDP
MC778,,2005,1999,,653089335,518327066,745318350,,32430,0,32430,,653056905,518327066,745285920,PDP
MC778,,2006,1999,,642678951,498442805,731369842,,32430,0,32430,,642646521,498442805,731337412,PDP
MC778,,2007,1999,,642678951,498442805,731369842,,0,0,0,,642678951,498442805,731369842,PDP
MC778,,2008,1999,,733146354,647714021,848397959,,12529890,9148842,14157798,,720616464,638565179,834240161,PDP
MC778,,2009,1999,,733146354,647714021,848397957,,48777774,37704057,55486681,,684368580,610009964,792911276,PDP
MC778,,2010,1999,,733146354,647714021,848397957,,63969082,50851498,73017391,,669177272,596862523,775380566,PDP
MC778,,2011,1999,,244971009,167859109,274839176,,73533677,59317438,84088383,,171437332,108541671,190750794,PDP
MC778,,2012,1999,,223670415,169930878,253907228,,78455577,63430405,89742126,,145214838,106500473,164165101,PDP
MC778,,2013,1999,,223670415,169995630,253918750,,82457003,66889261,94359008,,141213412,103106369,159559742,PDP
MC778,,2014,1999,,213822102,166769019,243496305,,96158260,76434152,109758641,,117663842,90334867,133737661,PDP
MC778,,2015,1999,,220946315,170160258,251223942,,109559419,85368477,124749538,,111386896,84791781,126474402,PDP
MC778,,2016,1999,,225646614,175243575,256828743,,120834688,92726786,137334118,,104811926,82516789,119494629,PDP
MC778,,2017,1999,,322829989,239090450,365372772,,144950906,109270386,164394034,,177879083,129820064,200978740,PDP
MC778,,2017,1999,,322829989,239090450,365372772,,144950906,109270386,164394034,,177879083,129820064,200978740,PDP
MC782,,2015,2013,,22806056,24878531,27232841,,480752,579730,583907,,22325304,24298801,26648934,PDP
MC782,,2016,2013,,39710974,41626576,47117838,,7037972,7578731,8386501,,32673002,34047845,38731337,PDP
MC782,,2017,2013,,20821964,21472002,24642605,,10542834,12925128,12842679,,10279130,8546874,11799926,PDP
MC782,,2017,2013,,20821964,21472002,24642605,,10542834,12925128,12842679,,10279130,8546874,11799926,PDP
MC794,,2017,2015,,9357235,10533900,11231595,,0,0,0,,9357235,10533900,11231595,RJD
MC794,,2017,2015,,9357235,10533900,11231595,,0,0,0,,9357235,10533900,11231595,RJD
MC800,,2009,2008,,6789002,10183504,8601013,,0,0,0,,6789002,10183504,8601013,PDP
MC800,,2010,2008,,6789002,10183504,8601013,,0,0,0,,6789002,10183504,8601013,PDP
MC800,,2011,2008,,6789002,10183504,8601013,,1300423,1944916,1646493,,5488579,8238588,6954520,PDP
MC800,,2012,2008,,6789002,10183504,8601013,,2343175,3486039,2963467,,4445827,6697465,5637547,PDP
MC800,,2013,2008,,6789002,10183504,8601013,,3085182,4501809,3886216,,3703820,5681695,4714798,PDP
MC800,,2014,2008,,6789002,10183504,8601013,,3763401,5426891,4729040,,3025601,4756613,3871973,PDP
MC800,,2015,2008,,6789002,10183504,8601013,,4438497,6357579,5569739,,2350505,3825925,3031274,PDP
MC800,,2016,2008,,6789002,10183504,8601013,,4856662,6902370,6084842,,1932340,3281134,2516172,PDP
MC800,,2017,2008,,6789002,10183504,8601013,,5293282,7450563,6619005,,1495720,2732941,1982008,PDP
MC800,,2017,2008,,6789002,10183504,8601013,,5293282,7450563,6619005,,1495720,2732941,1982008,PDP
MC807,,1993,1989,,161304440,227568474,201797051,,0,0,0,,161304440,227568474,201797051,PDP
MC807,,1994,1989,,203097697,285946946,253977937,,0,0,0,,203097697,285946946,253977937,PDP
MC807,,1995,1989,,203097697,285946946,253977937,,0,0,0,,203097697,285946946,253977937,PDP
MC807,,1996,1989,,346160670,406267604,418450279,,5594570,6530547,6756589,,340566100,399737057,411693690,PDP
MC807,,1997,1989,,686473090,1077663739,878228204,,37587434,39070684,44539513,,648885656,1038593055,833688691,PDP
MC807,,1998,1989,,705334114,961530386,876424930,,80773487,81481822,95272032,,624560627,880048564,781152898,PDP
MC807,,1999,1989,,714610165,1028107505,897547444,,140734770,150297880,167478165,,573875395,877809625,730069279,PDP
MC807,,2000,1989,,745492858,1058885302,933906613,,224754370,260447060,271097263,,520738488,798438242,662809350,PDP
MC807,,2001,1989,,1071049815,1467753696,1332215953,,321622783,392572768,391475589,,749427032,1075180928,940740364,PDP
MC807,,2002,1989,,1209972572,1759887057,1523119736,,414631297,510084330,505393633,,795341275,1249802727,1017726103,PDP
MC807,,2003,1989,,1371072477,1833921521,1697393032,,511421942,640347489,625362776,,859650535,1193574032,1072030256,PDP
MC807,,2004,1989,,1287241138,1791366486,1605989623,,610946206,790310589,751570866,,676294932,1001055897,854418757,PDP
MC807,,2005,1989,,1355586046,1866699894,1687739052,,673096608,875719452,828918575,,682489438,990980442,858820477,PDP
MC807,,2006,1989,,1355586067,1866709497,1687740782,,734663085,959606267,905411531,,620922982,907103230,782329251,PDP
MC807,,2007,1989,,1294904780,1804086932,1615916690,,809891559,1057727663,998099328,,485013221,746359269,617817362,PDP
MC807,,2008,1989,,1373124546,1906254316,1712315706,,871773960,1135246798,1073775170,,501350586,771007518,638540536,PDP
MC807,,2009,1989,,1325901979,1871387911,1658889152,,938524828,1215687038,1154839248,,387377151,655700873,504049904,PDP
MC807,,2010,1989,,1348975647,1889372948,1685163004,,994395905,1285293336,1223095787,,354579742,604079612,462067217,PDP
MC807,,2011,1989,,1370824610,1928466725,1713968155,,1044503054,1347872998,1284338107,,326321556,580593727,429630048,PDP
MC807,,2012,1989,,1400428480,1963128549,1749739609,,1085532827,1397043034,1334116994,,314895653,566085515,415622613,PDP
MC807,,2013,1989,,1391526095,1952771867,1738994397,,1124542201,1445748036,1381792736,,266983894,507023831,357201659,PDP
MC807,,2014,1989,,1456064520,2039249777,1818920349,,1174155475,1506302479,1442180824,,281909045,532947298,376739524,PDP
MC807,,2015,1989,,1486050002,2050909244,1850980469,,1225220574,1569302189,1504455836,,260829428,481607055,346524633,PDP
MC807,,2016,1989,,1696609991,2291824945,2104408023,,1282474004,1648264411,1575759483,,414135987,643560534,528648537,PDP
MC807,,2017,1989,,1871251106,2542742059,2323696311,,1352910698,1740915317,1662682104,,518340408,801826742,661014206,PDP
MC807,,2017,1989,,1871251106,2542742059,2323696311,,1352910698,1740915317,1662682104,,518340408,801826742,661014206,PDP
MC876,,2003,2001,,4680,46810388,8333931,,0,0,0,,4680,46810388,8333931,PDN
MC876,,2004,2001,,93629,46814152,8423549,,0,0,0,,93629,46814152,8423549,PDN
MC876,,2005,2001,,93629,46814152,8423549,,0,0,0,,93629,46814152,8423549,PDN
MC876,,2006,2001,,93632,46815465,8423786,,0,0,0,,93632,46815465,8423786,PDN
MC876,,2007,2001,,93632,46815465,8423786,,0,0,0,,93632,46815465,8423786,PDN
MC876,,2008,2001,,93632,46815465,8423786,,0,0,0,,93632,46815465,8423786,PDN
MC876,,2010,2001,,38914,19457042,3501021,,0,0,0,,38914,19457042,3501021,PDN
MC876,,2011,2001,,23655,38914084,6947869,,2047,11540750,2055561,,21608,27373334,4892308,PDN
MC876,,2012,2001,,23655,38914084,6947869,,3613,22158168,3946348,,20042,16755916,3001522,PDN
MC876,,2013,2001,,23655,38914084,6947869,,4422,30717701,5470205,,19233,8196383,1477664,PDN
MC876,,2014,2001,,8122,56817833,10118057,,5621,39780860,7084066,,2501,17036973,3033991,PDN
MC876,,2015,2001,,49643,64149459,11464137,,5621,52888782,9416436,,44022,11260677,2047701,PDN
MC876,,2016,2001,,5621,52897674,9418018,,5621,52897674,9418018,,0,0,0,PDN
MC876,,2017,2001,,5621,52897674,9418018,,5621,52897674,9418018,,0,0,0,PDN
MC876,,2017,2001,,5621,52897674,9418018,,5621,52897674,9418018,,0,0,0,PDN
MC899,,1997,1998,,26244266,43821263,34041644,,0,0,0,,26244266,43821263,34041644,PDP
MC899,,1998,1998,,187087238,285560363,237898690,,0,0,0,,187087238,285560363,237898690,PDP
MC899,,1999,1998,,192424809,322194667,249754821,,0,0,0,,192424809,322194667,249754821,PDP
MC899,,2000,1998,,61309015,102567023,79559375,,0,0,0,,61309015,102567023,79559375,PDP
MC899,,2001,1998,,77421098,112430887,97426594,,0,0,0,,77421098,112430887,97426594,PDP
MC899,,2002,1998,,77421098,112430887,97426594,,14411112,19153518,17819211,,63009986,93277369,79607383,PDP
MC899,,2003,1998,,77421098,112430887,97426594,,24220781,31670578,29856115,,53200317,80760309,67570479,PDP
MC899,,2004,1998,,103515458,157729893,131581275,,29132235,38342150,35954682,,74383223,119387743,95626593,PDP
MC899,,2005,1998,,103515458,157729893,131581275,,31512369,41657968,38924819,,72003089,116071925,92656456,PDP
MC899,,2006,1998,,104532975,159357920,132888477,,33740534,44799728,41712016,,70792441,114558192,91176461,PDP
MC899,,2007,1998,,105927617,160823749,134543942,,35312345,47137178,43699743,,70615272,113686571,90844199,PDP
MC899,,2008,1998,,59644632,85654238,74885599,,36384756,48619487,45035910,,23259876,37034751,29849689,PDP
MC899,,2009,1998,,55083485,74469228,68334236,,37348253,49971486,46239977,,17735232,24497742,22094260,PDP
MC899,,2010,1998,,53655247,73199359,66680043,,38845155,51868809,48074480,,14810092,21330550,18605563,PDP
MC899,,2011,1998,,54915608,75018308,68264061,,42673265,56294077,52690004,,12242343,18724231,15574057,PDP
MC899,,2012,1998,,61112407,82008138,75704602,,46146644,60506867,56912991,,14965763,21501271,18791613,PDP
MC899,,2013,1998,,61112407,82008138,75704602,,48758614,63410504,60041623,,12353793,18597634,15662981,PDP
MC899,,2014,1998,,61112407,82008138,75704602,,51150724,66223439,62934253,,9961683,15784699,12770349,PDP
MC899,,2015,1998,,62360176,83879060,77285275,,52790174,68194174,64924368,,9570002,15684886,12360907,PDP
MC899,,2016,1998,,76579411,105695440,95386430,,54297433,70042155,66760450,,22281978,35653285,28625978,PDP
MC899,,2017,1998,,75774676,103876128,94257974,,54523573,70314866,67035116,,21251103,33561262,27222857,PDP
MC899,,2017,1998,,75774676,103876128,94257974,,54523573,70314866,67035116,,21251103,33561262,27222857,PDP
MC935,,1995,1994,,76084283,68475855,88268599,,0,0,0,,76084283,68475855,88268599,PDP
MC935,,1996,1994,,76084283,68475855,88268599,,0,0,0,,76084283,68475855,88268599,PDP
MC935,,1997,1994,,115101739,86382223,130472241,,0,0,0,,115101739,86382223,130472241,PDP
MC935,,1998,1994,,115101739,86382224,130472242,,0,0,0,,115101739,86382224,130472242,PDP
MC935,,1999,1994,,115101739,87707216,130708006,,0,0,0,,115101739,87707216,130708006,PDP
MC935,,2000,1994,,115101739,87707216,130708006,,10245457,7698265,11615255,,104856282,80008951,119092751,PDP
MC935,,2001,1994,,76400966,64053734,87798427,,18379293,14108671,20889733,,58021673,49945063,66908694,PDP
MC935,,2002,1994,,68389535,57284370,78582483,,25178826,20297893,28790551,,43210709,36986477,49791932,PDP
MC935,,2003,1994,,68389535,57284370,78582483,,29320537,24091735,33607323,,39068998,33192635,44975160,PDP
MC935,,2004,1994,,64637321,53282456,74118185,,30174760,24798949,34587384,,34462561,28483507,39530801,PDP
MC935,,2005,1994,,80669863,135824600,104837941,,31835223,26200269,36497193,,48834640,109624331,68340748,PDP
MC935,,2006,1994,,80669863,135824600,104837941,,35898372,34824153,42094841,,44771491,101000447,62743100,PDP
MC935,,2007,1994,,85029123,109900876,104584439,,43420110,57295922,53615114,,41609013,52604954,50969325,PDP
MC935,,2008,1994,,85029123,109900876,104584439,,48616421,70552310,61170213,,36412702,39348566,43414226,PDP
MC935,,2009,1994,,69046408,96911953,86290528,,52621600,78065520,66512262,,16424808,18846433,19778266,PDP
MC935,,2010,1994,,69046408,96911953,86290528,,54512124,80372641,68813305,,14534284,16539312,17477222,PDP
MC935,,2011,1994,,69046408,96911953,86290528,,56383373,81971196,70968994,,12663035,14940757,15321533,PDP
MC935,,2012,1994,,70893238,98638739,88444615,,57839918,83312744,72664249,,13053320,15325995,15780366,PDP
MC935,,2013,1994,,70893238,98638739,88444615,,59440269,85041410,74572192,,11452969,13597329,13872422,PDP
MC935,,2014,1994,,79419038,107726839,98587515,,62823312,88185778,78514730,,16595726,19541061,20072784,PDP
MC935,,2015,1994,,96299868,123348530,118248006,,67888459,92832195,84406643,,28411409,30516335,33841361,PDP
MC935,,2016,1994,,88407470,115320129,108927067,,70897675,95509501,87892249,,17509795,19810628,21034817,PDP
MC935,,2017,1994,,83494883,122387529,105272024,,73442210,97867012,90856269,,10052673,24520517,14415755,PDP
MC935,,2017,1994,,83494883,122387529,105272024,,73442210,97867012,90856269,,10052673,24520517,14415755,PDP
MC948,,2008,2008,,122457555,580402637,225732046,,0,0,0,,122457555,580402637,225732046,PDP
MC948,,2014,2008,,43593661,121431329,65200660,,0,0,0,,43593661,121431329,65200660,PDP
MC948,,2015,2008,,55942570,133273337,79656688,,0,0,0,,55942570,133273337,79656688,PDP
MC948,,2016,2008,,55942570,131547049,79349519,,3197091,5090741,4102916,,52745479,126456308,75246602,PDP
MC948,,2017,2008,,54695081,129704320,77774142,,10003911,15839909,12822401,,44691170,113864411,64951742,PDP
MC948,,2017,2008,,54695081,129704320,77774142,,10003911,15839909,12822401,,44691170,113864411,64951742,PDP
MC961,,2005,2005,,195626,97812369,17599962,,0,0,0,,195626,97812369,17599962,PDN
MC961,,2006,2005,,195626,97812369,17599962,,0,0,0,,195626,97812369,17599962,PDN
MC961,,2007,2005,,6000,99533407,17716571,,1800,6790342,1210046,,4200,92743065,16506525,PDN
MC961,,2008,2005,,16645,122502655,21814270,,11193,33667989,6001938,,5452,88834666,15812332,PDN
MC961,,2009,2005,,34592,98391664,17542006,,25309,76342024,13609299,,9283,22049640,3932706,PDN
MC961,,2010,2005,,33629,95851240,17089010,,33629,95651240,17053423,,0,200000,35587,PDN
MC961,,2011,2005,,33629,95651240,17053423,,33629,95651240,17053423,,0,0,0,PDN
MC961,,2012,2005,,33629,95651240,17053423,,33629,95651240,17053423,,0,0,0,PDN
MC961,,2013,2005,,33629,95651240,17053423,,33629,95651240,17053423,,0,0,0,PDN
MC961,,2014,2005,,33629,95651240,17053423,,33629,95651240,17053423,,0,0,0,PDN
MC961,,2015,2005,,33629,95651240,17053423,,33629,95651240,17053423,,0,0,0,PDN
MC961,,2016,2005,,33629,95651240,17053423,,33629,95651240,17053423,,0,0,0,PDN
MC961,,2017,2005,,33629,95651240,17053423,,33629,95651240,17053423,,0,0,0,PDN
MC961,,2017,2005,,33629,95651240,17053423,,33629,95651240,17053423,,0,0,0,PDN
MI004A,,1986,1984,,10405,3144518,569928,,0,0,0,,10405,3144518,569928,PDN
MI004A,,1987,1984,,10405,3144518,569928,,0,0,0,,10405,3144518,569928,PDN
MI004A,,1989,1984,,9661,17811659,3178995,,1421,2669889,476490,,8240,15141770,2702505,PDN
MI004A,,1990,1984,,11189,20832678,3718071,,3907,8224119,1467273,,7282,12608559,2250798,PDN
MI004A,,1991,1984,,11490,24267008,4329463,,6051,13026690,2323967,,5439,11240318,2005496,PDN
MI004A,,1992,1984,,11722,24267008,4329695,,6790,14058593,2508319,,4932,10208415,1821376,PDN
MI004A,,1993,1984,,11802,24267008,4329775,,6976,14289207,2549540,,4826,9977801,1780235,PDN
MI004A,,1994,1984,,11802,24267008,4329775,,7283,14669858,2617578,,4519,9597150,1712197,PDN
MI004A,,1995,1984,,9803,21573647,3848530,,7488,15805970,2819938,,2315,5767677,1028592,PDN
MI004A,,1996,1984,,9770,21573647,3848497,,7488,16299676,2907786,,2282,5273971,940711,PDN
MI004A,,1997,1984,,9770,21573647,3848497,,7488,16300044,2907852,,2282,5273603,940645,PDN
MI004A,,1998,1984,,9770,21573647,3848497,,7488,16306423,2908987,,2282,5267224,939510,PDN
MI004A,,1999,1984,,9230,17825415,3181012,,7782,16575424,2957146,,1448,1249991,223866,PDN
MI004A,,2000,1984,,8154,20914870,3729661,,7844,17298665,3085898,,310,3616205,643763,PDN
MI004A,,2001,1984,,8154,20914870,3729661,,7844,17706262,3158424,,310,3208608,571237,PDN
MI004A,,2002,1984,,8154,20914870,3729661,,7844,17886094,3190423,,310,3028776,539238,PDN
MI004A,,2003,1984,,8154,20914870,3729661,,7844,18006695,3211882,,310,2908175,517779,PDN
MI004A,,2004,1984,,7844,18009480,3212378,,7844,18009480,3212378,,0,0,0,PDN
MI004A,,2005,1984,,7844,18009766,3212429,,7844,18009766,3212429,,0,0,0,PDN
MI004A,,2006,1984,,7844,18009766,3212429,,7844,18009766,3212429,,0,0,0,PDN
MI004A,,2007,1984,,7844,18009766,3212429,,7844,18009766,3212429,,0,0,0,PDN
MI004A,,2008,1984,,7844,18009766,3212429,,7844,18009766,3212429,,0,0,0,PDN
MI004A,,2009,1984,,7844,18336235,3270520,,7844,18336235,3270520,,0,0,0,PDN
MI004A,,2010,1984,,7844,18336235,3270520,,7844,18336235,3270520,,0,0,0,PDN
MI004A,,2011,1984,,7844,18336235,3270520,,7844,18336235,3270520,,0,0,0,PDN
MI004A,,2012,1984,,7844,18336235,3270520,,7844,18336235,3270520,,0,0,0,PDN
MI004A,,2013,1984,,7844,18336235,3270520,,7844,18336235,3270520,,0,0,0,PDN
MI004A,,2014,1984,,7844,18336235,3270520,,7844,18336235,3270520,,0,0,0,PDN
MI004A,,2015,1984,,7844,18336235,3270520,,7844,18336235,3270520,,0,0,0,PDN
MI004A,,2016,1984,,7844,18336235,3270520,,7844,18336235,3270520,,0,0,0,PDN
MI004A,,2017,1984,,7844,18336235,3270520,,7844,18336235,3270520,,0,0,0,PDN
MI004A,,2017,1984,,7844,18336235,3270520,,7844,18336235,3270520,,0,0,0,PDN
MI007A,,1979,1977,,70000,70000000,12525516,,0,0,0,,70000,70000000,12525516,PDN
MI007A,,1980,1977,,70000,70000000,12525516,,0,263952,46967,,70000,69736048,12478549,PDN
MI007A,,1981,1977,,70000,70000000,12525516,,116,8452688,1504153,,69884,61547312,11021363,PDN
MI007A,,1982,1977,,1059,27857092,4957837,,404,16232028,2888665,,655,11625064,2069172,PDN
MI007A,,1983,1977,,1923,40560289,7219056,,874,21918284,3900925,,1049,18642005,3318131,PDN
MI007A,,1984,1977,,3275,40560289,7220408,,1321,27886631,4963355,,1954,12673658,2257053,PDN
MI007A,,1985,1977,,8434,43756986,7794375,,1776,31495884,5606026,,6658,12261102,2188349,PDN
MI007A,,1986,1977,,4928,42561502,7578149,,2066,33555527,5972800,,2862,9005975,1605349,PDN
MI007A,,1987,1977,,4925,44219117,7873095,,2170,34276851,6101254,,2755,9942266,1771841,PDN
MI007A,,1988,1977,,4925,44219117,7873095,,2170,34663209,6170001,,2755,9555908,1703094,PDN
MI007A,,1989,1977,,4179,43958810,7826031,,2170,35038630,6236802,,2009,8920180,1589229,PDN
MI007A,,1990,1977,,4013,45347848,8073025,,2170,35455637,6311002,,1843,9892211,1762023,PDN
MI007A,,1991,1977,,4013,45347848,8073025,,2170,35485533,6316322,,1843,9862315,1756703,PDN
MI007A,,1992,1977,,2405,37058567,6596456,,2170,35692864,6353213,,235,1365703,243243,PDN
MI007A,,1993,1977,,2405,38611918,6872853,,2170,36014958,6410526,,235,2596960,462327,PDN
MI007A,,1994,1977,,2405,38611918,6872853,,2170,36015421,6410608,,235,2596497,462245,PDN
MI007A,,1995,1977,,2405,38611918,6872853,,2170,36016115,6410731,,235,2595803,462122,PDN
MI007A,,1996,1977,,2357,38432191,6840825,,2170,36017105,6410908,,187,2415086,429917,PDN
MI007A,,1997,1977,,2925,38859560,6917437,,2170,36020780,6411561,,755,2838780,505876,PDN
MI007A,,1998,1977,,2925,38859560,6917437,,2170,36181243,6440114,,755,2678317,477323,PDN
MI007A,,1999,1977,,2209,37220425,6625060,,2170,36292225,6459861,,39,928200,165199,PDN
MI007A,,2000,1977,,2209,37220425,6625060,,2170,36343540,6468992,,39,876885,156068,PDN
MI007A,,2001,1977,,2170,36411901,6481156,,2170,36411901,6481156,,0,0,0,PDN
MI007A,,2002,1977,,2170,36411901,6481156,,2170,36411901,6481156,,0,0,0,PDN
MI007A,,2003,1977,,2170,36411901,6481156,,2170,36411901,6481156,,0,0,0,PDN
MI007A,,2004,1977,,2170,36411901,6481156,,2170,36411901,6481156,,0,0,0,PDN
MI007A,,2005,1977,,2170,36411901,6481156,,2170,36411901,6481156,,0,0,0,PDN
MI007A,,2006,1977,,2170,36411901,6481156,,2170,36411901,6481156,,0,0,0,PDN
MI007A,,2007,1977,,2170,36411901,6481156,,2170,36411901,6481156,,0,0,0,PDN
MI007A,,2008,1977,,2170,36411901,6481156,,2170,36411901,6481156,,0,0,0,PDN
MI007A,,2009,1977,,2170,37135476,6609905,,2170,37135476,6609905,,0,0,0,PDN
MI007A,,2010,1977,,2170,37135476,6609905,,2170,37135476,6609905,,0,0,0,PDN
MI007A,,2011,1977,,2170,37135476,6609905,,2170,37135476,6609905,,0,0,0,PDN
MI007A,,2012,1977,,2170,37135476,6609905,,2170,37135476,6609905,,0,0,0,PDN
MI007A,,2013,1977,,2170,37135476,6609905,,2170,37135476,6609905,,0,0,0,PDN
MI007A,,2014,1977,,2170,37135476,6609905,,2170,37135476,6609905,,0,0,0,PDN
MI007A,,2015,1977,,2170,37135476,6609905,,2170,37135476,6609905,,0,0,0,PDN
MI007A,,2016,1977,,2170,37135476,6609905,,2170,37135476,6609905,,0,0,0,PDN
MI007A,,2017,1977,,2170,37135476,6609905,,2170,37135476,6609905,,0,0,0,PDN
MI007A,,2017,1977,,2170,37135476,6609905,,2170,37135476,6609905,,0,0,0,PDN
MI487,,1989,1988,,81807,27141702,4911291,,0,0,0,,81807,27141702,4911291,PDN
MI487,,1990,1988,,100584,27141702,4930068,,24642,6598594,1198769,,75942,20543108,3731299,PDN
MI487,,1991,1988,,100584,27141702,4930068,,44549,13580697,2461043,,56035,13561005,2469025,PDN
MI487,,1992,1988,,138325,44275903,8016600,,53418,20169596,3642314,,84907,24106307,4374286,PDN
MI487,,1993,1988,,71183,32689000,5887731,,57698,23721496,4278605,,13485,8967504,1609126,PDN
MI487,,1994,1988,,71183,32689000,5887731,,62881,27595069,4973036,,8302,5093931,914695,PDN
MI487,,1995,1988,,78856,38353572,6903335,,66881,31377469,5650061,,11975,6976103,1253274,PDN
MI487,,1996,1988,,79783,38761879,6976914,,69720,32922119,5927748,,10063,5839760,1049166,PDN
MI487,,1997,1988,,79783,38761879,6976914,,71256,33968419,6115459,,8527,4793460,861455,PDN
MI487,,1998,1988,,79783,38761879,6976914,,72025,34515851,6213635,,7758,4246028,763279,PDN
MI487,,1999,1988,,73166,36561425,6578758,,72234,34895738,6281440,,932,1665687,297318,PDN
MI487,,2000,1988,,72626,36082790,6493051,,72241,35193688,6334463,,385,889102,158588,PDN
MI487,,2001,1988,,72626,36082790,6493051,,72322,35373426,6366526,,304,709364,126525,PDN
MI487,,2002,1988,,72626,36082790,6493051,,72328,35521337,6392851,,298,561453,100200,PDN
MI487,,2003,1988,,72626,36082790,6493051,,72328,35679907,6421066,,298,402883,71985,PDN
MI487,,2004,1988,,76739,36355720,6545728,,72328,36046336,6486267,,4411,309384,59461,PDN
MI487,,2005,1988,,78114,37001515,6662013,,72328,36214856,6516253,,5786,786659,145760,PDN
MI487,,2006,1988,,78114,37001515,6662013,,72328,36369883,6543837,,5786,631632,118176,PDN
MI487,,2007,1988,,78114,37001515,6662013,,72328,36451015,6558274,,5786,550500,103739,PDN
MI487,,2008,1988,,72328,36570066,6579457,,72328,36565858,6578708,,0,4208,749,PDN
MI487,,2009,1988,,72328,37258248,6701910,,72328,37258248,6701910,,0,0,0,PDN
MI487,,2010,1988,,72328,37258248,6701910,,72328,37258248,6701910,,0,0,0,PDN
MI487,,2011,1988,,72328,37258248,6701910,,72328,37258248,6701910,,0,0,0,PDN
MI487,,2012,1988,,72328,37258248,6701910,,72328,37258248,6701910,,0,0,0,PDN
MI487,,2013,1988,,72328,37258248,6701910,,72328,37258248,6701910,,0,0,0,PDN
MI487,,2014,1988,,72328,37258248,6701910,,72328,37258248,6701910,,0,0,0,PDN
MI487,,2015,1988,,72328,37258248,6701910,,72328,37258248,6701910,,0,0,0,PDN
MI487,,2016,1988,,72328,37258248,6701910,,72328,37258248,6701910,,0,0,0,PDN
MI487,,2017,1988,,72328,37258248,6701910,,72328,37258248,6701910,,0,0,0,PDN
MI487,,2017,1988,,72328,37258248,6701910,,72328,37258248,6701910,,0,0,0,PDN
MI519,,1988,1987,,259523,139448064,25072346,,11064,6911415,1240853,,248459,132536649,23831493,PDP
MI519,,1989,1987,,259523,139448064,25072346,,25927,14322438,2574404,,233596,125125626,22497942,PDP
MI519,,1990,1987,,67528,50674140,9084279,,32279,19892065,3571792,,35249,30782075,5512487,PDP
MI519,,1991,1987,,67909,54480913,9762022,,38300,25433141,4563770,,29609,29047772,5198252,PDP
MI519,,1992,1987,,90581,54480913,9784694,,55491,33922223,6091474,,35090,20558690,3693220,PDP
MI519,,1993,1987,,93332,57608277,10343915,,72968,44695936,8025982,,20364,12912341,2317933,PDP
MI519,,1994,1987,,93332,57608277,10343915,,89596,54401058,9769500,,3736,3207219,574415,PDP
MI519,,1995,1987,,168222,105436615,18929186,,106823,62639971,11252725,,61399,42796644,7676461,PDP
MI519,,1996,1987,,166624,93463355,16797114,,126609,71163595,12789170,,40015,22299760,4007944,PDP
MI519,,1997,1987,,166624,93463355,16797114,,141549,78498733,14109295,,25075,14964622,2687819,PDP
MI519,,1998,1987,,166624,93463355,16797114,,154784,85469367,15362856,,11840,7993988,1434258,PDP
MI519,,1999,1987,,302508,162527111,29221923,,184833,100106468,17997372,,117675,62420643,11224551,PDP
MI519,,2000,1987,,321734,201501775,36176143,,227748,120137527,21604532,,93986,81364248,14571611,PDP
MI519,,2001,1987,,377801,180543721,32503018,,250910,132186740,23771682,,126891,48356981,8731336,PDP
MI519,,2002,1987,,377801,180543721,32503018,,282656,143706485,25853205,,95145,36837236,6649813,PDP
MI519,,2003,1987,,377801,180543721,32503018,,317913,152931297,27529888,,59888,27612424,4973130,PDP
MI519,,2004,1987,,422262,190892637,34388923,,350984,161631917,29111112,,71278,29260720,5277811,PDP
MI519,,2005,1987,,421126,179531727,32366273,,374810,167627959,30201849,,46316,11903768,2164424,PDP
MI519,,2006,1987,,421126,179531727,32366273,,393698,173384772,31245081,,27428,6146955,1121192,PDP
MI519,,2007,1987,,435674,189930678,34231168,,408912,178127304,32104162,,26762,11803374,2127006,PDP
MI519,,2008,1987,,450157,192659149,34731144,,418180,181885408,32782132,,31977,10773741,1949012,PDP
MI519,,2009,1987,,457854,196167168,35363043,,431124,187211482,33742776,,26730,8955686,1620269,PDP
MI519,,2010,1987,,448902,194121545,34990102,,435475,189081066,34079792,,13427,5040479,910310,PDP
MI519,,2011,1987,,448902,194121545,34990102,,437579,190164742,34274721,,11323,3956803,715381,PDP
MI519,,2012,1987,,448902,194121545,34990102,,439591,190982379,34422221,,9311,3139166,567881,PDP
MI519,,2013,1987,,448902,194121545,34990102,,441404,191521515,34519965,,7498,2600030,470137,PDP
MI519,,2014,1987,,448902,194121545,34990102,,442649,192063289,34617611,,6253,2058256,372491,PDP
MI519,,2015,1987,,448902,194121545,34990102,,444024,192454481,34688593,,4878,1667064,301509,PDP
MI519,,2016,1987,,448902,194121545,34990102,,444597,192656061,34725035,,4305,1465484,265067,PDP
MI519,,2017,1987,,448902,194121545,34990102,,445240,192938365,34775910,,3662,1183180,214192,PDP
MI519,,2017,1987,,448902,194121545,34990102,,445240,192938365,34775910,,3662,1183180,214192,PDP
MI527,,1981,1979,,72083,72083100,12898257,,18140,2063394,385292,,53943,70019706,12512965,PDN
MI527,,1982,1979,,593321,74838898,13909851,,41793,11398728,2070036,,551528,63440170,11839815,PDN
MI527,,1983,1979,,601882,75933244,14113135,,79046,31052698,5604437,,522836,44880546,8508698,PDN
MI527,,1984,1979,,406107,146987177,26560409,,111099,46295150,8348670,,295008,100692027,18211739,PDN
MI527,,1985,1979,,415794,151703296,27409263,,141798,59252177,10684890,,273996,92451119,16724373,PDN
MI527,,1986,1979,,441240,156312560,28254863,,177867,77291744,13930846,,263373,79020816,14324017,PDN
MI527,,1987,1979,,460877,170751389,30843686,,211678,94253366,16982740,,249199,76498023,13860946,PDN
MI527,,1988,1979,,684448,184819207,33570428,,328035,109818726,19868734,,356413,75000481,13701694,PDN
MI527,,1989,1979,,1466508,226910971,41842126,,435732,124483497,22585820,,1030776,102427474,19256306,PDN
MI527,,1990,1979,,1433717,225388448,41538423,,539260,138402653,25166067,,894457,86985795,16372356,PDN
MI527,,1991,1979,,1523420,242041682,44591335,,627241,152800115,27815874,,896179,89241567,16775461,PDN
MI527,,1992,1979,,1523420,242041682,44591335,,693293,165397626,30123476,,830127,76644056,14467859,PDN
MI527,,1993,1979,,986197,235327290,42859380,,744042,179490325,32681822,,242155,55836965,10177558,PDN
MI527,,1994,1979,,1112162,255268432,46533591,,800879,199219603,36249207,,311283,56048829,10284384,PDN
MI527,,1995,1979,,1201729,269276228,49115649,,842944,214743030,39053448,,358785,54533198,10062201,PDN
MI527,,1996,1979,,972632,251095046,45651466,,870842,225815089,41051463,,101790,25279957,4600003,PDN
MI527,,1997,1979,,1002483,283736238,51489358,,894720,239957524,43591788,,107763,43778714,7897570,PDN
MI527,,1998,1979,,1015634,298795883,54182161,,903028,245746335,44630134,,112606,53049548,9552027,PDN
MI527,,1999,1979,,1028078,304138668,55145279,,912071,251139285,45598777,,116007,52999383,9546502,PDN
MI527,,2000,1979,,1042752,315076666,57106216,,923278,256229800,46515769,,119474,58846866,10590447,PDN
MI527,,2001,1979,,1223619,318389918,57876629,,945778,259926123,47195978,,277841,58463795,10680651,PDN
MI527,,2002,1979,,1200645,306568011,55750113,,965997,262911185,47747347,,234648,43656826,8002766,PDN
MI527,,2003,1979,,1200645,306568011,55750113,,988511,267298993,48550609,,212134,39269018,7199504,PDN
MI527,,2004,1979,,1022261,284561599,51655997,,996062,270052628,49048131,,26199,14508971,2607866,PDN
MI527,,2005,1979,,1031607,281258224,51077555,,998580,270736908,49172407,,33027,10521316,1905148,PDN
MI527,,2006,1979,,1031607,280493661,50941511,,1000010,271068172,49232781,,31597,9425489,1708730,PDN
MI527,,2007,1979,,1019879,278783614,50625505,,1002182,271521969,49315700,,17697,7261645,1309805,PDN
MI527,,2008,1979,,1010713,273576096,49689734,,1003691,271882110,49381291,,7022,1693986,308443,PDN
MI527,,2009,1979,,1005053,277068212,50305446,,1004331,276888266,50272705,,722,179946,32741,PDN
MI527,,2010,1979,,1005053,277068212,50305446,,1004968,277043052,50300884,,85,25160,4562,PDN
MI527,,2011,1979,,1005053,277068212,50305446,,1005053,277068212,50305446,,0,0,0,PDN
MI527,,2012,1979,,1005053,277068212,50305446,,1005053,277068212,50305446,,0,0,0,PDN
MI527,,2013,1979,,1005053,277068212,50305446,,1005053,277068212,50305446,,0,0,0,PDN
MI527,,2014,1979,,1005053,277068212,50305446,,1005053,277068212,50305446,,0,0,0,PDN
MI527,,2015,1979,,1005053,277068212,50305446,,1005053,277068212,50305446,,0,0,0,PDN
MI527,,2016,1979,,1005053,277068212,50305446,,1005053,277068212,50305446,,0,0,0,PDN
MI527,,2017,1979,,1005053,277068212,50305446,,1005053,277068212,50305446,,0,0,0,PDN
MI527,,2017,1979,,1005053,277068212,50305446,,1005053,277068212,50305446,,0,0,0,PDN
MI565,,1981,1980,,67220,67219900,12028056,,0,0,0,,67220,67219900,12028056,PDN
MI565,,1982,1980,,67220,67219900,12028056,,0,0,0,,67220,67219900,12028056,PDN
MI565,,1983,1980,,67220,67219900,12028056,,0,0,0,,67220,67219900,12028056,PDN
MI565,,1984,1980,,67220,67219900,12028056,,0,0,0,,67220,67219900,12028056,PDN
MI565,,1985,1980,,67220,67219900,12028056,,0,0,0,,67220,67219900,12028056,PDN
MI565,,1986,1980,,66627,74759574,13369042,,1294,451120,81564,,65333,74308454,13287478,PDN
MI565,,1987,1980,,83434,80602564,14425527,,9947,3863528,697407,,73487,76739036,13728120,PDN
MI565,,1988,1980,,77048,34482370,6212701,,12827,5617703,1012418,,64221,28864667,5200283,PDN
MI565,,1989,1980,,74905,34761458,6260218,,14540,6809152,1226133,,60365,27952306,5034085,PDN
MI565,,1990,1980,,46812,15873008,2871191,,15172,7244162,1304169,,31640,8628846,1567022,PDN
MI565,,1991,1980,,47237,16282783,2944529,,15941,7819426,1407298,,31296,8463357,1537231,PDN
MI565,,1992,1980,,49878,18620104,3363064,,17049,8810027,1584669,,32829,9810077,1778395,PDN
MI565,,1993,1980,,27563,15979495,2870890,,19389,10520880,1891432,,8174,5458615,979458,PDN
MI565,,1994,1980,,27563,15979495,2870890,,20437,12021874,2159560,,7126,3957621,711330,PDN
MI565,,1995,1980,,27598,16018917,2877939,,20472,12061296,2166610,,7126,3957621,711329,PDN
MI565,,1996,1980,,43719,15878729,2869116,,26263,13128323,2362264,,17456,2750406,506852,PDN
MI565,,1997,1980,,43719,15878729,2869116,,31359,14898775,2682387,,12360,979954,186729,PDN
MI565,,1998,1980,,44296,16054655,2900996,,31638,15175257,2731862,,12658,879398,169134,PDN
MI565,,1999,1980,,111686,22728973,4155987,,34074,17165679,3088465,,77612,5563294,1067522,PDN
MI565,,2000,1980,,50634,32653329,5860835,,36834,19746954,3550527,,13800,12906375,2310308,PDN
MI565,,2001,1980,,50634,32653329,5860835,,39787,21081354,3790918,,10847,11571975,2069917,PDN
MI565,,2002,1980,,50634,32653329,5860835,,42492,22269047,4004956,,8142,10384282,1855879,PDN
MI565,,2003,1980,,50634,32653329,5860835,,43559,23257218,4181854,,7075,9396111,1678981,PDN
MI565,,2004,1980,,47417,26134990,4697771,,44076,23906577,4297915,,3341,2228413,399856,PDN
MI565,,2005,1980,,47417,26134990,4697771,,45004,24460011,4397319,,2413,1674979,300452,PDN
MI565,,2006,1980,,47417,26134990,4697771,,45829,24631073,4428582,,1588,1503917,269189,PDN
MI565,,2007,1980,,46891,27361715,4915524,,46120,25280752,4544474,,771,2080963,371050,PDN
MI565,,2008,1980,,46600,27361715,4915233,,46344,26849830,4823894,,256,511885,91339,PDN
MI565,,2009,1980,,46477,27508961,4941311,,46477,27508961,4941311,,0,0,0,PDN
MI565,,2010,1980,,46477,27508961,4941311,,46477,27508961,4941311,,0,0,0,PDN
MI565,,2011,1980,,46477,27508961,4941311,,46477,27508961,4941311,,0,0,0,PDN
MI565,,2012,1980,,46477,27508961,4941311,,46477,27508961,4941311,,0,0,0,PDN
MI565,,2013,1980,,46477,27508961,4941311,,46477,27508961,4941311,,0,0,0,PDN
MI565,,2014,1980,,46477,27508961,4941311,,46477,27508961,4941311,,0,0,0,PDN
MI565,,2015,1980,,46477,27508961,4941311,,46477,27508961,4941311,,0,0,0,PDN
MI565,,2016,1980,,46477,27508961,4941311,,46477,27508961,4941311,,0,0,0,PDN
MI565,,2017,1980,,46477,27508961,4941311,,46477,27508961,4941311,,0,0,0,PDN
MI565,,2017,1980,,46477,27508961,4941311,,46477,27508961,4941311,,0,0,0,PDN
MI568,,1985,1983,,70129,21178993,3838633,,0,0,0,,70129,21178993,3838633,PDN
MI568,,1986,1983,,70129,21178993,3838633,,0,0,0,,70129,21178993,3838633,PDN
MI568,,1987,1983,,70129,21178993,3838633,,0,0,0,,70129,21178993,3838633,PDN
MI568,,1988,1983,,133199,53500893,9652931,,0,0,0,,133199,53500893,9652931,PDN
MI568,,1989,1983,,159794,64965430,11719479,,9613,5171771,929857,,150181,59793659,10789622,PDN
MI568,,1990,1983,,159794,64965430,11719479,,21219,13635748,2447509,,138575,51329682,9271970,PDN
MI568,,1991,1983,,159794,64965430,11719479,,27863,18667991,3349570,,131931,46297439,8369909,PDN
MI568,,1992,1983,,159794,64965430,11719479,,30027,21077756,3780517,,129767,43887674,7938962,PDN
MI568,,1993,1983,,36197,33257581,5953916,,31774,22201104,3982148,,4423,11056477,1971768,PDN
MI568,,1994,1983,,63134,33257581,5980853,,34365,23502743,4216348,,28769,9754838,1764505,PDN
MI568,,1995,1983,,63466,33257581,5981185,,37850,24295163,4360833,,25616,8962418,1620352,PDN
MI568,,1996,1983,,63270,34360259,6177195,,38929,24668884,4428410,,24341,9691375,1748785,PDN
MI568,,1997,1983,,55819,28582118,5141605,,38958,24672306,4429048,,16861,3909812,712557,PDN
MI568,,1998,1983,,55819,28582118,5141605,,39200,24916097,4472669,,16619,3666021,668936,PDN
MI568,,1999,1983,,40950,26774371,4805073,,39425,25107482,4506948,,1525,1666889,298125,PDN
MI568,,2000,1983,,39431,25305500,4542189,,39426,25140485,4512822,,5,165015,29367,PDN
MI568,,2001,1983,,39456,25183924,4520581,,39456,25183924,4520581,,0,0,0,PDN
MI568,,2002,1983,,39456,25183924,4520581,,39456,25183924,4520581,,0,0,0,PDN
MI568,,2003,1983,,39456,25183932,4520583,,39456,25183932,4520583,,0,0,0,PDN
MI568,,2004,1983,,39456,25183932,4520583,,39456,25183932,4520583,,0,0,0,PDN
MI568,,2005,1983,,39456,25183932,4520583,,39456,25183932,4520583,,0,0,0,PDN
MI568,,2006,1983,,39456,25183932,4520583,,39456,25183932,4520583,,0,0,0,PDN
MI568,,2007,1983,,39456,25183932,4520583,,39456,25183932,4520583,,0,0,0,PDN
MI568,,2008,1983,,39456,25183932,4520583,,39456,25183932,4520583,,0,0,0,PDN
MI568,,2009,1983,,39456,25681323,4609087,,39456,25681323,4609087,,0,0,0,PDN
MI568,,2010,1983,,39456,25681323,4609087,,39456,25681323,4609087,,0,0,0,PDN
MI568,,2011,1983,,39456,25681323,4609087,,39456,25681323,4609087,,0,0,0,PDN
MI568,,2012,1983,,39456,25681323,4609087,,39456,25681323,4609087,,0,0,0,PDN
MI568,,2013,1983,,39456,25681323,4609087,,39456,25681323,4609087,,0,0,0,PDN
MI568,,2014,1983,,39456,25681323,4609087,,39456,25681323,4609087,,0,0,0,PDN
MI568,,2015,1983,,39456,25681323,4609087,,39456,25681323,4609087,,0,0,0,PDN
MI568,,2016,1983,,39456,25681323,4609087,,39456,25681323,4609087,,0,0,0,PDN
MI568,,2017,1983,,39456,25681323,4609087,,39456,25681323,4609087,,0,0,0,PDN
MI568,,2017,1983,,39456,25681323,4609087,,39456,25681323,4609087,,0,0,0,PDN
MI586,,1997,1996,,1086,6363027,1133297,,5,276368,49181,,1081,6086659,1084116,PDN
MI586,,1998,1996,,3214,9915795,1767590,,651,1140085,203513,,2563,8775710,1564077,PDN
MI586,,1999,1996,,3213,9909584,1766484,,1440,2266913,404805,,1773,7642671,1361679,PDN
MI586,,2000,1996,,4662,10894773,1943234,,1440,2629106,469252,,3222,8265667,1473982,PDN
MI586,,2001,1996,,4365,10749781,1917137,,2544,3995045,713406,,1821,6754736,1203731,PDN
MI586,,2002,1996,,6306,8520692,1522444,,4417,5056445,904140,,1889,3464247,618304,PDN
MI586,,2003,1996,,6967,10540006,1882413,,6035,7151478,1278540,,932,3388528,603873,PDN
MI586,,2004,1996,,6967,10540006,1882413,,6449,9293952,1660177,,518,1246054,222236,PDN
MI586,,2005,1996,,8003,12257281,2189014,,6897,10985305,1961578,,1106,1271976,227436,PDN
MI586,,2006,1996,,7230,12350575,2204842,,7123,11281621,2014529,,107,1068954,190313,PDN
MI586,,2007,1996,,7230,12510993,2233386,,7123,11442039,2043073,,107,1068954,190313,PDN
MI586,,2008,1996,,7125,11628654,2076281,,7123,11553601,2062924,,2,75053,13357,PDN
MI586,,2009,1996,,7125,11643743,2078964,,7125,11643743,2078964,,0,0,0,PDN
MI586,,2010,1996,,7125,11643743,2078964,,7125,11643743,2078964,,0,0,0,PDN
MI586,,2011,1996,,7125,11643743,2078964,,7125,11643743,2078964,,0,0,0,PDN
MI586,,2012,1996,,7125,11643743,2078964,,7125,11643743,2078964,,0,0,0,PDN
MI586,,2013,1996,,7125,11643743,2078964,,7125,11643743,2078964,,0,0,0,PDN
MI586,,2014,1996,,7125,11643743,2078964,,7125,11643743,2078964,,0,0,0,PDN
MI586,,2015,1996,,7125,11643743,2078964,,7125,11643743,2078964,,0,0,0,PDN
MI586,,2016,1996,,7125,11643743,2078964,,7125,11643743,2078964,,0,0,0,PDN
MI586,,2017,1996,,7125,11643743,2078964,,7125,11643743,2078964,,0,0,0,PDN
MI586,,2017,1996,,7125,11643743,2078964,,7125,11643743,2078964,,0,0,0,PDN
MI587,,1988,1987,,381320,85498535,15594582,,0,0,0,,381320,85498535,15594582,PDN
MI587,,1989,1987,,337458,97216699,17635803,,7594,8023985,1435349,,329864,89192714,16200454,PDN
MI587,,1990,1987,,368335,128669863,23263328,,29530,28594757,5117565,,338805,100075106,18145763,PDN
MI587,,1991,1987,,360862,137727028,24867451,,50545,50974466,9120735,,310317,86752562,15746716,PDN
MI587,,1992,1987,,289531,156799235,28189751,,63758,72644750,12989870,,225773,84154485,15199881,PDN
MI587,,1993,1987,,130836,167036970,29852717,,76301,91121873,16290157,,54535,75915097,13562560,PDN
MI587,,1994,1987,,130835,167006674,29847325,,84934,105257579,18814041,,45901,61749095,11033284,PDN
MI587,,1995,1987,,138437,175026779,31281992,,91805,117129821,20933410,,46632,57896958,10348582,PDN
MI587,,1996,1987,,177991,219387760,39214959,,107148,130494181,23326753,,70843,88893579,15888206,PDN
MI587,,1997,1987,,175187,215111701,38451290,,122512,142567154,25490333,,52675,72544547,12960957,PDN
MI587,,1998,1987,,176784,222951652,39847896,,130749,154945344,27701095,,46035,68006308,12146801,PDN
MI587,,1999,1987,,193887,234695547,41954660,,135917,164238953,29359930,,57970,70456594,12594730,PDN
MI587,,2000,1987,,188082,224266214,40093102,,138742,169537567,30305569,,49340,54728647,9787533,PDN
MI587,,2001,1987,,239814,245290120,43885743,,143324,174292489,31156222,,96490,70997631,12729521,PDN
MI587,,2002,1987,,236529,241242041,43162159,,147397,178572287,31921825,,89132,62669754,11240334,PDN
MI587,,2003,1987,,207431,233569947,41767920,,149874,183310967,32767484,,57557,50258980,9000436,PDN
MI587,,2004,1987,,174034,218753307,39098110,,151564,187233943,33467212,,22470,31519364,5630898,PDN
MI587,,2005,1987,,174718,218322021,39022053,,153446,191012237,34141389,,21272,27309784,4880664,PDN
MI587,,2006,1987,,175438,219020731,39147099,,155671,193103255,34515681,,19767,25917476,4631418,PDN
MI587,,2007,1987,,169760,219920179,39301465,,156816,194801168,34818946,,12944,25119011,4482519,PDN
MI587,,2008,1987,,164317,210765488,37667073,,157409,196447739,35112523,,6908,14317749,2554550,PDN
MI587,,2009,1987,,157441,200598382,35851103,,157440,199999036,35744458,,1,599346,106646,PDN
MI587,,2010,1987,,157441,200598382,35851103,,157441,200467165,35827755,,0,131217,23348,PDN
MI587,,2011,1987,,157441,200594769,35850460,,157441,200594769,35850460,,0,0,0,PDN
MI587,,2012,1987,,157441,200594769,35850460,,157441,200594769,35850460,,0,0,0,PDN
MI587,,2013,1987,,157441,200594769,35850460,,157441,200594769,35850460,,0,0,0,PDN
MI587,,2014,1987,,157441,200594769,35850460,,157441,200594769,35850460,,0,0,0,PDN
MI587,,2015,1987,,157441,200594769,35850460,,157441,200594769,35850460,,0,0,0,PDN
MI587,,2016,1987,,157441,200594769,35850460,,157441,200594769,35850460,,0,0,0,PDN
MI587,,2017,1987,,157441,200594769,35850460,,157441,200594769,35850460,,0,0,0,PDN
MI587,,2017,1987,,157441,200594769,35850460,,157441,200594769,35850460,,0,0,0,PDN
MI588,,1988,1987,,155279,34816304,6350351,,0,0,0,,155279,34816304,6350351,PDN
MI588,,1989,1987,,155279,34816304,6350351,,15175,2468531,454415,,140104,32347773,5895936,PDN
MI588,,1990,1987,,155279,34816304,6350351,,28702,4544484,837329,,126577,30271820,5513022,PDN
MI588,,1991,1987,,125972,29713528,5413077,,43426,8646272,1581909,,82546,21067256,3831168,PDN
MI588,,1992,1987,,101771,29775895,5399973,,62134,16437407,2986940,,39637,13338488,2413033,PDN
MI588,,1993,1987,,101771,29775895,5399973,,69012,21023434,3809837,,32759,8752461,1590136,PDN
MI588,,1994,1987,,101771,29775895,5399973,,72546,23333629,4224437,,29225,6442266,1175536,PDN
MI588,,1995,1987,,101771,29775895,5399973,,77101,26468258,4786755,,24670,3307637,613218,PDN
MI588,,1996,1987,,99506,34132466,6172899,,80816,28317174,5119459,,18690,5815292,1053440,PDN
MI588,,1997,1987,,99506,34132466,6172899,,82090,28838681,5213528,,17416,5293785,959371,PDN
MI588,,1998,1987,,82090,28838803,5213550,,82090,28838803,5213550,,0,0,0,PDN
MI588,,1999,1987,,82090,28838803,5213550,,82090,28838803,5213550,,0,0,0,PDN
MI588,,2000,1987,,82090,28838803,5213550,,82090,28838803,5213550,,0,0,0,PDN
MI588,,2001,1987,,82090,28838803,5213550,,82090,28838803,5213550,,0,0,0,PDN
MI588,,2002,1987,,82090,28838803,5213550,,82090,28838803,5213550,,0,0,0,PDN
MI588,,2003,1987,,82090,28838803,5213550,,82090,28838803,5213550,,0,0,0,PDN
MI588,,2004,1987,,82090,28838803,5213550,,82090,28838803,5213550,,0,0,0,PDN
MI588,,2005,1987,,82090,28838803,5213550,,82090,28838803,5213550,,0,0,0,PDN
MI588,,2006,1987,,82090,28838803,5213550,,82090,28838803,5213550,,0,0,0,PDN
MI588,,2007,1987,,82090,28838803,5213550,,82090,28838803,5213550,,0,0,0,PDN
MI588,,2008,1987,,82090,28838803,5213550,,82090,28838803,5213550,,0,0,0,PDN
MI588,,2009,1987,,82090,29416353,5316316,,82090,29416353,5316316,,0,0,0,PDN
MI588,,2010,1987,,82090,29416353,5316316,,82090,29416353,5316316,,0,0,0,PDN
MI588,,2011,1987,,82090,29416353,5316316,,82090,29416353,5316316,,0,0,0,PDN
MI588,,2012,1987,,82090,29416353,5316316,,82090,29416353,5316316,,0,0,0,PDN
MI588,,2013,1987,,82090,29416353,5316316,,82090,29416353,5316316,,0,0,0,PDN
MI588,,2014,1987,,82090,29416353,5316316,,82090,29416353,5316316,,0,0,0,PDN
MI588,,2015,1987,,82090,29416353,5316316,,82090,29416353,5316316,,0,0,0,PDN
MI588,,2016,1987,,82090,29416353,5316316,,82090,29416353,5316316,,0,0,0,PDN
MI588,,2017,1987,,82090,29416353,5316316,,82090,29416353,5316316,,0,0,0,PDN
MI588,,2017,1987,,82090,29416353,5316316,,82090,29416353,5316316,,0,0,0,PDN
MI591,,1990,1990,,39092,9987170,1816169,,0,4191,746,,39092,9982979,1815423,PDN
MI591,,1991,1990,,39092,9987170,1816169,,1082,531040,95573,,38010,9456130,1720596,PDN
MI591,,1992,1990,,39092,9987170,1816169,,3417,1928730,346607,,35675,8058440,1469562,PDN
MI591,,1993,1990,,48250,15103811,2735761,,7366,4096575,736294,,40884,11007236,1999467,PDN
MI591,,1994,1990,,33102,18409618,3308835,,7799,4604004,827017,,25303,13805614,2481818,PDN
MI591,,1995,1990,,33102,18409618,3308835,,12793,6811319,1224771,,20309,11598299,2084064,PDN
MI591,,1996,1990,,62674,18422425,3340686,,22220,7737427,1398986,,40454,10684998,1941700,PDN
MI591,,1997,1990,,62674,18422425,3340686,,23769,8082508,1461938,,38905,10339917,1878748,PDN
MI591,,1998,1990,,62674,18422425,3340686,,26074,8475881,1534238,,36600,9946544,1806448,PDN
MI591,,1999,1990,,34014,10918408,1976791,,27204,8824260,1597357,,6810,2094148,379434,PDN
MI591,,2000,1990,,34014,10918408,1976791,,28416,9238576,1672291,,5598,1679832,304500,PDN
MI591,,2001,1990,,34014,10918408,1976791,,29587,9611301,1739783,,4427,1307107,237008,PDN
MI591,,2002,1990,,34014,10918408,1976791,,30604,9897431,1791713,,3410,1020977,185078,PDN
MI591,,2003,1990,,34014,10918408,1976791,,31528,10152173,1837964,,2486,766235,138827,PDN
MI591,,2004,1990,,34014,10918408,1976791,,32154,10354540,1874599,,1860,563868,102192,PDN
MI591,,2005,1990,,34014,10918408,1976791,,32828,10493902,1900070,,1186,424506,76721,PDN
MI591,,2006,1990,,34014,10918408,1976791,,33492,10636181,1926051,,522,282227,50740,PDN
MI591,,2007,1990,,34014,10918408,1976791,,33620,10742098,1945025,,394,176310,31766,PDN
MI591,,2008,1990,,34156,10811971,1957994,,34156,10811971,1957994,,0,0,0,PDN
MI591,,2009,1990,,34156,10979059,1987725,,34156,10979059,1987725,,0,0,0,PDN
MI591,,2010,1990,,34156,10979059,1987725,,34156,10979059,1987725,,0,0,0,PDN
MI591,,2011,1990,,34156,10979059,1987725,,34156,10979059,1987725,,0,0,0,PDN
MI591,,2012,1990,,34156,10979059,1987725,,34156,10979059,1987725,,0,0,0,PDN
MI591,,2013,1990,,34156,10979059,1987725,,34156,10979059,1987725,,0,0,0,PDN
MI591,,2014,1990,,34156,10979059,1987725,,34156,10979059,1987725,,0,0,0,PDN
MI591,,2015,1990,,34156,10979059,1987725,,34156,10979059,1987725,,0,0,0,PDN
MI591,,2016,1990,,34156,10979059,1987725,,34156,10979059,1987725,,0,0,0,PDN
MI591,,2017,1990,,34156,10979059,1987725,,34156,10979059,1987725,,0,0,0,PDN
MI591,,2017,1990,,34156,10979059,1987725,,34156,10979059,1987725,,0,0,0,PDN
MI619,,1979,1975,,16800,16800000,3006124,,0,0,0,,16800,16800000,3006124,PDN
MI619,,1980,1975,,16800,16800000,3006124,,5705,999597,183569,,11095,15800403,2822555,PDN
MI619,,1981,1975,,224850,28561000,5306878,,20144,5045957,918001,,204706,23515043,4388877,PDN
MI619,,1982,1975,,224850,28561000,5306878,,39454,11510492,2087584,,185396,17050508,3219294,PDN
MI619,,1983,1975,,267319,32765597,6097496,,45762,13195648,2393742,,221557,19569949,3703754,PDN
MI619,,1984,1975,,267319,32765597,6097496,,56597,16531953,2998226,,210722,16233644,3099270,PDN
MI619,,1985,1975,,199861,58931062,10685815,,66374,20074964,3638432,,133487,38856098,7047383,PDN
MI619,,1986,1975,,215602,65427921,11857581,,71706,23133547,4187996,,143896,42294374,7669585,PDN
MI619,,1987,1975,,173280,65034264,11745213,,76104,24979233,4520807,,97176,40055031,7224406,PDN
MI619,,1988,1975,,462615,96066114,17556230,,84657,28035065,5073103,,377958,68031049,12483127,PDN
MI619,,1989,1975,,1665140,507585500,91982845,,159816,45132083,8190436,,1505324,462453417,83792409,PDN
MI619,,1990,1975,,1710002,456392523,82918636,,450124,128871904,23381068,,1259878,327520619,59537568,PDN
MI619,,1991,1975,,1505999,444234141,80551220,,631877,196608929,35615672,,874122,247625212,44935548,PDN
MI619,,1992,1975,,1434339,448499104,81238450,,794228,252564365,45734506,,640111,195934739,35503944,PDN
MI619,,1993,1975,,1549527,468310509,84878799,,940418,305131089,55234206,,609109,163179420,29644593,PDN
MI619,,1994,1975,,1573644,485698033,87996782,,1045891,350601739,63430542,,527753,135096294,24566240,PDN
MI619,,1995,1975,,1578803,489620894,88699959,,1126265,386703915,69934791,,452538,102916979,18765168,PDN
MI619,,1996,1975,,1346558,480694406,86879370,,1200321,416857434,75374242,,146237,63836972,11505128,PDN
MI619,,1997,1975,,1647143,553009904,100047482,,1264504,438746797,79333329,,382639,114263107,20714153,PDN
MI619,,1998,1975,,1653289,563403079,101902947,,1289495,451057855,81548900,,363794,112345224,20354047,PDN
MI619,,1999,1975,,1707549,567010637,102599121,,1297434,457886196,82771846,,410115,109124441,19827275,PDN
MI619,,2000,1975,,1579469,542195980,98055622,,1314960,467776914,84549286,,264509,74419066,13506336,PDN
MI619,,2001,1975,,1499530,550153403,99391594,,1326091,473097766,85507188,,173439,77055637,13884406,PDN
MI619,,2002,1975,,1494010,547866126,98979086,,1331867,476160438,86057924,,162143,71705688,12921162,PDN
MI619,,2003,1975,,1494755,548758128,99138550,,1335743,478669928,86508328,,159012,70088200,12630222,PDN
MI619,,2004,1975,,1364849,502460051,90770552,,1337944,480730110,86877109,,26905,21729941,3893443,PDN
MI619,,2005,1975,,1364737,499367437,90220153,,1339008,482175822,87135418,,25729,17191615,3084735,PDN
MI619,,2006,1975,,1372003,502530740,90790285,,1344862,485058098,87654132,,27141,17472642,3136153,PDN
MI619,,2007,1975,,1372777,502629159,90808571,,1348584,486915458,87988345,,24193,15713701,2820226,PDN
MI619,,2008,1975,,1354051,491811725,88865034,,1349753,487502879,88094038,,4298,4308846,770996,PDN
MI619,,2009,1975,,1349882,497214938,89822292,,1349878,497006178,89785142,,4,208760,37150,PDN
MI619,,2010,1975,,1349882,497214938,89822292,,1349882,497214938,89822292,,0,0,0,PDN
MI619,,2011,1975,,1349882,497215358,89822367,,1349882,497215358,89822367,,0,0,0,PDN
MI619,,2012,1975,,1349882,497215358,89822367,,1349882,497215358,89822367,,0,0,0,PDN
MI619,,2013,1975,,1349882,497215358,89822367,,1349882,497215358,89822367,,0,0,0,PDN
MI619,,2014,1975,,1349882,497215358,89822367,,1349882,497215358,89822367,,0,0,0,PDN
MI619,,2015,1975,,1349882,497215358,89822367,,1349882,497215358,89822367,,0,0,0,PDN
MI619,,2016,1975,,1349882,497215358,89822367,,1349882,497215358,89822367,,0,0,0,PDN
MI619,,2017,1975,,1349882,497215358,89822367,,1349882,497215358,89822367,,0,0,0,PDN
MI619,,2017,1975,,1349882,497215358,89822367,,1349882,497215358,89822367,,0,0,0,PDN
MI623,,1982,1980,,61595,61595230,11021600,,0,0,0,,61595,61595230,11021600,PDP
MI623,,1983,1980,,520000,260000000,46783345,,0,0,0,,520000,260000000,46783345,PDP
MI623,,1984,1980,,520000,260000000,46783345,,86954,13553897,2498679,,433046,246446103,44284666,PDP
MI623,,1985,1980,,2237000,260000000,48500345,,328651,39383729,7336432,,1908349,220616271,41163913,PDP
MI623,,1986,1980,,17134455,1310004817,250231398,,897792,86758745,16335291,,16236663,1223246072,233896107,PDP
MI623,,1987,1980,,17139214,1310253537,250280413,,1576520,150147606,28293176,,15562694,1160105931,221987237,PDP
MI623,,1988,1980,,14644223,1366693470,257828114,,2309244,230200075,43270111,,12334979,1136493395,214558003,PDP
MI623,,1989,1980,,14417893,1327541902,250635313,,3085291,291564951,54965176,,11332602,1035976951,195670137,PDP
MI623,,1990,1980,,7981490,747086014,140914944,,3636695,342330491,64549594,,4344795,404755523,76365350,PDP
MI623,,1991,1980,,7976803,745842962,140689074,,4189382,393117927,74139191,,3787421,352725035,66549883,PDP
MI623,,1992,1980,,7976129,745842962,140688400,,4835967,454790643,85759569,,3140162,291052319,54928831,PDP
MI623,,1993,1980,,8850392,825169355,155677679,,5577287,521563576,98382194,,3273105,303605779,57295485,PDP
MI623,,1994,1980,,9407008,882111917,166366424,,6282094,585911686,110536842,,3124914,296200231,55829582,PDP
MI623,,1995,1980,,10107678,915147753,172945356,,7075697,656232644,123843071,,3031981,258915109,49102285,PDP
MI623,,1996,1980,,10882685,978621919,185014699,,7894351,728210387,137469153,,2988334,250411532,47545546,PDP
MI623,,1997,1980,,13774086,1284939804,242411062,,8741224,807312881,152391203,,5032862,477626923,90019859,PDP
MI623,,1998,1980,,13941189,1295964593,244539871,,9764174,908306586,171384563,,4177015,387658007,73155308,PDP
MI623,,1999,1980,,14457872,1362119325,256827859,,10722853,1008758270,190217207,,3735019,353361055,66610652,PDP
MI623,,2000,1980,,14542031,1368119076,257979589,,11504455,1096085390,206537443,,3037576,272033686,51442146,PDP
MI623,,2001,1980,,14458461,1403600195,264209385,,12123075,1169700197,220254783,,2335386,233899998,43954602,PDP
MI623,,2002,1980,,14565030,1437191296,270293018,,12521379,1218741598,229379315,,2043651,218449698,40913703,PDP
MI623,,2003,1980,,14640134,1445711671,271884204,,12854353,1264647245,237880553,,1785781,181064426,34003651,PDP
MI623,,2004,1980,,14640134,1445711671,271884204,,13079834,1294386593,243397733,,1560300,151325078,28486471,PDP
MI623,,2005,1980,,14621814,1443502905,271472865,,13302150,1318032196,247827452,,1319664,125470709,23645413,PDP
MI623,,2006,1980,,14779374,1457984397,274207203,,13326271,1334998487,250870486,,1453103,122985910,23336717,PDP
MI623,,2007,1980,,14209221,1404555950,264130209,,13374406,1346868228,253030674,,834815,57687722,11099535,PDP
MI623,,2008,1980,,13855360,1401330412,263202408,,13468199,1356151859,254776359,,387161,45178553,8426049,PDP
MI623,,2009,1980,,14278899,1454043280,273005463,,13502501,1379793406,259017343,,776398,74249874,13988119,PDP
MI623,,2010,1980,,14278899,1454043280,273005463,,13517669,1383938136,259770009,,761230,70105144,13235456,PDP
MI623,,2011,1980,,14278899,1454043280,273005463,,13599939,1392773751,261424453,,678960,61269529,11581013,PDP
MI623,,2012,1980,,14265147,1452043383,272635858,,13676400,1400185375,262819707,,588747,51858008,9816151,PDP
MI623,,2013,1980,,13943141,1430788208,268531791,,13717807,1406687413,264018060,,225334,24100795,4513732,PDP
MI623,,2014,1980,,13807130,1418148730,266146763,,13728146,1408528671,264356025,,78984,9620059,1790739,PDP
MI623,,2015,1980,,13775927,1412366364,265086670,,13751792,1409304661,264517747,,24135,3061703,568922,PDP
MI623,,2016,1980,,13812512,1412242632,265101238,,13751792,1409718320,264591352,,60720,2524312,509887,PDP
MI623,,2017,1980,,13812512,1412242632,265101238,,13771702,1410140838,264686444,,40810,2101794,414795,PDP
MI623,,2017,1980,,13812512,1412242632,265101238,,13771702,1410140838,264686444,,40810,2101794,414795,PDP
MI633,,1978,1988,,1500000,15000000,4169039,,0,0,0,,1500000,15000000,4169039,PDN
MI633,,1979,1988,,0,15000000,2669039,,0,0,0,,0,15000000,2669039,PDN
MI633,,1980,1988,,15000,15000000,2684039,,0,0,0,,15000,15000000,2684039,PDN
MI633,,1981,1988,,15000,15000000,2684039,,0,0,0,,15000,15000000,2684039,PDN
MI633,,1990,1988,,446927,70302349,12956242,,1,5820,1037,,446926,70296529,12955205,PDN
MI633,,1991,1988,,446927,70302349,12956242,,3364,602160,110510,,443563,69700189,12845732,PDN
MI633,,1992,1988,,457151,72500422,13357582,,26405,4160372,766685,,430746,68340050,12590897,PDN
MI633,,1993,1988,,740015,48632488,9393483,,212823,11688861,2292692,,527192,36943627,7100791,PDN
MI633,,1994,1988,,751181,58121250,11093040,,276545,20018071,3838479,,474636,38103179,7254561,PDN
MI633,,1995,1988,,756626,58121250,11098485,,317803,29926311,5642769,,438823,28194939,5455716,PDN
MI633,,1996,1988,,489726,62348321,11583733,,353245,39208320,7329814,,136481,23140001,4253919,PDN
MI633,,1997,1988,,446005,60593914,11227840,,371190,45219442,8417354,,74815,15374472,2810486,PDN
MI633,,1998,1988,,516437,68270951,12664293,,403160,51629150,9589841,,113277,16641801,3074452,PDN
MI633,,1999,1988,,522524,76604838,14153278,,437951,58169082,10788321,,84573,18435756,3364957,PDN
MI633,,2000,1988,,517797,76092976,14057472,,447221,62111521,11499093,,70576,13981455,2558379,PDN
MI633,,2001,1988,,601609,85748091,15859276,,453454,64780407,11980217,,148155,20967684,3879059,PDN
MI633,,2002,1988,,601609,85748091,15859276,,457417,66350232,12263508,,144192,19397859,3595768,PDN
MI633,,2003,1988,,601609,85748091,15859276,,458397,66837302,12351155,,143212,18910789,3508121,PDN
MI633,,2004,1988,,465391,70785565,13060687,,459365,67239344,12423661,,6026,3546221,637026,PDN
MI633,,2005,1988,,465391,70785565,13060687,,459999,67582629,12485378,,5392,3202936,575309,PDN
MI633,,2006,1988,,465391,70785565,13060687,,460591,67866842,12536542,,4800,2918723,524145,PDN
MI633,,2007,1988,,1454550,96068381,18548568,,665497,80515832,14992157,,789053,15552549,3556411,PDN
MI633,,2008,1988,,1315297,130669406,24566081,,843905,92892693,17372854,,471392,37776713,7193227,PDN
MI633,,2009,1988,,988961,107135100,20052146,,940838,103244308,19311711,,48123,3890792,740435,PDN
MI633,,2010,1988,,988961,107135110,20052148,,975941,106455013,19918114,,13020,680097,134034,PDN
MI633,,2011,1988,,988961,107135044,20052135,,988961,107133687,20051893,,0,1357,241,PDN
MI633,,2012,1988,,988961,107135044,20052135,,988961,107135044,20052135,,0,0,0,PDN
MI633,,2013,1988,,988961,107135044,20052135,,988961,107135044,20052135,,0,0,0,PDN
MI633,,2014,1988,,461146,69043003,12746377,,461146,69043003,12746377,,0,0,0,PDN
MI633,,2015,1988,,461146,69043003,12746377,,461146,69043003,12746377,,0,0,0,PDN
MI633,,2016,1988,,461146,69043003,12746377,,461146,69043003,12746377,,0,0,0,PDN
MI633,,2017,1988,,461146,69043003,12746377,,461146,69043003,12746377,,0,0,0,PDN
MI633,,2017,1988,,461146,69043003,12746377,,461146,69043003,12746377,,0,0,0,PDN
MI639,,1987,1985,,51143,13265560,2411563,,0,0,0,,51143,13265560,2411563,PDN
MI639,,1988,1985,,270611,70191466,12760196,,0,0,0,,270611,70191466,12760196,PDN
MI639,,1989,1985,,270611,70191466,12760196,,26906,1784091,344360,,243705,68407375,12415836,PDN
MI639,,1990,1985,,213265,13120920,2547948,,66111,4140387,802835,,147154,8980533,1745113,PDN
MI639,,1991,1985,,213265,13120920,2547948,,106640,5500387,1085357,,106625,7620533,1462591,PDN
MI639,,1992,1985,,213265,13120920,2547948,,133358,6546496,1298215,,79907,6574424,1249733,PDN
MI639,,1993,1985,,212787,9565498,1914833,,156307,7449010,1481754,,56480,2116488,433079,PDN
MI639,,1994,1985,,212787,9565498,1914833,,164775,7806190,1553777,,48012,1759308,361056,PDN
MI639,,1995,1985,,181907,8562967,1705567,,171743,8189560,1628960,,10164,373407,76607,PDN
MI639,,1996,1985,,177184,8689996,1723447,,174793,8504976,1688134,,2391,185020,35313,PDN
MI639,,1997,1985,,177184,8689996,1723447,,176590,8664324,1718285,,594,25672,5162,PDN
MI639,,1998,1985,,176728,8673567,1720067,,176728,8673567,1720067,,0,0,0,PDN
MI639,,1999,1985,,176728,8673567,1720067,,176728,8673567,1720067,,0,0,0,PDN
MI639,,2000,1985,,176728,8673567,1720067,,176728,8673567,1720067,,0,0,0,PDN
MI639,,2001,1985,,176728,8673567,1720067,,176728,8673567,1720067,,0,0,0,PDN
MI639,,2002,1985,,176728,8673567,1720067,,176728,8673567,1720067,,0,0,0,PDN
MI639,,2003,1985,,176728,8673567,1720067,,176728,8673567,1720067,,0,0,0,PDN
MI639,,2004,1985,,176728,8673567,1720067,,176728,8673567,1720067,,0,0,0,PDN
MI639,,2005,1985,,177836,16198451,3060123,,177184,11054789,2144228,,652,5143662,915895,PDN
MI639,,2006,1985,,177836,16198451,3060123,,177610,14543223,2765372,,226,1655228,294751,PDN
MI639,,2007,1985,,177676,15233743,2888306,,177676,15233743,2888306,,0,0,0,PDN
MI639,,2008,1985,,177676,15223767,2886531,,177676,15223767,2886531,,0,0,0,PDN
MI639,,2009,1985,,177676,15397470,2917440,,177676,15397470,2917440,,0,0,0,PDN
MI639,,2010,1985,,177676,15397470,2917440,,177676,15397470,2917440,,0,0,0,PDN
MI639,,2011,1985,,177676,15397470,2917440,,177676,15397470,2917440,,0,0,0,PDN
MI639,,2012,1985,,177676,15397470,2917440,,177676,15397470,2917440,,0,0,0,PDN
MI639,,2013,1985,,177676,15397470,2917440,,177676,15397470,2917440,,0,0,0,PDN
MI639,,2014,1985,,177676,15397470,2917440,,177676,15397470,2917440,,0,0,0,PDN
MI639,,2015,1985,,177676,15397470,2917440,,177676,15397470,2917440,,0,0,0,PDN
MI639,,2016,1985,,177676,15397470,2917440,,177676,15397470,2917440,,0,0,0,PDN
MI639,,2017,1985,,177676,15397470,2917440,,177676,15397470,2917440,,0,0,0,PDN
MI639,,2017,1985,,177676,15397470,2917440,,177676,15397470,2917440,,0,0,0,PDN
MI650,,1989,1988,,13467,10960625,1963756,,0,0,0,,13467,10960625,1963756,PDN
MI650,,1990,1988,,254150,118169649,21280778,,55283,21486624,3878526,,198867,96683025,17402252,PDN
MI650,,1991,1988,,269204,122160491,22005946,,118470,43463130,7852123,,150734,78697361,14153823,PDN
MI650,,1992,1988,,301594,137089349,24694717,,169313,69056011,12456859,,132281,68033338,12237858,PDN
MI650,,1993,1988,,370590,180424551,32474603,,203658,89744404,16172413,,166932,90680147,16302190,PDN
MI650,,1994,1988,,370590,180424551,32474603,,224376,104919038,18893244,,146214,75505513,13581359,PDN
MI650,,1995,1988,,370136,180156506,32426454,,236488,112903832,20326138,,133648,67252674,12100316,PDN
MI650,,1996,1988,,308004,160925191,28942380,,243464,117921810,21225992,,64540,43003381,7716388,PDN
MI650,,1997,1988,,316228,160852528,28937674,,253398,124269209,22365357,,62830,36583319,6572317,PDN
MI650,,1998,1988,,319416,164208713,29538048,,257854,127612485,22964702,,61562,36596228,6573346,PDN
MI650,,1999,1988,,306848,155051067,27896006,,260361,129820739,23360137,,46487,25230328,4535869,PDN
MI650,,2000,1988,,285338,143607231,25838226,,263242,131652453,23688945,,22096,11954778,2149281,PDN
MI650,,2001,1988,,285307,143589150,25834978,,264457,133314268,23985857,,20850,10274882,1849121,PDN
MI650,,2002,1988,,285307,143589150,25834978,,265634,134591671,24214330,,19673,8997479,1620648,PDN
MI650,,2003,1988,,285508,143813585,25875114,,266004,135602188,24394507,,19504,8211397,1480607,PDN
MI650,,2004,1988,,267023,137368231,24709769,,266590,136151423,24492822,,433,1216808,216947,PDN
MI650,,2005,1988,,267023,137368231,24709769,,266843,136560261,24565822,,180,807970,143947,PDN
MI650,,2006,1988,,267387,136580429,24569954,,267387,136580429,24569954,,0,0,0,PDN
MI650,,2007,1988,,266899,136580429,24569466,,266899,136580429,24569466,,0,0,0,PDN
MI650,,2008,1988,,266897,136580427,24569464,,266897,136580427,24569464,,0,0,0,PDN
MI650,,2009,1988,,266898,139116097,25020651,,266898,139116097,25020651,,0,0,0,PDN
MI650,,2010,1988,,266898,139116097,25020651,,266898,139116097,25020651,,0,0,0,PDN
MI650,,2011,1988,,266898,139116097,25020651,,266898,139116097,25020651,,0,0,0,PDN
MI650,,2012,1988,,266898,139116097,25020651,,266898,139116097,25020651,,0,0,0,PDN
MI650,,2013,1988,,266898,139116097,25020651,,266898,139116097,25020651,,0,0,0,PDN
MI650,,2014,1988,,266898,139116097,25020651,,266898,139116097,25020651,,0,0,0,PDN
MI650,,2015,1988,,266898,139116097,25020651,,266898,139116097,25020651,,0,0,0,PDN
MI650,,2016,1988,,266898,139116097,25020651,,266898,139116097,25020651,,0,0,0,PDN
MI650,,2017,1988,,266898,139116097,25020651,,266898,139116097,25020651,,0,0,0,PDN
MI650,,2017,1988,,266898,139116097,25020651,,266898,139116097,25020651,,0,0,0,PDN
MI651,,1986,1984,,39612,9155792,1668756,,0,0,0,,39612,9155792,1668756,PDN
MI651,,1987,1984,,39612,9155792,1668756,,0,0,0,,39612,9155792,1668756,PDN
MI651,,1989,1984,,306056,64359267,11757883,,0,0,0,,306056,64359267,11757883,PDN
MI651,,1990,1984,,255600,64359267,11707427,,1300,5030981,896492,,254300,59328286,10810935,PDN
MI651,,1991,1984,,255600,64359267,11707427,,2409,10714082,1908829,,253191,53645185,9798598,PDN
MI651,,1992,1984,,222417,61234764,11118282,,4197,21020652,3744527,,218220,40214112,7373755,PDN
MI651,,1993,1984,,222562,69399138,12571163,,5507,31598928,5628092,,217055,37800210,6943071,PDN
MI651,,1994,1984,,222562,69399138,12571163,,6203,36844753,6562209,,216359,32554385,6008954,PDN
MI651,,1995,1984,,9606,57522512,10244928,,6682,39385019,7014692,,2924,18137493,3230236,PDN
MI651,,1996,1984,,9624,57610238,10260556,,7103,41460705,7384453,,2521,16149533,2876103,PDN
MI651,,1997,1984,,27737,72738221,12970481,,9788,44974221,8012318,,17949,27764000,4958163,PDN
MI651,,1998,1984,,27737,72738221,12970481,,10707,46970607,8368466,,17030,25767614,4602015,PDN
MI651,,1999,1984,,14568,64521114,11495193,,11118,48108593,8571366,,3450,16412521,2923827,PDN
MI651,,2000,1984,,129079,98425493,17642512,,19015,50040002,8922930,,110064,48385491,8719582,PDN
MI651,,2001,1984,,124966,96938288,17373771,,25870,51172710,9131334,,99096,45765578,8242437,PDN
MI651,,2002,1984,,125251,96938288,17374056,,25994,51664190,9218910,,99257,45274098,8155146,PDN
MI651,,2003,1984,,125251,96938288,17374056,,26281,52194584,9313574,,98970,44743704,8060482,PDN
MI651,,2004,1984,,116569,81513825,14620808,,26369,52629184,9390992,,90200,28884641,5229816,PDN
MI651,,2005,1984,,116542,81360363,14593475,,26414,52919651,9442722,,90128,28440712,5150753,PDN
MI651,,2006,1984,,26429,52954975,9449022,,26429,52952461,9448575,,0,2514,447,PDN
MI651,,2007,1984,,26429,52954975,9449022,,26429,52954975,9449022,,0,0,0,PDN
MI651,,2008,1984,,26429,52954975,9449022,,26429,52954975,9449022,,0,0,0,PDN
MI651,,2009,1984,,26429,53883820,9614297,,26429,53883820,9614297,,0,0,0,PDN
MI651,,2010,1984,,26429,53883820,9614297,,26429,53883820,9614297,,0,0,0,PDN
MI651,,2011,1984,,26429,53883820,9614297,,26429,53883820,9614297,,0,0,0,PDN
MI651,,2012,1984,,26429,53883820,9614297,,26429,53883820,9614297,,0,0,0,PDN
MI651,,2013,1984,,26429,53883820,9614297,,26429,53883820,9614297,,0,0,0,PDN
MI651,,2014,1984,,26429,53883820,9614297,,26429,53883820,9614297,,0,0,0,PDN
MI651,,2015,1984,,26429,53883820,9614297,,26429,53883820,9614297,,0,0,0,PDN
MI651,,2016,1984,,26429,53883820,9614297,,26429,53883820,9614297,,0,0,0,PDN
MI651,,2017,1984,,26429,53883820,9614297,,26429,53883820,9614297,,0,0,0,PDN
MI651,,2017,1984,,26429,53883820,9614297,,26429,53883820,9614297,,0,0,0,PDN
MI652,,1984,1982,,8710,2612857,473631,,0,0,0,,8710,2612857,473631,PDN
MI652,,1985,1982,,8710,2612857,473631,,0,0,0,,8710,2612857,473631,PDN
MI652,,1986,1982,,8710,2612857,473631,,0,0,0,,8710,2612857,473631,PDN
MI652,,1987,1982,,15341,3439801,627405,,0,0,0,,15341,3439801,627405,PDN
MI652,,1988,1982,,15341,3439801,627405,,0,0,0,,15341,3439801,627405,PDN
MI652,,1989,1982,,15341,3439801,627405,,0,0,0,,15341,3439801,627405,PDN
MI665,,1979,1977,,54600,54600000,9769902,,0,0,0,,54600,54600000,9769902,PDN
MI665,,1980,1977,,54600,54600000,9769902,,0,0,0,,54600,54600000,9769902,PDN
MI665,,1981,1977,,54600,54600000,9769902,,2768,9081202,1618640,,51832,45518798,8151262,PDN
MI665,,1982,1977,,64155,110163665,19666231,,5929,21388735,3811754,,58226,88774930,15854477,PDN
MI665,,1983,1977,,260821,121692274,21914251,,9705,40354730,7190262,,251116,81337544,14723989,PDN
MI665,,1984,1977,,165641,127553992,22862081,,13172,62939766,11212419,,152469,64614226,11649662,PDN
MI665,,1985,1977,,61160,215297247,38370279,,15863,78751449,14028576,,45297,136545798,24341703,PDN
MI665,,1986,1977,,61160,215297247,38370279,,17954,89016596,15857206,,43206,126280651,22513073,PDN
MI665,,1987,1977,,59037,214763612,38273203,,19963,100734559,17944262,,39074,114029053,20328941,PDN
MI665,,1988,1977,,69357,230323346,41052159,,22776,116088968,20679176,,46581,114234378,20372983,PDN
MI665,,1989,1977,,70530,237617615,42351244,,25093,130163673,23185889,,45437,107453942,19165355,PDN
MI665,,1990,1977,,70987,237617615,42351701,,26858,142415253,25367650,,44129,95202362,16984051,PDN
MI665,,1991,1977,,32591,199068977,35454117,,28073,151398302,26967273,,4518,47670675,8486844,PDN
MI665,,1992,1977,,33244,199068977,35454770,,29460,161883809,28834408,,3784,37185168,6620362,PDN
MI665,,1993,1977,,33725,202733681,36107334,,30529,173510005,30904195,,3196,29223676,5203139,PDN
MI665,,1994,1977,,38933,259215314,46162654,,31093,183849201,32744474,,7840,75366113,13418180,PDN
MI665,,1995,1977,,44880,266478724,47461023,,31681,193439954,34451602,,13199,73038770,13009421,PDN
MI665,,1996,1977,,51284,247663920,44119597,,34680,216489229,38555895,,16604,31174691,5563702,PDN
MI665,,1997,1977,,53055,295757372,52678922,,41963,246053303,43823690,,11092,49704069,8855232,PDN
MI665,,1998,1977,,54640,303707407,54095104,,45282,266810857,47520523,,9358,36896550,6574581,PDN
MI665,,1999,1977,,58971,330333828,58837232,,46920,284982887,50755619,,12051,45350941,8081613,PDN
MI665,,2000,1977,,59093,330850321,58929257,,47914,297615925,53004484,,11179,33234396,5924773,PDN
MI665,,2001,1977,,59060,330599694,58884628,,48340,306093933,54513453,,10720,24505761,4371175,PDN
MI665,,2002,1977,,58334,329376057,58666173,,48558,311200165,55422253,,9776,18175892,3243920,PDN
MI665,,2003,1977,,53651,340344568,60613182,,48762,319380923,56878108,,4889,20963645,3735074,PDN
MI665,,2004,1977,,54552,340503622,60642385,,48867,324675144,57820245,,5685,15828478,2822140,PDN
MI665,,2005,1977,,54566,340712326,60679535,,49179,329049396,58598894,,5387,11662930,2080641,PDN
MI665,,2006,1977,,54701,342059584,60919395,,49439,331711381,59072816,,5262,10348203,1846579,PDN
MI665,,2007,1977,,57685,353406300,62941368,,50223,334866911,59635083,,7462,18539389,3306285,PDN
MI665,,2008,1977,,104866,369074201,65776432,,50492,339851617,60522310,,54374,29222584,5254122,PDN
MI665,,2009,1977,,85731,371631222,66212284,,50493,347513017,61885550,,35238,24118205,4326733,PDN
MI665,,2010,1977,,85731,371631222,66212284,,50493,349983846,62325200,,35238,21647376,3887085,PDN
MI665,,2011,1977,,85731,371631222,66212284,,59784,353374268,62937769,,25947,18256954,3274515,PDN
MI665,,2012,1977,,85731,371631222,66212284,,65902,355919610,63396794,,19829,15711612,2815489,PDN
MI665,,2013,1977,,72188,358484468,63859460,,66257,356693292,63534815,,5931,1791176,324646,PDN
MI665,,2014,1977,,72188,358484468,63859460,,67909,357330884,63649917,,4279,1153584,209543,PDN
MI665,,2015,1977,,72188,358484468,63859460,,68420,357742761,63723716,,3768,741707,135744,PDN
MI665,,2016,1977,,68438,357768907,63728386,,68438,357768907,63728386,,0,0,0,PDN
MI665,,2017,1977,,68438,357768907,63728386,,68438,357768907,63728386,,0,0,0,PDN
MI665,,2017,1977,,68438,357768907,63728386,,68438,357768907,63728386,,0,0,0,PDN
MI668,,1984,1980,,887627,268063918,48585833,,0,0,0,,887627,268063918,48585833,PDP
MI668,,1985,1980,,1119940,314630396,57103996,,26278,8154111,1477187,,1093662,306476285,55626809,PDP
MI668,,1986,1980,,1933333,678804948,122717132,,158630,59966763,10828873,,1774703,618838185,111888259,PDP
MI668,,1987,1980,,3061198,1102631192,199258919,,354337,149098294,26884283,,2706861,953532898,172374636,PDP
MI668,,1988,1980,,4349765,1588986864,287087641,,652747,263022587,47453919,,3697018,1325964277,239633722,PDP
MI668,,1989,1980,,4504988,1620055753,292771136,,1022967,404609146,73017477,,3482021,1215446607,219753659,PDP
MI668,,1990,1980,,2861980,1077861529,194652288,,1238161,493061665,88971553,,1623819,584799864,105680735,PDP
MI668,,1991,1980,,2915843,1088105050,196528841,,1377962,548411313,98960046,,1537881,539693737,97568795,PDP
MI668,,1992,1980,,2861864,1095656989,197818624,,1527309,597531345,107849612,,1334555,498125644,89969012,PDP
MI668,,1993,1980,,3584609,1116673845,202281023,,1703266,639780737,115543255,,1881343,476893108,86737768,PDP
MI668,,1994,1980,,3246570,1095217869,198125194,,1793784,670597989,121117270,,1452786,424619880,77007924,PDP
MI668,,1995,1980,,3027279,1067222881,192924589,,1866122,692453100,125078417,,1161157,374769781,67846172,PDP
MI668,,1996,1980,,2666962,1030986648,186116543,,1897110,706970266,127692531,,769852,324016382,58424012,PDP
MI668,,1997,1980,,2917400,1030281327,186241480,,1943687,719648216,129994971,,973713,310633111,56246509,PDP
MI668,,1998,1980,,2929892,1037982216,187624236,,1983628,732618912,132342865,,946264,305363304,55281371,PDP
MI668,,1999,1980,,2655075,940190694,169948793,,2006533,741041639,133864476,,648542,199149055,36084317,PDP
MI668,,2000,1980,,2788477,1008190181,182181748,,2028631,747831914,135094808,,759846,260358267,47086940,PDP
MI668,,2001,1980,,2889400,1023269464,184965818,,2042715,751645531,135787471,,846685,271623933,49178347,PDP
MI668,,2002,1980,,2851503,1014252023,183323394,,2055571,755742537,136529332,,795932,258509486,46794062,PDP
MI668,,2003,1980,,2945009,1027151262,185712138,,2064957,760447099,137375829,,880052,266704163,48336309,PDP
MI668,,2004,1980,,2552107,968973247,174967276,,2068107,762911131,137817419,,484000,206062116,37149857,PDP
MI668,,2005,1980,,2553125,979141235,176777544,,2069800,764147315,138039073,,483325,214993920,38738471,PDP
MI668,,2006,1980,,2576185,979096084,176792570,,2087906,767920622,138728586,,488279,211175462,38063984,PDP
MI668,,2007,1980,,2530790,941195221,170003249,,2106823,769614324,139048874,,423967,171580897,30954375,PDP
MI668,,2008,1980,,2153117,780154644,140970669,,2117100,771496793,139394109,,36017,8657851,1576560,PDP
MI668,,2009,1980,,2128040,791097231,142892672,,2120226,787100198,142173642,,7814,3997033,719030,PDP
MI668,,2010,1980,,2128043,792887069,143211151,,2122318,788277533,142385224,,5725,4609536,825927,PDP
MI668,,2011,1980,,2130036,792883108,143212440,,2124749,789375404,142583006,,5287,3507704,629434,PDP
MI668,,2012,1980,,2131299,800028947,144485204,,2125881,790707675,142821197,,5418,9321272,1664007,PDP
MI668,,2013,1980,,2135162,800028947,144489067,,2128425,794441414,143488107,,6737,5587533,1000960,PDP
MI668,,2014,1980,,2671275,849728304,153868481,,2658396,833813119,151023718,,12879,15915185,2844762,PDP
MI668,,2015,1980,,2671275,849718728,153866778,,2662396,837620061,151705111,,8879,12098667,2161667,PDP
MI668,,2016,1980,,2671275,849718728,153866778,,2664461,839621500,152063304,,6814,10097228,1803474,PDP
MI668,,2017,1980,,2671275,849718728,153866778,,2664461,839629214,152064676,,6814,10089514,1802101,PDP
MI668,,2017,1980,,2671275,849718728,153866778,,2664461,839629214,152064676,,6814,10089514,1802101,PDP
MI670,,2000,1984,,84999,18395467,3358214,,84894,18342964,3348767,,105,52503,9447,PDN
MI670,,2001,1984,,123745,22993764,4215162,,86270,18557840,3388377,,37475,4435924,826785,PDN
MI670,,2002,1984,,102703,20466513,3744431,,88073,19044588,3476790,,14630,1421925,267641,PDN
MI670,,2003,1984,,103941,22003633,4019178,,88347,19243354,3512431,,15594,2760279,506747,PDN
MI670,,2004,1984,,88347,19243354,3512431,,88347,19243354,3512431,,0,0,0,PDN
MI670,,2005,1984,,88347,19243354,3512431,,88347,19243354,3512431,,0,0,0,PDN
MI670,,2006,1984,,88347,19243354,3512431,,88347,19243354,3512431,,0,0,0,PDN
MI670,,2007,1984,,88347,19243354,3512431,,88347,19243354,3512431,,0,0,0,PDN
MI670,,2008,1984,,88347,19243354,3512431,,88347,19243354,3512431,,0,0,0,PDN
MI670,,2009,1984,,88347,19610709,3577796,,88347,19610709,3577796,,0,0,0,PDN
MI670,,2010,1984,,88347,19610709,3577796,,88347,19610709,3577796,,0,0,0,PDN
MI670,,2011,1984,,88347,19610709,3577796,,88347,19610709,3577796,,0,0,0,PDN
MI670,,2012,1984,,88347,19610709,3577796,,88347,19610709,3577796,,0,0,0,PDN
MI670,,2013,1984,,88347,19610709,3577796,,88347,19610709,3577796,,0,0,0,PDN
MI670,,2014,1984,,88347,19610709,3577796,,88347,19610709,3577796,,0,0,0,PDN
MI670,,2015,1984,,88347,19610709,3577796,,88347,19610709,3577796,,0,0,0,PDN
MI670,,2016,1984,,88347,19610709,3577796,,88347,19610709,3577796,,0,0,0,PDN
MI670,,2017,1984,,88347,19610709,3577796,,88347,19610709,3577796,,0,0,0,PDN
MI670,,2017,1984,,88347,19610709,3577796,,88347,19610709,3577796,,0,0,0,PDN
MI681,,1984,1982,,23599,7079651,1283323,,0,0,0,,23599,7079651,1283323,PDN
MI681,,1985,1982,,23599,7079651,1283323,,0,0,0,,23599,7079651,1283323,PDN
MI681,,1986,1982,,100063,38930596,7027215,,76,30259,5460,,99987,38900337,7021755,PDN
MI681,,1987,1982,,384746,103379257,18779632,,105751,28712857,5214800,,278995,74666400,13564832,PDN
MI681,,1988,1982,,449865,124162768,22542884,,180686,50942860,9245252,,269179,73219908,13297632,PDN
MI681,,1989,1982,,449865,124162768,22542884,,223092,65202682,11824993,,226773,58960086,10717891,PDN
MI681,,1990,1982,,575628,185444815,33572926,,299670,88522674,16051035,,275958,96922141,17521891,PDN
MI681,,1991,1982,,718763,195798723,35558393,,340326,104908223,19007270,,378437,90890500,16551123,PDN
MI681,,1992,1982,,844454,233717029,42431114,,395890,122186563,22137271,,448564,111530466,20293843,PDN
MI681,,1993,1982,,654670,224923854,40676708,,449183,144806942,26215543,,205487,80116912,14461165,PDN
MI681,,1994,1982,,677505,241647688,43675314,,496320,173637643,31392698,,181185,68010045,12282616,PDN
MI681,,1995,1982,,687466,248983684,44990613,,527257,195225987,35264977,,160209,53757697,9725636,PDN
MI681,,1996,1982,,624469,259088544,46725633,,550533,213156843,38478797,,73936,45931701,8246836,PDN
MI681,,1997,1982,,721569,324110315,58392444,,565497,225868378,40755600,,156072,98241937,17636844,PDN
MI681,,1998,1982,,721593,324139484,58397658,,574513,235160260,42417976,,147080,88979224,15979682,PDN
MI681,,1999,1982,,659498,292947254,52785344,,579451,242076030,43653478,,80047,50871224,9131866,PDN
MI681,,2000,1982,,564012,274412380,49391838,,497464,228007311,41068160,,66548,46405069,8323678,PDN
MI681,,2001,1982,,563960,274370876,49384401,,500112,231569269,41704608,,63848,42801607,7679793,PDN
MI681,,2002,1982,,564013,274412316,49391827,,503081,234734839,42270846,,60932,39677477,7120981,PDN
MI681,,2003,1982,,567667,276257648,49723832,,505931,237977927,42850758,,61736,38279721,6873074,PDN
MI681,,2004,1982,,542011,259126795,46649981,,507594,240159010,43240514,,34417,18967785,3409467,PDN
MI681,,2005,1982,,542957,259804520,46771519,,509584,242061674,43581056,,33373,17742846,3190463,PDN
MI681,,2006,1982,,542957,259804520,46771519,,510279,242609413,43679214,,32678,17195107,3092305,PDN
MI681,,2007,1982,,543186,259805017,46771836,,510813,243041727,43756672,,32373,16763290,3015164,PDN
MI681,,2008,1982,,535678,270131464,48601775,,507648,238833697,43004747,,28030,31297767,5597028,PDN
MI681,,2009,1982,,528582,263241353,47368681,,514732,250496240,45087018,,13850,12745113,2281665,PDN
MI681,,2010,1982,,529279,263656784,47443298,,517515,253361925,45599708,,11764,10294859,1843589,PDN
MI681,,2011,1982,,528743,262763582,47283829,,519246,255275327,45941903,,9497,7488255,1341927,PDN
MI681,,2012,1982,,521441,256733100,46203488,,520350,256073741,46085074,,1091,659359,118415,PDN
MI681,,2013,1982,,521441,256733100,46203488,,521441,256733100,46203488,,0,0,0,PDN
MI681,,2014,1982,,521441,256733100,46203488,,521441,256733100,46203488,,0,0,0,PDN
MI681,,2015,1982,,521441,256733100,46203488,,521441,256733100,46203488,,0,0,0,PDN
MI681,,2016,1982,,521441,256733100,46203488,,521441,256733100,46203488,,0,0,0,PDN
MI681,,2017,1982,,521441,256733100,46203488,,521441,256733100,46203488,,0,0,0,PDN
MI681,,2017,1982,,521441,256733100,46203488,,521441,256733100,46203488,,0,0,0,PDN
MI686,,1983,1978,,900793,107510259,20030732,,314204,33706299,6311766,,586589,73803960,13718966,PDN
MI686,,1984,1978,,900793,107510259,20030732,,463238,51209526,9575253,,437555,56300733,10455479,PDN
MI686,,1985,1978,,900793,107510259,20030732,,518314,57382772,10728772,,382479,50127487,9301960,PDN
MI686,,1986,1978,,1259414,147303898,27470072,,588477,65075274,12167707,,670937,82228624,15302365,PDN
MI686,,1987,1978,,2183557,282987096,52537133,,763088,90464644,16860000,,1420469,192522452,35677133,PDN
MI686,,1988,1978,,2183557,282987096,52537133,,879813,111357534,20694321,,1303744,171629562,31842812,PDN
MI686,,1989,1978,,2110478,276230236,51261766,,946974,123596596,22939251,,1163504,152633640,28322515,PDN
MI686,,1990,1978,,1480453,200279478,37117371,,1012726,133989776,24854323,,467727,66289702,12263048,PDN
MI686,,1991,1978,,1574966,210651225,39057390,,1082828,141991724,26348259,,492138,68659501,12709131,PDN
MI686,,1992,1978,,1574966,210651225,39057390,,1125828,149167356,27668062,,449138,61483869,11389328,PDN
MI686,,1993,1978,,1556668,212441660,39357675,,1150383,154782270,28691712,,406285,57659390,10665963,PDN
MI686,,1994,1978,,1324729,181239316,33573718,,1165505,158259339,29325530,,159224,22979977,4248188,PDN
MI686,,1995,1978,,1324729,181239316,33573718,,1175009,160627221,29756365,,149720,20612095,3817353,PDN
MI686,,1996,1978,,1293063,179323023,33201074,,1180264,162319512,30062739,,112799,17003511,3138335,PDN
MI686,,1997,1978,,1315683,182683147,33821581,,1184668,163801313,30330809,,131015,18881834,3490772,PDN
MI686,,1998,1978,,1320206,183062802,33893658,,1192920,165697347,30676434,,127286,17365455,3217224,PDN
MI686,,1999,1978,,1351286,188091021,34819439,,1204469,167534603,31014897,,146817,20556418,3804542,PDN
MI686,,2000,1978,,1397153,194269658,35964708,,1214627,169616683,31395531,,182526,24652975,4569177,PDN
MI686,,2001,1978,,1401930,194277419,35970866,,1220848,171100141,31665713,,181082,23177278,4305153,PDN
MI686,,2002,1978,,1402078,194308074,35976468,,1228462,172342427,31894374,,173616,21965647,4082094,PDN
MI686,,2003,1978,,1415316,196372526,36357047,,1236698,173413825,32093250,,178618,22958701,4263797,PDN
MI686,,2004,1978,,1469876,209036280,38664944,,1258362,176976897,32748913,,211514,32059383,5916031,PDN
MI686,,2005,1978,,1411979,201852150,37328732,,1269466,180942814,33465696,,142513,20909336,3863036,PDN
MI686,,2006,1978,,1412326,203347385,37595135,,1277811,183146991,33866244,,134515,20200394,3728891,PDN
MI686,,2007,1978,,1407724,202702187,37475729,,1276752,184025444,34021493,,130972,18676743,3454236,PDN
MI686,,2008,1978,,1420671,205952442,38067013,,1281325,185402117,34271026,,139346,20550325,3795987,PDN
MI686,,2009,1978,,1388373,202414588,37405207,,1281968,188964125,34905480,,106405,13450463,2499726,PDN
MI686,,2010,1978,,1327906,202923031,37435210,,1285340,190122221,35114919,,42566,12800810,2320290,PDN
MI686,,2011,1978,,1327906,202923031,37435210,,1293778,192930251,35623006,,34128,9992780,1812203,PDN
MI686,,2012,1978,,1327906,202923031,37435210,,1299201,194369103,35884453,,28705,8553928,1550757,PDN
MI686,,2013,1978,,1310939,196092371,36202823,,1300126,195185666,36030675,,10813,906705,172148,PDN
MI686,,2014,1978,,1309846,195761167,36142797,,1309846,195761167,36142797,,0,0,0,PDN
MI686,,2015,1978,,1309846,195761167,36142797,,1309846,195761167,36142797,,0,0,0,PDN
MI686,,2016,1978,,1309846,195761167,36142797,,1309846,195761167,36142797,,0,0,0,PDN
MI686,,2017,1978,,1309846,195761167,36142797,,1309846,195761167,36142797,,0,0,0,PDN
MI686,,2017,1978,,1309846,195761167,36142797,,1309846,195761167,36142797,,0,0,0,PDN
MI687,,1989,1979,,75806,15936025,2911398,,0,0,0,,75806,15936025,2911398,PDN
MI687,,1990,1979,,59006,20843782,3767864,,334,1248149,222425,,58672,19595633,3545439,PDN
MI687,,1991,1979,,58686,22148084,3999626,,338,4436062,789673,,58348,17712022,3209953,PDN
MI687,,1992,1979,,59111,22148084,4000051,,639,7094853,1263068,,58472,15053231,2736983,PDN
MI687,,1993,1979,,49087,25351971,4560114,,1031,9646369,1717467,,48056,15705602,2842647,PDN
MI687,,1994,1979,,6180,32499322,5788978,,1263,11924670,2123090,,4917,20574652,3665888,PDN
MI687,,1995,1979,,11289,32499322,5794087,,3787,13943634,2484861,,7502,18555688,3309226,PDN
MI687,,1996,1979,,9045,32082611,5717695,,4466,15588183,2778164,,4579,16494428,2939531,PDN
MI687,,1997,1979,,9195,32082611,5717845,,5976,17172451,3061572,,3219,14910160,2656273,PDN
MI687,,1998,1979,,11171,27183638,4848117,,6540,17683359,3153045,,4631,9500279,1695072,PDN
MI687,,1999,1979,,14431,28251643,5041414,,7083,18722459,3338481,,7348,9529184,1702933,PDN
MI687,,2000,1979,,14431,28251643,5041414,,8416,19848754,3540223,,6015,8402889,1501191,PDN
MI687,,2001,1979,,14431,28257050,5042376,,9943,20662920,3686619,,4488,7594130,1355757,PDN
MI687,,2002,1979,,14431,28257449,5042447,,11192,21274598,3796708,,3239,6982851,1245739,PDN
MI687,,2003,1979,,14565,27450160,4898935,,12275,22174578,3957929,,2290,5275582,941006,PDN
MI687,,2004,1979,,12417,25029893,4466135,,12403,22459951,4008836,,14,2569942,457299,PDN
MI687,,2005,1979,,12405,24848926,4433922,,12405,22577694,4029788,,0,2271232,404134,PDN
MI687,,2006,1979,,16868,24848926,4438385,,13381,23048723,4114577,,3487,1800203,323808,PDN
MI687,,2007,1979,,16868,24848926,4438385,,14106,23634045,4219452,,2762,1214881,218933,PDN
MI687,,2008,1979,,18750,26890659,4803565,,16296,24462825,4369112,,2454,2427834,434453,PDN
MI687,,2009,1979,,18750,27240605,4865834,,16682,25189103,4498730,,2068,2051502,367104,PDN
MI687,,2010,1979,,18601,26719522,4772966,,17818,25965479,4638012,,783,754043,134954,PDN
MI687,,2011,1979,,18601,26719522,4772966,,18545,26520676,4737528,,56,198846,35438,PDN
MI687,,2012,1979,,18601,26719522,4772966,,18601,26719522,4772966,,0,0,0,PDN
MI687,,2013,1979,,18601,26719522,4772966,,18601,26719522,4772966,,0,0,0,PDN
MI687,,2014,1979,,18601,26719522,4772966,,18601,26719522,4772966,,0,0,0,PDN
MI687,,2015,1979,,18601,26719522,4772966,,18601,26719522,4772966,,0,0,0,PDN
MI687,,2016,1979,,18601,26719522,4772966,,18601,26719522,4772966,,0,0,0,PDN
MI687,,2017,1979,,18601,26719522,4772966,,18601,26719522,4772966,,0,0,0,PDN
MI687,,2017,1979,,18601,26719522,4772966,,18601,26719522,4772966,,0,0,0,PDN
MI696,,1984,1982,,3523805,72284966,16385899,,0,0,0,,3523805,72284966,16385899,PDN
MI696,,1985,1982,,3523805,72284966,16385899,,0,0,0,,3523805,72284966,16385899,PDN
MI696,,1986,1982,,3523805,72284966,16385899,,0,0,0,,3523805,72284966,16385899,PDN
MI696,,1987,1982,,3523805,72284966,16385899,,0,0,0,,3523805,72284966,16385899,PDN
MI696,,1988,1982,,181675,40735210,7429933,,0,0,0,,181675,40735210,7429933,PDN
MI696,,1989,1982,,210360,46931157,8561100,,3603,555496,102446,,206757,46375661,8458654,PDN
MI696,,1990,1982,,210360,46931157,8561100,,44370,9478312,1730902,,165990,37452845,6830198,PDN
MI696,,1991,1982,,213045,44144126,8067872,,62896,15184197,2764710,,150149,28959929,5303162,PDN
MI696,,1992,1982,,163562,44710545,8119175,,74418,19595429,3561149,,89144,25115116,4558026,PDN
MI696,,1993,1982,,208546,53173934,9670100,,87594,23331858,4239170,,120952,29842076,5430930,PDN
MI696,,1994,1982,,219483,55553479,10104444,,104772,28394060,5157096,,114711,27159419,4947348,PDN
MI696,,1995,1982,,214025,56193993,10212956,,111318,31483564,5713376,,102707,24710429,4499580,PDN
MI696,,1996,1982,,159986,46247556,8389088,,116100,34346601,6227595,,43886,11900955,2161493,PDN
MI696,,1997,1982,,240182,50736475,9268025,,123856,38155317,6913058,,116326,12581158,2354967,PDN
MI696,,1998,1982,,258720,64157836,11674705,,131712,42916024,7768015,,127008,21241812,3906690,PDN
MI696,,1999,1982,,263758,77569650,14066187,,142634,51321551,9274583,,121124,26248099,4791604,PDN
MI696,,2000,1982,,157845,62622081,11300564,,145137,54827821,9900977,,12708,7794260,1399587,PDN
MI696,,2001,1982,,158163,62733586,11320723,,145699,55458224,10013710,,12464,7275362,1307013,PDN
MI696,,2002,1982,,165153,64443923,11632043,,147470,55893692,10092967,,17683,8550231,1539076,PDN
MI696,,2003,1982,,165153,64443923,11632043,,149095,56425606,10189238,,16058,8018317,1442805,PDN
MI696,,2004,1982,,153346,60235025,10871322,,150112,56937998,10281428,,3234,3297027,589894,PDN
MI696,,2005,1982,,153346,60235025,10871322,,150962,57599081,10399909,,2384,2635944,471413,PDN
MI696,,2006,1982,,153346,60235025,10871322,,151665,58327646,10530250,,1681,1907379,341072,PDN
MI696,,2007,1982,,179532,59292831,10729858,,165942,58344076,10547450,,13590,948755,182408,PDN
MI696,,2008,1982,,219306,59310287,10772738,,204655,58358637,10588754,,14651,951650,183984,PDN
MI696,,2009,1982,,217270,59231126,10756616,,217147,59190974,10749348,,123,40152,7268,PDN
MI696,,2010,1982,,217270,59231126,10756616,,217270,59231126,10756616,,0,0,0,PDN
MI696,,2011,1982,,217270,59231126,10756616,,217270,59231126,10756616,,0,0,0,PDN
MI696,,2012,1982,,217270,59231126,10756616,,217270,59231126,10756616,,0,0,0,PDN
MI696,,2013,1982,,217270,59231126,10756616,,217270,59231126,10756616,,0,0,0,PDN
MI696,,2014,1982,,217270,59231126,10756616,,217270,59231126,10756616,,0,0,0,PDN
MI696,,2015,1982,,217270,59231126,10756616,,217270,59231126,10756616,,0,0,0,PDN
MI696,,2016,1982,,217270,59231126,10756616,,217270,59231126,10756616,,0,0,0,PDN
MI696,,2017,1982,,217270,59231126,10756616,,217270,59231126,10756616,,0,0,0,PDN
MI696,,2017,1982,,217270,59231126,10756616,,217270,59231126,10756616,,0,0,0,PDN
MI700,,1979,1975,,5000,5000000,894680,,0,0,0,,5000,5000000,894680,PDN
MI700,,1980,1975,,5000,5000000,894680,,0,0,0,,5000,5000000,894680,PDN
MI700,,1981,1975,,5000,5000000,894680,,0,0,0,,5000,5000000,894680,PDN
MI700,,1982,1975,,584788,60370341,11326842,,95198,9827730,1843904,,489590,50542611,9482938,PDN
MI700,,1983,1975,,846020,83755984,15749220,,0,0,0,,846020,83755984,15749220,PDN
MI700,,1984,1975,,855129,92856177,17377580,,21223,2444729,456228,,833906,90411448,16921352,PDN
MI700,,1985,1975,,1251817,126455224,23752747,,105513,16786634,3092459,,1146304,109668590,20660288,PDN
MI700,,1986,1975,,8233345,353987012,71220358,,170373,40754639,7422088,,8062972,313232373,63798270,PDN
MI700,,1987,1975,,8007289,350581927,70388415,,209817,61401484,11135348,,7797472,289180443,59253067,PDN
MI700,,1988,1975,,8007289,350581927,70388415,,235810,75420864,13655893,,7771479,275161063,56732522,PDN
MI700,,1989,1975,,7988239,345549737,69473957,,262221,88061617,15931548,,7726018,257488120,53542409,PDN
MI700,,1990,1975,,654580,232146293,41961750,,274697,99283285,17940762,,379883,132863008,24020988,PDN
MI700,,1991,1975,,654712,236880520,42804271,,282835,108331472,19558898,,371877,128549048,23245373,PDN
MI700,,1992,1975,,640642,236681595,42754805,,287558,114613689,20681453,,353084,122067906,22073352,PDN
MI700,,1993,1975,,556826,228003044,41126763,,293613,119859293,21620889,,263213,108143751,19505874,PDN
MI700,,1994,1975,,547878,222269692,40097645,,296418,121899403,21986703,,251460,100370289,18110942,PDN
MI700,,1995,1975,,618695,229321464,41423226,,317430,128223248,23132955,,301265,101098216,18290271,PDN
MI700,,1996,1975,,547009,207674112,37499698,,347679,136801117,24689515,,199330,70872995,12810183,PDN
MI700,,1997,1975,,555328,208180670,37598152,,362540,141545720,25548611,,192788,66634950,12049541,PDN
MI700,,1998,1975,,548550,208352543,37621956,,364496,142644501,25746080,,184054,65708042,11875876,PDN
MI700,,1999,1975,,537820,206897859,37352386,,366653,143544500,25908379,,171167,63353359,11444007,PDN
MI700,,2000,1975,,601248,232385151,41950919,,367571,143854966,25964540,,233677,88530185,15986379,PDN
MI700,,2001,1975,,1114780,279664127,50877081,,382360,145285776,26233922,,732420,134378351,24643159,PDN
MI700,,2002,1975,,1114780,279664127,50877081,,421237,150129807,27134726,,693543,129534320,23742355,PDN
MI700,,2003,1975,,1130277,281461182,51212338,,448487,157849552,28535596,,681790,123611630,22676742,PDN
MI700,,2004,1975,,647326,239611999,43282913,,449792,159965970,28913488,,197534,79646029,14369425,PDN
MI700,,2005,1975,,647326,239611999,43282913,,450546,160786613,29060264,,196780,78825386,14222649,PDN
MI700,,2006,1975,,647326,239611999,43282913,,450690,161267743,29146018,,196636,78344256,14136895,PDN
MI700,,2007,1975,,584430,214752857,38796682,,450962,161804093,29241726,,133468,52948764,9554956,PDN
MI700,,2008,1975,,450985,161821970,29244930,,450985,161821970,29244930,,0,0,0,PDN
MI700,,2009,1975,,450986,164674121,29752432,,450986,164674121,29752432,,0,0,0,PDN
MI700,,2010,1975,,450986,164674121,29752432,,450986,164674121,29752432,,0,0,0,PDN
MI700,,2011,1975,,450986,164674121,29752432,,450986,164674121,29752432,,0,0,0,PDN
MI700,,2012,1975,,450986,164674121,29752432,,450986,164674121,29752432,,0,0,0,PDN
MI700,,2013,1975,,450986,164674121,29752432,,450986,164674121,29752432,,0,0,0,PDN
MI700,,2014,1975,,450986,164674121,29752432,,450986,164674121,29752432,,0,0,0,PDN
MI700,,2015,1975,,450986,164674121,29752432,,450986,164674121,29752432,,0,0,0,PDN
MI700,,2016,1975,,450986,164674121,29752432,,450986,164674121,29752432,,0,0,0,PDN
MI700,,2017,1975,,450986,164674121,29752432,,450986,164674121,29752432,,0,0,0,PDN
MI700,,2017,1975,,450986,164674121,29752432,,450986,164674121,29752432,,0,0,0,PDN
MI703,,1984,1979,,306661,30359409,5708691,,972,232427,42329,,305689,30126982,5666362,PDN
MI703,,1985,1979,,1898009,496066237,90166023,,46355,9086475,1663165,,1851654,486979762,88502858,PDN
MI703,,1986,1979,,1898009,496066237,90166023,,100876,21568880,3938755,,1797133,474497357,86227268,PDN
MI703,,1987,1979,,1898009,496066237,90166023,,146797,31638076,5776348,,1751212,464428161,84389675,PDN
MI703,,1988,1979,,1591077,371816745,67750640,,223741,50272862,9169090,,1367336,321543883,58581550,PDN
MI703,,1989,1979,,745272,175142930,31909494,,283853,69169852,12591656,,461419,105973078,19317838,PDN
MI703,,1990,1979,,745272,175142930,31909494,,327551,85231786,15493349,,417721,89911144,16416145,PDN
MI703,,1991,1979,,745272,175142930,31909494,,358597,99570989,18075855,,386675,75571941,13833639,PDN
MI703,,1992,1979,,686258,226048156,40908350,,376875,110282969,20000179,,309383,115765187,20908171,PDN
MI703,,1993,1979,,630668,227695349,41145855,,398079,128800770,23316365,,232589,98894579,17829490,PDN
MI703,,1994,1979,,641764,240236199,43388419,,414814,146940076,26560735,,226950,93296123,16827684,PDN
MI703,,1995,1979,,642372,240944295,43515022,,423633,160545134,28990383,,218739,80399161,14524639,PDN
MI703,,1996,1979,,566518,249611294,44981339,,430965,172603826,31143390,,135553,77007468,13837949,PDN
MI703,,1997,1979,,555867,250125467,45062178,,438725,182786498,32963013,,117142,67338969,12099165,PDN
MI703,,1998,1979,,557269,253633576,45687799,,443158,189848742,34224073,,114111,63784834,11463726,PDN
MI703,,1999,1979,,496587,219195305,39499310,,448025,194004440,34968388,,48562,25190865,4530922,PDN
MI703,,2000,1979,,494026,235818568,42454625,,454672,202440934,36476191,,39354,33377634,5978434,PDN
MI703,,2001,1979,,494133,235882453,42466099,,459131,211255128,38049011,,35002,24627325,4417088,PDN
MI703,,2002,1979,,494133,235882453,42466099,,462724,217327790,39133149,,31409,18554663,3332950,PDN
MI703,,2003,1979,,493833,238229794,42883476,,464680,222160204,39994965,,29153,16069590,2888511,PDN
MI703,,2004,1979,,493833,238229794,42883476,,465370,223503255,40234632,,28463,14726539,2648844,PDN
MI703,,2005,1979,,493948,237671375,42784228,,465921,225685010,40623396,,28027,11986365,2160832,PDN
MI703,,2006,1979,,521443,251402057,45254905,,466641,226885699,40837762,,54802,24516358,4417143,PDN
MI703,,2007,1979,,518002,248486826,44732739,,467708,227735029,40989955,,50294,20751797,3742784,PDN
MI703,,2008,1979,,484470,236856726,42629795,,468586,228428275,41114187,,15884,8428451,1515608,PDN
MI703,,2009,1979,,487151,240728435,43321391,,468815,232584363,41853933,,18336,8144072,1467460,PDN
MI703,,2010,1979,,487808,241819055,43516109,,469284,233232153,41969667,,18524,8586902,1546443,PDN
MI703,,2011,1979,,487808,241819055,43516109,,469977,233816175,42074279,,17831,8002880,1441831,PDN
MI703,,2012,1979,,470806,234551757,42205994,,470660,234318592,42164360,,146,233165,41634,PDN
MI703,,2013,1979,,470806,234551757,42205994,,470806,234551757,42205994,,0,0,0,PDN
MI703,,2014,1979,,470806,234551757,42205994,,470806,234551757,42205994,,0,0,0,PDN
MI703,,2015,1979,,470806,234551757,42205994,,470806,234551757,42205994,,0,0,0,PDN
MI703,,2016,1979,,470806,234551757,42205994,,470806,234551757,42205994,,0,0,0,PDN
MI703,,2017,1979,,470806,234551757,42205994,,470806,234551757,42205994,,0,0,0,PDN
MI703,,2017,1979,,470806,234551757,42205994,,470806,234551757,42205994,,0,0,0,PDN
MI705,,1989,1988,,37721,7928864,1448551,,0,0,0,,37721,7928864,1448551,PDN
MI705,,1990,1988,,37721,7928864,1448551,,4852,1182166,215202,,32869,6746698,1233349,PDN
MI705,,1991,1988,,37721,7928864,1448551,,9312,2369090,430858,,28409,5559774,1017693,PDN
MI705,,1992,1988,,37721,7928864,1448551,,17445,4263979,776160,,20276,3664885,672391,PDN
MI705,,1993,1988,,52679,12247333,2231920,,25828,6301140,1147027,,26851,5946193,1084893,PDN
MI705,,1994,1988,,85631,20699451,3768807,,26427,6616104,1203670,,59204,14083347,2565137,PDN
MI705,,1995,1988,,89766,21973403,3999624,,28783,7267306,1321898,,60983,14706097,2677726,PDN
MI705,,1996,1988,,87839,21315522,3880637,,31285,7933727,1442980,,56554,13381795,2437657,PDN
MI705,,1997,1988,,140860,41185471,7469236,,31790,8088136,1470960,,109070,33097335,5998276,PDN
MI705,,1998,1988,,140860,41185471,7469236,,38304,10833292,1965936,,102556,30352179,5503300,PDN
MI705,,1999,1988,,140860,41185471,7469236,,42643,13572888,2457748,,98217,27612583,5011488,PDN
MI705,,2000,1988,,65755,19731994,3576786,,42645,14009020,2535353,,23110,5722974,1041433,PDN
MI705,,2001,1988,,43566,14245782,2578403,,43566,14245782,2578403,,0,0,0,PDN
MI705,,2002,1988,,43566,14245782,2578403,,43566,14245782,2578403,,0,0,0,PDN
MI705,,2003,1988,,43566,14245782,2578403,,43566,14245782,2578403,,0,0,0,PDN
MI705,,2004,1988,,43566,14245782,2578403,,43566,14245782,2578403,,0,0,0,PDN
MI705,,2005,1988,,43566,14245782,2578403,,43566,14245782,2578403,,0,0,0,PDN
MI705,,2006,1988,,43566,14245782,2578403,,43566,14245782,2578403,,0,0,0,PDN
MI705,,2007,1988,,43566,14245782,2578403,,43566,14245782,2578403,,0,0,0,PDN
MI705,,2008,1988,,43566,14245782,2578403,,43566,14245782,2578403,,0,0,0,PDN
MI705,,2009,1988,,43566,14449139,2614587,,43566,14449139,2614587,,0,0,0,PDN
MI705,,2010,1988,,43566,14449139,2614587,,43566,14449139,2614587,,0,0,0,PDN
MI705,,2011,1988,,43566,14449139,2614587,,43566,14449139,2614587,,0,0,0,PDN
MI705,,2012,1988,,43566,14449139,2614587,,43566,14449139,2614587,,0,0,0,PDN
MI705,,2013,1988,,43566,14449139,2614587,,43566,14449139,2614587,,0,0,0,PDN
MI705,,2014,1988,,43566,14449139,2614587,,43566,14449139,2614587,,0,0,0,PDN
MI705,,2015,1988,,43566,14449139,2614587,,43566,14449139,2614587,,0,0,0,PDN
MI705,,2016,1988,,43566,14449139,2614587,,43566,14449139,2614587,,0,0,0,PDN
MI705,,2017,1988,,43566,14449139,2614587,,43566,14449139,2614587,,0,0,0,PDN
MI705,,2017,1988,,43566,14449139,2614587,,43566,14449139,2614587,,0,0,0,PDN
MI710,,1994,1982,,83309,50062581,8991242,,245,157393,28251,,83064,49905188,8962991,PDN
MI710,,1995,1982,,83309,50062581,8991242,,12311,8059618,1446407,,70998,42002963,7544835,PDN
MI710,,1996,1982,,68030,49294164,8839234,,19031,13216378,2370700,,48999,36077786,6468534,PDN
MI710,,1997,1982,,66705,36524919,6565801,,23936,15582883,2796691,,42769,20942036,3769110,PDN
MI710,,1998,1982,,75713,40398042,7263977,,25198,16842202,3022031,,50515,23555840,4241946,PDN
MI710,,1999,1982,,52495,28291660,5086598,,25592,17174092,3081480,,26903,11117568,2005118,PDN
MI710,,2000,1982,,156983,46406021,8414282,,26205,17373644,3117601,,130778,29032377,5296681,PDN
MI710,,2001,1982,,153420,44767449,8119158,,60983,24500283,4420464,,92437,20267166,3698694,PDN
MI710,,2002,1982,,153420,44767449,8119158,,71834,27738867,5007575,,81586,17028582,3111583,PDN
MI710,,2003,1982,,153420,44767449,8119158,,77951,29022109,5242027,,75469,15745340,2877131,PDN
MI710,,2004,1982,,193861,58487013,10600803,,88682,33161220,5989255,,105179,25325793,4611548,PDN
MI710,,2005,1982,,158342,52336406,9470870,,97889,36601131,6610546,,60453,15735275,2860324,PDN
MI710,,2006,1982,,156022,52522650,9501689,,99408,37679142,6803882,,56614,14843508,2697807,PDN
MI710,,2007,1982,,128282,44412819,8030919,,98873,38413775,6934064,,29409,5999044,1096855,PDN
MI710,,2008,1982,,99667,38565207,6961803,,99667,38565189,6961800,,0,18,3,PDN
MI710,,2009,1982,,99666,38898194,7021054,,99666,38898194,7021054,,0,0,0,PDN
MI710,,2010,1982,,99666,38898194,7021054,,99666,38898194,7021054,,0,0,0,PDN
MI710,,2011,1982,,99666,38898194,7021054,,99666,38898194,7021054,,0,0,0,PDN
MI710,,2012,1982,,99666,38898194,7021054,,99666,38898194,7021054,,0,0,0,PDN
MI710,,2013,1982,,99666,38898194,7021054,,99666,38898194,7021054,,0,0,0,PDN
MI710,,2014,1982,,99666,38898194,7021054,,99666,38898194,7021054,,0,0,0,PDN
MI710,,2015,1982,,99666,38898194,7021054,,99666,38898194,7021054,,0,0,0,PDN
MI710,,2016,1982,,99666,38898194,7021054,,99666,38898194,7021054,,0,0,0,PDN
MI710,,2017,1982,,99666,38898194,7021054,,99666,38898194,7021054,,0,0,0,PDN
MI710,,2017,1982,,99666,38898194,7021054,,99666,38898194,7021054,,0,0,0,PDN
MO1002,,1989,1988,,321,3210631,571608,,0,0,0,,321,3210631,571608,PDN
MO1002,,1990,1988,,321,3210631,571608,,0,0,0,,321,3210631,571608,PDN
MO1002,,1991,1988,,321,3210631,571608,,0,0,0,,321,3210631,571608,PDN
MO1002,,1992,1988,,321,3210631,571608,,0,0,0,,321,3210631,571608,PDN
MO1002,,1993,1988,,321,3210631,571608,,0,0,0,,321,3210631,571608,PDN
MO1002,,1994,1988,,320,3196116,569024,,0,0,0,,320,3196116,569024,PDN
MO1002,,2008,1988,,0,4317947,768318,,0,2870394,510746,,0,1447553,257572,PDN
MO1002,,2009,1988,,0,4407247,784208,,0,4151693,738735,,0,255554,45472,PDN
MO1002,,2010,1988,,0,4407247,784208,,0,4247382,755762,,0,159865,28446,PDN
MO1002,,2011,1988,,0,4247382,755762,,0,4247382,755762,,0,0,0,PDN
MO1002,,2012,1988,,0,4247382,755762,,0,4247382,755762,,0,0,0,PDN
MO1002,,2013,1988,,0,4247382,755762,,0,4247382,755762,,0,0,0,PDN
MO1002,,2014,1988,,0,4247382,755762,,0,4247382,755762,,0,0,0,PDN
MO1002,,2015,1988,,0,4247382,755762,,0,4247382,755762,,0,0,0,PDN
MO1002,,2016,1988,,0,4247382,755762,,0,4247382,755762,,0,0,0,PDN
MO1002,,2017,1988,,0,4247382,755762,,0,4247382,755762,,0,0,0,PDN
MO1002,,2017,1988,,0,4247382,755762,,0,4247382,755762,,0,0,0,PDN
MO1003,,1989,1988,,268,2684417,477922,,0,0,0,,268,2684417,477922,PDN
MO1003,,1990,1988,,268,2684417,477922,,0,0,0,,268,2684417,477922,PDN
MO1003,,1991,1988,,268,2684417,477922,,0,0,0,,268,2684417,477922,PDN
MO1003,,1992,1988,,268,2684417,477922,,0,0,0,,268,2684417,477922,PDN
MO1003,,1993,1988,,268,2684417,477922,,0,0,0,,268,2684417,477922,PDN
MO1003,,1994,1988,,267,2672336,475772,,0,0,0,,267,2672336,475772,PDN
MO1003,,2007,1988,,267,2966362,528089,,0,0,0,,267,2966362,528089,PDN
MO1003,,2008,1988,,375,3980676,708680,,0,804258,143106,,375,3176418,565574,PDN
MO1003,,2009,1988,,0,1125981,200352,,0,991127,176357,,0,134854,23996,PDN
MO1003,,2010,1988,,0,1125981,200352,,0,1022855,182003,,0,103126,18350,PDN
MO1003,,2011,1988,,0,1022855,182003,,0,1022855,182003,,0,0,0,PDN
MO1003,,2012,1988,,0,1022855,182003,,0,1022855,182003,,0,0,0,PDN
MO1003,,2013,1988,,0,1022855,182003,,0,1022855,182003,,0,0,0,PDN
MO1003,,2014,1988,,0,1022855,182003,,0,1022855,182003,,0,0,0,PDN
MO1003,,2015,1988,,0,1022855,182003,,0,1022855,182003,,0,0,0,PDN
MO1003,,2016,1988,,0,1022855,182003,,0,1022855,182003,,0,0,0,PDN
MO1003,,2017,1988,,0,1022855,182003,,0,1022855,182003,,0,0,0,PDN
MO1003,,2017,1988,,0,1022855,182003,,0,1022855,182003,,0,0,0,PDN
MO819,,1997,1996,,0,53641346,9544723,,0,0,0,,0,53641346,9544723,PDN
MO819,,1998,1996,,100,53641346,9544823,,26,4906140,873005,,74,48735206,8671818,PDN
MO819,,1999,1996,,47,14133115,2514836,,26,7857579,1398172,,21,6275536,1116664,PDN
MO819,,2000,1996,,47,14133115,2514836,,26,9329570,1660092,,21,4803545,854744,PDN
MO819,,2001,1996,,47,14133115,2514836,,26,10234256,1821068,,21,3898859,693768,PDN
MO819,,2002,1996,,47,14133115,2514836,,26,10853164,1931194,,21,3279951,583642,PDN
MO819,,2003,1996,,47,14133115,2514836,,26,11306479,2011855,,21,2826636,502981,PDN
MO819,,2004,1996,,26,11687393,2079633,,26,11687393,2079633,,0,0,0,PDN
MO819,,2005,1996,,26,11717441,2084980,,26,11717441,2084980,,0,0,0,PDN
MO819,,2006,1996,,26,11717441,2084980,,26,11717441,2084980,,0,0,0,PDN
MO819,,2007,1996,,26,11717441,2084980,,26,11717441,2084980,,0,0,0,PDN
MO819,,2008,1996,,26,11717441,2084980,,26,11717441,2084980,,0,0,0,PDN
MO819,,2009,1996,,26,11791179,2098101,,26,11791179,2098101,,0,0,0,PDN
MO819,,2010,1996,,26,11791179,2098101,,26,11791179,2098101,,0,0,0,PDN
MO819,,2011,1996,,26,11791179,2098101,,26,11791179,2098101,,0,0,0,PDN
MO819,,2012,1996,,26,11791179,2098101,,26,11791179,2098101,,0,0,0,PDN
MO819,,2013,1996,,26,11791179,2098101,,26,11791179,2098101,,0,0,0,PDN
MO819,,2014,1996,,26,11791179,2098101,,26,11791179,2098101,,0,0,0,PDN
MO819,,2015,1996,,26,11791179,2098101,,26,11791179,2098101,,0,0,0,PDN
MO819,,2016,1996,,26,11791179,2098101,,26,11791179,2098101,,0,0,0,PDN
MO819,,2017,1996,,26,11791179,2098101,,26,11791179,2098101,,0,0,0,PDN
MO819,,2017,1996,,26,11791179,2098101,,26,11791179,2098101,,0,0,0,PDN
MO820,,1996,1994,,600,33096793,5889709,,0,1313094,233647,,600,31783699,5656062,PDN
MO820,,1997,1994,,0,81653942,14529171,,0,16315229,2903066,,0,65338713,11626105,PDN
MO820,,1998,1994,,0,81653942,14529171,,0,25624921,4559594,,0,56029021,9969577,PDN
MO820,,1999,1994,,0,40826971,7264586,,0,26962813,4797654,,0,13864158,2466932,PDN
MO820,,2000,1994,,0,40826971,7264586,,0,26962813,4797654,,0,13864158,2466932,PDN
MO820,,2001,1994,,0,40826971,7264586,,0,26962813,4797654,,0,13864158,2466932,PDN
MO820,,2002,1994,,0,26962813,4797654,,0,26962813,4797654,,0,0,0,PDN
MO820,,2003,1994,,0,26962813,4797654,,0,26962813,4797654,,0,0,0,PDN
MO820,,2004,1994,,0,26962813,4797654,,0,26962813,4797654,,0,0,0,PDN
MO820,,2005,1994,,0,26962813,4797654,,0,26962813,4797654,,0,0,0,PDN
MO820,,2006,1994,,0,26962813,4797654,,0,26962813,4797654,,0,0,0,PDN
MO820,,2007,1994,,0,26962813,4797654,,0,26962813,4797654,,0,0,0,PDN
MO820,,2008,1994,,0,26962813,4797654,,0,26962813,4797654,,0,0,0,PDN
MO820,,2009,1994,,0,27442518,4883010,,0,27442518,4883010,,0,0,0,PDN
MO820,,2010,1994,,0,27442518,4883010,,0,27442518,4883010,,0,0,0,PDN
MO820,,2011,1994,,0,27442518,4883010,,0,27442518,4883010,,0,0,0,PDN
MO820,,2012,1994,,0,27442518,4883010,,0,27442518,4883010,,0,0,0,PDN
MO820,,2013,1994,,0,27442518,4883010,,0,27442518,4883010,,0,0,0,PDN
MO820,,2014,1994,,0,27442518,4883010,,0,27442518,4883010,,0,0,0,PDN
MO820,,2015,1994,,0,27442518,4883010,,0,27442518,4883010,,0,0,0,PDN
MO820,,2016,1994,,0,27442518,4883010,,0,27442518,4883010,,0,0,0,PDN
MO820,,2017,1994,,0,27442518,4883010,,0,27442518,4883010,,0,0,0,PDN
MO820,,2017,1994,,0,27442518,4883010,,0,27442518,4883010,,0,0,0,PDN
MO821,,1987,1986,,0,20937520,3725537,,0,0,0,,0,20937520,3725537,PDN
MO821,,1991,1986,,50,70421488,12530564,,0,0,0,,50,70421488,12530564,PDN
MO821,,1992,1986,,35288,70421488,12565802,,4492,8696352,1551886,,30796,61725136,11013916,PDN
MO821,,1993,1986,,35288,70421488,12565802,,9358,18841830,3361997,,25930,51579658,9203805,PDN
MO821,,1994,1986,,35288,70421488,12565802,,12119,24865411,4436569,,23169,45556077,8129233,PDN
MO821,,1995,1986,,35595,72418692,12921483,,14730,30273514,5401476,,20865,42145178,7520007,PDN
MO821,,1996,1986,,31636,71340200,12725622,,16436,34639530,6180053,,15200,36700670,6545569,PDN
MO821,,1997,1986,,18610,59987000,10692453,,18610,40098652,7153601,,0,19888348,3538852,PDN
MO821,,1998,1986,,27585,59987000,10701428,,19779,43011120,7673003,,7806,16975880,3028425,PDN
MO821,,1999,1986,,27585,59987000,10701428,,21636,46702719,8331728,,5949,13284281,2369700,PDN
MO821,,2000,1986,,27585,59987000,10701428,,21689,46848031,8357638,,5896,13138969,2343790,PDN
MO821,,2001,1986,,27585,59987000,10701428,,21689,46848031,8357638,,5896,13138969,2343790,PDN
MO821,,2002,1986,,32557,70101933,12506211,,24874,53789856,9596023,,7683,16312077,2910188,PDN
MO821,,2003,1986,,32557,70101933,12506211,,27612,58988305,10523752,,4945,11113628,1982459,PDN
MO821,,2004,1986,,32557,70101933,12506211,,28549,62562925,11160742,,4008,7539008,1345469,PDN
MO821,,2005,1986,,32557,70101933,12506211,,29318,64997047,11594629,,3239,5104886,911582,PDN
MO821,,2006,1986,,32867,75134500,13401995,,30228,67574067,12054083,,2639,7560433,1347912,PDN
MO821,,2007,1986,,32867,75134500,13401995,,30841,69632482,12420962,,2026,5502018,981033,PDN
MO821,,2008,1986,,32867,75134500,13401995,,31356,71664527,12783051,,1511,3469973,618944,PDN
MO821,,2009,1986,,36323,84733827,15113516,,31631,73549489,13118729,,4692,11184338,1994788,PDN
MO821,,2010,1986,,36323,84733827,15113516,,31698,73799721,13163321,,4625,10934106,1950195,PDN
MO821,,2011,1986,,35188,82085895,14641219,,32352,76537633,13651148,,2836,5548262,990071,PDN
MO821,,2012,1986,,35188,82085895,14641219,,32813,78240983,13954696,,2375,3844912,686523,PDN
MO821,,2013,1986,,34575,82085895,14640606,,33266,79229226,14130993,,1309,2856669,509613,PDN
MO821,,2014,1986,,33266,79244274,14133671,,33266,79244274,14133671,,0,0,0,PDN
MO821,,2015,1986,,33266,79244274,14133671,,33266,79244274,14133671,,0,0,0,PDN
MO821,,2016,1986,,33266,79244274,14133671,,33266,79244274,14133671,,0,0,0,PDN
MO821,,2017,1986,,33266,79244274,14133671,,33266,79244274,14133671,,0,0,0,PDN
MO821,,2017,1986,,33266,79244274,14133671,,33266,79244274,14133671,,0,0,0,PDN
MO823,,1985,1983,,5758127,575812608,108215886,,0,0,0,,5758127,575812608,108215886,PDP
MO823,,1986,1983,,0,677008217,120464096,,0,0,0,,0,677008217,120464096,PDP
MO823,,1987,1983,,0,677008217,120464096,,0,0,0,,0,677008217,120464096,PDP
MO823,,1988,1983,,0,296670208,52788293,,0,0,0,,0,296670208,52788293,PDP
MO823,,1989,1983,,85589,855804848,152364032,,0,0,0,,85589,855804848,152364032,PDP
MO823,,1990,1983,,13000,842169328,149865194,,0,0,0,,13000,842169328,149865194,PDP
MO823,,1991,1983,,13000,560099632,99674856,,0,2721985,484339,,13000,557377647,99190517,PDP
MO823,,1992,1983,,400,560099632,99662256,,0,52149863,9279335,,400,507949769,90382921,PDP
MO823,,1993,1983,,3472,587299571,104505175,,0,98840793,17587330,,3472,488458778,86917845,PDP
MO823,,1994,1983,,3472,586126032,104296360,,0,168759932,30028458,,3472,417366100,74267902,PDP
MO823,,1995,1983,,60950,705289012,125557215,,4342,244589562,43525616,,56608,460699450,82031599,PDP
MO823,,1996,1983,,80984,709981954,126412293,,20143,313003036,55714633,,60841,396978918,70697660,PDP
MO823,,1997,1983,,80984,709981954,126412293,,35572,364360028,64868317,,45412,345621926,61543976,PDP
MO823,,1998,1983,,80984,709981954,126412293,,45476,421447203,75036082,,35508,288534751,51376211,PDP
MO823,,1999,1983,,167848,905150751,161226700,,63222,486955130,86710042,,104626,418195621,74516658,PDP
MO823,,2000,1983,,167848,904776825,161160166,,73694,545290962,97100556,,94154,359485863,64059610,PDP
MO823,,2001,1983,,146277,904306801,161054960,,85744,590330314,105126725,,60533,313976487,55928235,PDP
MO823,,2002,1983,,136570,881230794,156939202,,97022,625526203,111400617,,39548,255704591,45538585,PDP
MO823,,2003,1983,,133623,859582436,153084234,,100797,657848637,117155715,,32826,201733799,35928519,PDP
MO823,,2004,1983,,133623,859582436,153084234,,108780,688367827,122594158,,24843,171214609,30490076,PDP
MO823,,2005,1983,,133623,859582436,153084234,,115102,715364339,127404130,,18521,144218097,25680104,PDP
MO823,,2006,1983,,133932,862403681,153586544,,119822,740378957,131859850,,14110,122024724,21726694,PDP
MO823,,2007,1983,,133583,858915942,152965601,,124122,759437879,135255417,,9461,99478063,17710184,PDP
MO823,,2008,1983,,133583,858915942,152965601,,130332,779421285,138817393,,3251,79494657,14148208,PDP
MO823,,2009,1983,,376169,864459423,154194571,,134700,804994077,143372079,,241469,59465346,10822492,PDP
MO823,,2010,1983,,376169,864459423,154194571,,139462,819589382,145973870,,236707,44870041,8220701,PDP
MO823,,2011,1983,,169068,911816574,162414010,,143719,831572047,148110274,,25349,80244527,14303735,PDP
MO823,,2012,1983,,169068,911816574,162414010,,148793,843760148,150284049,,20275,68056426,12129960,PDP
MO823,,2013,1983,,176139,911816574,162421081,,153250,854877141,152266620,,22889,56939433,10154461,PDP
MO823,,2014,1983,,175782,910269330,162145413,,156916,864534685,153988710,,18866,45734645,8156703,PDP
MO823,,2015,1983,,177818,910119335,162120759,,161146,873178943,155531063,,16672,36940392,6589695,PDP
MO823,,2016,1983,,166604,894318860,159298073,,164674,881623823,157037239,,1930,12695037,2260833,PDP
MO823,,2017,1983,,167168,894318852,159298636,,167145,888747479,158307265,,23,5571373,991371,PDP
MO823,,2017,1983,,167168,894318852,159298636,,167145,888747479,158307265,,23,5571373,991371,PDP
MO827,,1992,1984,,0,168879200,30049680,,0,0,0,,0,168879200,30049680,PDP
MO827,,1993,1984,,0,168879200,30049680,,0,534562,95118,,0,168344638,29954562,PDP
MO827,,1994,1984,,74646,168879200,30124326,,3317,7504400,1338619,,71329,161374800,28785707,PDP
MO827,,1995,1984,,74444,247610592,44133268,,1173,11619391,2068680,,73271,235991201,42064588,PDP
MO827,,1996,1984,,26112,168423498,29994706,,2990,23548586,4193130,,23122,144874912,25801576,PDP
MO827,,1997,1984,,26112,168423498,29994706,,4513,34405733,6126530,,21599,134017765,23868176,PDP
MO827,,1998,1984,,26112,168423498,29994706,,4876,39955948,7114475,,21236,128467550,22880231,PDP
MO827,,1999,1984,,11335,78948515,14059113,,6159,47607648,8477271,,5176,31340867,5581842,PDP
MO827,,2000,1984,,11335,158135609,28149343,,7118,52317319,9316249,,4217,105818290,18833094,PDP
MO827,,2001,1984,,11335,158135609,28149343,,8193,59130670,10529665,,3142,99004939,17619678,PDP
MO827,,2002,1984,,9892,153374862,27300792,,9357,65295444,11627763,,535,88079418,15673029,PDP
MO827,,2003,1984,,9892,153374862,27300792,,9510,67722201,12059724,,382,85652661,15241068,PDP
MO827,,2004,1984,,9892,153374862,27300792,,9868,70607417,12573465,,24,82767445,14727327,PDP
MO827,,2005,1984,,15168,197793361,35209716,,10119,75779999,13494105,,5049,122013362,21715611,PDP
MO827,,2006,1984,,15160,118542226,21108083,,10039,81832373,14570959,,5121,36709853,6537124,PDP
MO827,,2007,1984,,20845,175391085,31229223,,10437,87393562,15560893,,10408,87997523,15668330,PDP
MO827,,2008,1984,,20845,175391085,31229223,,10866,92234100,16422628,,9979,83156985,14806595,PDP
MO827,,2009,1984,,16466,136163009,24244760,,12604,97797017,17414209,,3862,38365992,6830551,PDP
MO827,,2010,1984,,16466,136163009,24244760,,12998,110145602,19611860,,3468,26017407,4632899,PDP
MO827,,2011,1984,,18606,148948304,26521863,,13800,115785931,20616279,,4806,33162373,5905583,PDP
MO827,,2012,1984,,18606,149113820,26551314,,14871,118697569,21135435,,3735,30416251,5415880,PDP
MO827,,2013,1984,,23221,149113820,26555929,,15885,125250129,22302386,,7336,23863691,4253545,PDP
MO827,,2014,1984,,23753,165396968,29453818,,16753,133228750,23722936,,7000,32168218,5730882,PDP
MO827,,2015,1984,,24179,165373207,29450017,,17874,143373093,25529101,,6305,22000114,3920916,PDP
MO827,,2016,1984,,21081,164329020,29261121,,18785,149840329,26680766,,2296,14488691,2580355,PDP
MO827,,2017,1984,,21081,170792223,30411157,,19525,157001040,27955653,,1556,13791183,2455504,PDP
MO827,,2017,1984,,21081,170792223,30411157,,19525,157001040,27955653,,1556,13791183,2455504,PDP
MO830,,1989,1989,,1568,15680145,2791629,,0,0,0,,1568,15680145,2791629,PDN
MO830,,1990,1989,,1568,15680145,2791629,,0,0,0,,1568,15680145,2791629,PDN
MO830,,1991,1989,,1568,15680145,2791629,,0,0,0,,1568,15680145,2791629,PDN
MO830,,1992,1989,,1568,15680145,2791629,,0,0,0,,1568,15680145,2791629,PDN
MO830,,1993,1989,,1568,15680145,2791629,,0,0,0,,1568,15680145,2791629,PDN
MO830,,1994,1989,,1561,15607425,2778683,,0,0,0,,1561,15607425,2778683,PDN
MO830,,1995,1989,,1561,15607425,2778683,,0,0,0,,1561,15607425,2778683,PDN
MO830,,1996,1989,,1561,15607425,2778683,,0,0,0,,1561,15607425,2778683,PDN
MO830,,1997,1989,,0,11148161,1983659,,0,0,0,,0,11148161,1983659,PDN
MO830,,1998,1989,,0,11148161,1983659,,0,0,0,,0,11148161,1983659,PDN
MO830,,1999,1989,,0,294980,52488,,0,211044,37552,,0,83936,14936,PDN
MO830,,2000,1989,,0,294980,52488,,0,264924,47140,,0,30056,5348,PDN
MO830,,2001,1989,,0,463000,82384,,0,303374,53981,,0,159626,28403,PDN
MO830,,2002,1989,,0,463000,82384,,0,326026,58012,,0,136974,24372,PDN
MO830,,2003,1989,,0,463000,82384,,0,352407,62706,,0,110593,19678,PDN
MO830,,2004,1989,,0,372856,66344,,0,372856,66344,,0,0,0,PDN
MO830,,2005,1989,,0,377120,67103,,0,377120,67103,,0,0,0,PDN
MO830,,2006,1989,,0,377120,67103,,0,377120,67103,,0,0,0,PDN
MO830,,2007,1989,,0,377120,67103,,0,377120,67103,,0,0,0,PDN
MO830,,2008,1989,,0,375370,66792,,0,375370,66792,,0,0,0,PDN
MO830,,2009,1989,,0,11388280,2026385,,0,375370,66792,,0,11012910,1959593,PDN
MO830,,2010,1989,,0,11388280,2026385,,0,375370,66792,,0,11012910,1959593,PDN
MO830,,2011,1989,,0,11388280,2026385,,0,375370,66792,,0,11012910,1959593,PDN
MO830,,2012,1989,,0,11388280,2026385,,0,375370,66792,,0,11012910,1959593,PDN
MO830,,2013,1989,,0,375370,66792,,0,375370,66792,,0,0,0,PDN
MO830,,2014,1989,,0,375370,66792,,0,375370,66792,,0,0,0,PDN
MO830,,2015,1989,,0,375370,66792,,0,375370,66792,,0,0,0,PDN
MO830,,2016,1989,,0,375370,66792,,0,375370,66792,,0,0,0,PDN
MO830,,2017,1989,,0,375370,66792,,0,375370,66792,,0,0,0,PDN
MO830,,2017,1989,,0,375370,66792,,0,375370,66792,,0,0,0,PDN
MO861,,1988,1984,,2534,25333664,4510303,,0,0,0,,2534,25333664,4510303,PDN
MO861,,1989,1984,,2534,25333664,4510303,,0,0,0,,2534,25333664,4510303,PDN
MO861,,1990,1984,,2534,25333664,4510303,,0,0,0,,2534,25333664,4510303,PDN
MO861,,1991,1984,,2534,25333664,4510303,,0,0,0,,2534,25333664,4510303,PDN
MO861,,1992,1984,,2534,25333664,4510303,,0,0,0,,2534,25333664,4510303,PDN
MO861,,1993,1984,,2534,25333664,4510303,,0,0,0,,2534,25333664,4510303,PDN
MO861,,1994,1984,,2528,25275763,4499995,,0,1950011,346977,,2528,23325752,4153018,PDN
MO861,,1995,1984,,0,27238844,4846769,,0,4644141,826360,,0,22594703,4020409,PDN
MO861,,1996,1984,,0,148182387,26366973,,0,7340861,1306203,,0,140841526,25060770,PDN
MO861,,1997,1984,,0,148182387,26366973,,0,11879155,2113729,,0,136303232,24253244,PDN
MO861,,1998,1984,,0,149747621,26645484,,0,14528477,2585138,,0,135219144,24060346,PDN
MO861,,1999,1984,,0,19626044,3492179,,0,15443692,2747988,,0,4182352,744191,PDN
MO861,,2000,1984,,10,19243189,3424065,,5,15671340,2788500,,5,3571849,635565,PDN
MO861,,2001,1984,,200,22095100,3931712,,56,18133793,3226710,,144,3961307,705002,PDN
MO861,,2002,1984,,200,22095100,3931712,,105,18334067,3262395,,95,3761033,669317,PDN
MO861,,2003,1984,,122,20790535,3699505,,122,18433759,3280150,,0,2356776,419355,PDN
MO861,,2004,1984,,122,19023175,3385029,,122,19023175,3385029,,0,0,0,PDN
MO861,,2005,1984,,122,19317784,3437450,,122,19317784,3437450,,0,0,0,PDN
MO861,,2006,1984,,191,20007916,3560318,,122,19317784,3437450,,69,690132,122868,PDN
MO861,,2007,1984,,191,20007916,3560318,,122,19947609,3549519,,69,60307,10799,PDN
MO861,,2008,1984,,191,20007916,3560318,,122,19996471,3558213,,69,11445,2105,PDN
MO861,,2009,1984,,122,20323234,3616356,,122,20323234,3616356,,0,0,0,PDN
MO861,,2010,1984,,122,20323234,3616356,,122,20323234,3616356,,0,0,0,PDN
MO861,,2011,1984,,122,20323234,3616356,,122,20323234,3616356,,0,0,0,PDN
MO861,,2012,1984,,122,20323234,3616356,,122,20323234,3616356,,0,0,0,PDN
MO861,,2013,1984,,122,20323234,3616356,,122,20323234,3616356,,0,0,0,PDN
MO861,,2014,1984,,122,20323234,3616356,,122,20323234,3616356,,0,0,0,PDN
MO861,,2015,1984,,122,20323234,3616356,,122,20323234,3616356,,0,0,0,PDN
MO861,,2016,1984,,122,20323234,3616356,,122,20323234,3616356,,0,0,0,PDN
MO861,,2017,1984,,122,20323234,3616356,,122,20323234,3616356,,0,0,0,PDN
MO861,,2017,1984,,122,20323234,3616356,,122,20323234,3616356,,0,0,0,PDN
MO862,,1988,1987,,0,12616185,2244873,,0,0,0,,0,12616185,2244873,PDN
MO862,,1989,1987,,0,12616185,2244873,,0,0,0,,0,12616185,2244873,PDN
MO862,,1990,1987,,0,12616185,2244873,,0,0,0,,0,12616185,2244873,PDN
MO862,,1991,1987,,0,12616185,2244873,,0,0,0,,0,12616185,2244873,PDN
MO862,,1992,1987,,0,10400743,1850666,,0,0,0,,0,10400743,1850666,PDN
MO862,,1993,1987,,0,10400743,1850666,,0,0,0,,0,10400743,1850666,PDN
MO862,,1994,1987,,0,10345963,1840919,,0,0,0,,0,10345963,1840919,PDN
MO862,,1995,1987,,0,16875590,3002774,,0,819554,145828,,0,16056036,2856946,PDN
MO862,,1996,1987,,0,51253876,9119907,,0,1294553,230348,,0,49959323,8889559,PDN
MO862,,1997,1987,,0,51253876,9119907,,0,1798224,319969,,0,49455652,8799938,PDN
MO862,,1998,1987,,0,51253876,9119907,,0,2057741,366146,,0,49196135,8753761,PDN
MO862,,1999,1987,,0,33244710,5915429,,0,2123703,377883,,0,31121007,5537546,PDN
MO862,,2000,1987,,0,33244710,5915429,,0,2123703,377883,,0,31121007,5537546,PDN
MO862,,2002,1987,,0,39297194,6992383,,0,0,0,,0,39297194,6992383,PDN
MO862,,2003,1987,,0,17028784,3030033,,0,0,0,,0,17028784,3030033,PDN
MO862,,2004,1987,,0,17028784,3030033,,0,111286,19802,,0,16917498,3010231,PDN
MO862,,2005,1987,,0,17028784,3030033,,0,111286,19802,,0,16917498,3010231,PDN
MO862,,2006,1987,,0,17028784,3030033,,0,111286,19802,,0,16917498,3010231,PDN
MO862,,2007,1987,,0,111286,19802,,0,111286,19802,,0,0,0,PDN
MO862,,2008,1987,,0,111286,19802,,0,111286,19802,,0,0,0,PDN
MO862,,2009,1987,,0,111286,19802,,0,111286,19802,,0,0,0,PDN
MO862,,2010,1987,,0,111286,19802,,0,111286,19802,,0,0,0,PDN
MO862,,2011,1987,,0,111286,19802,,0,111286,19802,,0,0,0,PDN
MO862,,2012,1987,,0,111286,19802,,0,111286,19802,,0,0,0,PDN
MO862,,2013,1987,,0,111286,19802,,0,111286,19802,,0,0,0,PDN
MO862,,2014,1987,,0,111286,19802,,0,111286,19802,,0,0,0,PDN
MO862,,2015,1987,,0,111286,19802,,0,111286,19802,,0,0,0,PDN
MO862,,2016,1987,,0,111286,19802,,0,111286,19802,,0,0,0,PDN
MO862,,2017,1987,,0,111286,19802,,0,111286,19802,,0,0,0,PDN
MO862,,2017,1987,,0,111286,19802,,0,111286,19802,,0,0,0,PDN
MO864,,1985,1983,,800909,80090864,15051952,,0,0,0,,800909,80090864,15051952,PDN
MO864,,1986,1983,,0,80090864,14251043,,0,0,0,,0,80090864,14251043,PDN
MO864,,1987,1983,,0,80090864,14251043,,0,0,0,,0,80090864,14251043,PDN
MO864,,1988,1983,,0,96536432,17177301,,0,0,0,,0,96536432,17177301,PDN
MO864,,1989,1983,,0,96536432,17177301,,0,0,0,,0,96536432,17177301,PDN
MO864,,1990,1983,,0,96536432,17177301,,0,0,0,,0,96536432,17177301,PDN
MO864,,1991,1983,,600,98319609,17495192,,0,0,0,,600,98319609,17495192,PDN
MO864,,1992,1983,,600,103541767,18424402,,0,18827450,3350080,,600,84714317,15074322,PDN
MO864,,1993,1983,,600,103541767,18424402,,0,39311331,6994899,,600,64230436,11429503,PDN
MO864,,1994,1983,,600,102821353,18296214,,0,57500372,10231383,,600,45320981,8064831,PDN
MO864,,1995,1983,,2000,231541880,41201623,,0,71308801,12688399,,2000,160233079,28513224,PDN
MO864,,1996,1983,,1400,205927098,36643232,,0,83663448,14886735,,1400,122263650,21756497,PDN
MO864,,1997,1983,,2000,239023891,42532941,,0,101405173,18043625,,2000,137618718,24489316,PDN
MO864,,1998,1983,,2000,239023891,42532941,,393,125330902,22301265,,1607,113692989,20231676,PDN
MO864,,1999,1983,,1590,246929754,43939269,,393,141450480,25169518,,1197,105479274,18769751,PDN
MO864,,2000,1983,,2090,262577390,46724046,,393,147983628,26331999,,1697,114593762,20392047,PDN
MO864,,2001,1983,,2245,254248911,45242265,,393,154879627,27559045,,1852,99369284,17683220,PDN
MO864,,2002,1983,,745,186336384,33156685,,393,159909196,28453987,,352,26427188,4702698,PDN
MO864,,2003,1983,,600,185885444,33076302,,393,163462792,29086299,,207,22422652,3990003,PDN
MO864,,2004,1983,,590,185882567,33075780,,393,165650400,29475553,,197,20232167,3600227,PDN
MO864,,2005,1983,,590,185882567,33075780,,393,167388877,29784891,,197,18493690,3290889,PDN
MO864,,2006,1983,,590,188686484,33574697,,393,168810324,30037817,,197,19876160,3536880,PDN
MO864,,2007,1983,,590,188686484,33574697,,393,169814614,30216516,,197,18871870,3358181,PDN
MO864,,2008,1983,,738,190162260,33837439,,393,170655572,30366153,,345,19506688,3471286,PDN
MO864,,2009,1983,,393,191891503,34144789,,393,173971876,30956242,,0,17919627,3188546,PDN
MO864,,2010,1983,,393,191891503,34144789,,393,174924649,31125776,,0,16966854,3019013,PDN
MO864,,2011,1983,,393,193922314,34506143,,393,175931720,31304970,,0,17990594,3201173,PDN
MO864,,2012,1983,,393,192686972,34286331,,393,176616658,31426845,,0,16070314,2859486,PDN
MO864,,2013,1983,,393,176801630,31459758,,393,176801630,31459758,,0,0,0,PDN
MO864,,2014,1983,,393,176801630,31459758,,393,176801630,31459758,,0,0,0,PDN
MO864,,2015,1983,,393,176801630,31459758,,393,176801630,31459758,,0,0,0,PDN
MO864,,2016,1983,,393,176801630,31459758,,393,176801630,31459758,,0,0,0,PDN
MO864,,2017,1983,,393,176801630,31459758,,393,176801630,31459758,,0,0,0,PDN
MO864,,2017,1983,,393,176801630,31459758,,393,176801630,31459758,,0,0,0,PDN
MO865,,1993,1989,,0,14931133,2656785,,0,0,0,,0,14931133,2656785,PDN
MO865,,1994,1989,,0,14867812,2645518,,0,2916732,518991,,0,11951080,2126527,PDN
MO865,,1995,1989,,0,14862310,2644539,,0,6275227,1116588,,0,8587083,1527951,PDN
MO865,,1996,1989,,0,15449132,2748956,,0,9134320,1625324,,0,6314812,1123632,PDN
MO865,,1997,1989,,0,16297198,2899857,,0,10513711,1870767,,0,5783487,1029090,PDN
MO865,,1998,1989,,0,16456264,2928161,,0,10965125,1951090,,0,5491139,977071,PDN
MO865,,1999,1989,,0,11474810,2041781,,0,11151536,1984259,,0,323274,57522,PDN
MO865,,2000,1989,,0,11474810,2041781,,0,11193845,1991787,,0,280965,49994,PDN
MO865,,2001,1989,,0,11193845,1991787,,0,11193845,1991787,,0,0,0,PDN
MO865,,2002,1989,,0,11193845,1991787,,0,11193845,1991787,,0,0,0,PDN
MO865,,2003,1989,,0,11193845,1991787,,0,11193845,1991787,,0,0,0,PDN
MO865,,2004,1989,,0,11193845,1991787,,0,11193845,1991787,,0,0,0,PDN
MO865,,2005,1989,,0,11193845,1991787,,0,11193845,1991787,,0,0,0,PDN
MO865,,2006,1989,,0,11193845,1991787,,0,11193845,1991787,,0,0,0,PDN
MO865,,2007,1989,,0,11193845,1991787,,0,11193845,1991787,,0,0,0,PDN
MO865,,2008,1989,,0,11193845,1991787,,0,11193845,1991787,,0,0,0,PDN
MO865,,2009,1989,,0,11412423,2030681,,0,11412423,2030681,,0,0,0,PDN
MO865,,2010,1989,,0,11412423,2030681,,0,11412423,2030681,,0,0,0,PDN
MO865,,2011,1989,,0,11412423,2030681,,0,11412423,2030681,,0,0,0,PDN
MO865,,2012,1989,,0,11412423,2030681,,0,11412423,2030681,,0,0,0,PDN
MO865,,2013,1989,,0,11412423,2030681,,0,11412423,2030681,,0,0,0,PDN
MO865,,2014,1989,,0,11412423,2030681,,0,11412423,2030681,,0,0,0,PDN
MO865,,2015,1989,,0,11412423,2030681,,0,11412423,2030681,,0,0,0,PDN
MO865,,2016,1989,,0,11412423,2030681,,0,11412423,2030681,,0,0,0,PDN
MO865,,2017,1989,,0,11412423,2030681,,0,11412423,2030681,,0,0,0,PDN
MO865,,2017,1989,,0,11412423,2030681,,0,11412423,2030681,,0,0,0,PDN
MO866,,1994,1994,,357,3568604,635340,,0,881369,156827,,357,2687235,478513,PDN
MO866,,1995,1994,,357,3568604,635340,,0,1807861,321683,,357,1760743,313657,PDN
MO866,,1996,1994,,100,3580906,637272,,0,2820376,501846,,100,760530,135426,PDN
MO866,,1997,1994,,100,3580906,637272,,0,3422952,609066,,100,157954,28206,PDN
MO866,,1998,1994,,100,3580906,637272,,0,3573795,635907,,100,7111,1365,PDN
MO866,,1999,1994,,100,3620172,644259,,0,3590827,638937,,100,29345,5322,PDN
MO866,,2000,1994,,100,3620172,644259,,0,3590827,638937,,100,29345,5322,PDN
MO866,,2001,1994,,100,4036202,718285,,0,3590827,638937,,100,445375,79348,PDN
MO866,,2002,1994,,100,4044055,719683,,0,3590827,638937,,100,453228,80746,PDN
MO866,,2003,1994,,0,3590827,638937,,0,3590827,638937,,0,0,0,PDN
MO866,,2004,1994,,0,3590827,638937,,0,3590827,638937,,0,0,0,PDN
MO866,,2005,1994,,0,3590827,638937,,0,3590827,638937,,0,0,0,PDN
MO866,,2006,1994,,0,3590827,638937,,0,3590827,638937,,0,0,0,PDN
MO866,,2007,1994,,0,3590827,638937,,0,3590827,638937,,0,0,0,PDN
MO866,,2008,1994,,0,3590827,638937,,0,3590827,638937,,0,0,0,PDN
MO866,,2009,1994,,0,3661361,651488,,0,3661361,651488,,0,0,0,PDN
MO866,,2010,1994,,0,3661361,651488,,0,3661361,651488,,0,0,0,PDN
MO866,,2011,1994,,0,3661361,651488,,0,3661361,651488,,0,0,0,PDN
MO866,,2012,1994,,0,3661361,651488,,0,3661361,651488,,0,0,0,PDN
MO866,,2013,1994,,0,3661361,651488,,0,3661361,651488,,0,0,0,PDN
MO866,,2014,1994,,0,3661361,651488,,0,3661361,651488,,0,0,0,PDN
MO866,,2015,1994,,0,3661361,651488,,0,3661361,651488,,0,0,0,PDN
MO866,,2016,1994,,0,3661361,651488,,0,3661361,651488,,0,0,0,PDN
MO866,,2017,1994,,0,3661361,651488,,0,3661361,651488,,0,0,0,PDN
MO866,,2017,1994,,0,3661361,651488,,0,3661361,651488,,0,0,0,PDN
MO868,,1989,1986,,575,222432176,39579254,,0,0,0,,575,222432176,39579254,PDP
MO868,,1990,1986,,575,284596496,50640521,,0,0,0,,575,284596496,50640521,PDP
MO868,,1991,1986,,575,284596496,50640521,,0,0,0,,575,284596496,50640521,PDP
MO868,,1992,1986,,575,192357968,34227971,,0,0,0,,575,192357968,34227971,PDP
MO868,,1993,1986,,0,218661632,38907764,,0,0,0,,0,218661632,38907764,PDP
MO868,,1994,1986,,0,217808151,38755899,,0,0,0,,0,217808151,38755899,PDP
MO868,,1995,1986,,0,217003461,38612715,,0,0,0,,0,217003461,38612715,PDP
MO868,,1996,1986,,0,217003461,38612715,,0,0,0,,0,217003461,38612715,PDP
MO868,,1997,1986,,48015,217003461,38660730,,6103,23196821,4133651,,41912,193806640,34527079,PDP
MO868,,1998,1986,,48015,217003461,38660730,,9561,42213725,7520900,,38454,174789736,31139830,PDP
MO868,,1999,1986,,35725,174990759,31172871,,13232,57536561,10251054,,22493,117454198,20921817,PDP
MO868,,2000,1986,,35725,174990759,31172871,,15285,70511749,12561860,,20440,104479010,18611011,PDP
MO868,,2001,1986,,34228,159158477,28354242,,17481,81272903,14478852,,16747,77885574,13875390,PDP
MO868,,2002,1986,,27729,159130828,28342823,,19880,90326160,16092150,,7849,68804668,12250673,PDP
MO868,,2003,1986,,27729,159130828,28342823,,20418,98324838,17515941,,7311,60805990,10826882,PDP
MO868,,2004,1986,,27729,159130828,28342823,,21883,105160081,18733641,,5846,53970747,9609182,PDP
MO868,,2005,1986,,33383,159130828,28348477,,23151,111055480,19783913,,10232,48075348,8564564,PDP
MO868,,2006,1986,,33383,159130828,28348477,,23938,116160244,20693021,,9445,42970584,7655456,PDP
MO868,,2007,1986,,33383,159130828,28348477,,24816,120940112,21544409,,8567,38190716,6804068,PDP
MO868,,2008,1986,,33383,159130828,28348477,,25649,125093385,22284258,,7734,34037443,6064219,PDP
MO868,,2009,1986,,33611,158040619,28154718,,26299,129582674,23083714,,7312,28457945,5071003,PDP
MO868,,2010,1986,,33611,158040619,28154718,,27488,132689457,23637712,,6123,25351162,4517006,PDP
MO868,,2011,1986,,34665,158040619,28155772,,28656,135569804,24151397,,6009,22470815,4004375,PDP
MO868,,2012,1986,,34665,158040619,28155772,,29943,138564811,24685603,,4722,19475808,3470168,PDP
MO868,,2013,1986,,37862,158040619,28158969,,31082,141366004,25185175,,6780,16674615,2973793,PDP
MO868,,2014,1986,,38618,161194423,28720900,,32070,143931675,25642688,,6548,17262748,3078211,PDP
MO868,,2015,1986,,39631,161194423,28721913,,33204,146385526,26080451,,6427,14808897,2641462,PDP
MO868,,2016,1986,,36903,161194423,28719185,,34140,148658132,26485765,,2763,12536291,2233420,PDP
MO868,,2017,1986,,36903,161194423,28719185,,34875,150715661,26852608,,2028,10478762,1866576,PDP
MO868,,2017,1986,,36903,161194423,28719185,,34875,150715661,26852608,,2028,10478762,1866576,PDP
MO870,,1988,1987,,0,13483131,2399134,,0,0,0,,0,13483131,2399134,PDP
MO870,,1989,1987,,0,13483131,2399134,,0,0,0,,0,13483131,2399134,PDP
MO870,,1990,1987,,0,13483131,2399134,,0,0,0,,0,13483131,2399134,PDP
MO870,,1991,1987,,0,13483131,2399134,,0,0,0,,0,13483131,2399134,PDP
MO870,,1992,1987,,1290,12901381,2296909,,0,0,0,,1290,12901381,2296909,PDP
MO870,,1993,1987,,1290,12901381,2296909,,0,0,0,,1290,12901381,2296909,PDP
MO870,,1994,1987,,1285,12847243,2287271,,0,1126161,200385,,1285,11721082,2086886,PDP
MO870,,1995,1987,,1285,12847243,2287271,,0,5832809,1037866,,1285,7014434,1249405,PDP
MO870,,1996,1987,,100,16060642,2857865,,0,11102202,1975481,,100,4958440,882384,PDP
MO870,,1997,1987,,100,19990806,3557183,,0,16751257,2980651,,100,3239549,576532,PDP
MO870,,1998,1987,,100,32858314,5846775,,0,22120276,3935992,,100,10738038,1910783,PDP
MO870,,1999,1987,,100,37762502,6719406,,0,27334419,4863776,,100,10428083,1855630,PDP
MO870,,2000,1987,,100,37762502,6719406,,0,31992880,5692683,,100,5769622,1026723,PDP
MO870,,2001,1987,,100,37762501,6719406,,0,36201515,6441551,,100,1560986,277855,PDP
MO870,,2002,1987,,100,50232022,8938182,,0,40035337,7123725,,100,10196685,1814457,PDP
MO870,,2003,1987,,100,50232022,8938182,,0,43555309,7750055,,100,6676713,1188127,PDP
MO870,,2004,1987,,100,50232022,8938182,,0,46621940,8295719,,100,3610082,642463,PDP
MO870,,2005,1987,,100,68000160,12099773,,0,49344520,8780164,,100,18655640,3319609,PDP
MO870,,2006,1987,,100,68000160,12099773,,0,51934279,9240975,,100,16065881,2858798,PDP
MO870,,2007,1987,,100,68000160,12099773,,0,54202703,9644609,,100,13797457,2455164,PDP
MO870,,2008,1987,,100,68000160,12099773,,0,56280823,10014381,,100,11719337,2085392,PDP
MO870,,2009,1987,,0,72315687,12867560,,0,58639906,10434147,,0,13675781,2433413,PDP
MO870,,2010,1987,,0,72315687,12867560,,0,60319118,10732939,,0,11996569,2134621,PDP
MO870,,2011,1987,,0,72315687,12867560,,0,61863454,11007732,,0,10452233,1859828,PDP
MO870,,2012,1987,,0,70249524,12499915,,0,63290108,11261585,,0,6959416,1238330,PDP
MO870,,2013,1987,,0,70249524,12499915,,0,64630750,11500133,,0,5618774,999782,PDP
MO870,,2014,1987,,0,70144360,12481203,,0,65810036,11709971,,0,4334324,771232,PDP
MO870,,2015,1987,,0,70144360,12481203,,0,66816612,11889077,,0,3327748,592126,PDP
MO870,,2016,1987,,0,67740490,12053468,,0,67515367,12013410,,0,225123,40057,PDP
MO870,,2017,1987,,0,68736674,12230725,,0,68275230,12148617,,0,461444,82107,PDP
MO870,,2017,1987,,0,68736674,12230725,,0,68275230,12148617,,0,461444,82107,PDP
MO872,,1989,1988,,4932,49316960,8780192,,0,0,0,,4932,49316960,8780192,PDP
MO872,,1990,1988,,4932,49316960,8780192,,0,0,0,,4932,49316960,8780192,PDP
MO872,,1991,1988,,4932,49316960,8780192,,0,0,0,,4932,49316960,8780192,PDP
MO872,,1992,1988,,0,112485056,20015135,,0,0,0,,0,112485056,20015135,PDP
MO872,,1993,1988,,0,112485056,20015135,,0,0,0,,0,112485056,20015135,PDP
MO872,,1994,1988,,0,112485056,20015135,,0,0,0,,0,112485056,20015135,PDP
MO872,,1995,1988,,0,112098903,19946424,,0,0,0,,0,112098903,19946424,PDP
MO872,,1996,1988,,0,113451008,20187012,,0,3366584,599036,,0,110084424,19587976,PDP
MO872,,1997,1988,,0,113451008,20187012,,0,8016053,1426344,,0,105434955,18760668,PDP
MO872,,1998,1988,,0,113388120,20175822,,0,12006380,2136367,,0,101381740,18039455,PDP
MO872,,1999,1988,,0,70867575,12609889,,0,16532283,2941687,,0,54335292,9668202,PDP
MO872,,2000,1988,,0,70867575,12609889,,0,20684409,3680500,,0,50183166,8929389,PDP
MO872,,2001,1988,,0,35433787,6304944,,0,24075184,4283841,,0,11358603,2021103,PDP
MO872,,2002,1988,,0,49607302,8826922,,0,27679093,4925106,,0,21928209,3901816,PDP
MO872,,2003,1988,,0,49607302,8826922,,0,31721333,5644365,,0,17885969,3182557,PDP
MO872,,2004,1988,,0,49607302,8826922,,0,35120602,6249217,,0,14486700,2577705,PDP
MO872,,2005,1988,,0,49634816,8831818,,0,38247239,6805559,,0,11387577,2026259,PDP
MO872,,2006,1988,,0,49607302,8826922,,0,41531209,7389895,,0,8076093,1437027,PDP
MO872,,2007,1988,,0,49607302,8826922,,0,44824216,7975839,,0,4783086,851083,PDP
MO872,,2008,1988,,0,55103800,9804947,,0,47844252,8513212,,0,7259548,1291735,PDP
MO872,,2009,1988,,0,70475504,12540125,,0,50868214,9051284,,0,19607290,3488842,PDP
MO872,,2010,1988,,0,70475504,12540125,,0,53756123,9565146,,0,16719381,2974979,PDP
MO872,,2011,1988,,0,79510825,14147834,,0,56484349,10050596,,0,23026476,4097238,PDP
MO872,,2012,1988,,0,79510825,14147834,,0,58819850,10466165,,0,20690975,3681668,PDP
MO872,,2013,1988,,0,79510825,14147834,,0,61092144,10870488,,0,18418681,3277345,PDP
MO872,,2014,1988,,0,79575679,14159373,,0,63263894,11256921,,0,16311785,2902453,PDP
MO872,,2015,1988,,0,79575679,14159373,,0,65350071,11628127,,0,14225608,2531247,PDP
MO872,,2016,1988,,0,79575679,14159373,,0,67331830,11980753,,0,12243849,2178621,PDP
MO872,,2017,1988,,0,79575679,14159373,,0,69327605,12335873,,0,10248074,1823501,PDP
MO872,,2017,1988,,0,79575679,14159373,,0,69327605,12335873,,0,10248074,1823501,PDP
MO873,,2006,2006,,693,6929091,1233627,,0,0,0,,693,6929091,1233627,PDN
MO873,,2007,2006,,674,6739901,1199945,,0,240016,42707,,674,6499885,1157238,PDN
MO873,,2008,2006,,674,6739901,1199945,,0,604577,107576,,674,6135324,1092369,PDN
MO873,,2009,2006,,0,1373994,244483,,0,940232,167301,,0,433762,77182,PDN
MO873,,2010,2006,,0,1373994,244483,,0,1123014,199825,,0,250980,44658,PDN
MO873,,2011,2006,,0,1123014,199825,,0,1123014,199825,,0,0,0,PDN
MO873,,2012,2006,,0,1123014,199825,,0,1123014,199825,,0,0,0,PDN
MO873,,2013,2006,,0,1123014,199825,,0,1123014,199825,,0,0,0,PDN
MO873,,2014,2006,,0,1123014,199825,,0,1123014,199825,,0,0,0,PDN
MO873,,2015,2006,,0,1123014,199825,,0,1123014,199825,,0,0,0,PDN
MO873,,2016,2006,,0,1123014,199825,,0,1123014,199825,,0,0,0,PDN
MO873,,2017,2006,,0,1123014,199825,,0,1123014,199825,,0,0,0,PDN
MO873,,2017,2006,,0,1123014,199825,,0,1123014,199825,,0,0,0,PDN
MO904,,1988,1988,,759,7585943,1350571,,0,0,0,,759,7585943,1350571,PDP
MO904,,1989,1988,,759,7585943,1350571,,0,0,0,,759,7585943,1350571,PDP
MO904,,1990,1988,,759,7585943,1350571,,0,0,0,,759,7585943,1350571,PDP
MO904,,1991,1988,,759,7585943,1350571,,0,0,0,,759,7585943,1350571,PDP
MO904,,1992,1988,,759,7585943,1350571,,0,0,0,,759,7585943,1350571,PDP
MO904,,1993,1988,,759,7585943,1350571,,0,84265,14994,,759,7501678,1335577,PDP
MO904,,1994,1988,,2420,10939908,1949023,,890,4030733,718102,,1530,6909175,1230921,PDP
MO904,,1995,1988,,2420,10939908,1949023,,890,4037252,719262,,1530,6902656,1229761,PDP
MO904,,1996,1988,,22502,102069867,18184400,,890,4242052,755704,,21612,97827815,17428696,PDP
MO904,,1997,1988,,22502,102069867,18184400,,890,20127896,3582366,,21612,81941971,14602034,PDP
MO904,,1998,1988,,22502,102069867,18184400,,890,32682693,5816316,,21612,69387174,12368084,PDP
MO904,,1999,1988,,19941,123334423,21965568,,8387,51874168,9238666,,11554,71460255,12726902,PDP
MO904,,2000,1988,,20401,126306138,22494803,,12737,75358752,13421768,,7664,50947386,9073035,PDP
MO904,,2001,1988,,25119,146116548,26024505,,16954,97160776,17305348,,8165,48955772,8719157,PDP
MO904,,2002,1988,,28314,177503248,31612522,,20690,112855055,20101661,,7624,64648193,11510861,PDP
MO904,,2003,1988,,28314,177503248,31612522,,22746,127593345,22726188,,5568,49909903,8886334,PDP
MO904,,2004,1988,,29404,191985042,34190444,,24401,141775470,25251353,,5003,50209572,8939091,PDP
MO904,,2005,1988,,29390,191889973,34173513,,25714,153925477,27414589,,3676,37964496,6758924,PDP
MO904,,2006,1988,,29404,191985042,34190444,,27083,168127099,29942937,,2321,23857943,4247507,PDP
MO904,,2007,1988,,29404,191985042,34190444,,28525,180853958,32208945,,879,11131084,1981499,PDP
MO904,,2008,1988,,38811,281438226,50116787,,29620,192393578,34263353,,9191,89044648,15853434,PDP
MO904,,2009,1988,,42341,286602861,51039291,,31050,205080800,36522295,,11291,81522061,14516996,PDP
MO904,,2010,1988,,42341,286602861,51039291,,32338,215350169,38350873,,10003,71252692,12688418,PDP
MO904,,2011,1988,,43025,300098537,53441341,,33241,224969593,40063417,,9784,75128944,13377924,PDP
MO904,,2012,1988,,43025,300098537,53441341,,34143,234206623,41707919,,8882,65891914,11733422,PDP
MO904,,2013,1988,,39456,300098537,53437772,,34797,242317336,43151760,,4659,57781201,10286011,PDP
MO904,,2014,1988,,39456,300098537,53437772,,35349,249983302,44516363,,4107,50115235,8921409,PDP
MO904,,2015,1988,,39481,300098537,53437797,,35966,257466068,45848433,,3515,42632469,7589364,PDP
MO904,,2016,1988,,41408,300098537,53439724,,36367,264437826,47089360,,5041,35660711,6350363,PDP
MO904,,2017,1988,,41408,300098537,53439724,,36457,270898406,48239020,,4951,29200131,5200704,PDP
MO904,,2017,1988,,41408,300098537,53439724,,36457,270898406,48239020,,4951,29200131,5200704,PDP
MO914,,1988,1986,,914,9138467,1626976,,0,0,0,,914,9138467,1626976,PDN
MO914,,1989,1986,,914,9138467,1626976,,0,0,0,,914,9138467,1626976,PDN
MO914,,1990,1986,,914,9138467,1626976,,0,0,0,,914,9138467,1626976,PDN
MO914,,1991,1986,,914,9138467,1626976,,0,0,0,,914,9138467,1626976,PDN
MO914,,1992,1986,,914,9138467,1626976,,0,0,0,,914,9138467,1626976,PDN
MO914,,1993,1986,,1008,10079427,1794500,,0,0,0,,1008,10079427,1794500,PDN
MO914,,1994,1986,,1002,10024644,1784746,,0,956227,170147,,1002,9068417,1614599,PDN
MO914,,1995,1986,,1002,10024644,1784746,,0,3447019,613349,,1002,6577625,1171397,PDN
MO914,,1996,1986,,0,10517660,1871470,,0,4929512,877137,,0,5588148,994333,PDN
MO914,,1997,1986,,0,10517660,1871470,,0,5590628,994774,,0,4927032,876696,PDN
MO914,,1998,1986,,0,10517660,1871470,,0,6108089,1086849,,0,4409571,784621,PDN
MO914,,1999,1986,,0,10517660,1871470,,0,6562816,1167761,,0,3954844,703709,PDN
MO914,,2000,1986,,0,7510057,1336309,,0,6899842,1227730,,0,610215,108579,PDN
MO914,,2001,1986,,0,7496150,1333835,,0,7117064,1266381,,0,379086,67454,PDN
MO914,,2002,1986,,0,7496150,1333835,,0,7285376,1296330,,0,210774,37505,PDN
MO914,,2003,1986,,0,8134120,1447352,,0,7436706,1323257,,0,697414,124095,PDN
MO914,,2004,1986,,0,8134120,1447352,,0,7572380,1347399,,0,561740,99953,PDN
MO914,,2005,1986,,0,8134120,1447352,,0,7668790,1364553,,0,465330,82799,PDN
MO914,,2006,1986,,0,8134120,1447352,,0,7755916,1380056,,0,378204,67296,PDN
MO914,,2007,1986,,0,8134120,1447352,,0,7804642,1388726,,0,329478,58626,PDN
MO914,,2008,1986,,0,7804642,1388726,,0,7804642,1388726,,0,0,0,PDN
MO914,,2009,1986,,0,7923575,1409889,,0,7923575,1409889,,0,0,0,PDN
MO914,,2010,1986,,0,7923575,1409889,,0,7923575,1409889,,0,0,0,PDN
MO914,,2011,1986,,0,7923575,1409889,,0,7923575,1409889,,0,0,0,PDN
MO914,,2012,1986,,0,7923575,1409889,,0,7923575,1409889,,0,0,0,PDN
MO914,,2013,1986,,0,7923575,1409889,,0,7923575,1409889,,0,0,0,PDN
MO914,,2014,1986,,0,7923575,1409889,,0,7923575,1409889,,0,0,0,PDN
MO914,,2015,1986,,0,7923575,1409889,,0,7923575,1409889,,0,0,0,PDN
MO914,,2016,1986,,0,7923575,1409889,,0,7923575,1409889,,0,0,0,PDN
MO914,,2017,1986,,0,7923575,1409889,,0,7923575,1409889,,0,0,0,PDN
MO914,,2017,1986,,0,7923575,1409889,,0,7923575,1409889,,0,0,0,PDN
MO916,,1988,1987,,202,2018137,359301,,0,0,0,,202,2018137,359301,PDP
MO916,,1989,1987,,202,2018137,359301,,0,0,0,,202,2018137,359301,PDP
MO916,,1990,1987,,202,2018137,359301,,0,0,0,,202,2018137,359301,PDP
MO916,,1991,1987,,202,2018137,359301,,0,0,0,,202,2018137,359301,PDP
MO916,,1992,1987,,637,423464654,75350220,,0,0,0,,637,423464654,75350220,PDP
MO916,,1993,1987,,637,423464654,75350220,,0,0,0,,637,423464654,75350220,PDP
MO916,,1994,1987,,137,405952654,72233705,,0,0,0,,137,405952654,72233705,PDP
MO916,,1995,1987,,146,417172729,74230169,,0,14419698,2565783,,146,402753031,71664386,PDP
MO916,,1996,1987,,113,404558394,71985592,,0,33303086,5925816,,113,371255308,66059776,PDP
MO916,,1997,1987,,113,404558394,71985592,,0,44954506,7999022,,113,359603888,63986570,PDP
MO916,,1998,1987,,0,401812188,71496831,,0,54144962,9634335,,0,347667226,61862496,PDP
MO916,,1999,1987,,3674,133880419,23825813,,0,62153579,11059356,,3674,71726840,12766457,PDP
MO916,,2000,1987,,3674,133880419,23825813,,0,70059772,12466152,,3674,63820647,11359661,PDP
MO916,,2001,1987,,1929,112488941,20017755,,0,75633266,13457877,,1929,36855675,6559878,PDP
MO916,,2002,1987,,1929,109924279,19561409,,0,79454620,14137833,,1929,30469659,5423576,PDP
MO916,,2003,1987,,1929,110384277,19643259,,0,82936224,14757335,,1929,27448053,4885924,PDP
MO916,,2004,1987,,1929,110384277,19643259,,0,85557250,15223710,,1929,24827027,4419549,PDP
MO916,,2005,1987,,1928,113818526,20254335,,0,88096418,15675519,,1928,25722108,4578816,PDP
MO916,,2006,1987,,1929,122667242,21828840,,0,90455549,16095293,,1929,32211693,5733547,PDP
MO916,,2007,1987,,23,102644534,18264175,,0,92481396,16455764,,23,10163138,1808411,PDP
MO916,,2008,1987,,23,102427825,18225615,,0,94387055,16794850,,23,8040770,1430765,PDP
MO916,,2009,1987,,23,101530469,18065943,,0,96837395,17230853,,23,4693074,835090,PDP
MO916,,2010,1987,,23,101530469,18065943,,0,98126293,17460194,,23,3404176,605749,PDP
MO916,,2011,1987,,23,102540681,18245696,,0,99249143,17659990,,23,3291538,585706,PDP
MO916,,2012,1987,,23,102540681,18245696,,0,100065357,17805224,,23,2475324,440473,PDP
MO916,,2013,1987,,23,108108848,19236473,,0,101046733,17979846,,23,7062115,1256628,PDP
MO916,,2014,1987,,0,107883640,19196377,,0,101990239,18147729,,0,5893401,1048647,PDP
MO916,,2015,1987,,0,107883640,19196377,,0,102953273,18319088,,0,4930367,877290,PDP
MO916,,2016,1987,,0,107883640,19196377,,0,103848351,18478354,,0,4035289,718023,PDP
MO916,,2017,1987,,0,107883640,19196377,,0,104205833,18541963,,0,3677807,654414,PDP
MO916,,2017,1987,,0,107883640,19196377,,0,104205833,18541963,,0,3677807,654414,PDP
MO945,,1990,1990,,311,3106929,553145,,0,0,0,,311,3106929,553145,PDN
MO945,,1991,1990,,311,3106929,553145,,0,119273,21223,,311,2987656,531922,PDN
MO945,,1992,1990,,311,3106929,553145,,0,1200467,213606,,311,1906462,339539,PDN
MO945,,1993,1990,,311,3106929,553145,,0,2028635,360967,,311,1078294,192178,PDN
MO945,,1994,1990,,309,3085382,549309,,0,2621600,466477,,309,463782,82832,PDN
MO945,,1995,1990,,388,3881609,691066,,0,3110906,553542,,388,770703,137524,PDN
MO945,,1996,1990,,373,3732206,664467,,0,3358876,597665,,373,373330,66802,PDN
MO945,,1997,1990,,0,3454504,614680,,0,3454504,614680,,0,0,0,PDN
MO945,,1998,1990,,0,3455981,614943,,0,3455981,614943,,0,0,0,PDN
MO945,,1999,1990,,0,3455981,614943,,0,3455981,614943,,0,0,0,PDN
MO945,,2000,1990,,0,3455981,614943,,0,3455981,614943,,0,0,0,PDN
MO945,,2001,1990,,0,3455981,614943,,0,3455981,614943,,0,0,0,PDN
MO945,,2002,1990,,0,3455981,614943,,0,3455981,614943,,0,0,0,PDN
MO945,,2003,1990,,0,3455981,614943,,0,3455981,614943,,0,0,0,PDN
MO945,,2004,1990,,0,3455981,614943,,0,3455981,614943,,0,0,0,PDN
MO945,,2005,1990,,0,3455981,614943,,0,3455981,614943,,0,0,0,PDN
MO945,,2006,1990,,0,3455981,614943,,0,3455981,614943,,0,0,0,PDN
MO945,,2007,1990,,0,3455981,614943,,0,3455981,614943,,0,0,0,PDN
MO945,,2008,1990,,0,3455981,614943,,0,3455981,614943,,0,0,0,PDN
MO945,,2009,1990,,0,3525196,627259,,0,3525196,627259,,0,0,0,PDN
MO945,,2010,1990,,0,3525196,627259,,0,3525196,627259,,0,0,0,PDN
MO945,,2011,1990,,0,3525196,627259,,0,3525196,627259,,0,0,0,PDN
MO945,,2012,1990,,0,3525196,627259,,0,3525196,627259,,0,0,0,PDN
MO945,,2013,1990,,0,3525196,627259,,0,3525196,627259,,0,0,0,PDN
MO945,,2014,1990,,0,3525196,627259,,0,3525196,627259,,0,0,0,PDN
MO945,,2015,1990,,0,3525196,627259,,0,3525196,627259,,0,0,0,PDN
MO945,,2016,1990,,0,3525196,627259,,0,3525196,627259,,0,0,0,PDN
MO945,,2017,1990,,0,3525196,627259,,0,3525196,627259,,0,0,0,PDN
MO945,,2017,1990,,0,3525196,627259,,0,3525196,627259,,0,0,0,PDN
MO947,,1990,1990,,507,5065415,901826,,0,0,0,,507,5065415,901826,PDN
MO947,,1991,1990,,507,5065415,901826,,0,131485,23396,,507,4933930,878430,PDN
MO947,,1992,1990,,507,5065415,901826,,0,1991608,354379,,507,3073807,547447,PDN
MO947,,1993,1990,,507,5065415,901826,,0,3627966,645546,,507,1437449,256280,PDN
MO947,,1994,1990,,505,5047351,898610,,0,4673459,831576,,505,373892,67034,PDN
MO947,,1995,1990,,613,6128926,1091169,,0,5794488,1031048,,613,334438,60121,PDN
MO947,,1996,1990,,1113,11132281,1981946,,0,6738327,1198991,,1113,4393954,782955,PDN
MO947,,1997,1990,,1113,11132281,1981946,,0,7199744,1281093,,1113,3932537,700853,PDN
MO947,,1998,1990,,1113,11132281,1981946,,0,7404792,1317579,,1113,3727489,664367,PDN
MO947,,1999,1990,,781,7807630,1390039,,0,7672628,1365236,,781,135002,24803,PDN
MO947,,2000,1990,,0,7807630,1389258,,0,7735256,1376380,,0,72374,12878,PDN
MO947,,2001,1990,,0,7735256,1376380,,0,7735256,1376380,,0,0,0,PDN
MO947,,2002,1990,,0,7735256,1376380,,0,7735256,1376380,,0,0,0,PDN
MO947,,2003,1990,,0,7735256,1376380,,0,7735256,1376380,,0,0,0,PDN
MO947,,2004,1990,,0,7735256,1376380,,0,7735256,1376380,,0,0,0,PDN
MO947,,2005,1990,,0,7735256,1376380,,0,7735256,1376380,,0,0,0,PDN
MO947,,2006,1990,,0,7735256,1376380,,0,7735256,1376380,,0,0,0,PDN
MO947,,2007,1990,,0,7735256,1376380,,0,7735256,1376380,,0,0,0,PDN
MO947,,2008,1990,,0,7735256,1376380,,0,7735256,1376380,,0,0,0,PDN
MO947,,2009,1990,,0,7883339,1402729,,0,7883339,1402729,,0,0,0,PDN
MO947,,2010,1990,,0,7883339,1402729,,0,7883339,1402729,,0,0,0,PDN
MO947,,2011,1990,,0,7883339,1402729,,0,7883339,1402729,,0,0,0,PDN
MO947,,2012,1990,,0,7883339,1402729,,0,7883339,1402729,,0,0,0,PDN
MO947,,2013,1990,,0,7883339,1402729,,0,7883339,1402729,,0,0,0,PDN
MO947,,2014,1990,,0,7883339,1402729,,0,7883339,1402729,,0,0,0,PDN
MO947,,2015,1990,,0,7883339,1402729,,0,7883339,1402729,,0,0,0,PDN
MO947,,2016,1990,,0,7883339,1402729,,0,7883339,1402729,,0,0,0,PDN
MO947,,2017,1990,,0,7883339,1402729,,0,7883339,1402729,,0,0,0,PDN
MO947,,2017,1990,,0,7883339,1402729,,0,7883339,1402729,,0,0,0,PDN
MO950,,2005,2006,,93,937625,166930,,0,0,0,,93,937625,166930,PDN
MO950,,2006,2006,,93,937625,166930,,0,0,0,,93,937625,166930,PDN
MO950,,2007,2006,,93,938519,167089,,0,294833,52461,,93,643686,114628,PDN
MO950,,2008,2006,,3,1692948,301239,,0,1659245,295239,,3,33703,6000,PDN
MO950,,2009,2006,,3,1856120,330274,,0,1843291,327988,,3,12829,2286,PDN
MO950,,2010,2006,,3,1856120,330274,,0,1849367,329069,,3,6753,1205,PDN
MO950,,2011,2006,,0,1849367,329069,,0,1849367,329069,,0,0,0,PDN
MO950,,2012,2006,,0,1849367,329069,,0,1849367,329069,,0,0,0,PDN
MO950,,2013,2006,,0,1849367,329069,,0,1849367,329069,,0,0,0,PDN
MO950,,2014,2006,,0,1849367,329069,,0,1849367,329069,,0,0,0,PDN
MO950,,2015,2006,,0,1849367,329069,,0,1849367,329069,,0,0,0,PDN
MO950,,2016,2006,,0,1849367,329069,,0,1849367,329069,,0,0,0,PDN
MO950,,2017,2006,,0,1849367,329069,,0,1849367,329069,,0,0,0,PDN
MO950,,2017,2006,,0,1849367,329069,,0,1849367,329069,,0,0,0,PDN
MO951,,2005,2006,,146,1456505,259311,,0,0,0,,146,1456505,259311,PDN
MO951,,2006,2006,,146,1456505,259311,,0,0,0,,146,1456505,259311,PDN
MO951,,2007,2006,,146,1456505,259311,,0,286131,50913,,146,1170374,208398,PDN
MO951,,2008,2006,,0,1637336,291341,,0,1474439,262356,,0,162897,28985,PDN
MO951,,2009,2006,,0,1698200,302171,,0,1617784,287862,,0,80416,14309,PDN
MO951,,2010,2006,,0,1698200,302171,,0,1637023,291285,,0,61177,10886,PDN
MO951,,2011,2006,,0,1637023,291285,,0,1637023,291285,,0,0,0,PDN
MO951,,2012,2006,,0,1637023,291285,,0,1637023,291285,,0,0,0,PDN
MO951,,2013,2006,,0,1637023,291285,,0,1637023,291285,,0,0,0,PDN
MO951,,2014,2006,,0,1637023,291285,,0,1637023,291285,,0,0,0,PDN
MO951,,2015,2006,,0,1637023,291285,,0,1637023,291285,,0,0,0,PDN
MO951,,2016,2006,,0,1637023,291285,,0,1637023,291285,,0,0,0,PDN
MO951,,2017,2006,,0,1637023,291285,,0,1637023,291285,,0,0,0,PDN
MO951,,2017,2006,,0,1637023,291285,,0,1637023,291285,,0,0,0,PDN
MO952,,1986,1984,,0,19913040,3543246,,0,0,0,,0,19913040,3543246,PDN
MO952,,1987,1984,,0,19913040,3543246,,0,0,0,,0,19913040,3543246,PDN
MO952,,1988,1984,,0,21444816,3815804,,0,0,0,,0,21444816,3815804,PDN
MO952,,1989,1984,,0,21444816,3815804,,0,0,0,,0,21444816,3815804,PDN
MO952,,1990,1984,,0,21444816,3815804,,0,0,0,,0,21444816,3815804,PDN
MO952,,1991,1984,,0,21444816,3815804,,0,0,0,,0,21444816,3815804,PDN
MO952,,1992,1984,,0,16845056,2997341,,0,835162,148605,,0,16009894,2848736,PDN
MO952,,1993,1984,,0,16845056,2997341,,0,1937583,344766,,0,14907473,2652575,PDN
MO952,,1994,1984,,16731865,16731865,19709065,,0,2904583,516830,,16731865,13827282,19192235,PDN
MO952,,1995,1984,,0,16731865,2977200,,0,3926484,698663,,0,12805381,2278537,PDN
MO952,,1996,1984,,0,16448914,2926853,,0,5178980,921527,,0,11269934,2005326,PDN
MO952,,1997,1984,,0,16448914,2926853,,0,8055735,1433405,,0,8393179,1493448,PDN
MO952,,1998,1984,,0,16448914,2926853,,0,10728823,1909043,,0,5720091,1017810,PDN
MO952,,1999,1984,,0,20037768,3565439,,0,13833767,2461524,,0,6204001,1103915,PDN
MO952,,2000,1984,,0,20037768,3565439,,0,16712366,2973731,,0,3325402,591708,PDN
MO952,,2001,1984,,0,23327550,4150810,,0,19242887,3424001,,0,4084663,726809,PDN
MO952,,2002,1984,,0,36528097,6499661,,0,24727008,4399823,,0,11801089,2099838,PDN
MO952,,2003,1984,,0,41708000,7421352,,0,33044876,5879871,,0,8663124,1541481,PDN
MO952,,2004,1984,,0,41708000,7421352,,0,37977262,6757520,,0,3730738,663832,PDN
MO952,,2005,1984,,0,45403100,8078843,,0,40687970,7239852,,0,4715130,838991,PDN
MO952,,2006,1984,,0,45403100,8078843,,0,42527772,7567219,,0,2875328,511624,PDN
MO952,,2007,1984,,0,45403100,8078843,,0,43632478,7763786,,0,1770622,315057,PDN
MO952,,2008,1984,,0,45403100,8078843,,0,44251964,7874015,,0,1151136,204828,PDN
MO952,,2009,1984,,0,45485164,8093446,,0,44714681,7956349,,0,770483,137097,PDN
MO952,,2010,1984,,0,45485164,8093446,,0,44809394,7973202,,0,675770,120244,PDN
MO952,,2011,1984,,0,44809394,7973202,,0,44809394,7973202,,0,0,0,PDN
MO952,,2012,1984,,0,44809394,7973202,,0,44809394,7973202,,0,0,0,PDN
MO952,,2013,1984,,0,44809394,7973202,,0,44809394,7973202,,0,0,0,PDN
MO952,,2014,1984,,0,44809394,7973202,,0,44809394,7973202,,0,0,0,PDN
MO952,,2015,1984,,0,44809394,7973202,,0,44809394,7973202,,0,0,0,PDN
MO952,,2016,1984,,0,44809394,7973202,,0,44809394,7973202,,0,0,0,PDN
MO952,,2017,1984,,0,44809394,7973202,,0,44809394,7973202,,0,0,0,PDN
MO952,,2017,1984,,0,44809394,7973202,,0,44809394,7973202,,0,0,0,PDN
MO955,,1992,1984,,1968,19679392,3503639,,0,1015586,180709,,1968,18663806,3322930,PDN
MO955,,1993,1984,,1968,19679392,3503639,,0,2404828,427905,,1968,17274564,3075734,PDN
MO955,,1994,1984,,1959,19592502,3488169,,0,3588891,638593,,1959,16003611,2849576,PDN
MO955,,1995,1984,,1959,19592502,3488169,,0,4721000,840036,,1959,14871502,2648133,PDN
MO955,,1996,1984,,100,12927314,2300334,,0,5757679,1024498,,100,7169635,1275836,PDN
MO955,,1997,1984,,100,12927314,2300334,,0,6697280,1191687,,100,6230034,1108647,PDN
MO955,,1998,1984,,100,12927314,2300334,,0,7313066,1301257,,100,5614248,999077,PDN
MO955,,1999,1984,,100,12927314,2300334,,0,7844293,1395782,,100,5083021,904552,PDN
MO955,,2000,1984,,160,13526374,2406988,,0,8472309,1507528,,160,5054065,899460,PDN
MO955,,2001,1984,,160,13526374,2406988,,0,9483254,1687412,,160,4043120,719576,PDN
MO955,,2002,1984,,160,13526374,2406988,,0,10534664,1874495,,160,2991710,532493,PDN
MO955,,2003,1984,,160,13526374,2406988,,0,11375188,2024055,,160,2151186,382933,PDN
MO955,,2004,1984,,160,16908060,3008711,,0,13410444,2386200,,160,3497616,622511,PDN
MO955,,2005,1984,,160,16908060,3008711,,0,14054203,2500748,,160,2853857,507963,PDN
MO955,,2006,1984,,160,16908060,3008711,,0,14284917,2541800,,160,2623143,466911,PDN
MO955,,2007,1984,,60,14965075,2662884,,0,14366015,2556230,,60,599060,106654,PDN
MO955,,2008,1984,,60,14884245,2648502,,0,14285185,2541848,,60,599060,106654,PDN
MO955,,2009,1984,,60,15027761,2674039,,0,14428701,2567385,,60,599060,106654,PDN
MO955,,2010,1984,,0,14428701,2567385,,0,14428701,2567385,,0,0,0,PDN
MO955,,2011,1984,,0,14428701,2567385,,0,14428701,2567385,,0,0,0,PDN
MO955,,2012,1984,,0,14428701,2567385,,0,14428701,2567385,,0,0,0,PDN
MO955,,2013,1984,,0,14428701,2567385,,0,14428701,2567385,,0,0,0,PDN
MO955,,2014,1984,,0,14428701,2567385,,0,14428701,2567385,,0,0,0,PDN
MO955,,2015,1984,,0,14428701,2567385,,0,14428701,2567385,,0,0,0,PDN
MO955,,2016,1984,,0,14428701,2567385,,0,14428701,2567385,,0,0,0,PDN
MO955,,2017,1984,,0,14428701,2567385,,0,14428701,2567385,,0,0,0,PDN
MO955,,2017,1984,,0,14428701,2567385,,0,14428701,2567385,,0,0,0,PDN
MO959,,1988,1987,,2586,25856876,4603454,,0,0,0,,2586,25856876,4603454,PDN
MO959,,1989,1987,,2586,25856876,4603454,,0,0,0,,2586,25856876,4603454,PDN
MO959,,1990,1987,,2586,25856876,4603454,,0,0,0,,2586,25856876,4603454,PDN
MO959,,1991,1987,,2586,25856876,4603454,,0,0,0,,2586,25856876,4603454,PDN
MO959,,1992,1987,,2586,25856876,4603454,,0,0,0,,2586,25856876,4603454,PDN
MO959,,1993,1987,,4592,45927504,8176746,,0,0,0,,4592,45927504,8176746,PDN
MO959,,1994,1987,,4567,45676611,8132078,,0,0,0,,4567,45676611,8132078,PDN
MO959,,1995,1987,,4567,45676611,8132078,,0,4902169,872272,,4567,40774442,7259806,PDN
MO959,,1996,1987,,0,24425772,4346223,,0,7986736,1421127,,0,16439036,2925096,PDN
MO959,,1997,1987,,0,24425772,4346223,,0,9004043,1602143,,0,15421729,2744080,PDN
MO959,,1998,1987,,0,24425772,4346223,,0,9757241,1736164,,0,14668531,2610059,PDN
MO959,,1999,1987,,0,16953554,3016647,,0,10428165,1855545,,0,6525389,1161102,PDN
MO959,,2000,1987,,74,12934102,2301516,,0,11047951,1965828,,74,1886151,335688,PDN
MO959,,2001,1987,,74,12934102,2301516,,0,11827102,2104467,,74,1107000,197049,PDN
MO959,,2002,1987,,371,13889885,2471881,,0,12422456,2210401,,371,1467429,261480,PDN
MO959,,2003,1987,,371,14308997,2546456,,0,12872740,2290523,,371,1436257,255933,PDN
MO959,,2004,1987,,371,14308997,2546456,,0,13276991,2362454,,371,1032006,184002,PDN
MO959,,2005,1987,,371,14308997,2546456,,0,13535064,2408374,,371,773933,138082,PDN
MO959,,2006,1987,,371,14308997,2546456,,0,13770540,2450274,,371,538457,96182,PDN
MO959,,2007,1987,,371,14561285,2591347,,0,14060418,2501854,,371,500867,89493,PDN
MO959,,2008,1987,,0,13647970,2428464,,0,13647970,2428464,,0,0,0,PDN
MO959,,2009,1987,,0,14313278,2546847,,0,14313278,2546847,,0,0,0,PDN
MO959,,2010,1987,,0,14313278,2546847,,0,14313278,2546847,,0,0,0,PDN
MO959,,2011,1987,,0,14313278,2546847,,0,14313278,2546847,,0,0,0,PDN
MO959,,2012,1987,,0,14313278,2546847,,0,14313278,2546847,,0,0,0,PDN
MO959,,2013,1987,,0,14313278,2546847,,0,14313278,2546847,,0,0,0,PDN
MO959,,2014,1987,,0,14313278,2546847,,0,14313278,2546847,,0,0,0,PDN
MO959,,2015,1987,,0,14313278,2546847,,0,14313278,2546847,,0,0,0,PDN
MO959,,2016,1987,,0,14313278,2546847,,0,14313278,2546847,,0,0,0,PDN
MO959,,2017,1987,,0,14313278,2546847,,0,14313278,2546847,,0,0,0,PDN
MO959,,2017,1987,,0,14313278,2546847,,0,14313278,2546847,,0,0,0,PDN
MO960,,1993,1987,,635,6348750,1130306,,0,0,0,,635,6348750,1130306,PDN
MO960,,1994,1987,,632,6314575,1124222,,0,0,0,,632,6314575,1124222,PDN
MO960,,1995,1987,,774,7746345,1379127,,0,936008,166549,,774,6810337,1212578,PDN
MO960,,1996,1987,,463,7468816,1329434,,0,1499722,266854,,463,5969094,1062580,PDN
MO960,,1997,1987,,463,7468816,1329434,,0,1845149,328318,,463,5623667,1001116,PDN
MO960,,1998,1987,,463,7468816,1329434,,0,2138370,380493,,463,5330446,948941,PDN
MO960,,1999,1987,,463,7374668,1312682,,0,2384019,424203,,463,4990649,888479,PDN
MO960,,2000,1987,,0,2646829,470966,,0,2605266,463570,,0,41563,7396,PDN
MO960,,2001,1987,,0,2604980,463520,,0,2604980,463520,,0,0,0,PDN
MO960,,2002,1987,,0,2604980,463520,,0,2604980,463520,,0,0,0,PDN
MO960,,2003,1987,,0,2604980,463520,,0,2604980,463520,,0,0,0,PDN
MO960,,2004,1987,,0,2604980,463520,,0,2604980,463520,,0,0,0,PDN
MO960,,2005,1987,,0,2604980,463520,,0,2604980,463520,,0,0,0,PDN
MO960,,2006,1987,,0,2604980,463520,,0,2604980,463520,,0,0,0,PDN
MO960,,2007,1987,,0,2604980,463520,,0,2604980,463520,,0,0,0,PDN
MO960,,2008,1987,,0,2604980,463520,,0,2604980,463520,,0,0,0,PDN
MO960,,2009,1987,,0,2646041,470826,,0,2646041,470826,,0,0,0,PDN
MO960,,2010,1987,,0,2646041,470826,,0,2646041,470826,,0,0,0,PDN
MO960,,2011,1987,,0,2646041,470826,,0,2646041,470826,,0,0,0,PDN
MO960,,2012,1987,,0,2646041,470826,,0,2646041,470826,,0,0,0,PDN
MO960,,2013,1987,,0,2646041,470826,,0,2646041,470826,,0,0,0,PDN
MO960,,2014,1987,,0,2646041,470826,,0,2646041,470826,,0,0,0,PDN
MO960,,2015,1987,,0,2646041,470826,,0,2646041,470826,,0,0,0,PDN
MO960,,2016,1987,,0,2646041,470826,,0,2646041,470826,,0,0,0,PDN
MO960,,2017,1987,,0,2646041,470826,,0,2646041,470826,,0,0,0,PDN
MO960,,2017,1987,,0,2646041,470826,,0,2646041,470826,,0,0,0,PDN
MO961,,1988,1987,,1224,12240491,2179247,,0,0,0,,1224,12240491,2179247,PDP
MO961,,1989,1987,,1224,12240491,2179247,,0,0,0,,1224,12240491,2179247,PDP
MO961,,1990,1987,,1224,12240491,2179247,,0,0,0,,1224,12240491,2179247,PDP
MO961,,1991,1987,,1224,12240491,2179247,,0,0,0,,1224,12240491,2179247,PDP
MO961,,1992,1987,,1224,12240491,2179247,,0,0,0,,1224,12240491,2179247,PDP
MO961,,1993,1987,,760,7598952,1352887,,0,0,0,,760,7598952,1352887,PDP
MO961,,1994,1987,,756,7551241,1344393,,0,0,0,,756,7551241,1344393,PDP
MO961,,1995,1987,,803,8037677,1430995,,0,1448287,257702,,803,6589390,1173293,PDP
MO961,,1996,1987,,549,88506135,15748972,,0,9065700,1613114,,549,79440435,14135858,PDP
MO961,,1997,1987,,549,88506135,15748972,,0,24077242,4284207,,549,64428893,11464765,PDP
MO961,,1998,1987,,162,44494817,7917389,,0,35641276,6341864,,162,8853541,1575525,PDP
MO961,,1999,1987,,0,76842340,13673014,,0,39002652,6939974,,0,37839688,6733040,PDP
MO961,,2000,1987,,0,76842340,13673014,,0,47162144,8391841,,0,29680196,5281173,PDP
MO961,,2001,1987,,0,76842340,13673014,,0,55730298,9916423,,0,21112042,3756591,PDP
MO961,,2002,1987,,0,97166189,17289357,,0,63616475,11319657,,0,33549714,5969700,PDP
MO961,,2003,1987,,0,97166189,17289357,,0,73510337,13080131,,0,23655852,4209226,PDP
MO961,,2004,1987,,0,97166189,17289357,,0,80137892,14259411,,0,17028297,3029946,PDP
MO961,,2005,1987,,0,97166189,17289357,,0,85632589,15237115,,0,11533600,2052242,PDP
MO961,,2006,1987,,0,97115460,17280331,,0,89784888,15975959,,0,7330572,1304372,PDP
MO961,,2007,1987,,0,97115460,17280331,,0,93195208,16582777,,0,3920252,697554,PDP
MO961,,2008,1987,,0,120069835,21364739,,0,96518457,17174103,,0,23551378,4190636,PDP
MO961,,2009,1987,,0,108118576,19238181,,0,99969885,17788236,,0,8148691,1449945,PDP
MO961,,2010,1987,,0,108118576,19238181,,0,103006397,18328541,,0,5112179,909640,PDP
MO961,,2011,1987,,0,125984643,22417197,,0,107309242,19094171,,0,18675401,3323025,PDP
MO961,,2012,1987,,0,125984643,22417197,,0,110181347,19605222,,0,15803296,2811974,PDP
MO961,,2013,1987,,0,125984643,22417197,,0,112731860,20059050,,0,13252783,2358146,PDP
MO961,,2014,1987,,0,125984643,22417197,,0,114996047,20461930,,0,10988596,1955266,PDP
MO961,,2015,1987,,0,125984643,22417197,,0,116888258,20798623,,0,9096385,1618574,PDP
MO961,,2016,1987,,0,127608831,22706198,,0,119092048,21190756,,0,8516783,1515442,PDP
MO961,,2017,1987,,0,127608831,22706198,,0,121230540,21571271,,0,6378291,1134927,PDP
MO961,,2017,1987,,0,127608831,22706198,,0,121230540,21571271,,0,6378291,1134927,PDP
MO988,,2004,2004,,168,1676523,298482,,0,0,0,,168,1676523,298482,PDN
MO988,,2005,2004,,168,1676523,298482,,0,292928,52122,,168,1383595,246360,PDN
MO988,,2006,2004,,168,1677454,298647,,0,354594,63095,,168,1322860,235552,PDN
MO988,,2007,2004,,0,367688,65425,,0,367688,65425,,0,0,0,PDN
MO988,,2008,2004,,0,363653,64707,,0,363653,64707,,0,0,0,PDN
MO988,,2009,2004,,0,363653,64707,,0,363653,64707,,0,0,0,PDN
MO988,,2010,2004,,0,363653,64707,,0,363653,64707,,0,0,0,PDN
MO988,,2011,2004,,0,363653,64707,,0,363653,64707,,0,0,0,PDN
MO988,,2012,2004,,0,363653,64707,,0,363653,64707,,0,0,0,PDN
MO988,,2013,2004,,0,363653,64707,,0,363653,64707,,0,0,0,PDN
MO988,,2014,2004,,0,363653,64707,,0,363653,64707,,0,0,0,PDN
MO988,,2015,2004,,0,363653,64707,,0,363653,64707,,0,0,0,PDN
MO988,,2016,2004,,0,363653,64707,,0,363653,64707,,0,0,0,PDN
MO988,,2017,2004,,0,363653,64707,,0,363653,64707,,0,0,0,PDN
MO988,,2017,2004,,0,363653,64707,,0,363653,64707,,0,0,0,PDN
MO990,,1990,1990,,647,6466271,1151229,,0,0,0,,647,6466271,1151229,PDN
MO990,,1991,1990,,647,6466271,1151229,,0,384013,68330,,647,6082258,1082899,PDN
MO990,,1992,1990,,647,6466271,1151229,,0,4680457,832822,,647,1785814,318407,PDN
MO990,,1993,1990,,2853,28533167,5079929,,0,8602159,1530633,,2853,19931008,3549296,PDN
MO990,,1994,1990,,2853,28533167,5079929,,0,11475871,2041970,,2853,17057296,3037959,PDN
MO990,,1995,1990,,2853,28533167,5079929,,0,13945731,2481447,,2853,14587436,2598482,PDN
MO990,,1996,1990,,100,20983083,3733745,,0,15697797,2793202,,100,5285286,940543,PDN
MO990,,1997,1990,,100,20983083,3733745,,0,16618736,2957070,,100,4364347,776675,PDN
MO990,,1998,1990,,100,20983083,3733745,,0,17020959,3028640,,100,3962124,705105,PDN
MO990,,1999,1990,,0,17202400,3060925,,0,17177971,3056578,,0,24429,4347,PDN
MO990,,2000,1990,,0,17177971,3056578,,0,17177971,3056578,,0,0,0,PDN
MO990,,2001,1990,,0,17177971,3056578,,0,17177971,3056578,,0,0,0,PDN
MO990,,2002,1990,,0,17177971,3056578,,0,17177971,3056578,,0,0,0,PDN
MO990,,2003,1990,,0,17177971,3056578,,0,17177971,3056578,,0,0,0,PDN
MO990,,2004,1990,,0,17177971,3056578,,0,17177971,3056578,,0,0,0,PDN
MO990,,2005,1990,,0,17177971,3056578,,0,17177971,3056578,,0,0,0,PDN
MO990,,2006,1990,,0,17177971,3056578,,0,17177971,3056578,,0,0,0,PDN
MO990,,2007,1990,,0,17177971,3056578,,0,17177971,3056578,,0,0,0,PDN
MO990,,2008,1990,,0,17177971,3056578,,0,17177971,3056578,,0,0,0,PDN
MO990,,2009,1990,,0,17517426,3116980,,0,17517426,3116980,,0,0,0,PDN
MO990,,2010,1990,,0,17517426,3116980,,0,17517426,3116980,,0,0,0,PDN
MO990,,2011,1990,,0,17517426,3116980,,0,17517426,3116980,,0,0,0,PDN
MO990,,2012,1990,,0,17517426,3116980,,0,17517426,3116980,,0,0,0,PDN
MO990,,2013,1990,,0,17517426,3116980,,0,17517426,3116980,,0,0,0,PDN
MO990,,2014,1990,,0,17517426,3116980,,0,17517426,3116980,,0,0,0,PDN
MO990,,2015,1990,,0,17517426,3116980,,0,17517426,3116980,,0,0,0,PDN
MO990,,2016,1990,,0,17517426,3116980,,0,17517426,3116980,,0,0,0,PDN
MO990,,2017,1990,,0,17517426,3116980,,0,17517426,3116980,,0,0,0,PDN
MO990,,2017,1990,,0,17517426,3116980,,0,17517426,3116980,,0,0,0,PDN
MO991,,1993,1987,,762,7622593,1357095,,0,0,0,,762,7622593,1357095,PDN
MO991,,1997,1987,,564,5641632,1004413,,0,0,0,,564,5641632,1004413,PDN
MO991,,1998,1987,,1390,13906214,2475805,,0,1116563,198677,,1390,12789651,2277128,PDN
MO991,,1999,1987,,486,7973179,1419201,,0,3794707,675215,,486,4178472,743986,PDN
MO991,,2000,1987,,781,20019032,3562886,,0,8478800,1508683,,781,11540232,2054203,PDN
MO991,,2001,1987,,886,58117902,10342150,,0,16851783,2998538,,886,41266119,7343612,PDN
MO991,,2002,1987,,886,82751845,14725414,,0,27204196,4840604,,886,55547649,9884810,PDN
MO991,,2003,1987,,886,82751845,14725414,,0,36163396,6434768,,886,46588449,8290646,PDN
MO991,,2004,1987,,886,82751845,14725414,,0,41564998,7395907,,886,41186847,7329507,PDN
MO991,,2005,1987,,886,82751845,14725414,,0,47555773,8461881,,886,35196072,6263533,PDN
MO991,,2006,1987,,886,82751845,14725414,,0,51255062,9120118,,886,31496783,5605296,PDN
MO991,,2007,1987,,886,82751845,14725414,,0,54260592,9654910,,886,28491253,5070504,PDN
MO991,,2008,1987,,886,82751845,14725414,,0,56999497,10142259,,886,25752348,4583155,PDN
MO991,,2009,1987,,886,75044330,13353970,,0,59335192,10557863,,886,15709138,2796107,PDN
MO991,,2010,1987,,886,75044330,13353970,,0,61402199,10925658,,886,13642131,2428312,PDN
MO991,,2011,1987,,886,75784583,13485688,,0,63334705,11269520,,886,12449878,2216168,PDN
MO991,,2012,1987,,886,75784583,13485688,,0,64813658,11532679,,886,10970925,1953009,PDN
MO991,,2013,1987,,886,74515053,13259792,,0,65595593,11671814,,886,8919460,1587979,PDN
MO991,,2014,1987,,886,74515053,13259792,,0,65659408,11683168,,886,8855645,1576624,PDN
MO991,,2015,1987,,0,65659408,11683168,,0,65659408,11683168,,0,0,0,PDN
MO991,,2016,1987,,0,65659408,11683168,,0,65659408,11683168,,0,0,0,PDN
MO991,,2017,1987,,0,65659408,11683168,,0,65659408,11683168,,0,0,0,PDN
MO991,,2017,1987,,0,65659408,11683168,,0,65659408,11683168,,0,0,0,PDN
MO993,,2005,2006,,127,1272090,226478,,0,0,0,,127,1272090,226478,PDN
MO993,,2006,2006,,127,1273369,226705,,0,0,0,,127,1273369,226705,PDN
MO993,,2007,2006,,127,1272090,226478,,0,271705,48346,,127,1000385,178132,PDN
MO993,,2008,2006,,127,1272090,226478,,0,857712,152618,,127,414378,73860,PDN
MO993,,2009,2006,,0,984593,175194,,0,929370,165368,,0,55223,9826,PDN
MO993,,2010,2006,,0,984593,175194,,0,953484,169659,,0,31109,5535,PDN
MO993,,2011,2006,,0,953484,169659,,0,953484,169659,,0,0,0,PDN
MO993,,2012,2006,,0,953484,169659,,0,953484,169659,,0,0,0,PDN
MO993,,2013,2006,,0,953484,169659,,0,953484,169659,,0,0,0,PDN
MO993,,2014,2006,,0,953484,169659,,0,953484,169659,,0,0,0,PDN
MO993,,2015,2006,,0,953484,169659,,0,953484,169659,,0,0,0,PDN
MO993,,2016,2006,,0,953484,169659,,0,953484,169659,,0,0,0,PDN
MO993,,2017,2006,,0,953484,169659,,0,953484,169659,,0,0,0,PDN
MO993,,2017,2006,,0,953484,169659,,0,953484,169659,,0,0,0,PDN
MO994,,2007,2007,,158,1579419,281193,,0,93693,16671,,158,1485726,264522,PDN
MO994,,2008,2007,,86,1646277,293018,,0,517945,92161,,86,1128332,200857,PDN
MO994,,2009,2007,,0,1333900,237349,,0,1016498,180872,,0,317402,56477,PDN
MO994,,2010,2007,,0,1333900,237349,,0,1311521,233367,,0,22379,3982,PDN
MO994,,2011,2007,,0,1311521,233367,,0,1311521,233367,,0,0,0,PDN
MO994,,2012,2007,,0,1311521,233367,,0,1311521,233367,,0,0,0,PDN
MO994,,2013,2007,,0,1311521,233367,,0,1311521,233367,,0,0,0,PDN
MO994,,2014,2007,,0,1311521,233367,,0,1311521,233367,,0,0,0,PDN
MO994,,2015,2007,,0,1311521,233367,,0,1311521,233367,,0,0,0,PDN
MO994,,2016,2007,,0,1311521,233367,,0,1311521,233367,,0,0,0,PDN
MO994,,2017,2007,,0,1311521,233367,,0,1311521,233367,,0,0,0,PDN
MO994,,2017,2007,,0,1311521,233367,,0,1311521,233367,,0,0,0,PDN
MP006,,1975,1964,,13000027,960000000,183818532,,4370496,393690084,74422112,,8629531,566309916,109396420,PDN
MP006,,1976,1964,,9500046,830000000,157186879,,4757270,438551971,82791429,,4742776,391448029,74395450,PDN
MP006,,1977,1964,,9500046,830000000,157186879,,5122185,483936065,91231805,,4377861,346063935,65955074,PDN
MP006,,1978,1964,,5853436,758877716,140885058,,4585138,567516951,105566802,,1268298,191360765,35318256,PDN
MP006,,1979,1964,,6012270,784322396,145571415,,4891360,591523042,110144570,,1120910,192799354,35426845,PDN
MP006,,1980,1964,,6132260,784322396,145691405,,5187466,611444104,113985349,,944794,172878292,31706056,PDN
MP006,,1981,1964,,6569411,713622641,133548529,,5709834,621946276,116376431,,859577,91676365,17172098,PDN
MP006,,1982,1964,,7930153,714665966,135094916,,6030550,635652760,119136023,,1899603,79013206,15958893,PDN
MP006,,1983,1964,,7933251,725669119,137055870,,6326599,650149389,122011544,,1606652,75519730,15044326,PDN
MP006,,1984,1964,,7733061,739568675,139328911,,6366156,664848862,124666665,,1366905,74719813,14662246,PDN
MP006,,1985,1964,,7763903,741573683,139716516,,6617474,675741067,126856098,,1146429,65832616,12860418,PDN
MP006,,1986,1964,,8252333,783134806,147600163,,6844241,685376186,128797299,,1408092,97758620,18802864,PDN
MP006,,1987,1964,,8245248,783915406,147731975,,7016667,693362141,130390713,,1228581,90553265,17341262,PDN
MP006,,1988,1964,,9059693,784335398,148621152,,7206253,699556965,131682581,,1853440,84778433,16938571,PDN
MP006,,1989,1964,,9059693,784335398,148621152,,7387822,703882590,132633834,,1671871,80452808,15987318,PDN
MP006,,1990,1964,,9110681,784335398,148672140,,7548706,710524627,133976576,,1561975,73810771,14695564,PDN
MP006,,1991,1964,,8187847,755578837,142632480,,7705708,723606140,136461249,,482139,31972697,6171231,PDN
MP006,,1992,1964,,8183872,750616983,141745613,,7808836,727561436,137268166,,375036,23055547,4477447,PDN
MP006,,1993,1964,,8198241,789503903,148679363,,7881914,736464300,138925384,,316327,53039603,9753979,PDN
MP006,,1994,1964,,8087649,794642508,149483113,,7923054,743091058,140145662,,164595,51551450,9337451,PDN
MP006,,1995,1964,,8028157,797215098,149881377,,7944557,748250372,141085193,,83600,48964726,8796184,PDN
MP006,,1996,1964,,8127138,802282157,150881970,,7976380,752977219,141958092,,150758,49304938,8923878,PDN
MP006,,1997,1964,,8128707,807085808,151738281,,8010865,764353940,144016904,,117842,42731868,7721377,PDN
MP006,,1998,1964,,8133363,817965273,153678785,,8039315,774717252,145889360,,94048,43248021,7789425,PDN
MP006,,1999,1964,,8154535,801745347,150813849,,8070457,782776299,147354496,,84078,18969048,3459353,PDN
MP006,,2000,1964,,8178068,812187294,152695380,,8089486,789524777,148574322,,88582,22662517,4121058,PDN
MP006,,2001,1964,,8173562,810539105,152397602,,8107488,797950962,150091645,,66074,12588143,2305957,PDN
MP006,,2002,1964,,9477829,821325723,155621196,,8130077,801769322,150793657,,1347752,19556401,4827539,PDN
MP006,,2003,1964,,8159705,819654329,154005671,,8142413,807180429,151768824,,17292,12473900,2236847,PDN
MP006,,2004,1964,,8185649,820311583,154148564,,8149200,810220860,152316613,,36449,10090723,1831951,PDN
MP006,,2005,1964,,8341412,824310367,155015855,,8232573,814784162,153211961,,108839,9526205,1803894,PDN
MP006,,2006,1964,,8341381,823340897,154843320,,8291807,817188102,153698943,,49574,6152795,1144377,PDN
MP006,,2007,1964,,8403381,823393052,154914600,,8324449,818361152,153940312,,78932,5031900,974288,PDN
MP006,,2008,1964,,8403381,823393052,154914600,,8348087,818523403,153992821,,55294,4869649,921779,PDN
MP006,,2009,1964,,8376850,838965431,157658954,,8368980,834110755,156787263,,7870,4854676,871691,PDN
MP006,,2010,1964,,8434131,838980241,157718869,,8403404,834254139,156847199,,30727,4726102,871670,PDN
MP006,,2011,1964,,8434131,838980241,157718869,,8426375,834370396,156890856,,7756,4609845,828013,PDN
MP006,,2012,1964,,8434131,838980241,157718869,,8426375,834370396,156890856,,7756,4609845,828013,PDN
MP006,,2013,1964,,8426375,834370396,156890856,,8426375,834370396,156890856,,0,0,0,PDN
MP006,,2014,1964,,8426375,834370396,156890856,,8426375,834370396,156890856,,0,0,0,PDN
MP006,,2015,1964,,8426375,834370396,156890856,,8426375,834370396,156890856,,0,0,0,PDN
MP006,,2016,1964,,8426375,834370396,156890856,,8426375,834370396,156890856,,0,0,0,PDN
MP006,,2017,1964,,8426375,834370396,156890856,,8426375,834370396,156890856,,0,0,0,PDN
MP006,,2017,1964,,8426375,834370396,156890856,,8426375,834370396,156890856,,0,0,0,PDN
MP020,,2002,2001,,2607113,33240686,8521826,,0,0,0,,2607113,33240686,8521826,PDN
MP020,,2003,2001,,28501,363744,93224,,28501,363744,93224,,0,0,0,PDN
MP020,,2004,2001,,28501,363744,93224,,28501,363744,93224,,0,0,0,PDN
MP020,,2005,2001,,28501,363744,93224,,28501,363744,93224,,0,0,0,PDN
MP020,,2006,2001,,30732,9884812,1789595,,28501,363744,93224,,2231,9521068,1696371,PDN
MP020,,2007,2001,,30732,9884812,1789595,,29994,3461003,645831,,738,6423809,1143764,PDN
MP020,,2008,2001,,31783,9176995,1664700,,31183,4760565,878259,,600,4416430,786441,PDN
MP020,,2009,2001,,31418,6312110,1154570,,31290,4882164,900003,,128,1429946,254566,PDN
MP020,,2010,2001,,31290,4882164,900003,,31290,4882164,900003,,0,0,0,PDN
MP020,,2011,2001,,31290,4882164,900003,,31290,4882164,900003,,0,0,0,PDN
MP020,,2012,2001,,31290,4882164,900003,,31290,4882164,900003,,0,0,0,PDN
MP020,,2013,2001,,31290,4882164,900003,,31290,4882164,900003,,0,0,0,PDN
MP020,,2014,2001,,31290,4882164,900003,,31290,4882164,900003,,0,0,0,PDN
MP020,,2015,2001,,31290,4882164,900003,,31290,4882164,900003,,0,0,0,PDN
MP020,,2016,2001,,31290,4882164,900003,,31290,4882164,900003,,0,0,0,PDN
MP020,,2017,2001,,31290,4882164,900003,,31290,4882164,900003,,0,0,0,PDN
MP020,,2017,2001,,31290,4882164,900003,,31290,4882164,900003,,0,0,0,PDN
MP029,,1984,1982,,3776,660877,121370,,0,0,0,,3776,660877,121370,PDN
MP029,,1985,1982,,3776,660877,121370,,0,0,0,,3776,660877,121370,PDN
MP029,,1986,1982,,3776,660877,121370,,0,0,0,,3776,660877,121370,PDN
MP029,,2006,1982,,18557,5418579,982717,,0,0,0,,18557,5418579,982717,PDN
MP029,,2007,1982,,18557,5418579,982717,,8808,2564985,465211,,9749,2853594,517506,PDN
MP029,,2008,1982,,18557,5418579,982717,,17383,5126724,929611,,1174,291855,53106,PDN
MP029,,2009,1982,,18021,6150929,1112492,,17724,6049571,1094160,,297,101358,18332,PDN
MP029,,2010,1982,,18021,7043806,1271367,,17753,6357461,1148974,,268,686345,122393,PDN
MP029,,2011,1982,,18021,7043806,1271367,,17777,6738368,1216775,,244,305438,54592,PDN
MP029,,2012,1982,,17971,7131444,1286911,,17777,6890424,1243831,,194,241020,43080,PDN
MP029,,2013,1982,,17971,7131444,1286911,,17777,7020739,1267019,,194,110705,19892,PDN
MP029,,2014,1982,,17841,7131444,1286781,,17777,7094733,1280185,,64,36711,6596,PDN
MP029,,2015,1982,,17975,7237884,1305855,,17777,7145880,1289286,,198,92004,16569,PDN
MP029,,2016,1982,,17777,7187730,1296733,,17777,7180600,1295464,,0,7130,1269,PDN
MP029,,2017,1982,,17777,7180600,1295464,,17777,7180600,1295464,,0,0,0,PDN
MP029,,2017,1982,,17777,7180600,1295464,,17777,7180600,1295464,,0,0,0,PDN
MP030,,1986,1984,,3003731,4632939,3828097,,0,0,0,,3003731,4632939,3828097,PDP
MP030,,1987,1984,,3060369,7677508,4426474,,19372,40832,26637,,3040997,7636676,4399837,PDP
MP030,,1988,1984,,3060369,7677508,4426474,,454879,1311589,688258,,2605490,6365919,3738216,PDP
MP030,,1989,1984,,3060369,7677508,4426474,,837650,2337245,1253530,,2222719,5340263,3172944,PDP
MP030,,1990,1984,,3060369,7677508,4426474,,1250193,3138062,1808567,,1810176,4539446,2617907,PDP
MP030,,1991,1984,,3370212,8421131,4868634,,1781322,4388682,2562226,,1588890,4032449,2306408,PDP
MP030,,1992,1984,,6614306,21374072,10417522,,2242647,5386207,3201047,,4371659,15987865,7216475,PDP
MP030,,1993,1984,,6614306,21374072,10417522,,2617870,6020224,3689084,,3996436,15353848,6728438,PDP
MP030,,1994,1984,,6615779,21376093,10419354,,3043904,6702007,4236432,,3571875,14674086,6182922,PDP
MP030,,1995,1984,,6307668,18256310,9556122,,3450708,7145556,4722159,,2856960,11110754,4833963,PDP
MP030,,1996,1984,,5430649,15061422,8110617,,3962934,7656438,5325290,,1467715,7404984,2785327,PDP
MP030,,1997,1984,,5826027,15242900,8538287,,4610702,8294353,6086566,,1215325,6948547,2451721,PDP
MP030,,1998,1984,,6028394,16099487,8893071,,5055386,8611958,6587763,,973008,7487529,2305308,PDP
MP030,,1999,1984,,6910868,13459319,9305765,,5384910,8799858,6950721,,1525958,4659461,2355044,PDP
MP030,,2000,1984,,6911143,16207929,9795116,,5641250,9582019,7346236,,1269893,6625910,2448880,PDP
MP030,,2001,1984,,7866546,18221725,11108846,,5968342,10520305,7840282,,1898204,7701420,3268564,PDP
MP030,,2002,1984,,7803900,21440873,11619002,,6341954,11982920,8474146,,1461946,9457953,3144856,PDP
MP030,,2003,1984,,7804211,21443240,11619734,,6741919,13427708,9131191,,1062292,8015532,2488543,PDP
MP030,,2004,1984,,8450313,19799674,11973387,,7098381,14405105,9661567,,1351932,5394569,2311820,PDP
MP030,,2005,1984,,8447906,20152407,12033744,,7466016,14861952,10110491,,981890,5290455,1923253,PDP
MP030,,2006,1984,,9328689,26831377,14102955,,7969054,18849290,11323020,,1359635,7982087,2779935,PDP
MP030,,2007,1984,,9500888,32195077,15229549,,8323027,23316122,12471803,,1177861,8878955,2757746,PDP
MP030,,2008,1984,,9759397,28517010,14833598,,8578776,24217571,12887952,,1180621,4299439,1945646,PDP
MP030,,2009,1984,,10007263,30722485,15473897,,8822403,25792544,13411823,,1184860,4929941,2062074,PDP
MP030,,2010,1984,,10009183,30709196,15473451,,8960738,26424545,13662614,,1048445,4284651,1810838,PDP
MP030,,2011,1984,,10009512,31548714,15623160,,9192630,26872923,13974286,,816882,4675791,1648872,PDP
MP030,,2012,1984,,10205637,31277289,15770988,,9372967,27484789,14263498,,832670,3792500,1507491,PDP
MP030,,2013,1984,,10205556,30472684,15627738,,9485102,27908271,14450985,,720454,2564413,1176755,PDP
MP030,,2014,1984,,10157055,29810745,15461456,,9550285,28141546,14557676,,606770,1669199,903781,PDP
MP030,,2015,1984,,10158055,29037870,15324934,,9638315,28185154,14653466,,519740,852716,671469,PDP
MP030,,2016,1984,,10133616,29024484,15298113,,9696909,28238496,14721551,,436707,785988,576564,PDP
MP030,,2017,1984,,10183088,28584820,15269353,,9742571,28311670,14780233,,440517,273150,489121,PDP
MP030,,2017,1984,,10183088,28584820,15269353,,9742571,28311670,14780233,,440517,273150,489121,PDP
MP039,,1985,1984,,18442,4610599,838833,,0,1033861,183961,,18442,3576738,654872,PDN
MP039,,1986,1984,,6408,9401053,1679193,,2259,3293382,588270,,4149,6107671,1090923,PDN
MP039,,1987,1984,,21983,10724928,1930333,,4418,4387958,785193,,17565,6336970,1145140,PDN
MP039,,1988,1984,,21983,10724928,1930333,,6451,5635682,1009241,,15532,5089246,921092,PDN
MP039,,1989,1984,,27597,10724928,1935947,,8912,5855768,1050864,,18685,4869160,885083,PDN
MP039,,1990,1984,,8933,5859249,1051504,,8933,5859249,1051504,,0,0,0,PDN
MP039,,1991,1984,,8933,5859249,1051504,,8933,5859249,1051504,,0,0,0,PDN
MP039,,1992,1984,,8933,5859249,1051504,,8933,5859249,1051504,,0,0,0,PDN
MP039,,1993,1984,,8933,5859249,1051504,,8933,5859249,1051504,,0,0,0,PDN
MP039,,1994,1984,,8933,5859249,1051504,,8933,5859249,1051504,,0,0,0,PDN
MP039,,1995,1984,,8933,5859249,1051504,,8933,5859249,1051504,,0,0,0,PDN
MP039,,1996,1984,,8933,5859249,1051504,,8933,5859249,1051504,,0,0,0,PDN
MP039,,1997,1984,,8933,5859249,1051504,,8933,5859249,1051504,,0,0,0,PDN
MP039,,1998,1984,,8933,5859249,1051504,,8933,5859249,1051504,,0,0,0,PDN
MP039,,1999,1984,,8933,5859249,1051504,,8933,5859249,1051504,,0,0,0,PDN
MP039,,2000,1984,,8933,5859249,1051504,,8933,5859249,1051504,,0,0,0,PDN
MP039,,2001,1984,,8933,5859249,1051504,,8933,5859249,1051504,,0,0,0,PDN
MP039,,2002,1984,,8933,5859249,1051504,,8933,5859249,1051504,,0,0,0,PDN
MP039,,2003,1984,,8933,5859249,1051504,,8933,5859249,1051504,,0,0,0,PDN
MP039,,2004,1984,,8933,5859249,1051504,,8933,5859249,1051504,,0,0,0,PDN
MP039,,2005,1984,,8933,5859249,1051504,,8933,5859249,1051504,,0,0,0,PDN
MP039,,2006,1984,,8933,5859249,1051504,,8933,5859249,1051504,,0,0,0,PDN
MP039,,2007,1984,,8933,5859249,1051504,,8933,5859249,1051504,,0,0,0,PDN
MP039,,2008,1984,,8933,5859249,1051504,,8933,5859249,1051504,,0,0,0,PDN
MP039,,2009,1984,,8933,5976594,1072384,,8933,5976594,1072384,,0,0,0,PDN
MP039,,2010,1984,,8933,5976594,1072384,,8933,5976594,1072384,,0,0,0,PDN
MP039,,2011,1984,,8933,5976594,1072384,,8933,5976594,1072384,,0,0,0,PDN
MP039,,2012,1984,,8933,5976594,1072384,,8933,5976594,1072384,,0,0,0,PDN
MP039,,2013,1984,,8933,5976594,1072384,,8933,5976594,1072384,,0,0,0,PDN
MP039,,2014,1984,,8933,5976594,1072384,,8933,5976594,1072384,,0,0,0,PDN
MP039,,2015,1984,,8933,5976594,1072384,,8933,5976594,1072384,,0,0,0,PDN
MP039,,2016,1984,,8933,5976594,1072384,,8933,5976594,1072384,,0,0,0,PDN
MP039,,2017,1984,,8933,5976594,1072384,,8933,5976594,1072384,,0,0,0,PDN
MP039,,2017,1984,,8933,5976594,1072384,,8933,5976594,1072384,,0,0,0,PDN
MP041,,1975,1956,,270939913,1032044467,454577719,,143902938,385235142,212450116,,127036975,646809325,242127603,PDP
MP041,,1976,1956,,270939913,1032044467,454577719,,150685103,422026292,225778749,,120254810,610018175,228798970,PDP
MP041,,1977,1956,,273914112,1085960295,467145481,,159167367,465264820,241954702,,114746745,620695475,225190779,PDP
MP041,,1978,1956,,222911021,1010457196,402707675,,164675789,508292929,255119371,,58235232,502164267,147588304,PDP
MP041,,1979,1956,,222918430,1020314970,404469136,,169588934,550304389,267507864,,53329496,470010581,136961272,PDP
MP041,,1980,1956,,223079069,1044770240,408981247,,173463031,595755072,279469272,,49616038,449015168,129511975,PDP
MP041,,1981,1956,,199996934,932652930,365949413,,184590659,643458361,299085029,,15406275,289194569,66864384,PDP
MP041,,1982,1956,,203297574,961161848,374322814,,189454134,683079868,310998594,,13843440,278081980,63324220,PDP
MP041,,1983,1956,,227213325,999759725,405106515,,191014329,728709556,320677951,,36198996,271050169,84428564,PDP
MP041,,1984,1956,,229360895,1060444401,418052070,,194188499,782743720,333466741,,35172396,277700681,84585329,PDP
MP041,,1985,1956,,247294022,1212148696,462978843,,197015121,822270348,343326571,,50278901,389878348,119652272,PDP
MP041,,1986,1956,,253788719,1237345416,473956942,,200058742,873843427,355546896,,53729977,363501989,118410046,PDP
MP041,,1987,1956,,223833134,1192719197,436060749,,202768449,909773686,364649888,,21064685,282945511,71410861,PDP
MP041,,1988,1956,,224762867,1199037457,438114728,,205590090,942311355,373261150,,19172777,256726102,64853578,PDP
MP041,,1989,1956,,224823297,1216805922,441336806,,207789012,974628446,381210444,,17034285,242177476,60126362,PDP
MP041,,1990,1956,,224612451,1185584396,435570529,,210245179,1007024790,389431085,,14367272,178559606,46139444,PDP
MP041,,1991,1956,,224775894,1187073691,435998971,,212111217,1032725232,395870155,,12664677,154348459,40128816,PDP
MP041,,1992,1956,,224222450,1172731000,432893446,,214227416,1070912553,404781251,,9995034,101818447,28112195,PDP
MP041,,1993,1956,,225036346,1187644110,436360921,,216226242,1109370025,413623044,,8810104,78274085,22737877,PDP
MP041,,1994,1956,,225264151,1240889343,446062966,,218071133,1156782406,423904301,,7193018,84106937,22158665,PDP
MP041,,1995,1956,,230036835,1283673324,458448458,,219942719,1190871241,431841516,,10094116,92802083,26606942,PDP
MP041,,1996,1956,,233780474,1326286608,469774532,,222415587,1222805104,439996566,,11364887,103481504,29777966,PDP
MP041,,1997,1956,,233707714,1337351853,471670677,,226546691,1251640463,449258517,,7161023,85711390,22412160,PDP
MP041,,1998,1956,,235275251,1370873926,479202996,,229605414,1276015645,456654461,,5669837,94858281,22548535,PDP
MP041,,1999,1956,,243480287,1418871598,495948543,,232196268,1314359951,466068145,,11284019,104511647,29880398,PDP
MP041,,2000,1956,,251131227,1442244078,507758287,,235698598,1348754111,475690433,,15432629,93489967,32067854,PDP
MP041,,2001,1956,,261951886,1471046468,523703927,,239005494,1376683663,483967000,,22946392,94362805,39736927,PDP
MP041,,2002,1956,,264954595,1501309931,532091594,,241993738,1395150182,490241101,,22960857,106159749,41850493,PDP
MP041,,2003,1956,,258846682,1521515010,529578890,,245006642,1414864158,496761830,,13840040,106650852,32817060,PDP
MP041,,2004,1956,,259140181,1492728117,524750166,,247665295,1428278724,501807417,,11474886,64449393,22942749,PDP
MP041,,2005,1956,,261970421,1489283144,526967422,,249711330,1437246807,505449196,,12259091,52036337,21518226,PDP
MP041,,2006,1956,,263029268,1503138694,530491669,,252119036,1448172162,509800915,,10910232,54966532,20690754,PDP
MP041,,2007,1956,,266151542,1510544065,534931625,,254446695,1457971294,513872192,,11704847,52572771,21059433,PDP
MP041,,2008,1956,,267698956,1517483566,537713825,,256525126,1463880471,517002078,,11173830,53603095,20711747,PDP
MP041,,2009,1956,,266655039,1526437068,538263058,,258422173,1492582394,524006229,,8232866,33854674,14256829,PDP
MP041,,2010,1956,,267842636,1537247276,541374180,,259688525,1495813875,525847577,,8154111,41433401,15526603,PDP
MP041,,2011,1956,,275089179,1592084205,558378183,,261286197,1500265835,528237413,,13802982,91818370,30140770,PDP
MP041,,2012,1956,,274614621,1588296668,557229686,,263141098,1516221729,532931441,,11473523,72074939,24298245,PDP
MP041,,2013,1956,,270046331,1567915233,549034807,,265273566,1532495490,537959596,,4772765,35419743,11075211,PDP
MP041,,2014,1956,,268532358,1552564956,544789468,,266801004,1540007635,540823715,,1731354,12557321,3965753,PDP
MP041,,2015,1956,,271575916,1563516053,549781619,,268440295,1546496542,543617616,,3135621,17019511,6164003,PDP
MP041,,2016,1956,,271450819,1560852545,549182589,,269896277,1551742671,546007073,,1554542,9109874,3175516,PDP
MP041,,2017,1956,,272755068,1559943338,550325053,,271360383,1556551741,548326882,,1394685,3391597,1998171,PDP
MP041,,2017,1956,,272755068,1559943338,550325053,,271360383,1556551741,548326882,,1394685,3391597,1998171,PDP
MP056,,1987,1986,,15799,3712762,676433,,66,391222,69678,,15733,3321540,606755,PDN
MP056,,1988,1986,,15799,3712762,676433,,66,1637068,291359,,15733,2075694,385074,PDN
MP056,,1989,1986,,200,5446725,969368,,66,1815844,323170,,134,3630881,646198,PDN
MP056,,1990,1986,,200,5446725,969368,,66,2419943,430661,,134,3026782,538707,PDN
MP056,,1991,1986,,66,2419943,430661,,66,2419943,430661,,0,0,0,PDN
MP056,,1992,1986,,66,2419943,430661,,66,2419943,430661,,0,0,0,PDN
MP056,,1993,1986,,66,2419943,430661,,66,2419943,430661,,0,0,0,PDN
MP056,,1994,1986,,66,2419943,430661,,66,2419943,430661,,0,0,0,PDN
MP056,,1995,1986,,66,2419943,430661,,66,2419943,430661,,0,0,0,PDN
MP056,,1996,1986,,66,2419943,430661,,66,2419943,430661,,0,0,0,PDN
MP056,,1997,1986,,66,2419943,430661,,66,2419943,430661,,0,0,0,PDN
MP056,,1998,1986,,66,2419943,430661,,66,2419943,430661,,0,0,0,PDN
MP056,,1999,1986,,66,2419943,430661,,66,2419943,430661,,0,0,0,PDN
MP056,,2000,1986,,66,2419943,430661,,66,2419943,430661,,0,0,0,PDN
MP056,,2001,1986,,66,2419943,430661,,66,2419943,430661,,0,0,0,PDN
MP056,,2002,1986,,66,2419943,430661,,66,2419943,430661,,0,0,0,PDN
MP056,,2003,1986,,66,2419943,430661,,66,2419943,430661,,0,0,0,PDN
MP056,,2004,1986,,66,2419943,430661,,66,2419943,430661,,0,0,0,PDN
MP056,,2005,1986,,66,2419943,430661,,66,2419943,430661,,0,0,0,PDN
MP056,,2006,1986,,66,2419943,430661,,66,2419943,430661,,0,0,0,PDN
MP056,,2007,1986,,66,2419943,430661,,66,2419943,430661,,0,0,0,PDN
MP056,,2008,1986,,66,2419943,430661,,66,2419943,430661,,0,0,0,PDN
MP056,,2009,1986,,66,2468406,439284,,66,2468406,439284,,0,0,0,PDN
MP056,,2010,1986,,66,2468406,439284,,66,2468406,439284,,0,0,0,PDN
MP056,,2011,1986,,66,2468406,439284,,66,2468406,439284,,0,0,0,PDN
MP056,,2012,1986,,66,2468406,439284,,66,2468406,439284,,0,0,0,PDN
MP056,,2013,1986,,66,2468406,439284,,66,2468406,439284,,0,0,0,PDN
MP056,,2014,1986,,66,2468406,439284,,66,2468406,439284,,0,0,0,PDN
MP056,,2015,1986,,66,2468406,439284,,66,2468406,439284,,0,0,0,PDN
MP056,,2016,1986,,66,2468406,439284,,66,2468406,439284,,0,0,0,PDN
MP056,,2017,1986,,66,2468406,439284,,66,2468406,439284,,0,0,0,PDN
MP056,,2017,1986,,66,2468406,439284,,66,2468406,439284,,0,0,0,PDN
MP061,,2000,2000,,14382645,28765288,19501024,,0,0,0,,14382645,28765288,19501024,PDP
MP061,,2001,2000,,16874600,8637330,18411491,,2368,0,2368,,16872232,8637330,18409123,PDP
MP061,,2002,2000,,33611012,25300023,38112795,,5493369,3720381,6155359,,28117643,21579642,31957436,PDP
MP061,,2003,2000,,33611012,25300023,38112795,,14868827,9135298,16494325,,18742185,16164725,21618470,PDP
MP061,,2004,2000,,37649775,22960418,41735259,,21480972,13565284,23894724,,16168803,9395134,17840535,PDP
MP061,,2005,2000,,37649775,22960418,41735259,,26035665,16773542,29020281,,11614110,6186876,12714978,PDP
MP061,,2006,2000,,37688421,22991261,41779393,,29450366,18849666,32804399,,8238055,4141595,8974994,PDP
MP061,,2007,2000,,41194167,24746505,45597460,,31638301,19809935,35163200,,9555866,4936570,10434260,PDP
MP061,,2008,2000,,52217799,37302321,58855223,,34575470,21709569,38438383,,17642329,15592752,20416840,PDP
MP061,,2009,2000,,48180484,32182289,53906870,,38019756,24991171,42466584,,10160728,7191118,11440285,PDP
MP061,,2010,2000,,48180484,32182289,53906870,,41294560,27656892,46215715,,6885924,4525397,7691155,PDP
MP061,,2011,2000,,62166300,45325597,70231352,,44250370,30031155,49593992,,17915930,15294442,20637361,PDP
MP061,,2012,2000,,61962856,47748524,70459034,,47109219,34661958,53276828,,14853637,13086566,17182207,PDP
MP061,,2013,2000,,52685397,42139579,60183542,,49860845,39060710,56811148,,2824552,3078869,3372392,PDP
MP061,,2014,2000,,53794142,43442451,61524117,,52712793,42405912,60258328,,1081349,1036539,1265785,PDP
MP061,,2015,2000,,57218615,48369666,65825316,,55203944,45296112,63263751,,2014671,3073554,2561566,PDP
MP061,,2016,2000,,58890754,48584445,67535674,,56902902,46748987,65221226,,1987852,1835458,2314445,PDP
MP061,,2017,2000,,60508620,51878914,69739743,,58213035,48565989,66854670,,2295585,3312925,2885073,PDP
MP061,,2017,2000,,60508620,51878914,69739743,,58213035,48565989,66854670,,2295585,3312925,2885073,PDP
MP062,,2002,1997,,165436,4348534,939196,,0,0,0,,165436,4348534,939196,PDP
MP062,,2003,1997,,165436,4348534,939196,,19267,913291,181774,,146169,3435243,757422,PDP
MP062,,2004,1997,,160101,7949865,1574667,,25304,3029220,564311,,134797,4920645,1010356,PDP
MP062,,2005,1997,,160511,10492405,2027487,,25304,4925645,901753,,135207,5566760,1125734,PDP
MP062,,2006,1997,,160511,10492405,2027487,,26635,6750247,1227747,,133876,3742158,799740,PDP
MP062,,2007,1997,,186308,10492405,2053284,,34923,7559412,1380014,,151385,2932993,673270,PDP
MP062,,2008,1997,,186308,10492405,2053284,,43624,8352071,1529758,,142684,2140334,523526,PDP
MP062,,2009,1997,,200587,11188888,2191492,,48707,8668982,1591230,,151880,2519906,600261,PDP
MP062,,2010,1997,,204753,11347490,2223879,,56002,9158353,1685602,,148751,2189137,538277,PDP
MP062,,2011,1997,,204753,11347490,2223879,,62991,9486986,1751067,,141762,1860504,472812,PDP
MP062,,2012,1997,,215886,12465024,2433861,,69450,9914474,1833591,,146436,2550550,600270,PDP
MP062,,2013,1997,,215886,12465024,2433861,,73944,10432312,1930227,,141942,2032712,503634,PDP
MP062,,2014,1997,,187210,12247888,2366549,,79182,10869260,2013214,,108028,1378628,353335,PDP
MP062,,2015,1997,,86757,11796283,2185740,,84363,11238365,2084072,,2394,557918,101668,PDP
MP062,,2016,1997,,97152,13041900,2417775,,87742,11870110,2199861,,9410,1171790,217914,PDP
MP062,,2017,1997,,97152,13041900,2417775,,92283,12271448,2275815,,4869,770452,141960,PDP
MP062,,2017,1997,,97152,13041900,2417775,,92283,12271448,2275815,,4869,770452,141960,PDP
MP064,,1982,1982,,9366059,79731825,23553216,,0,0,0,,9366059,79731825,23553216,PDP
MP064,,1983,1982,,65924432,337799000,126031016,,210025,1613305,497090,,65714407,336185695,125533926,PDP
MP064,,1984,1982,,65924432,337799000,126031016,,918382,2788573,1414569,,65006050,335010427,124616447,PDP
MP064,,1985,1982,,67685860,337799000,127792444,,2226508,6685454,3416091,,65459352,331113546,124376353,PDP
MP064,,1986,1982,,14051739,51535864,23221822,,3589211,11218785,5585436,,10462528,40317079,17636386,PDP
MP064,,1987,1982,,13870463,50905937,22928459,,4737614,15767770,7543267,,9132849,35138167,15385192,PDP
MP064,,1988,1982,,13870463,50905937,22928459,,5532017,18667023,8853551,,8338446,32238914,14074908,PDP
MP064,,1989,1982,,13870463,50905937,22928459,,6299418,20761974,9993719,,7571045,30143963,12934740,PDP
MP064,,1990,1982,,8801339,34115413,14871697,,6907576,22566708,10923004,,1893763,11548705,3948693,PDP
MP064,,1991,1982,,8801339,35374653,15095761,,7473756,23701514,11691107,,1327583,11673139,3404654,PDP
MP064,,1992,1982,,8801339,35374653,15095761,,8113549,25527148,12655746,,687790,9847505,2440015,PDP
MP064,,1993,1982,,10936094,42016413,18412324,,8781236,26632828,13520173,,2154858,15383585,4892151,PDP
MP064,,1994,1982,,11179797,44065949,19020713,,9535303,27050137,14348495,,1644494,17015812,4672218,PDP
MP064,,1995,1982,,20309917,44831452,28287044,,10231368,27522776,15128659,,10078549,17308676,13158385,PDP
MP064,,1996,1982,,20333794,44503942,28252645,,10803815,27181659,15640409,,9529979,17322283,12612236,PDP
MP064,,1997,1982,,20341110,44910307,28332268,,11313380,28409602,16368469,,9027730,16500705,11963799,PDP
MP064,,1998,1982,,20357321,45463102,28446841,,11697747,28690125,16802751,,8659574,16772977,11644090,PDP
MP064,,1999,1982,,20357321,45463102,28446841,,12065365,29060749,17236317,,8291956,16402353,11210524,PDP
MP064,,2000,1982,,14566120,32894536,20419240,,12387730,29406269,17620162,,2178390,3488267,2799078,PDP
MP064,,2001,1982,,14569535,32922890,20427700,,12674419,29642692,17948919,,1895116,3280198,2478781,PDP
MP064,,2002,1982,,14569535,32922890,20427700,,12918038,29837519,18227205,,1651497,3085371,2200495,PDP
MP064,,2003,1982,,14799439,33267746,20718967,,13149584,30041798,18495100,,1649855,3225948,2223867,PDP
MP064,,2004,1982,,14866675,34285494,20967297,,13385643,30870811,18878670,,1481032,3414683,2088627,PDP
MP064,,2005,1982,,14887070,36336885,21352708,,13564780,31439211,19158946,,1322290,4897674,2193762,PDP
MP064,,2006,1982,,14886986,36645767,21407585,,13806833,33113691,19698949,,1080153,3532076,1708636,PDP
MP064,,2007,1982,,14809101,37036233,21399178,,14019232,33460826,19973116,,789869,3575407,1426062,PDP
MP064,,2008,1982,,14809101,37414977,21466570,,14213384,33754563,20219534,,595717,3660414,1247036,PDP
MP064,,2009,1982,,15266270,38766841,22164284,,14362807,34423724,20488025,,903463,4343117,1676259,PDP
MP064,,2010,1982,,15652521,39284021,22642560,,14551828,34518011,20693823,,1100693,4766010,1948737,PDP
MP064,,2011,1982,,15652521,39284021,22642560,,14824888,34659325,20992027,,827633,4624696,1650532,PDP
MP064,,2012,1982,,15652522,39336882,22651967,,15083892,34804394,21276844,,568630,4532488,1375122,PDP
MP064,,2013,1982,,15652521,39324316,22649730,,15355699,34992579,21582136,,296822,4331737,1067593,PDP
MP064,,2014,1982,,15882963,38071189,22657197,,15579139,35190410,21840778,,303824,2880779,816418,PDP
MP064,,2015,1982,,16074596,38080913,22850560,,15817231,35396944,22115620,,257365,2683969,734939,PDP
MP064,,2016,1982,,16584075,38451256,23425936,,16071232,35625036,22410206,,512843,2826220,1015728,PDP
MP064,,2017,1982,,16523795,36036642,22936008,,16307262,35868215,22689506,,216533,168427,246503,PDP
MP064,,2017,1982,,16523795,36036642,22936008,,16307262,35868215,22689506,,216533,168427,246503,PDP
MP069,,1975,1969,,102857,7200000,1383996,,63005,3882778,753891,,39852,3317222,630105,PDP
MP069,,1976,1969,,102857,7200000,1383996,,77137,4900616,949133,,25720,2299384,434863,PDP
MP069,,1977,1969,,168000,9889656,1927725,,103165,6073015,1183773,,64835,3816641,743952,PDP
MP069,,1978,1969,,168000,9889656,1927725,,114155,7018580,1363013,,53845,2871076,564712,PDP
MP069,,1979,1969,,168000,9889656,1927725,,118466,7474318,1448416,,49534,2415338,479309,PDP
MP069,,1980,1969,,168000,9889656,1927725,,122037,7817045,1512970,,45963,2072611,414755,PDP
MP069,,1981,1969,,168000,9889656,1927725,,124133,8114701,1568030,,43867,1774955,359695,PDP
MP069,,1982,1969,,168000,9889656,1927725,,126425,8307359,1604603,,41575,1582297,323122,PDP
MP069,,1983,1969,,168000,9889656,1927725,,128207,8517078,1643701,,39793,1372578,284024,PDP
MP069,,1984,1969,,168000,9889656,1927725,,129202,8735085,1683488,,38798,1154571,244237,PDP
MP069,,1985,1969,,168000,9889656,1927725,,129606,8826799,1700211,,38394,1062857,227514,PDP
MP069,,1986,1969,,168000,9889656,1927725,,130112,8935599,1720076,,37888,954057,207649,PDP
MP069,,1987,1969,,168000,9889656,1927725,,130670,9052393,1741416,,37330,837263,186309,PDP
MP069,,1988,1969,,172443,10289564,2003326,,130894,9158781,1760570,,41549,1130783,242756,PDP
MP069,,1989,1969,,171236,10601491,2057622,,134415,9839376,1885194,,36821,762115,172428,PDP
MP069,,1990,1969,,171236,10601491,2057622,,135110,9923157,1900796,,36126,678334,156826,PDP
MP069,,1991,1969,,171236,10601491,2057622,,135220,9956142,1906776,,36016,645349,150846,PDP
MP069,,1992,1969,,854521,16643950,3816078,,159518,10223500,1978646,,695003,6420450,1837432,PDP
MP069,,1993,1969,,1491434,23543512,5680671,,669987,15144442,3364728,,821447,8399070,2315943,PDP
MP069,,1994,1969,,1540442,23646697,5748039,,1051689,19018602,4435782,,488753,4628095,1312257,PDP
MP069,,1995,1969,,1994274,28219872,7015604,,1372760,22463660,5369853,,621514,5756212,1645751,PDP
MP069,,1996,1969,,3204117,37954833,9957646,,1806333,27224877,6650617,,1397784,10729956,3307029,PDP
MP069,,1997,1969,,3124797,37252303,9753321,,2096748,30802040,7577538,,1028049,6450263,2175783,PDP
MP069,,1998,1969,,3639418,43441303,11369187,,2372551,34065668,8434058,,1266867,9375635,2935129,PDP
MP069,,1999,1969,,3598998,42961907,11243465,,2646306,37111962,9249858,,952692,5849945,1993607,PDP
MP069,,2000,1969,,2813416,40350053,9993141,,2722010,37992696,9482276,,91406,2357357,510865,PDP
MP069,,2001,1969,,3983996,42568886,11558531,,2794684,38633565,9668984,,1189312,3935321,1889547,PDP
MP069,,2002,1969,,4088275,42422589,11636778,,2832524,38867256,9748406,,1255751,3555333,1888372,PDP
MP069,,2003,1969,,2984673,40027773,10107053,,2858142,38987173,9795361,,126531,1040600,311692,PDP
MP069,,2004,1969,,3098345,40979801,10390125,,2870473,39060640,9820765,,227872,1919161,569360,PDP
MP069,,2005,1969,,3117078,41264915,10459590,,2966004,39773679,10043171,,151074,1491236,416419,PDP
MP069,,2006,1969,,3245048,42160747,10746960,,3033711,40215438,10189483,,211337,1945309,557477,PDP
MP069,,2007,1969,,3215282,42289686,10740137,,3127266,40762955,10380461,,88016,1526731,359676,PDP
MP069,,2008,1969,,3255444,41609183,10659213,,3214156,41343591,10570667,,41288,265592,88546,PDP
MP069,,2009,1969,,3273285,42560965,10846411,,3250858,42358916,10788032,,22427,202049,58378,PDP
MP069,,2010,1969,,3273387,42561581,10846622,,3255851,42416511,10803272,,17536,145070,43349,PDP
MP069,,2011,1969,,3273388,42561582,10846623,,3273290,42561581,10846525,,98,1,98,PDP
MP069,,2012,1969,,3273388,42561582,10846623,,3273387,42561581,10846622,,1,1,1,PDP
MP069,,2013,1969,,3282252,42695591,10879332,,3273695,42566150,10847743,,8557,129441,31589,PDP
MP069,,2014,1969,,3305375,42963456,10950118,,3283633,42739470,10888521,,21742,223986,61597,PDP
MP069,,2015,1969,,3307519,43049573,10967585,,3307519,43049573,10967585,,0,0,0,PDP
MP069,,2016,1969,,3307519,43049573,10967585,,3307519,43049573,10967585,,0,0,0,PDP
MP069,,2017,1969,,3427885,44128032,11279848,,3323389,43210825,11012148,,104496,917207,267700,PDP
MP069,,2017,1969,,3427885,44128032,11279848,,3323389,43210825,11012148,,104496,917207,267700,PDP
MP073,,1978,1975,,25000000,25000000,29448399,,0,0,0,,25000000,25000000,29448399,PDP
MP073,,1979,1975,,25000000,25000000,29448399,,318321,2360115,738270,,24681679,22639885,28710129,PDP
MP073,,1980,1975,,25000000,34000000,31049822,,1086495,14487441,3664331,,23913505,19512559,27385491,PDP
MP073,,1981,1975,,26050000,51840000,35274199,,1861696,31645898,7492639,,24188304,20194102,27781560,PDP
MP073,,1982,1975,,26050000,51840000,35274199,,2924981,45760938,11067497,,23125019,6079062,24206702,PDP
MP073,,1983,1975,,40234852,104103509,58758608,,6294067,61624441,17259270,,33940785,42479068,41499338,PDP
MP073,,1984,1975,,28967089,238304888,71370094,,9927200,79004026,23984856,,19039889,159300862,47385238,PDP
MP073,,1985,1975,,32176244,245811930,75915022,,13681694,95242656,30628786,,18494550,150569274,45286236,PDP
MP073,,1986,1975,,34850763,256253614,80447491,,16882258,110952612,36624716,,17968505,145301002,43822775,PDP
MP073,,1987,1975,,36731455,279382071,86443567,,19978221,131129026,43310788,,16753234,148253045,43132779,PDP
MP073,,1988,1975,,41019729,295423286,93586150,,22679947,148144361,49040154,,18339782,147278925,44545996,PDP
MP073,,1989,1975,,43006244,258389308,88982989,,25093119,161933541,53906916,,17913125,96455767,35076073,PDP
MP073,,1990,1975,,44030533,260736652,90424955,,27417828,171811051,57989189,,16612705,88925601,32435766,PDP
MP073,,1991,1975,,44161056,266373818,91558533,,29233760,182655845,61734800,,14927296,83717973,29823733,PDP
MP073,,1992,1975,,45471896,267522663,93073793,,30823373,194264807,65390065,,14648523,73257856,27683728,PDP
MP073,,1993,1975,,40174738,252233076,85056068,,32140249,202243169,68126578,,8034489,49989907,16929490,PDP
MP073,,1994,1975,,44342718,329547497,102981063,,33394214,209399805,70653966,,10948504,120147692,32327097,PDP
MP073,,1995,1975,,53399908,355078428,116581123,,34577443,216630749,73123840,,18822465,138447679,43457283,PDP
MP073,,1996,1975,,57418187,342092400,118288721,,36236389,225098218,76289453,,21181798,116994182,41999268,PDP
MP073,,1997,1975,,55266326,338171601,115439209,,38355758,230929625,79446439,,16910568,107241976,35992770,PDP
MP073,,1998,1975,,57730334,339216977,118089227,,40385336,235631538,82312656,,17344998,103585439,35776571,PDP
MP073,,1999,1975,,50932746,304510079,105116034,,41808216,239136586,84359210,,9124530,65373493,20756824,PDP
MP073,,2000,1975,,51034583,295012868,103527976,,42794738,242702103,85980166,,8239845,52310765,17547810,PDP
MP073,,2001,1975,,51404347,294792587,103858544,,43614895,246401001,87458489,,7789452,48391586,16400055,PDP
MP073,,2002,1975,,52583928,294810316,105041279,,44155593,247796681,88247529,,8428335,47013635,16793750,PDP
MP073,,2003,1975,,52203555,291248928,104027207,,44793594,249427131,89175646,,7409961,41821797,14851561,PDP
MP073,,2004,1975,,51526854,284898966,102220620,,45141669,250103795,89644124,,6385185,34795171,12576496,PDP
MP073,,2005,1975,,51839201,285087544,102566522,,45351243,250531482,89929799,,6487958,34556062,12636723,PDP
MP073,,2006,1975,,51869868,285568279,102682729,,45677958,251216923,90378478,,6191910,34351356,12304251,PDP
MP073,,2007,1975,,51868319,270077367,99924790,,45837787,251479599,90585047,,6030532,18597768,9339743,PDP
MP073,,2008,1975,,53262196,270906581,101466214,,46501856,252169219,91371824,,6760340,18737362,10094390,PDP
MP073,,2009,1975,,52942511,275600806,101981798,,47321516,257765408,93187244,,5620995,17835398,8794553,PDP
MP073,,2010,1975,,53005488,275707706,102063795,,47958135,258459144,93947306,,5047353,17248562,8116490,PDP
MP073,,2011,1975,,56345825,277224410,105674009,,48894984,259677205,95100893,,7450841,17547205,10573118,PDP
MP073,,2012,1975,,57113305,277967114,106573644,,50388739,260681879,96773414,,6724566,17285235,9800230,PDP
MP073,,2013,1975,,55751540,277455762,105120889,,51090495,261442928,97610589,,4661045,16012834,7510302,PDP
MP073,,2014,1975,,55941485,276106306,105070720,,51739335,262208944,98395730,,4202150,13897362,6674990,PDP
MP073,,2015,1975,,56128534,275297402,105113834,,52115613,262647405,98850025,,4012921,12649997,6263808,PDP
MP073,,2016,1975,,56020908,274477956,104860399,,52535011,263335704,99391897,,3485897,11142252,5468502,PDP
MP073,,2017,1975,,56676798,276463837,105869650,,52951357,263842292,99898381,,3725441,12621545,5971265,PDP
MP073,,2017,1975,,56676798,276463837,105869650,,52951357,263842292,99898381,,3725441,12621545,5971265,PDP
MP086,,2000,2000,,589,5896634,1049812,,0,0,0,,589,5896634,1049812,PDN
MP086,,2001,2000,,589,5896634,1049812,,0,0,0,,589,5896634,1049812,PDN
MP086,,2002,2000,,589,5896634,1049812,,0,0,0,,589,5896634,1049812,PDN
MP086,,2003,2000,,589,5896634,1049812,,0,0,0,,589,5896634,1049812,PDN
MP086,,2004,2000,,589,5896634,1049812,,0,889768,158322,,589,5006866,891490,PDN
MP086,,2005,2000,,190695,6241540,1301289,,128268,3919973,825772,,62427,2321567,475517,PDN
MP086,,2006,2000,,214499,6721600,1410513,,182110,5783544,1211210,,32389,938056,199303,PDN
MP086,,2007,2000,,214414,6731196,1412136,,194378,6186410,1295163,,20036,544786,116973,PDN
MP086,,2008,2000,,214414,6731196,1412136,,202481,6428581,1346357,,11933,302615,65779,PDN
MP086,,2009,2000,,202481,6428581,1346357,,202481,6428581,1346357,,0,0,0,PDN
MP086,,2010,2000,,202481,6428581,1346357,,202481,6428581,1346357,,0,0,0,PDN
MP086,,2011,2000,,202481,6428581,1346357,,202481,6428581,1346357,,0,0,0,PDN
MP086,,2012,2000,,202481,6428581,1346357,,202481,6428581,1346357,,0,0,0,PDN
MP086,,2013,2000,,202481,6428581,1346357,,202481,6428581,1346357,,0,0,0,PDN
MP086,,2014,2000,,202481,6428581,1346357,,202481,6428581,1346357,,0,0,0,PDN
MP086,,2015,2000,,202481,6428581,1346357,,202481,6428581,1346357,,0,0,0,PDN
MP086,,2016,2000,,202481,6428581,1346357,,202481,6428581,1346357,,0,0,0,PDN
MP086,,2017,2000,,202481,6428581,1346357,,202481,6428581,1346357,,0,0,0,PDN
MP086,,2017,2000,,202481,6428581,1346357,,202481,6428581,1346357,,0,0,0,PDN
MP089,,1987,1986,,6185,10543289,1882215,,3414,5162162,921948,,2771,5381127,960267,PDN
MP089,,1988,1986,,8184,13433689,2398520,,5889,9892883,1766188,,2295,3540806,632332,PDN
MP089,,1989,1986,,12340,21570464,3850501,,7362,13300954,2374080,,4978,8269510,1476421,PDN
MP089,,1990,1986,,12340,21570464,3850501,,8192,15719403,2805239,,4148,5851061,1045262,PDN
MP089,,1991,1986,,12340,21570464,3850501,,8579,16939951,3022805,,3761,4630513,827696,PDN
MP089,,1992,1986,,12340,21570464,3850501,,8865,17910797,3195840,,3475,3659667,654661,PDN
MP089,,1993,1986,,10036,21570464,3848197,,9086,18595665,3317923,,950,2974799,530274,PDN
MP089,,1994,1986,,9246,19148341,3416424,,9086,18883907,3369212,,160,264434,47212,PDN
MP089,,1995,1986,,9246,19148341,3416424,,9086,19044207,3397735,,160,104134,18689,PDN
MP089,,1996,1986,,9086,19057945,3400179,,9086,19057945,3400179,,0,0,0,PDN
MP089,,1997,1986,,9086,19057945,3400179,,9086,19057945,3400179,,0,0,0,PDN
MP089,,1998,1986,,9086,19057945,3400179,,9086,19057945,3400179,,0,0,0,PDN
MP089,,1999,1986,,9086,19057945,3400179,,9086,19057945,3400179,,0,0,0,PDN
MP089,,2000,1986,,9086,19057945,3400179,,9086,19057945,3400179,,0,0,0,PDN
MP089,,2001,1986,,9086,19057945,3400179,,9086,19057945,3400179,,0,0,0,PDN
MP089,,2002,1986,,9086,19057945,3400179,,9086,19057945,3400179,,0,0,0,PDN
MP089,,2003,1986,,9319,21385026,3814484,,9086,19057945,3400179,,233,2327081,414305,PDN
MP089,,2004,1986,,10441,32614261,5813690,,9086,21296525,3798503,,1355,11317736,2015187,PDN
MP089,,2005,1986,,9802,26821105,4782241,,9086,23378694,4168996,,716,3442411,613245,PDN
MP089,,2006,1986,,9806,26853467,4788003,,9086,24687120,4401812,,720,2166347,386191,PDN
MP089,,2007,1986,,9806,26853467,4788003,,9086,24898845,4439485,,720,1954622,348518,PDN
MP089,,2008,1986,,9608,26608122,4744149,,9086,24893633,4438558,,522,1714489,305591,PDN
MP089,,2009,1986,,9620,25275308,4507006,,9086,25275308,4506472,,534,0,534,PDN
MP089,,2010,1986,,9086,25275308,4506472,,9086,25275308,4506472,,0,0,0,PDN
MP089,,2011,1986,,9086,25275308,4506472,,9086,25275308,4506472,,0,0,0,PDN
MP089,,2012,1986,,9086,25275308,4506472,,9086,25275308,4506472,,0,0,0,PDN
MP089,,2013,1986,,9086,25275308,4506472,,9086,25275308,4506472,,0,0,0,PDN
MP089,,2014,1986,,9086,25275308,4506472,,9086,25275308,4506472,,0,0,0,PDN
MP089,,2015,1986,,9086,25275308,4506472,,9086,25275308,4506472,,0,0,0,PDN
MP089,,2016,1986,,9086,25275308,4506472,,9086,25275308,4506472,,0,0,0,PDN
MP089,,2017,1986,,9086,25275308,4506472,,9086,25275308,4506472,,0,0,0,PDN
MP089,,2017,1986,,9086,25275308,4506472,,9086,25275308,4506472,,0,0,0,PDN
MP093,,1984,1969,,1008784,176537299,32421115,,0,0,0,,1008784,176537299,32421115,PDN
MP093,,1985,1969,,1060629,185350899,34041216,,12586,2937102,535202,,1048043,182413797,33506014,PDN
MP093,,1986,1969,,1012516,184407975,33825323,,26255,11745855,2116265,,986261,172662120,31709058,PDN
MP093,,1987,1969,,1034185,229465872,41864411,,41390,22713769,4082986,,992795,206752103,37781425,PDN
MP093,,1988,1969,,866402,200038848,36460503,,51088,35191698,6312956,,815314,164847150,30147547,PDN
MP093,,1989,1969,,154772,126674234,22694671,,56395,42416021,7603730,,98377,84258213,15090941,PDN
MP093,,1990,1969,,154772,126674234,22694671,,59308,47588871,8527079,,95464,79085363,14167592,PDN
MP093,,1991,1969,,154772,130124234,23308550,,63189,53031927,9499475,,91583,77092307,13809075,PDN
MP093,,1992,1969,,159981,128399756,23006913,,73558,67025734,11999845,,86423,61374022,11007068,PDN
MP093,,1993,1969,,165415,140659669,25193826,,78215,70638160,12647283,,87200,70021509,12546543,PDN
MP093,,1994,1969,,118177,117380169,21004328,,80200,76043148,13611009,,37977,41337021,7393319,PDN
MP093,,1995,1969,,112912,120286420,21516190,,80200,82148955,14697452,,32712,38137465,6818738,PDN
MP093,,1996,1969,,4100901,106100111,22979924,,80233,84520596,15119485,,4020668,21579515,7860439,PDN
MP093,,1997,1969,,4101231,105584529,22888514,,80461,87017875,15564069,,4020770,18566654,7324445,PDN
MP093,,1998,1969,,4101236,105687403,22906824,,81360,89999968,16095589,,4019876,15687435,6811235,PDN
MP093,,1999,1969,,82601,99048879,17706957,,81526,92148400,16478038,,1075,6900479,1228919,PDN
MP093,,2000,1969,,84624,109666256,19598193,,81885,98300420,17573063,,2739,11365836,2025130,PDN
MP093,,2001,1969,,85467,111927960,20001474,,82884,104472992,18672384,,2583,7454968,1329090,PDN
MP093,,2002,1969,,86450,112619431,20125495,,83451,108118890,19321688,,2999,4500541,803807,PDN
MP093,,2003,1969,,85121,113072088,20204710,,83584,109596128,19584674,,1537,3475960,620036,PDN
MP093,,2004,1969,,83674,111260838,19880976,,83584,110161572,19685287,,90,1099266,195689,PDN
MP093,,2005,1969,,83843,113219619,20229683,,83584,110721527,19784923,,259,2498092,444760,PDN
MP093,,2006,1969,,84055,115953454,20716342,,83584,111470407,19918176,,471,4483047,798166,PDN
MP093,,2007,1969,,84055,115465209,20629466,,83584,112101018,20030384,,471,3364191,599082,PDN
MP093,,2008,1969,,84127,115702044,20671679,,83761,113798584,20332619,,366,1903460,339060,PDN
MP093,,2009,1969,,83977,119291080,21310148,,83826,116906247,20885650,,151,2384833,424498,PDN
MP093,,2010,1969,,83977,119282137,21308556,,83826,117548398,20999911,,151,1733739,308645,PDN
MP093,,2011,1969,,83977,119282137,21308556,,83826,117802568,21045137,,151,1479569,263419,PDN
MP093,,2012,1969,,83977,119282137,21308556,,83826,117883777,21059587,,151,1398360,248969,PDN
MP093,,2013,1969,,83977,119282137,21308556,,83826,117883777,21059587,,151,1398360,248969,PDN
MP093,,2014,1969,,83826,117883777,21059587,,83826,117883777,21059587,,0,0,0,PDN
MP093,,2015,1969,,83826,117883777,21059587,,83826,117883777,21059587,,0,0,0,PDN
MP093,,2016,1969,,83826,117883777,21059587,,83826,117883777,21059587,,0,0,0,PDN
MP093,,2017,1969,,83826,117883777,21059587,,83826,117883777,21059587,,0,0,0,PDN
MP093,,2017,1969,,83826,117883777,21059587,,83826,117883777,21059587,,0,0,0,PDN
MP096,,1975,1968,,0,6618142,1177605,,1,6618142,1177606,,-1,0,-1,PDN
MP096,,1976,1968,,0,6618142,1177605,,1,6618142,1177606,,-1,0,-1,PDN
MP096,,1977,1968,,0,6618142,1177605,,0,6618142,1177605,,0,0,0,PDN
MP096,,1978,1968,,0,6618142,1177605,,0,6618142,1177605,,0,0,0,PDN
MP096,,1979,1968,,4017,6994237,1248543,,4017,6994237,1248543,,0,0,0,PDN
MP096,,1980,1968,,4017,6994237,1248543,,4017,6994237,1248543,,0,0,0,PDN
MP096,,1981,1968,,4017,6994237,1248543,,4017,6994237,1248543,,0,0,0,PDN
MP096,,1982,1968,,4017,6994237,1248543,,4017,6994237,1248543,,0,0,0,PDN
MP096,,1983,1968,,4017,6994237,1248543,,4017,6994237,1248543,,0,0,0,PDN
MP096,,1984,1968,,4017,6994237,1248543,,4017,6994237,1248543,,0,0,0,PDN
MP096,,1985,1968,,4017,6994237,1248543,,4017,6994237,1248543,,0,0,0,PDN
MP096,,1986,1968,,20598,9877667,1778190,,4017,6994237,1248543,,16581,2883430,529647,PDN
MP096,,1987,1968,,56986,19441741,3516371,,4017,6994237,1248543,,52969,12447504,2267828,PDN
MP096,,1988,1968,,150882,41507298,7536522,,4017,7070126,1262047,,146865,34437172,6274475,PDN
MP096,,1989,1968,,146796,42309929,7675253,,7341,12635691,2255685,,139455,29674238,5419568,PDN
MP096,,1990,1968,,146320,48931219,8852943,,9468,16773543,2994084,,136852,32157676,5858859,PDN
MP096,,1991,1968,,164295,56856428,10281097,,10917,22369626,3991277,,153378,34486802,6289820,PDN
MP096,,1992,1968,,168918,56856428,10285720,,16699,26313045,4698735,,152219,30543383,5586985,PDN
MP096,,1993,1968,,31369,40333662,7208177,,19615,29695578,5303526,,11754,10638084,1904651,PDN
MP096,,1994,1968,,28359,40956811,7316048,,21629,31896961,5697245,,6730,9059850,1618803,PDN
MP096,,1995,1968,,28353,43259190,7725718,,22740,36159247,6456770,,5613,7099943,1268948,PDN
MP096,,1996,1968,,28076,55006507,9815711,,23440,40503536,7230475,,4636,14502971,2585236,PDN
MP096,,1997,1968,,28076,55006507,9815711,,23971,47631433,8499315,,4105,7375074,1316396,PDN
MP096,,1998,1968,,28076,55006507,9815711,,24215,48843119,8715161,,3861,6163388,1100550,PDN
MP096,,1999,1968,,26758,56513701,10082577,,24437,49844320,8893533,,2321,6669381,1189044,PDN
MP096,,2000,1968,,26390,54759767,9770121,,24633,50385638,8990049,,1757,4374129,780072,PDN
MP096,,2001,1968,,26390,54759767,9770121,,24633,50499175,9010251,,1757,4260592,759870,PDN
MP096,,2002,1968,,37144,74942179,13372051,,25967,53977802,9630558,,11177,20964377,3741493,PDN
MP096,,2003,1968,,37574,84233419,15025727,,28417,57638706,10284415,,9157,26594713,4741312,PDN
MP096,,2004,1968,,35598,73951980,13194313,,29983,59908293,10689822,,5615,14043687,2504491,PDN
MP096,,2005,1968,,36052,76709264,13685387,,35392,65680481,11722310,,660,11028783,1963077,PDN
MP096,,2006,1968,,40660,88695465,15822771,,38422,76431476,13638329,,2238,12263989,2184442,PDN
MP096,,2007,1968,,40660,88806611,15842548,,39876,83360980,14872791,,784,5445631,969757,PDN
MP096,,2008,1968,,41232,91647258,16348573,,40340,86214762,15381045,,892,5432496,967528,PDN
MP096,,2009,1968,,41116,91345925,16294839,,40756,88626934,15810673,,360,2718991,484166,PDN
MP096,,2010,1968,,40936,91722640,16361690,,40840,89590275,15982170,,96,2132365,379520,PDN
MP096,,2011,1968,,40936,91722640,16361690,,40935,90088530,16070923,,1,1634110,290768,PDN
MP096,,2012,1968,,40936,93742482,16721093,,40936,90568876,16156395,,0,3173606,564698,PDN
MP096,,2013,1968,,40936,93742482,16721093,,40936,91073083,16246111,,0,2669399,474981,PDN
MP096,,2014,1968,,40936,91268234,16280835,,40936,91268234,16280835,,0,0,0,PDN
MP096,,2015,1968,,40936,91268234,16280835,,40936,91268234,16280835,,0,0,0,PDN
MP096,,2016,1968,,40936,91268234,16280835,,40936,91268234,16280835,,0,0,0,PDN
MP096,,2017,1968,,40936,91269024,16280976,,40936,91269024,16280976,,0,0,0,PDN
MP096,,2017,1968,,40936,91269024,16280976,,40936,91269024,16280976,,0,0,0,PDN
MP098,,1986,1984,,3603,36026852,6414075,,0,1810198,322099,,3603,34216654,6091976,PDP
MP098,,1987,1984,,3603,36026852,6414075,,0,4376586,778752,,3603,31650266,5635323,PDP
MP098,,1988,1984,,3603,36026852,6414075,,0,5576225,992211,,3603,30450627,5421864,PDP
MP098,,1989,1984,,45,13207000,2350045,,0,6633047,1180257,,45,6573953,1169788,PDP
MP098,,1990,1984,,101,13769888,2450259,,0,7419156,1320135,,101,6350732,1130124,PDP
MP098,,1991,1984,,141,13281515,2363400,,0,8272357,1471950,,141,5009158,891450,PDP
MP098,,1992,1984,,141,13281515,2363400,,0,9368502,1666993,,141,3913013,696407,PDP
MP098,,1993,1984,,86,12764990,2271437,,0,10395015,1849647,,86,2369975,421790,PDP
MP098,,1994,1984,,56,12553407,2233758,,0,11173583,1988182,,56,1379824,245576,PDP
MP098,,1995,1984,,56,13360142,2377305,,0,11908833,2119009,,56,1451309,258296,PDP
MP098,,1996,1984,,20,15306743,2723640,,0,12709535,2261483,,20,2597208,462157,PDP
MP098,,1997,1984,,20,15306743,2723640,,0,13174776,2344266,,20,2131967,379374,PDP
MP098,,1998,1984,,20,15306743,2723640,,0,13594337,2418921,,20,1712406,304719,PDP
MP098,,1999,1984,,20,16012859,2849283,,0,13957341,2483513,,20,2055518,365770,PDP
MP098,,2000,1984,,66,17347737,3086852,,22,15087473,2684626,,44,2260264,402226,PDP
MP098,,2001,1984,,660,17347737,3087446,,341,16142435,2872660,,319,1205302,214786,PDP
MP098,,2002,1984,,242796,52544134,9592286,,540,16961704,3018637,,242256,35582430,6573649,PDP
MP098,,2003,1984,,242796,52544134,9592286,,734,17656996,3142548,,242062,34887138,6449738,PDP
MP098,,2004,1984,,242644,51461214,9399444,,52546,21075446,3802625,,190098,30385768,5596819,PDP
MP098,,2005,1984,,243947,50237379,9182982,,101179,23720595,4321925,,142768,26516784,4861057,PDP
MP098,,2006,1984,,243947,50237379,9182982,,144712,25739718,4724733,,99235,24497661,4458249,PDP
MP098,,2007,1984,,160993,48149637,8728544,,157448,26640456,4897743,,3545,21509181,3830801,PDP
MP098,,2008,1984,,160993,48143599,8727470,,157448,27005437,4962686,,3545,21138162,3764784,PDP
MP098,,2009,1984,,160899,48241459,8744788,,157448,27465224,5044497,,3451,20776235,3700290,PDP
MP098,,2010,1984,,717727,58697740,11162164,,157448,27505138,5051600,,560279,31192602,6110564,PDP
MP098,,2011,1984,,700111,58697740,11144548,,308924,30123223,5668927,,391187,28574517,5475621,PDP
MP098,,2012,1984,,700111,58966485,11192367,,428061,32906891,6283378,,272050,26059594,4908988,PDP
MP098,,2013,1984,,700111,58966485,11192367,,477666,34279820,6577277,,222445,24686665,4615090,PDP
MP098,,2014,1984,,696660,38290169,7509856,,538662,35496298,6854729,,157998,2793871,655128,PDP
MP098,,2015,1984,,696660,38290169,7509856,,584763,36171817,7021028,,111897,2118352,488828,PDP
MP098,,2016,1984,,842676,41557322,8237217,,670733,37807769,7398092,,171943,3749553,839124,PDP
MP098,,2017,1984,,842676,41552890,8236428,,738879,39306879,7732984,,103797,2246011,503443,PDP
MP098,,2017,1984,,842676,41552890,8236428,,738879,39306879,7732984,,103797,2246011,503443,PDP
MP099,,2004,1971,,746,7932946,1412302,,746,7932946,1412302,,0,0,0,PDN
MP099,,2005,1971,,746,7932946,1412302,,746,7932946,1412302,,0,0,0,PDN
MP099,,2006,1971,,746,7932946,1412302,,746,7932946,1412302,,0,0,0,PDN
MP099,,2007,1971,,746,7932946,1412302,,746,7932946,1412302,,0,0,0,PDN
MP099,,2008,1971,,746,7932946,1412302,,746,7932946,1412302,,0,0,0,PDN
MP099,,2009,1971,,746,8091732,1440556,,746,8091732,1440556,,0,0,0,PDN
MP099,,2010,1971,,746,8091732,1440556,,746,8091732,1440556,,0,0,0,PDN
MP099,,2011,1971,,746,8091732,1440556,,746,8091732,1440556,,0,0,0,PDN
MP099,,2012,1971,,746,8091732,1440556,,746,8091732,1440556,,0,0,0,PDN
MP099,,2013,1971,,746,8091732,1440556,,746,8091732,1440556,,0,0,0,PDN
MP099,,2014,1971,,746,8091732,1440556,,746,8091732,1440556,,0,0,0,PDN
MP099,,2015,1971,,746,8091732,1440556,,746,8091732,1440556,,0,0,0,PDN
MP099,,2016,1971,,746,8091732,1440556,,746,8091732,1440556,,0,0,0,PDN
MP099,,2017,1971,,746,8091732,1440556,,746,8091732,1440556,,0,0,0,PDN
MP099,,2017,1971,,746,8091732,1440556,,746,8091732,1440556,,0,0,0,PDN
MP103,,1975,1968,,1535928,135913783,25719875,,444697,29956727,5775075,,1091231,105957056,19944800,PDN
MP103,,1976,1968,,1697472,53150283,11154818,,442208,23600971,4641669,,1255264,29549312,6513149,PDN
MP103,,1977,1968,,1707472,63150283,12944177,,525833,28037739,5514755,,1181639,35112544,7429422,PDN
MP103,,1978,1968,,1707472,63150283,12944177,,609503,32423607,6378828,,1097969,30726676,6565349,PDN
MP103,,1979,1968,,1707653,63542962,13014230,,665926,36071677,7084374,,1041727,27471285,5929856,PDN
MP103,,1980,1968,,1723978,73564643,14813772,,751584,45042429,8766251,,972394,28522214,6047521,PDN
MP103,,1981,1968,,1723978,73564643,14813772,,801649,48080515,9356901,,922329,25484128,5456871,PDN
MP103,,1982,1968,,1748696,73564643,14838490,,839938,50382068,9804719,,908758,23182575,5033771,PDN
MP103,,1983,1968,,1748696,73564643,14838490,,873610,51439296,10026510,,875086,22125347,4811980,PDN
MP103,,1984,1968,,1737484,78025635,15621049,,934495,52415890,10261166,,802989,25609745,5359883,PDN
MP103,,1985,1968,,2936445,79950499,17162512,,965999,53348355,10458589,,1970446,26602144,6703923,PDN
MP103,,1986,1968,,2936445,79950499,17162512,,1020638,54133710,10652971,,1915807,25816789,6509541,PDN
MP103,,1987,1968,,2936445,79950499,17162512,,1096907,54771945,10842805,,1839538,25178554,6319707,PDN
MP103,,1988,1968,,2936445,79950499,17162512,,1154099,55289976,10992173,,1782346,24660523,6170339,PDN
MP103,,1989,1968,,2936445,79950499,17162512,,1192087,55785472,11118328,,1744358,24165027,6044184,PDN
MP103,,1990,1968,,2936445,79950499,17162512,,1248062,56421933,11287552,,1688383,23528566,5874960,PDN
MP103,,1991,1968,,2936445,79950499,17162512,,1296468,57833465,11587120,,1639977,22117034,5575392,PDN
MP103,,1992,1968,,1622663,64665147,13128917,,1347188,59154579,11872914,,275475,5510568,1256003,PDN
MP103,,1993,1968,,1631204,64665147,13137458,,1433284,60419364,12184061,,197920,4245783,953397,PDN
MP103,,1994,1968,,1610002,66774100,13491514,,1569444,63194105,12813947,,40558,3579995,677567,PDN
MP103,,1995,1968,,3858893,80951312,18263041,,1779159,67824490,13847574,,2079734,13126822,4415467,PDN
MP103,,1996,1968,,3846857,86458293,19230895,,1961712,72174581,14804164,,1885145,14283712,4426731,PDN
MP103,,1997,1968,,3846627,85677140,19091670,,2109976,75725649,15584291,,1736651,9951491,3507379,PDN
MP103,,1998,1968,,3931151,87396163,19482070,,2233755,78867992,16267206,,1697396,8528171,3214864,PDN
MP103,,1999,1968,,3931093,86815172,19378633,,2354617,80855193,16741662,,1576476,5959979,2636971,PDN
MP103,,2000,1968,,2891199,85761826,18151310,,2476126,82461066,17148914,,415073,3300760,1002396,PDN
MP103,,2001,1968,,2893515,86287288,18247125,,2554761,83139630,17348289,,338754,3147658,898836,PDN
MP103,,2002,1968,,2893778,86087288,18211801,,2614277,83633973,17495767,,279501,2453315,716034,PDN
MP103,,2003,1968,,2614853,84393471,17631485,,2614460,83947381,17551716,,393,446090,79769,PDN
MP103,,2004,1968,,2614479,89744355,18583225,,2614471,85325194,17796890,,8,4419161,786335,PDN
MP103,,2005,1968,,2615979,92359818,19050110,,2614471,87095966,18111974,,1508,5263852,938136,PDN
MP103,,2006,1968,,2645411,106282553,21556897,,2622768,93855948,19323115,,22643,12426605,2233782,PDN
MP103,,2007,1968,,2744320,109885304,22296865,,2651059,99194066,20301249,,93261,10691238,1995616,PDN
MP103,,2008,1968,,2754038,111367077,22570244,,2692355,103549712,21117571,,61683,7817365,1452673,PDN
MP103,,2009,1968,,2757143,114053219,23051309,,2728851,108608123,22054141,,28292,5445096,997169,PDN
MP103,,2010,1968,,2759496,114249925,23088664,,2747507,111123831,22520431,,11989,3126094,568233,PDN
MP103,,2011,1968,,2758394,125128788,25023303,,2757017,112059270,22696389,,1377,13069518,2326914,PDN
MP103,,2012,1968,,2759564,125806223,25145014,,2758031,113324737,22922575,,1533,12481486,2222439,PDN
MP103,,2013,1968,,2758785,116981580,23574013,,2758105,114294281,23095166,,680,2687299,478847,PDN
MP103,,2014,1968,,2759049,116845664,23550092,,2758274,114831873,23190992,,775,2013791,359101,PDN
MP103,,2015,1968,,2758385,114966955,23215139,,2758385,114966955,23215139,,0,0,0,PDN
MP103,,2016,1968,,2758385,114966955,23215139,,2758385,114966955,23215139,,0,0,0,PDN
MP103,,2017,1968,,2758385,114966955,23215139,,2758385,114966955,23215139,,0,0,0,PDN
MP103,,2017,1968,,2758385,114966955,23215139,,2758385,114966955,23215139,,0,0,0,PDN
MP107,,1975,1965,,280505,50000000,9177302,,80583,18032615,3289233,,199922,31967385,5888069,PDP
MP107,,1976,1965,,280505,50000000,9177302,,80583,24599596,4457735,,199922,25400404,4719567,PDP
MP107,,1977,1965,,280505,50000000,9177302,,80583,29533487,5335652,,199922,20466513,3841650,PDP
MP107,,1978,1965,,162000,64959500,11720630,,162000,41528639,7551438,,0,23430861,4169192,PDP
MP107,,1979,1965,,0,66678450,11864493,,0,44545636,7926270,,0,22132814,3938223,PDP
MP107,,1980,1965,,407,68544243,12196892,,407,41205254,7332303,,0,27338989,4864589,PDP
MP107,,1981,1965,,407,68544243,12196892,,407,42486947,7560362,,0,26057296,4636530,PDP
MP107,,1982,1965,,497,68544243,12196982,,425,43754699,7785959,,72,24789544,4411023,PDP
MP107,,1983,1965,,497,68544243,12196982,,425,45028698,8012649,,72,23515545,4184333,PDP
MP107,,1984,1965,,803,71606913,12742247,,425,46025489,8190014,,378,25581424,4552233,PDP
MP107,,1985,1965,,2776,71164205,12665446,,816,47916778,8526933,,1960,23247427,4138513,PDP
MP107,,1986,1965,,9058,61470625,10946892,,1473,54724651,9738955,,7585,6745974,1207937,PDP
MP107,,1987,1965,,5976,75624049,13462212,,2961,64694888,11514507,,3015,10929161,1947705,PDP
MP107,,1988,1965,,10009,68858457,12262403,,6243,58836444,10475361,,3766,10022013,1787042,PDP
MP107,,1989,1965,,11415,73936550,13167385,,7080,64941788,11562558,,4335,8994762,1604827,PDP
MP107,,1990,1965,,19461,82416978,14684404,,8378,69099861,12303727,,11083,13317117,2380677,PDP
MP107,,1991,1965,,14786,76095902,13554982,,7549,70028754,12468181,,7237,6067148,1086801,PDP
MP107,,1992,1965,,99625,84463137,15128653,,11300,71424070,12720209,,88325,13039067,2408444,PDP
MP107,,1993,1965,,66387,79316537,14179650,,35270,74093490,13219165,,31117,5223047,960485,PDP
MP107,,1994,1965,,66387,79316537,14179650,,40118,74932919,13373378,,26269,4383618,806272,PDP
MP107,,1995,1965,,44594,77756668,13880300,,44109,75569791,13490691,,485,2186877,389609,PDP
MP107,,1996,1965,,44584,77653174,13861875,,44109,75777924,13527725,,475,1875250,334150,PDP
MP107,,1997,1965,,44584,77653174,13861875,,44109,75925318,13553952,,475,1727856,307923,PDP
MP107,,1998,1965,,44584,77653174,13861875,,44109,76011978,13569372,,475,1641196,292503,PDP
MP107,,1999,1965,,44456,76372731,13633910,,44109,76119015,13588418,,347,253716,45492,PDP
MP107,,2000,1965,,44456,76372731,13633910,,44109,76182195,13599660,,347,190536,34250,PDP
MP107,,2001,1965,,44456,76372731,13633910,,44109,76240209,13609982,,347,132522,23928,PDP
MP107,,2002,1965,,44456,76372731,13633910,,44109,76291425,13619096,,347,81306,14814,PDP
MP107,,2003,1965,,507672,103232315,18876411,,112159,78942620,14158889,,395513,24289695,4717522,PDP
MP107,,2004,1965,,554760,106143027,19441420,,234278,84683254,15302473,,320482,21459773,4138947,PDP
MP107,,2005,1965,,664372,121693779,22318069,,366924,91879884,16715658,,297448,29813895,5602411,PDP
MP107,,2006,1965,,1244331,120966697,22768654,,539554,96585182,17725529,,704777,24381515,5043125,PDP
MP107,,2007,1965,,1269708,121010501,22801826,,643881,100180826,18469651,,625827,20829675,4332175,PDP
MP107,,2008,1965,,1269361,121078623,22813600,,735101,102809720,19028645,,534260,18268903,3784955,PDP
MP107,,2009,1965,,1084066,113040521,21198036,,809702,106225045,19710955,,274364,6815476,1487082,PDP
MP107,,2010,1965,,1064300,113656500,21287874,,837232,107183584,19909043,,227068,6472916,1378833,PDP
MP107,,2011,1965,,1134537,113689589,21363999,,906432,108686610,20245683,,228105,5002979,1118315,PDP
MP107,,2012,1965,,1134462,113690504,21364088,,967543,110144895,20566277,,166919,3545609,797810,PDP
MP107,,2013,1965,,1134462,113694886,21364868,,1018513,111110415,20789048,,115949,2584471,575819,PDP
MP107,,2014,1965,,1101559,113577179,21311020,,1041850,111761097,20928165,,59709,1816082,382856,PDP
MP107,,2015,1965,,1101559,113527292,21302143,,1055841,112346355,21046294,,45718,1180937,255849,PDP
MP107,,2016,1965,,1101559,113527292,21302143,,1080638,112888795,21167611,,20921,638497,134533,PDP
MP107,,2017,1965,,1101559,113527292,21302143,,1094388,113389210,21270403,,7171,138082,31741,PDP
MP107,,2017,1965,,1101559,113527292,21302143,,1094388,113389210,21270403,,7171,138082,31741,PDP
MP108,,1987,1962,,34963,7377207,1347633,,0,0,0,,34963,7377207,1347633,PDP
MP108,,1988,1962,,35086,8069791,1470992,,0,0,0,,35086,8069791,1470992,PDP
MP108,,1989,1962,,35086,8069791,1470992,,0,0,0,,35086,8069791,1470992,PDP
MP108,,1990,1962,,478195,21953639,4384536,,131671,3858649,818263,,346524,18094990,3566273,PDP
MP108,,1991,1962,,485811,32237719,6222060,,391663,17159591,3444971,,94148,15078128,2777089,PDP
MP108,,1992,1962,,2216201,75816921,15706756,,628259,28262943,5657252,,1587942,47553978,10049504,PDP
MP108,,1993,1962,,2619835,96497301,19790173,,903716,43715322,8682243,,1716119,52781979,11107930,PDP
MP108,,1994,1962,,2620115,99294271,20288135,,1087157,52958297,10510342,,1532958,46335974,9777793,PDP
MP108,,1995,1962,,2687218,96330305,19827842,,1228884,60843230,12055082,,1458334,35487075,7772760,PDP
MP108,,1996,1962,,1692716,88070164,17363564,,1347763,67865338,13423446,,344953,20204826,3940118,PDP
MP108,,1997,1962,,1734288,90771858,17885864,,1480514,74755505,14782205,,253774,16016353,3103659,PDP
MP108,,1998,1962,,1734311,91514677,18018061,,1635990,83116865,16425468,,98321,8397812,1592593,PDP
MP108,,1999,1962,,2012218,106036832,20879982,,1742652,89107492,17598078,,269566,16929340,3281904,PDP
MP108,,2000,1962,,2003684,105677668,20807540,,1821393,93363285,18434077,,182291,12314383,2373463,PDP
MP108,,2001,1962,,2166069,118055751,23172430,,1950881,98330651,19447438,,215188,19725100,3724992,PDP
MP108,,2002,1962,,2346985,119982391,23696165,,2130956,106559189,21091666,,216029,13423202,2604499,PDP
MP108,,2003,1962,,2403042,122098229,24128706,,2245411,111806742,22139849,,157631,10291487,1988857,PDP
MP108,,2004,1962,,2681217,128612144,25565940,,2398969,111735785,22280781,,282248,16876359,3285159,PDP
MP108,,2005,1962,,2912912,136270910,27160405,,2502923,118258913,23545434,,409989,18011997,3614971,PDP
MP108,,2006,1962,,3008937,141709577,28224164,,2619106,125588079,24965739,,389831,16121498,3258425,PDP
MP108,,2007,1962,,3026692,142480913,28379168,,2724847,132205843,26249018,,301845,10275070,2130150,PDP
MP108,,2008,1962,,3625118,191164975,37640238,,2859330,140501357,27859571,,765788,50663618,9780667,PDP
MP108,,2009,1962,,4819238,229116943,45587377,,3789315,181301422,36049354,,1029923,47815521,9538023,PDP
MP108,,2010,1962,,4604765,228523727,45267349,,4046740,193888632,38546496,,558025,34635095,6720853,PDP
MP108,,2011,1962,,4963083,247134184,48937137,,4317436,206818793,41117931,,645647,40315391,7819202,PDP
MP108,,2012,1962,,5067589,244205900,48520595,,4590038,220281153,43785970,,477551,23924747,4734624,PDP
MP108,,2013,1962,,5129369,249092138,49451810,,4783030,231823398,46032745,,346339,17268740,3419069,PDP
MP108,,2014,1962,,5034986,250464020,49601535,,4904127,240915749,47771696,,130859,9548271,1829839,PDP
MP108,,2015,1962,,5180742,257460381,50992195,,4992465,247295898,48995294,,188277,10164483,1996903,PDP
MP108,,2016,1962,,5213343,259911199,51460886,,5110681,254592406,50411820,,102662,5318793,1049067,PDP
MP108,,2017,1962,,6002326,269819192,54012858,,5228219,261391787,51739211,,774107,8427405,2273646,PDP
MP108,,2017,1962,,6002326,269819192,54012858,,5228219,261391787,51739211,,774107,8427405,2273646,PDP
MP111,,1988,1966,,1798,17974040,3200026,,0,13880408,2469823,,1798,4093632,730203,PDN
MP111,,1989,1966,,1798,17974040,3200026,,0,15081903,2683613,,1798,2892137,516413,PDN
MP111,,1990,1966,,1798,17974040,3200026,,0,15800780,2811527,,1798,2173260,388499,PDN
MP111,,1991,1966,,1798,17974040,3200026,,0,16079820,2861178,,1798,1894220,338848,PDN
MP111,,1992,1966,,1798,17974040,3200026,,0,16181079,2879196,,1798,1792961,320830,PDN
MP111,,1993,1966,,0,16181079,2879196,,0,16181079,2879196,,0,0,0,PDN
MP111,,1994,1966,,81,16991923,3023555,,0,16407742,2919527,,81,584181,104028,PDN
MP111,,1995,1966,,307,19253580,3426211,,0,18545684,3299944,,307,707896,126267,PDN
MP111,,1996,1966,,1462,30801039,5482074,,33,21029329,3741906,,1429,9771710,1740168,PDN
MP111,,1997,1966,,1462,30801039,5482074,,33,23591513,4197811,,1429,7209526,1284263,PDN
MP111,,1998,1966,,33,25204158,4484759,,33,25204158,4484759,,0,0,0,PDN
MP111,,1999,1966,,33,27890885,4962824,,33,26788958,4766752,,0,1101927,196072,PDN
MP111,,2000,1966,,543,31852977,5668333,,33,27731916,4934538,,510,4121061,733795,PDN
MP111,,2001,1966,,543,31852977,5668333,,33,28398146,5053084,,510,3454831,615249,PDN
MP111,,2002,1966,,543,31852977,5668333,,33,28973870,5155526,,510,2879107,512807,PDN
MP111,,2003,1966,,33,29296545,5212941,,33,29296545,5212941,,0,0,0,PDN
MP111,,2004,1966,,111,30073745,5351311,,33,29886311,5317882,,78,187434,33429,PDN
MP111,,2005,1966,,33,31932607,5681992,,33,30331158,5397036,,0,1601449,284956,PDN
MP111,,2006,1966,,233,31932607,5682192,,33,31192082,5550226,,200,740525,131966,PDN
MP111,,2007,1966,,233,31932607,5682192,,33,31863464,5669689,,200,69143,12503,PDN
MP111,,2008,1966,,233,31932607,5682192,,198,31881807,5673117,,35,50800,9075,PDN
MP111,,2009,1966,,233,32427501,5770251,,198,32381973,5762115,,35,45528,8136,PDN
MP111,,2010,1966,,198,32381973,5762115,,198,32381973,5762115,,0,0,0,PDN
MP111,,2011,1966,,198,32381973,5762115,,198,32381973,5762115,,0,0,0,PDN
MP111,,2012,1966,,198,32381973,5762115,,198,32381973,5762115,,0,0,0,PDN
MP111,,2013,1966,,198,32381973,5762115,,198,32381973,5762115,,0,0,0,PDN
MP111,,2014,1966,,198,32381973,5762115,,198,32381973,5762115,,0,0,0,PDN
MP111,,2015,1966,,198,32381973,5762115,,198,32381973,5762115,,0,0,0,PDN
MP111,,2016,1966,,198,32381973,5762115,,198,32381973,5762115,,0,0,0,PDN
MP111,,2017,1966,,198,32381973,5762115,,198,32381973,5762115,,0,0,0,PDN
MP111,,2017,1966,,198,32381973,5762115,,198,32381973,5762115,,0,0,0,PDN
MP112,,1988,1962,,407,9376914,1668897,,407,9376914,1668897,,0,0,0,PDN
MP112,,1989,1962,,27043,15030018,2701423,,7464,10130895,1810114,,19579,4899123,891309,PDN
MP112,,1990,1962,,50094,23897615,4302339,,16358,11191489,2007726,,33736,12706126,2294613,PDN
MP112,,1991,1962,,45869,23980035,4312779,,20373,12836261,2304405,,25496,11143774,2008374,PDN
MP112,,1992,1962,,45974,25032306,4500121,,24039,14831892,2663166,,21935,10200414,1836955,PDN
MP112,,1993,1962,,28993,19989572,3585856,,26568,16413718,2947158,,2425,3575854,638698,PDN
MP112,,1994,1962,,29114,21203436,3801967,,27962,17572288,3154704,,1152,3631148,647263,PDN
MP112,,1995,1962,,29163,19653469,3526222,,28441,18357183,3294844,,722,1296286,231378,PDN
MP112,,1996,1962,,29766,20292644,3640557,,28447,18848621,3382294,,1319,1444023,258263,PDN
MP112,,1997,1962,,29766,20292644,3640557,,28447,19290628,3460943,,1319,1002016,179614,PDN
MP112,,1998,1962,,28687,20634088,3700233,,28447,19533745,3504202,,240,1100343,196031,PDN
MP112,,1999,1962,,29064,24331935,4358590,,28447,20013703,3589604,,617,4318232,768986,PDN
MP112,,2000,1962,,29244,25063415,4488926,,28447,20592427,3692580,,797,4470988,796346,PDN
MP112,,2001,1962,,29244,25063415,4488926,,28447,21012623,3767348,,797,4050792,721578,PDN
MP112,,2002,1962,,29600,26510705,4746807,,28447,21285886,3815971,,1153,5224819,930836,PDN
MP112,,2003,1962,,29153,22884395,4101109,,28447,21488322,3851992,,706,1396073,249117,PDN
MP112,,2004,1962,,58329,26768095,4821335,,30980,21876848,3923658,,27349,4891247,897677,PDN
MP112,,2005,1962,,51648,25053143,4509503,,49405,24364597,4384743,,2243,688546,124760,PDN
MP112,,2006,1962,,111648,25101143,4578044,,55327,24994909,4502820,,56321,106234,75224,PDN
MP112,,2007,1962,,111648,25101143,4578044,,100408,25032752,4554634,,11240,68391,23410,PDN
MP112,,2008,1962,,189407,25397165,4708476,,121799,25051307,4579327,,67608,345858,129149,PDN
MP112,,2009,1962,,185211,25725230,4762651,,161703,25678914,4730902,,23508,46316,31749,PDN
MP112,,2010,1962,,312103,25791330,4901305,,175744,25693314,4747506,,136359,98016,153800,PDN
MP112,,2011,1962,,312103,25800922,4903012,,182035,25696392,4754345,,130068,104530,148668,PDN
MP112,,2012,1962,,312103,25813914,4905324,,207563,25713136,4782852,,104540,100778,122472,PDN
MP112,,2013,1962,,727312,25990204,5351901,,339719,25776914,4926357,,387593,213290,425545,PDN
MP112,,2014,1962,,727278,25974729,5349114,,463182,25845223,5061974,,264096,129506,287140,PDN
MP112,,2015,1962,,727278,26011586,5355672,,529312,25891702,5136374,,197966,119884,219297,PDN
MP112,,2016,1962,,547789,25917023,5159357,,543926,25915148,5155161,,3863,1875,4197,PDN
MP112,,2017,1962,,543976,25915148,5155211,,543976,25915148,5155211,,0,0,0,PDN
MP112,,2017,1962,,543976,25915148,5155211,,543976,25915148,5155211,,0,0,0,PDN
MP114,,1988,2007,,12902,13255203,2371479,,8221,8775700,1569733,,4681,4479503,801746,PDN
MP114,,1989,2007,,12902,13255203,2371479,,9325,9624972,1721953,,3577,3630231,649526,PDN
MP114,,1990,2007,,9325,9676967,1731205,,9325,9676967,1731205,,0,0,0,PDN
MP114,,1991,2007,,9325,9676967,1731205,,9325,9676967,1731205,,0,0,0,PDN
MP114,,1992,2007,,9325,9676967,1731205,,9325,9676967,1731205,,0,0,0,PDN
MP114,,1993,2007,,9325,9676967,1731205,,9325,9676967,1731205,,0,0,0,PDN
MP114,,1994,2007,,9325,9676967,1731205,,9325,9676967,1731205,,0,0,0,PDN
MP114,,1995,2007,,9325,9676967,1731205,,9325,9676967,1731205,,0,0,0,PDN
MP114,,1996,2007,,9325,9676967,1731205,,9325,9676967,1731205,,0,0,0,PDN
MP114,,1997,2007,,9325,9676967,1731205,,9325,9676967,1731205,,0,0,0,PDN
MP114,,1998,2007,,9325,9676967,1731205,,9325,9676967,1731205,,0,0,0,PDN
MP114,,1999,2007,,9325,9676967,1731205,,9325,9676967,1731205,,0,0,0,PDN
MP114,,2000,2007,,9325,9676967,1731205,,9325,9676967,1731205,,0,0,0,PDN
MP114,,2001,2007,,9325,9676967,1731205,,9325,9676967,1731205,,0,0,0,PDN
MP114,,2002,2007,,9325,9676967,1731205,,9325,9676967,1731205,,0,0,0,PDN
MP114,,2003,2007,,9325,9676967,1731205,,9325,9676967,1731205,,0,0,0,PDN
MP114,,2004,2007,,9325,9676967,1731205,,9325,9676967,1731205,,0,0,0,PDN
MP114,,2005,2007,,9325,9676967,1731205,,9325,9676967,1731205,,0,0,0,PDN
MP114,,2006,2007,,10376,17403879,3107152,,9325,9676967,1731205,,1051,7726912,1375947,PDN
MP114,,2007,2007,,10376,17403879,3107152,,9400,9914115,1773477,,976,7489764,1333675,PDN
MP114,,2008,2007,,10376,17403879,3107152,,9941,11586060,2071518,,435,5817819,1035634,PDN
MP114,,2009,2007,,10576,19178913,3423194,,10142,13500008,2412279,,434,5678905,1010915,PDN
MP114,,2010,2007,,11695,19178913,3424313,,10142,15257173,2724941,,1553,3921740,699371,PDN
MP114,,2011,2007,,11695,19178913,3424313,,10142,17061337,3045967,,1553,2117576,378346,PDN
MP114,,2012,2007,,11556,18622248,3325123,,11423,17839792,3185763,,133,782456,139360,PDN
MP114,,2013,2007,,11556,18622248,3325123,,11447,18067174,3226247,,109,555074,98876,PDN
MP114,,2014,2007,,11447,18167505,3244099,,11447,18167505,3244099,,0,0,0,PDN
MP114,,2015,2007,,11447,18167505,3244099,,11447,18167505,3244099,,0,0,0,PDN
MP114,,2016,2007,,11447,18167505,3244099,,11447,18167505,3244099,,0,0,0,PDN
MP114,,2017,2007,,11447,18167505,3244099,,11447,18167505,3244099,,0,0,0,PDN
MP114,,2017,2007,,11447,18167505,3244099,,11447,18167505,3244099,,0,0,0,PDN
MP115,,1978,1976,,28925,28925400,5175793,,0,0,0,,28925,28925400,5175793,PDN
MP115,,1979,1976,,28925,28925400,5175793,,0,0,0,,28925,28925400,5175793,PDN
MP115,,1980,1976,,28925,28925400,5175793,,0,0,0,,28925,28925400,5175793,PDN
MP115,,1981,1976,,35925,35925400,6428345,,1206,1813793,323945,,34719,34111607,6104400,PDN
MP115,,1982,1976,,35925,35925400,6428345,,2153,2991738,534491,,33772,32933662,5893854,PDN
MP115,,1983,1976,,35925,35925400,6428345,,4214,5212293,931668,,31711,30713107,5496677,PDN
MP115,,1984,1976,,36006,37275399,6668639,,5066,6398027,1143505,,30940,30877372,5525134,PDN
MP115,,1985,1976,,36006,37275399,6668639,,5339,7190774,1284836,,30667,30084625,5383803,PDN
MP115,,1986,1976,,38646,39811051,7122463,,7465,8673940,1550871,,31181,31137111,5571592,PDN
MP115,,1987,1976,,41786,41425400,7412854,,9235,9740151,1742358,,32551,31685249,5670496,PDN
MP115,,1988,1976,,28925,28925400,5175793,,941,990949,177266,,27984,27934451,4998527,PDN
MP115,,1989,1976,,28925,28925400,5175793,,941,990949,177266,,27984,27934451,4998527,PDN
MP115,,1990,1976,,941,990949,177266,,941,990949,177266,,0,0,0,PDN
MP115,,1991,1976,,941,990949,177266,,941,990949,177266,,0,0,0,PDN
MP115,,1992,1976,,941,990949,177266,,941,990949,177266,,0,0,0,PDN
MP115,,1993,1976,,941,990949,177266,,941,990949,177266,,0,0,0,PDN
MP115,,1994,1976,,941,990949,177266,,941,990949,177266,,0,0,0,PDN
MP115,,1995,1976,,941,990949,177266,,941,990949,177266,,0,0,0,PDN
MP115,,1996,1976,,941,990949,177266,,941,990949,177266,,0,0,0,PDN
MP115,,1997,1976,,941,990949,177266,,941,990949,177266,,0,0,0,PDN
MP115,,1998,1976,,941,990949,177266,,941,990949,177266,,0,0,0,PDN
MP115,,1999,1976,,941,990949,177266,,941,990949,177266,,0,0,0,PDN
MP115,,2000,1976,,941,990949,177266,,941,990949,177266,,0,0,0,PDN
MP115,,2001,1976,,941,990949,177266,,941,990949,177266,,0,0,0,PDN
MP115,,2002,1976,,941,990949,177266,,941,990949,177266,,0,0,0,PDN
MP115,,2003,1976,,941,990949,177266,,941,990949,177266,,0,0,0,PDN
MP115,,2004,1976,,941,990949,177266,,941,990949,177266,,0,0,0,PDN
MP115,,2005,1976,,941,990949,177266,,941,990949,177266,,0,0,0,PDN
MP115,,2006,1976,,941,990949,177266,,941,990949,177266,,0,0,0,PDN
MP115,,2007,1976,,941,990949,177266,,941,990949,177266,,0,0,0,PDN
MP115,,2008,1976,,941,990949,177266,,941,990949,177266,,0,0,0,PDN
MP115,,2009,1976,,941,1010795,180798,,941,1010795,180798,,0,0,0,PDN
MP115,,2010,1976,,941,1010795,180798,,941,1010795,180798,,0,0,0,PDN
MP115,,2011,1976,,941,1010795,180798,,941,1010795,180798,,0,0,0,PDN
MP115,,2012,1976,,941,1010795,180798,,941,1010795,180798,,0,0,0,PDN
MP115,,2013,1976,,941,1010795,180798,,941,1010795,180798,,0,0,0,PDN
MP115,,2014,1976,,941,1010795,180798,,941,1010795,180798,,0,0,0,PDN
MP115,,2015,1976,,941,1010795,180798,,941,1010795,180798,,0,0,0,PDN
MP115,,2016,1976,,941,1010795,180798,,941,1010795,180798,,0,0,0,PDN
MP115,,2017,1976,,941,1010795,180798,,941,1010795,180798,,0,0,0,PDN
MP115,,2017,1976,,941,1010795,180798,,941,1010795,180798,,0,0,0,PDN
MP118,,2005,2005,,292029,7300722,1591090,,160,4034,878,,291869,7296688,1590212,PDN
MP118,,2006,2005,,292029,7300722,1591090,,160,4034,878,,291869,7296688,1590212,PDN
MP118,,2007,2005,,292029,7300722,1591090,,101592,3419180,709987,,190437,3881542,881103,PDN
MP118,,2008,2005,,336520,12386800,2540577,,228839,7930553,1639969,,107681,4456247,900608,PDN
MP118,,2009,2005,,380523,13793972,2834966,,323465,11577444,2383508,,57058,2216528,451458,PDN
MP118,,2010,2005,,375392,14049416,2875288,,333185,12012806,2470695,,42207,2036610,404593,PDN
MP118,,2011,2005,,375392,14049416,2875288,,347647,12596608,2589036,,27745,1452808,286252,PDN
MP118,,2012,2005,,373695,14279264,2914489,,366887,13499571,2768946,,6808,779693,145543,PDN
MP118,,2013,2005,,373695,14279264,2914489,,373376,14211216,2902062,,319,68048,12427,PDN
MP118,,2014,2005,,373380,14211216,2902066,,373380,14211216,2902066,,0,0,0,PDN
MP118,,2015,2005,,373380,14211216,2902066,,373380,14211216,2902066,,0,0,0,PDN
MP118,,2016,2005,,373380,14211216,2902066,,373380,14211216,2902066,,0,0,0,PDN
MP118,,2017,2005,,373380,14211216,2902066,,373380,14211216,2902066,,0,0,0,PDN
MP118,,2017,2005,,373380,14211216,2902066,,373380,14211216,2902066,,0,0,0,PDN
MP120,,1978,1977,,24372,24372450,4361107,,0,0,0,,24372,24372450,4361107,PDP
MP120,,1979,1977,,28032,28032050,5015941,,0,1177345,209492,,28032,26854705,4806449,PDP
MP120,,1980,1977,,38072,38081050,6814060,,0,5480109,975108,,38072,32600941,5838952,PDP
MP120,,1981,1977,,38072,38081050,6814060,,0,8978129,1597532,,38072,29102921,5216528,PDP
MP120,,1982,1977,,38072,38081050,6814060,,0,10976351,1953087,,38072,27104699,4860973,PDP
MP120,,1983,1977,,38072,38081050,6814060,,0,13556927,2412265,,38072,24524123,4401795,PDP
MP120,,1984,1977,,38072,38081050,6814060,,0,14711752,2617749,,38072,23369298,4196311,PDP
MP120,,1985,1977,,0,27795855,4945882,,0,15426370,2744906,,0,12369485,2200976,PDP
MP120,,1986,1977,,0,27795855,4945882,,0,16240234,2889721,,0,11555621,2056161,PDP
MP120,,1987,1977,,0,27795855,4945882,,0,16799123,2989168,,0,10996732,1956714,PDP
MP120,,1988,1977,,0,27795855,4945882,,0,16858083,2999659,,0,10937772,1946223,PDP
MP120,,1989,1977,,503,27115473,4825320,,0,17544669,3121827,,503,9570804,1703493,PDP
MP120,,1990,1977,,503,27115473,4825320,,0,20164790,3588041,,503,6950683,1237279,PDP
MP120,,1991,1977,,5578,27833621,4958180,,4545,21540234,3837327,,1033,6293387,1120853,PDP
MP120,,1992,1977,,89844,27904360,5055033,,60018,24807017,4474078,,29826,3097343,580955,PDP
MP120,,1993,1977,,103119,35213204,6368814,,79406,28275746,5110678,,23713,6937458,1258136,PDP
MP120,,1994,1977,,103119,35213204,6368814,,87850,31000523,5603957,,15269,4212681,764857,PDP
MP120,,1995,1977,,103119,35213204,6368814,,91253,32913118,5947680,,11866,2300086,421134,PDP
MP120,,1996,1977,,103119,35609076,6439254,,93638,34209273,6180697,,9481,1399803,258557,PDP
MP120,,1997,1977,,103839,36306797,6564123,,93882,34977357,6317611,,9957,1329440,246512,PDP
MP120,,1998,1977,,103839,36306797,6564123,,93882,35000477,6321725,,9957,1306320,242398,PDP
MP120,,1999,1977,,94636,35829476,6469988,,93882,35059012,6332140,,754,770464,137848,PDP
MP120,,2000,1977,,94636,35829476,6469988,,93882,35194225,6356200,,754,635251,113788,PDP
MP120,,2001,1977,,94636,35829476,6469988,,93882,35245492,6365322,,754,583984,104666,PDP
MP120,,2002,1977,,94836,35867552,6476963,,93882,35323224,6379153,,954,544328,97810,PDP
MP120,,2003,1977,,94126,35601122,6428845,,93882,35453158,6402273,,244,147964,26572,PDP
MP120,,2004,1977,,94126,35601122,6428845,,93882,35545898,6418775,,244,55224,10070,PDP
MP120,,2005,1977,,94126,35660993,6439498,,93882,35579960,6424836,,244,81033,14662,PDP
MP120,,2006,1977,,94126,36183131,6532406,,93882,35705660,6447202,,244,477471,85204,PDP
MP120,,2007,1977,,94947,37876407,6834521,,93885,35946603,6490078,,1062,1929804,344443,PDP
MP120,,2008,1977,,94947,37876407,6834521,,94693,37368458,6743885,,254,507949,90636,PDP
MP120,,2009,1977,,94836,39518303,7126563,,94698,38664336,6974473,,138,853967,152089,PDP
MP120,,2010,1977,,94698,39573502,7136247,,94698,39252369,7079106,,0,321133,57140,PDP
MP120,,2011,1977,,1133376,45386752,9209311,,195433,40675334,7433036,,937943,4711418,1776274,PDP
MP120,,2012,1977,,1133376,45629613,9252524,,311202,41899830,7766688,,822174,3729783,1485836,PDP
MP120,,2013,1977,,1133376,45629613,9252524,,394285,42794963,8009048,,739091,2834650,1243477,PDP
MP120,,2014,1977,,568645,44065781,8409531,,446353,43423767,8173003,,122292,642014,236529,PDP
MP120,,2015,1977,,568645,44037956,8404580,,448009,43497399,8187761,,120636,540557,216820,PDP
MP120,,2016,1977,,448009,43497399,8187761,,448009,43497399,8187761,,0,0,0,PDP
MP120,,2017,1977,,449605,44288203,8330069,,448994,43641066,8214309,,611,647137,115759,PDP
MP120,,2017,1977,,449605,44288203,8330069,,448994,43641066,8214309,,611,647137,115759,PDP
MP125,,1988,1984,,98096,22562067,4112699,,228,422279,75367,,97868,22139788,4037332,PDN
MP125,,1989,1984,,98096,22562067,4112699,,2280,2689938,480917,,95816,19872129,3631782,PDN
MP125,,1990,1984,,98096,22562067,4112699,,3962,4692652,838953,,94134,17869415,3273746,PDN
MP125,,1991,1984,,91953,21901049,3988937,,4090,5943055,1061573,,87863,15957994,2927364,PDN
MP125,,1992,1984,,91953,21901049,3988937,,4844,7199862,1285958,,87109,14701187,2702979,PDN
MP125,,1993,1984,,13828,22013490,3930819,,4844,8016938,1431345,,8984,13996552,2499474,PDN
MP125,,1994,1984,,13828,22013490,3930819,,4845,8623314,1539243,,8983,13390176,2391576,PDN
MP125,,1995,1984,,13470,21292837,3802231,,4845,9907938,1767823,,8625,11384899,2034408,PDN
MP125,,1996,1984,,13509,24977390,4457884,,4845,10156802,1812105,,8664,14820588,2645779,PDN
MP125,,1997,1984,,10842,22298447,3978537,,4845,10156855,1812115,,5997,12141592,2166422,PDN
MP125,,1998,1984,,10926,23133908,4127280,,4845,10345037,1845599,,6081,12788871,2281681,PDN
MP125,,1999,1984,,10926,23133908,4127280,,4845,10424685,1859771,,6081,12709223,2267509,PDN
MP125,,2000,1984,,9686,17863983,3188331,,4845,10442056,1862862,,4841,7421927,1325469,PDN
MP125,,2001,1984,,4876,10469439,1867766,,4845,10466053,1867132,,31,3386,634,PDN
MP125,,2002,1984,,4876,10469439,1867766,,4845,10467278,1867350,,31,2161,416,PDN
MP125,,2003,1984,,4845,10467278,1867350,,4845,10467278,1867350,,0,0,0,PDN
MP125,,2004,1984,,4845,10467278,1867350,,4845,10467278,1867350,,0,0,0,PDN
MP125,,2005,1984,,4845,10467278,1867350,,4845,10467278,1867350,,0,0,0,PDN
MP125,,2006,1984,,4845,10467278,1867350,,4845,10467278,1867350,,0,0,0,PDN
MP125,,2007,1984,,4845,10467278,1867350,,4845,10467278,1867350,,0,0,0,PDN
MP125,,2008,1984,,137633,18169283,3370602,,10381,10710420,1916150,,127252,7458863,1454452,PDN
MP125,,2009,1984,,175993,20751271,3868390,,104788,14996459,2773197,,71205,5754812,1095193,PDN
MP125,,2010,1984,,185146,21094387,3938596,,141116,16564429,3088524,,44030,4529958,850072,PDN
MP125,,2011,1984,,203832,21987819,4116256,,178212,18170229,3411349,,25620,3817590,704907,PDN
MP125,,2012,1984,,203832,21987819,4116256,,188564,18645042,3506187,,15268,3342777,610068,PDN
MP125,,2013,1984,,254477,23953585,4516681,,199309,19127066,3602702,,55168,4826519,913979,PDN
MP125,,2014,1984,,253031,23449167,4425481,,212802,19477354,3678524,,40229,3971813,746957,PDN
MP125,,2015,1984,,214125,19573925,3697030,,214125,19573925,3697030,,0,0,0,PDN
MP125,,2016,1984,,214125,19573925,3697030,,214125,19573925,3697030,,0,0,0,PDN
MP125,,2017,1984,,214125,19573925,3697030,,214125,19573925,3697030,,0,0,0,PDN
MP125,,2017,1984,,214125,19573925,3697030,,214125,19573925,3697030,,0,0,0,PDN
MP126,,1985,1984,,7662,1915523,348502,,0,494743,88033,,7662,1420780,260469,PDN
MP126,,1986,1984,,431,4311471,767597,,39,1998727,355684,,392,2312744,411913,PDN
MP126,,1987,1984,,431,4311471,767597,,39,3825425,680720,,392,486046,86877,PDN
MP126,,1988,1984,,700,6997303,1245772,,98,5540157,985891,,602,1457146,259881,PDN
MP126,,1989,1984,,1150,11500000,2047413,,276,7585109,1349940,,874,3914891,697473,PDN
MP126,,1990,1984,,1150,11500000,2047413,,380,9602510,1709012,,770,1897490,338401,PDN
MP126,,1991,1984,,968,23450000,4173566,,470,11391436,2027416,,498,12058564,2146150,PDN
MP126,,1992,1984,,968,23450000,4173566,,588,12958301,2306336,,380,10491699,1867230,PDN
MP126,,1993,1984,,968,23450000,4173566,,588,14167569,2521508,,380,9282431,1652058,PDN
MP126,,1994,1984,,968,23450000,4173566,,588,14415651,2565650,,380,9034349,1607916,PDN
MP126,,1995,1984,,588,14415758,2565669,,588,14415758,2565669,,0,0,0,PDN
MP126,,1996,1984,,588,14415758,2565669,,588,14415758,2565669,,0,0,0,PDN
MP126,,1997,1984,,588,14415758,2565669,,588,14415758,2565669,,0,0,0,PDN
MP126,,1998,1984,,588,14415758,2565669,,588,14415758,2565669,,0,0,0,PDN
MP126,,1999,1984,,588,14415758,2565669,,588,14415758,2565669,,0,0,0,PDN
MP126,,2000,1984,,588,14415758,2565669,,588,14415758,2565669,,0,0,0,PDN
MP126,,2001,1984,,588,14415758,2565669,,588,14415758,2565669,,0,0,0,PDN
MP126,,2002,1984,,588,14415758,2565669,,588,14415758,2565669,,0,0,0,PDN
MP126,,2003,1984,,588,14415758,2565669,,588,14415758,2565669,,0,0,0,PDN
MP126,,2004,1984,,588,14415758,2565669,,588,14415758,2565669,,0,0,0,PDN
MP126,,2005,1984,,588,14415758,2565669,,588,14415758,2565669,,0,0,0,PDN
MP126,,2006,1984,,588,14415758,2565669,,588,14415758,2565669,,0,0,0,PDN
MP126,,2007,1984,,588,14415758,2565669,,588,14415758,2565669,,0,0,0,PDN
MP126,,2008,1984,,588,14415758,2565669,,588,14415758,2565669,,0,0,0,PDN
MP126,,2009,1984,,588,14704461,2617040,,588,14704461,2617040,,0,0,0,PDN
MP126,,2010,1984,,588,14704461,2617040,,588,14704461,2617040,,0,0,0,PDN
MP126,,2011,1984,,588,14704461,2617040,,588,14704461,2617040,,0,0,0,PDN
MP126,,2012,1984,,588,14704461,2617040,,588,14704461,2617040,,0,0,0,PDN
MP126,,2013,1984,,588,14704461,2617040,,588,14704461,2617040,,0,0,0,PDN
MP126,,2014,1984,,588,14704461,2617040,,588,14704461,2617040,,0,0,0,PDN
MP126,,2015,1984,,588,14704461,2617040,,588,14704461,2617040,,0,0,0,PDN
MP126,,2016,1984,,588,14704461,2617040,,588,14704461,2617040,,0,0,0,PDN
MP126,,2017,1984,,588,14704461,2617040,,588,14704461,2617040,,0,0,0,PDN
MP126,,2017,1984,,588,14704461,2617040,,588,14704461,2617040,,0,0,0,PDN
MP127,,1975,1965,,3500000,35000000,9727758,,473420,3004931,1008105,,3026580,31995069,8719653,PDN
MP127,,1976,1965,,2200000,14999600,4868968,,494108,3123457,1049883,,1705892,11876143,3819085,PDN
MP127,,1977,1965,,2098991,16751541,5079692,,541965,3867053,1230053,,1557026,12884488,3849639,PDN
MP127,,1978,1965,,2098991,16751541,5079692,,546867,4250929,1303260,,1552124,12500612,3776432,PDN
MP127,,1979,1965,,2091491,16751541,5072192,,550452,4577429,1364941,,1541039,12174112,3707251,PDN
MP127,,1980,1965,,2091491,16751541,5072192,,551198,4648456,1378325,,1540293,12103085,3693867,PDN
MP127,,1981,1965,,2100723,25983143,6724058,,570702,8649832,2109818,,1530021,17333311,4614240,PDN
MP127,,1982,1965,,2103010,24285860,6424337,,571926,9133709,2197141,,1531084,15152151,4227196,PDN
MP127,,1983,1965,,2313815,47053908,10686396,,574262,11769930,2668556,,1739553,35283978,8017840,PDN
MP127,,1984,1965,,2315421,49287568,11085451,,576670,16040651,3430878,,1738751,33246917,7654573,PDN
MP127,,1985,1965,,2318122,53610566,11857369,,578435,19270219,4007300,,1739687,34340347,7850069,PDN
MP127,,1986,1965,,2318758,56974567,12456581,,580325,24553359,4949250,,1738433,32421208,7507331,PDN
MP127,,1987,1965,,2339288,69788762,14757217,,581635,33812525,6598099,,1757653,35976237,8159118,PDN
MP127,,1988,1965,,2420653,85938447,17712192,,587888,46716113,8900364,,1832765,39222334,8811828,PDN
MP127,,1989,1965,,2409565,97331737,19728379,,597378,68949624,12865994,,1812187,28382113,6862385,PDN
MP127,,1990,1965,,2463890,150961372,29325344,,603648,93784846,17291343,,1860242,57176526,12034001,PDN
MP127,,1991,1965,,633188,200703583,36345569,,607201,113569871,20815363,,25987,87133712,15530206,PDN
MP127,,1992,1965,,740732,200764209,36463901,,610337,129729709,23693915,,130395,71034500,12769986,PDN
MP127,,1993,1965,,740732,200764209,36463901,,612934,139044098,25353877,,127798,61720111,11110024,PDN
MP127,,1994,1965,,740789,200764241,36463964,,613180,143499286,26146861,,127609,57264955,10317103,PDN
MP127,,1995,1965,,616836,156202082,28410801,,613269,144380832,26303809,,3567,11821250,2106992,PDN
MP127,,1996,1965,,618031,162098993,29461268,,613269,144871159,26391055,,4762,17227834,3070213,PDN
MP127,,1997,1965,,618031,162098993,29461268,,613269,145065258,26425592,,4762,17033735,3035676,PDN
MP127,,1998,1965,,618031,162098993,29461268,,613269,145117400,26434870,,4762,16981593,3026398,PDN
MP127,,1999,1965,,800975,150167875,27521237,,619622,145416380,26494423,,181353,4751495,1026814,PDN
MP127,,2000,1965,,622251,148748173,27089897,,620121,145963467,26592268,,2130,2784706,497629,PDN
MP127,,2001,1965,,622526,148029539,26962302,,620121,146554306,26697400,,2405,1475233,264902,PDN
MP127,,2002,1965,,622944,151038482,27498119,,620121,147451423,26857029,,2823,3587059,641090,PDN
MP127,,2003,1965,,622944,151038482,27498119,,620121,147870117,26931530,,2823,3168365,566589,PDN
MP127,,2004,1965,,623059,153139344,27872053,,620121,148684718,27076477,,2938,4454626,795576,PDN
MP127,,2005,1965,,623059,153139344,27872053,,620121,150115873,27331130,,2938,3023471,540923,PDN
MP127,,2006,1965,,622643,153788890,27987214,,620121,151678241,27609132,,2522,2110649,378082,PDN
MP127,,2007,1965,,623217,154192520,28059608,,620437,152791966,27807620,,2780,1400554,251988,PDN
MP127,,2008,1965,,623217,154192520,28059608,,620552,153394866,27915012,,2665,797654,144596,PDN
MP127,,2009,1965,,621587,157327201,28615748,,620552,156721408,28506923,,1035,605793,108826,PDN
MP127,,2010,1965,,621587,157412074,28630851,,620552,156936288,28545157,,1035,475786,85693,PDN
MP127,,2011,1965,,621587,157412074,28630851,,620552,157046931,28564845,,1035,365143,66006,PDN
MP127,,2012,1965,,621767,157774320,28695487,,620552,157087061,28571985,,1215,687259,123502,PDN
MP127,,2013,1965,,621767,157774320,28695487,,620680,157374893,28623329,,1087,399427,72159,PDN
MP127,,2014,1965,,620717,157505241,28646560,,620680,157411509,28629845,,37,93732,16715,PDN
MP127,,2015,1965,,620680,157411509,28629845,,620680,157411509,28629845,,0,0,0,PDN
MP127,,2016,1965,,620680,157411509,28629845,,620680,157411509,28629845,,0,0,0,PDN
MP127,,2017,1965,,620680,157411509,28629845,,620680,157411509,28629845,,0,0,0,PDN
MP127,,2017,1965,,620680,157411509,28629845,,620680,157411509,28629845,,0,0,0,PDN
MP128,,1983,1981,,1531300,30625900,6980748,,0,0,0,,1531300,30625900,6980748,PDN
MP128,,1984,1981,,1531300,30625900,6980748,,0,0,0,,1531300,30625900,6980748,PDN
MP128,,1985,1981,,58215,10129302,1860582,,0,0,0,,58215,10129302,1860582,PDN
MP128,,1986,1981,,58215,10129302,1860582,,0,0,0,,58215,10129302,1860582,PDN
MP128,,1987,1981,,58215,10129302,1860582,,0,0,0,,58215,10129302,1860582,PDN
MP128,,1988,1981,,53202,12236414,2230500,,505,270032,48553,,52697,11966382,2181947,PDN
MP128,,1989,1981,,53202,12236414,2230500,,929,437730,78817,,52273,11798684,2151683,PDN
MP128,,1990,1981,,61886,12664420,2315342,,15310,2794213,512501,,46576,9870207,1802841,PDN
MP128,,1991,1981,,66980,14120532,2579530,,19766,3865451,707569,,47214,10255081,1871961,PDN
MP128,,1992,1981,,20821,4108104,751800,,20821,4108104,751800,,0,0,0,PDN
MP128,,1993,1981,,21158,4112276,752880,,21158,4112276,752880,,0,0,0,PDN
MP128,,1994,1981,,21158,4112276,752880,,21158,4112276,752880,,0,0,0,PDN
MP128,,1995,1981,,21158,4112276,752880,,21158,4112276,752880,,0,0,0,PDN
MP128,,1996,1981,,21158,4112276,752880,,21158,4112276,752880,,0,0,0,PDN
MP128,,1997,1981,,21158,4112276,752880,,21158,4112276,752880,,0,0,0,PDN
MP128,,1998,1981,,21158,4112276,752880,,21158,4112276,752880,,0,0,0,PDN
MP128,,1999,1981,,21158,4112276,752880,,21158,4112276,752880,,0,0,0,PDN
MP128,,2000,1981,,21158,4112276,752880,,21158,4112276,752880,,0,0,0,PDN
MP128,,2001,1981,,21158,4112276,752880,,21158,4112276,752880,,0,0,0,PDN
MP128,,2002,1981,,21158,4112276,752880,,21158,4112276,752880,,0,0,0,PDN
MP128,,2003,1981,,21158,4112276,752880,,21158,4112276,752880,,0,0,0,PDN
MP128,,2004,1981,,21158,4112276,752880,,21158,4112276,752880,,0,0,0,PDN
MP128,,2005,1981,,21158,4112276,752880,,21158,4112276,752880,,0,0,0,PDN
MP128,,2006,1981,,21158,4112276,752880,,21158,4112276,752880,,0,0,0,PDN
MP128,,2007,1981,,21158,4112276,752880,,21158,4112276,752880,,0,0,0,PDN
MP128,,2008,1981,,21158,4112276,752880,,21158,4112276,752880,,0,0,0,PDN
MP128,,2009,1981,,21158,4194634,767535,,21158,4194634,767535,,0,0,0,PDN
MP128,,2010,1981,,21158,4194634,767535,,21158,4194634,767535,,0,0,0,PDN
MP128,,2011,1981,,21158,4194634,767535,,21158,4194634,767535,,0,0,0,PDN
MP128,,2012,1981,,21158,4194634,767535,,21158,4194634,767535,,0,0,0,PDN
MP128,,2013,1981,,21158,4194634,767535,,21158,4194634,767535,,0,0,0,PDN
MP128,,2014,1981,,21158,4194634,767535,,21158,4194634,767535,,0,0,0,PDN
MP128,,2015,1981,,21158,4194634,767535,,21158,4194634,767535,,0,0,0,PDN
MP128,,2016,1981,,21158,4194634,767535,,21158,4194634,767535,,0,0,0,PDN
MP128,,2017,1981,,21158,4194634,767535,,21158,4194634,767535,,0,0,0,PDN
MP128,,2017,1981,,21158,4194634,767535,,21158,4194634,767535,,0,0,0,PDN
MP129,,1986,1961,,275173,1626951,564666,,0,0,0,,275173,1626951,564666,PDP
MP129,,1987,1961,,275173,1626951,564666,,0,0,0,,275173,1626951,564666,PDP
MP129,,1988,1961,,1963710,18153850,5193932,,59,335022,59671,,1963651,17818828,5134261,PDP
MP129,,1989,1961,,1963710,18153850,5193932,,5763,2567236,462567,,1957947,15586614,4731365,PDP
MP129,,1990,1961,,3479679,22052565,7403623,,11702,5887283,1059261,,3467977,16165282,6344362,PDP
MP129,,1991,1961,,3479679,22052565,7403623,,357122,7766220,1739012,,3122557,14286345,5664611,PDP
MP129,,1992,1961,,1782919,20932348,5507536,,535408,8713176,2085795,,1247511,12219172,3421741,PDP
MP129,,1993,1961,,1782919,20932348,5507536,,656199,11050047,2622400,,1126720,9882301,2885136,PDP
MP129,,1994,1961,,1832669,27176459,6668338,,750884,17084002,3790742,,1081785,10092457,2877596,PDP
MP129,,1995,1961,,756670,33078508,6642526,,753142,22544395,4764600,,3528,10534113,1877926,PDP
MP129,,1996,1961,,827178,31863150,6496778,,753167,23834877,4994248,,74011,8028273,1502530,PDP
MP129,,1997,1961,,1167938,33668143,7158711,,753167,24946421,5192032,,414771,8721722,1966679,PDP
MP129,,1998,1961,,4243681,40206129,11397796,,1105643,26408117,5804596,,3138038,13798012,5593200,PDP
MP129,,1999,1961,,3854070,33612434,9834930,,1577648,27454383,6462770,,2276422,6158051,3372160,PDP
MP129,,2000,1961,,2844490,32799022,8680614,,1922206,28392811,6974308,,922284,4406211,1706306,PDP
MP129,,2001,1961,,3265887,34342957,9376733,,2313301,28937067,7462245,,952586,5405890,1914488,PDP
MP129,,2002,1961,,4226064,35060840,10464647,,2825315,29373562,8051927,,1400749,5687278,2412720,PDP
MP129,,2003,1961,,4125992,33234735,10039646,,3178038,31050995,8703126,,947954,2183740,1336520,PDP
MP129,,2004,1961,,4005927,33067269,9889783,,3353224,31793556,9010440,,652703,1273713,879343,PDP
MP129,,2005,1961,,3978165,33022501,9854055,,3381858,31877143,9053948,,596307,1145358,800107,PDP
MP129,,2006,1961,,3978165,33022501,9854055,,3381854,31877143,9053944,,596311,1145358,800111,PDP
MP129,,2007,1961,,4107165,33396601,10049621,,3503750,32207833,9234681,,603415,1188768,814940,PDP
MP129,,2008,1961,,4107165,32687221,9923396,,3932399,32457700,9707790,,174766,229521,215606,PDP
MP129,,2009,1961,,4436631,33433846,10385714,,4197243,33141550,10094315,,239388,292296,291398,PDP
MP129,,2010,1961,,4693400,34253732,10788370,,4288417,33264620,10207387,,404983,989112,580982,PDP
MP129,,2011,1961,,4693400,34253732,10788370,,4347400,33543446,10315984,,346000,710286,472385,PDP
MP129,,2012,1961,,5045349,34585598,11199369,,4468066,33894705,10499151,,577283,690893,700217,PDP
MP129,,2013,1961,,5045349,34585598,11199369,,4512865,33934934,10551109,,532484,650664,648261,PDP
MP129,,2014,1961,,4985359,34458925,11116839,,4679589,34147456,10755647,,305770,311469,361192,PDP
MP129,,2015,1961,,5032034,34600191,11188650,,4832585,34351571,10944963,,199449,248620,243687,PDP
MP129,,2016,1961,,5106457,34499918,11245231,,4952312,34336412,11061993,,154145,163506,183239,PDP
MP129,,2017,1961,,5400735,34907576,11612047,,5067219,34459952,11198882,,333516,447624,413165,PDP
MP129,,2017,1961,,5400735,34907576,11612047,,5067219,34459952,11198882,,333516,447624,413165,PDP
MP131,,1998,1995,,12568,4687740,846685,,0,6260,1114,,12568,4681480,845571,PDN
MP131,,1999,1995,,6377,2219290,401268,,6377,2219290,401268,,0,0,0,PDN
MP131,,2000,1995,,6728,2315826,418797,,6728,2315826,418797,,0,0,0,PDN
MP131,,2001,1995,,6815,2457143,444029,,6815,2457143,444029,,0,0,0,PDN
MP131,,2002,1995,,6815,2457143,444029,,6815,2457143,444029,,0,0,0,PDN
MP131,,2003,1995,,6815,2457143,444029,,6815,2457143,444029,,0,0,0,PDN
MP131,,2004,1995,,6815,2457143,444029,,6815,2457143,444029,,0,0,0,PDN
MP131,,2005,1995,,6815,2457143,444029,,6815,2457143,444029,,0,0,0,PDN
MP131,,2006,1995,,6815,2457143,444029,,6815,2457143,444029,,0,0,0,PDN
MP131,,2007,1995,,6815,2457143,444029,,6815,2457143,444029,,0,0,0,PDN
MP131,,2008,1995,,6815,2457143,444029,,6815,2457143,444029,,0,0,0,PDN
MP131,,2009,1995,,6815,2457143,444029,,6815,2457143,444029,,0,0,0,PDN
MP131,,2010,1995,,6815,2457143,444029,,6815,2457143,444029,,0,0,0,PDN
MP131,,2011,1995,,6815,2457143,444029,,6815,2457143,444029,,0,0,0,PDN
MP131,,2012,1995,,6815,2457143,444029,,6815,2457143,444029,,0,0,0,PDN
MP131,,2013,1995,,6815,2457143,444029,,6815,2457143,444029,,0,0,0,PDN
MP131,,2014,1995,,6815,2457143,444029,,6815,2457143,444029,,0,0,0,PDN
MP131,,2015,1995,,6815,2457143,444029,,6815,2457143,444029,,0,0,0,PDN
MP131,,2016,1995,,6815,2457143,444029,,6815,2457143,444029,,0,0,0,PDN
MP131,,2017,1995,,6815,2457143,444029,,6815,2457143,444029,,0,0,0,PDN
MP131,,2017,1995,,6815,2457143,444029,,6815,2457143,444029,,0,0,0,PDN
MP133,,1975,1970,,2000000,90000000,18014235,,559169,18237100,3804205,,1440831,71762900,14210030,PDP
MP133,,1976,1970,,2000000,90000000,18014235,,830137,24232147,5141907,,1169863,65767853,12872328,PDP
MP133,,1977,1970,,2000000,90000000,18014235,,989182,28357059,6034922,,1010818,61642941,11979313,PDP
MP133,,1978,1970,,2255663,113614906,22471838,,1589220,36803547,8137894,,666443,76811359,14333944,PDP
MP133,,1979,1970,,2387112,133537455,26148225,,1529183,50369156,10491666,,857929,83168299,15656559,PDP
MP133,,1980,1970,,3779873,164627870,33073088,,2052575,77568520,15854803,,1727298,87059350,17218285,PDP
MP133,,1981,1970,,3863388,196918063,38902189,,2396511,98241774,19877254,,1466877,98676289,19024935,PDP
MP133,,1982,1970,,3863388,196918063,38902189,,2775758,114855093,23212607,,1087630,82062970,15689582,PDP
MP133,,1983,1970,,4401006,211628812,42057378,,3113016,130269748,26292686,,1287990,81359064,15764692,PDP
MP133,,1984,1970,,4413080,211628812,42069452,,3446529,148104542,29799650,,966551,63524270,12269802,PDP
MP133,,1985,1970,,4592796,220245961,43782469,,3681938,158924753,31960364,,910858,61321208,11822105,PDP
MP133,,1986,1970,,4592796,220245961,43782469,,3818990,166894843,33515581,,773806,53351118,10266888,PDP
MP133,,1987,1970,,4787682,208993058,41975059,,3935589,180431883,36040906,,852093,28561175,5934153,PDP
MP133,,1988,1970,,4789301,216007952,43224880,,4007362,192205395,38207610,,781939,23802557,5017270,PDP
MP133,,1989,1970,,4789301,218760284,43714618,,4058650,200909111,39807602,,730651,17851173,3907016,PDP
MP133,,1990,1970,,4946850,235666744,46880434,,4164170,213762042,42200121,,782680,21904702,4680313,PDP
MP133,,1991,1970,,5582676,245886382,49334701,,4249756,223226593,43969790,,1332920,22659789,5364911,PDP
MP133,,1992,1970,,5595548,262138456,52239401,,4358869,236389298,46421022,,1236679,25749158,5818379,PDP
MP133,,1993,1970,,4835709,278283033,54352263,,4536709,249978935,49016947,,299000,28304098,5335316,PDP
MP133,,1994,1970,,4838836,280869182,54815559,,4626676,252737311,49597728,,212160,28131871,5217831,PDP
MP133,,1995,1970,,5536050,283018592,55895230,,5013378,257686102,50864998,,522672,25332490,5030232,PDP
MP133,,1996,1970,,6197653,282638127,56489135,,5343891,261365001,51850119,,853762,21273126,4639016,PDP
MP133,,1997,1970,,6106657,282044273,56292471,,5619635,262857039,52391350,,487022,19187234,3901121,PDP
MP133,,1998,1970,,6761544,289202621,58221085,,5907461,264391739,52952254,,854083,24810882,5268831,PDP
MP133,,1999,1970,,7296233,275206611,56265381,,6296779,265759536,53584953,,999454,9447075,2680428,PDP
MP133,,2000,1970,,8862394,275415183,57868654,,6806455,267744950,54447905,,2055939,7670233,3420749,PDP
MP133,,2001,1970,,8862394,275448597,57874600,,7208600,268484422,54981629,,1653794,6964175,2892971,PDP
MP133,,2002,1970,,9538155,279719402,59310291,,7624697,269316800,55545836,,1913458,10402602,3764455,PDP
MP133,,2003,1970,,9469210,275743717,58533928,,8164325,271232932,56426413,,1304885,4510785,2107515,PDP
MP133,,2004,1970,,9578173,278151531,59071328,,8456695,272382082,56923258,,1121478,5769449,2148070,PDP
MP133,,2005,1970,,9604095,276110147,58734014,,8509124,272977216,57081582,,1094971,3132931,1652432,PDP
MP133,,2006,1970,,9484578,277346693,58834523,,8612883,274161388,57396048,,871695,3185305,1438475,PDP
MP133,,2007,1970,,9485027,277372056,58839485,,8888633,275250629,57865613,,596394,2121427,973872,PDP
MP133,,2008,1970,,9572797,279273092,59265518,,8967923,275722787,58028917,,604874,3550305,1236601,PDP
MP133,,2009,1970,,9685057,283665911,60159417,,9142922,281919036,59306455,,542135,1746875,852967,PDP
MP133,,2010,1970,,10721018,355739495,74019860,,9275847,285125739,60009964,,1445171,70613756,14009896,PDP
MP133,,2011,1970,,10920449,358176816,74652979,,9511379,289003935,60935567,,1409070,69172881,13717412,PDP
MP133,,2012,1970,,10561839,303803048,64619320,,9709122,292102627,61684676,,852717,11700421,2934642,PDP
MP133,,2013,1970,,11174800,304561226,65367189,,9880215,293582080,62119019,,1294585,10979146,3248167,PDP
MP133,,2014,1970,,10199379,302969593,64108559,,9990857,295221521,62521375,,208522,7748072,1587182,PDP
MP133,,2015,1970,,10163338,302887692,64057945,,10006734,295448268,62577601,,156604,7439424,1480344,PDP
MP133,,2016,1970,,10024332,301226143,63623290,,10006315,295448268,62577182,,18017,5777875,1046108,PDP
MP133,,2017,1970,,10096104,296196899,62800179,,10037277,295591548,62633637,,58827,605351,166540,PDP
MP133,,2017,1970,,10096104,296196899,62800179,,10037277,295591548,62633637,,58827,605351,166540,PDP
MP139,,1997,1988,,1938668,10296496,3770785,,30334,99675,48070,,1908334,10196821,3722715,PDN
MP139,,1998,1988,,1938668,10296496,3770785,,50136,181319,82399,,1888532,10115177,3688386,PDN
MP139,,1999,1988,,64752,3095557,615563,,64752,318270,121384,,0,2777287,494179,PDN
MP139,,2000,1988,,1208905,2309570,1619860,,65307,866513,219491,,1143598,1443057,1400369,PDN
MP139,,2001,1988,,1209224,5500488,2187958,,65307,2149492,447779,,1143917,3350996,1740179,PDN
MP139,,2002,1988,,1209224,6796404,2418548,,65307,3334698,658670,,1143917,3461706,1759878,PDN
MP139,,2003,1988,,1209359,8139196,2657614,,65307,4960511,947960,,1144052,3178685,1709654,PDN
MP139,,2004,1988,,1209359,8139196,2657614,,65307,6247598,1176979,,1144052,1891598,1480635,PDN
MP139,,2005,1988,,1209128,13473209,3606496,,65380,7457975,1392422,,1143748,6015234,2214074,PDN
MP139,,2006,1988,,1209379,13473209,3606747,,65631,9051107,1676148,,1143748,4422102,1930599,PDN
MP139,,2007,1988,,1209379,13473209,3606747,,65631,9612769,1776088,,1143748,3860440,1830659,PDN
MP139,,2008,1988,,1209379,13473209,3606747,,65631,9772332,1804480,,1143748,3700877,1802267,PDN
MP139,,2009,1988,,65642,9941784,1834643,,65631,9844651,1817349,,11,97133,17294,PDN
MP139,,2010,1988,,65631,9930111,1832555,,65631,9930111,1832555,,0,0,0,PDN
MP139,,2011,1988,,65631,9930111,1832555,,65631,9930111,1832555,,0,0,0,PDN
MP139,,2012,1988,,65631,9930111,1832555,,65631,9930111,1832555,,0,0,0,PDN
MP139,,2013,1988,,65631,9930111,1832555,,65631,9930111,1832555,,0,0,0,PDN
MP139,,2014,1988,,65631,9930111,1832555,,65631,9930111,1832555,,0,0,0,PDN
MP139,,2015,1988,,65631,9930111,1832555,,65631,9930111,1832555,,0,0,0,PDN
MP139,,2016,1988,,65631,9930111,1832555,,65631,9930111,1832555,,0,0,0,PDN
MP139,,2017,1988,,65631,9930111,1832555,,65631,9930111,1832555,,0,0,0,PDN
MP139,,2017,1988,,65631,9930111,1832555,,65631,9930111,1832555,,0,0,0,PDN
MP140,,1975,1972,,35693707,109104451,55107310,,921005,2273565,1325554,,34772702,106830886,53781756,PDP
MP140,,1976,1972,,35693707,109104451,55107310,,3390686,9676302,5112448,,32303021,99428149,49994862,PDP
MP140,,1977,1972,,30182847,109717455,49705526,,5389346,20414244,9021774,,24793501,89303211,40683752,PDP
MP140,,1978,1972,,28830048,120592946,50287868,,7141563,31418712,12732081,,21688485,89174234,37555787,PDP
MP140,,1979,1972,,28830048,123545704,50813269,,8657574,39947337,15765641,,20172474,83598367,35047628,PDP
MP140,,1980,1972,,24761525,134320519,48661973,,10099911,47812865,18607538,,14661614,86507654,30054435,PDP
MP140,,1981,1972,,19771124,88385238,35498035,,11982610,54360987,21655383,,7788514,34024251,13842652,PDP
MP140,,1982,1972,,19771124,88385238,35498035,,13060730,57293902,23255374,,6710394,31091336,12242661,PDP
MP140,,1983,1972,,19774335,88385238,35501246,,14010405,59567259,24609561,,5763930,28817979,10891685,PDP
MP140,,1984,1972,,20953181,89737440,36920697,,14858007,61857741,25864722,,6095174,27879699,11055975,PDP
MP140,,1985,1972,,21239491,91879258,37588113,,15857453,68822506,28103451,,5382038,23056752,9484662,PDP
MP140,,1986,1972,,20856657,92711354,37353339,,16801696,73998159,29968628,,4054961,18713195,7384711,PDP
MP140,,1987,1972,,23196686,99138309,40836955,,17653738,80707399,32014485,,5542948,18430910,8822470,PDP
MP140,,1988,1972,,23170724,98667017,40727133,,18470732,86679729,33894171,,4699992,11987288,6832962,PDP
MP140,,1989,1972,,24613714,109416119,44082774,,19071573,91366981,35329043,,5542141,18049138,8753731,PDP
MP140,,1990,1972,,24613714,110791363,44327480,,19762826,95309320,36721780,,4850888,15482043,7605700,PDP
MP140,,1991,1972,,24613714,115323334,45133880,,20520108,99906199,38297012,,4093606,15417135,6836868,PDP
MP140,,1992,1972,,26159914,122254918,47913458,,21315854,105348704,40061175,,4844060,16906214,7852283,PDP
MP140,,1993,1972,,29178810,129983655,52307574,,21963450,109416744,41432622,,7215360,20566911,10874952,PDP
MP140,,1994,1972,,29230255,129983813,52359047,,22724641,113556819,42930481,,6505614,16426994,9428566,PDP
MP140,,1995,1972,,28598110,132117963,52106644,,23335046,116976553,44149379,,5263064,15141410,7957265,PDP
MP140,,1996,1972,,29078632,140106083,54008540,,23768451,119462025,45025039,,5310181,20644058,8983501,PDP
MP140,,1997,1972,,38134766,141992841,63400396,,24614409,123743015,46632739,,13520357,18249826,16767657,PDP
MP140,,1998,1972,,38341219,145498873,64230698,,25517882,128551516,48391817,,12823337,16947357,15838881,PDP
MP140,,1999,1972,,30643575,169914821,60877529,,26492667,133892172,50316897,,4150908,36022649,10560632,PDP
MP140,,2000,1972,,30612407,169568041,60784656,,27255290,136644210,51569206,,3357117,32923831,9215450,PDP
MP140,,2001,1972,,30749676,169918529,60984290,,27774471,138257417,52375435,,2975205,31661112,8608855,PDP
MP140,,2002,1972,,30894591,171033294,61327561,,28370768,139715647,53231203,,2523823,31317647,8096358,PDP
MP140,,2003,1972,,30890664,169704865,61087259,,28781434,140378907,53759887,,2109230,29325958,7327372,PDP
MP140,,2004,1972,,34091568,153482249,61401577,,29503525,142541415,54866766,,4588043,10940834,6534811,PDP
MP140,,2005,1972,,34091463,152476226,61222464,,29864167,143495936,55397252,,4227296,8980290,5825212,PDP
MP140,,2006,1972,,34197607,150894132,61047097,,30613656,145267867,56462031,,3583951,5626265,4585066,PDP
MP140,,2007,1972,,34197607,150894132,61047097,,31455126,147025361,57616222,,2742481,3868771,3430875,PDP
MP140,,2008,1972,,34307585,151326079,61233934,,32069992,147579637,58329714,,2237593,3746442,2904220,PDP
MP140,,2009,1972,,34303955,155319803,61940929,,32758430,150705404,59574338,,1545525,4614399,2366593,PDP
MP140,,2010,1972,,37780451,161374770,66494821,,33341348,151048813,60218361,,4439103,10325957,6276463,PDP
MP140,,2011,1972,,37355037,158115765,65489512,,33950668,151637730,60932471,,3404369,6478035,4557045,PDP
MP140,,2012,1972,,37439009,158115765,65573484,,34313246,151970185,61354204,,3125763,6145580,4219282,PDP
MP140,,2013,1972,,37473328,158162345,65616091,,34858564,152126130,61927270,,2614764,6036215,3688824,PDP
MP140,,2014,1972,,37467306,157824786,65550006,,35345764,152351566,62454582,,2121542,5473220,3095425,PDP
MP140,,2015,1972,,37466761,157807514,65546388,,35756051,152604164,62909816,,1710710,5203350,2636573,PDP
MP140,,2016,1972,,37452405,154900499,65014770,,36095886,152852465,63293833,,1356519,2048034,1720938,PDP
MP140,,2017,1972,,37453769,153949515,64846921,,36444479,153129688,63691754,,1009290,819827,1155166,PDP
MP140,,2017,1972,,37453769,153949515,64846921,,36444479,153129688,63691754,,1009290,819827,1155166,PDP
MP141,,1994,1988,,2045875,2621279,2512295,,435776,642641,550125,,1610099,1978638,1962170,PDN
MP141,,1995,1988,,2026174,2002883,2382559,,846311,1146313,1050281,,1179863,856570,1332278,PDN
MP141,,1996,1988,,2242741,2197793,2633807,,1090574,1353795,1331463,,1152167,843998,1302344,PDN
MP141,,1997,1988,,1645977,1818251,1969509,,1266612,1501171,1533724,,379365,317080,435785,PDN
MP141,,1998,1988,,1645977,1818251,1969509,,1296096,1720864,1602300,,349881,97387,367209,PDN
MP141,,1999,1988,,1645977,2169448,2032000,,1416281,1894370,1753358,,229696,275078,278642,PDN
MP141,,2000,1988,,1645977,2169448,2032000,,1447632,2020011,1807065,,198345,149437,224935,PDN
MP141,,2001,1988,,1645977,2169448,2032000,,1461190,2081004,1831475,,184787,88444,200525,PDN
MP141,,2002,1988,,1645977,2169448,2032000,,1464967,2111143,1840615,,181010,58305,191385,PDN
MP141,,2003,1988,,1469874,2186368,1858907,,1466452,2161258,1851017,,3422,25110,7890,PDN
MP141,,2004,1988,,1469874,2186368,1858907,,1466879,2185901,1855829,,2995,467,3078,PDN
MP141,,2005,1988,,1468162,2230616,1865069,,1467392,2203787,1859525,,770,26829,5544,PDN
MP141,,2006,1988,,1467392,2203787,1859525,,1467392,2203787,1859525,,0,0,0,PDN
MP141,,2007,1988,,1467392,2198391,1858565,,1467392,2198391,1858565,,0,0,0,PDN
MP141,,2008,1988,,1467392,2198391,1858565,,1467392,2198391,1858565,,0,0,0,PDN
MP141,,2009,1988,,1467392,2232366,1864610,,1467392,2232366,1864610,,0,0,0,PDN
MP141,,2010,1988,,1467392,2232366,1864610,,1467392,2232366,1864610,,0,0,0,PDN
MP141,,2011,1988,,1467392,2232366,1864610,,1467392,2232366,1864610,,0,0,0,PDN
MP141,,2012,1988,,1467392,2232366,1864610,,1467392,2232366,1864610,,0,0,0,PDN
MP141,,2013,1988,,1467392,2232366,1864610,,1467392,2232366,1864610,,0,0,0,PDN
MP141,,2014,1988,,1467392,2232366,1864610,,1467392,2232366,1864610,,0,0,0,PDN
MP141,,2015,1988,,1467392,2232366,1864610,,1467392,2232366,1864610,,0,0,0,PDN
MP141,,2016,1988,,1467392,2232366,1864610,,1467392,2232366,1864610,,0,0,0,PDN
MP141,,2017,1988,,1467392,2232366,1864610,,1467392,2232366,1864610,,0,0,0,PDN
MP141,,2017,1988,,1467392,2232366,1864610,,1467392,2232366,1864610,,0,0,0,PDN
MP144,,1975,1967,,80000000,40000000,87117438,,24623387,13451561,27016903,,55376613,26548439,60100535,PDP
MP144,,1976,1967,,80000000,40000000,87117438,,29928958,16369866,32841746,,50071042,23630134,54275692,PDP
MP144,,1977,1967,,80000000,40000000,87117438,,34896194,19250536,38321556,,45103806,20749464,48795882,PDP
MP144,,1978,1967,,80000000,40000000,87117438,,38675462,21109168,42431542,,41324538,18890832,44685896,PDP
MP144,,1979,1967,,67064150,39958214,74174152,,47037283,25244559,51529197,,20026867,14713655,22644955,PDP
MP144,,1980,1967,,69026170,40881499,76300458,,51104406,26839931,55880194,,17921764,14041568,20420264,PDP
MP144,,1981,1967,,66136281,43872630,73942799,,55104142,29164867,60293620,,11032139,14707763,13649179,PDP
MP144,,1982,1967,,66132321,37964509,72887572,,58273177,30345284,63672694,,7859144,7619225,9214878,PDP
MP144,,1983,1967,,80801429,50545443,89795280,,63259508,33637491,69244827,,17541921,16907952,20550453,PDP
MP144,,1984,1967,,85057459,53210872,94525586,,69715197,38424355,76552271,,15342262,14786517,17973315,PDP
MP144,,1985,1967,,97416748,64233111,108846127,,75963400,42660528,83554241,,21453348,21572583,25291886,PDP
MP144,,1986,1967,,103747151,67659576,115786221,,81671309,45563534,89778699,,22075842,22096042,26007522,PDP
MP144,,1987,1967,,103941418,68745982,116173799,,86539327,47800385,95044734,,17402091,20945597,21129065,PDP
MP144,,1988,1967,,109453298,69957918,121901326,,90128980,49583202,98951614,,19324318,20374716,22949712,PDP
MP144,,1989,1967,,109488828,70290454,121996026,,93212019,50839265,102258152,,16276809,19451189,19737874,PDP
MP144,,1990,1967,,109987294,70552527,122541124,,96226761,53595574,105763340,,13760533,16956953,16777784,PDP
MP144,,1991,1967,,113648471,77903343,127510276,,98658811,56799915,108765557,,14989660,21103428,18744719,PDP
MP144,,1992,1967,,114065670,73559354,127154523,,101601555,60566646,112378538,,12464115,12992708,14775985,PDP
MP144,,1993,1967,,114204651,78445283,128162886,,104965327,64935942,116519765,,9239324,13509341,11643121,PDP
MP144,,1994,1967,,114641940,81043149,129062429,,107928754,70808811,120528187,,6713186,10234338,8534242,PDP
MP144,,1995,1967,,126321100,110297653,145947017,,110482526,75910242,123989686,,15838574,34387411,21957331,PDP
MP144,,1996,1967,,133337181,115454877,153880753,,112473805,79368727,126596354,,20863376,36086150,27284399,PDP
MP144,,1997,1967,,133432956,115603303,154002939,,114157640,81403474,128642244,,19275316,34199829,25360695,PDP
MP144,,1998,1967,,134139669,118612163,155245036,,115708436,84466090,130737989,,18431233,34146073,24507047,PDP
MP144,,1999,1967,,129795065,115933871,150423868,,116894455,87103703,132393335,,12900610,28830168,18030533,PDP
MP144,,2000,1967,,133290433,112052445,153228591,,118163277,88712357,133948394,,15127156,23340088,19280197,PDP
MP144,,2001,1967,,135017835,113600250,155231403,,119634003,90240816,135691088,,15383832,23359434,19540315,PDP
MP144,,2002,1967,,137951094,115000394,158413798,,121237484,91401506,137501097,,16713610,23598888,20912701,PDP
MP144,,2003,1967,,137991729,114728676,158406084,,122838632,92538884,139304626,,15153097,22189792,19101458,PDP
MP144,,2004,1967,,132938089,103947305,151434051,,123845445,93042390,140401030,,9092644,10904915,11033021,PDP
MP144,,2005,1967,,136321893,104734596,154957942,,124467687,93275644,141064777,,11854206,11458952,13893165,PDP
MP144,,2006,1967,,136414357,104889145,155077906,,125355266,93719852,142031396,,11059091,11169293,13046510,PDP
MP144,,2007,1967,,136396153,105430827,155156087,,126649328,94474719,143459776,,9746825,10956108,11696311,PDP
MP144,,2008,1967,,136705592,105630867,155501120,,127380291,94893980,144265341,,9325301,10736887,11235779,PDP
MP144,,2009,1967,,136761754,106837938,155772064,,128457972,97033109,145723650,,8303782,9804829,10048414,PDP
MP144,,2010,1967,,137495428,108162232,156741377,,129262941,97743718,146655062,,8232487,10418514,10086315,PDP
MP144,,2011,1967,,141581127,109863472,161129789,,130476309,98420649,147988878,,11104818,11442823,13140906,PDP
MP144,,2012,1967,,141659291,109917481,161217563,,131488355,98867172,149080378,,10170936,11050309,12137183,PDP
MP144,,2013,1967,,141659291,109953781,161224021,,132711761,99401951,150398940,,8947530,10551830,10825079,PDP
MP144,,2014,1967,,140750456,106699058,159736054,,133861357,99779862,151615779,,6889099,6919196,8120272,PDP
MP144,,2015,1967,,138284473,102029007,156439101,,134787061,100163586,152609763,,3497412,1865421,3829336,PDP
MP144,,2016,1967,,137530013,101408868,155574295,,135826906,100604236,153728014,,1703107,804632,1846281,PDP
MP144,,2017,1967,,137810417,101648195,155897283,,136482623,100876740,154432220,,1327794,771455,1465063,PDP
MP144,,2017,1967,,137810417,101648195,155897283,,136482623,100876740,154432220,,1327794,771455,1465063,PDP
MP150,,2000,2000,,62947,1724741,369840,,0,0,0,,62947,1724741,369840,PDN
MP150,,2001,2000,,65998,1847937,394812,,63175,1787195,381181,,2823,60742,13631,PDN
MP150,,2002,2000,,235633,8044514,1667041,,128003,3660430,779325,,107630,4384084,887716,PDN
MP150,,2003,2000,,235633,8044514,1667041,,183187,5707677,1198788,,52446,2336837,468253,PDN
MP150,,2004,2000,,235633,8044514,1667041,,200066,6751587,1401416,,35567,1292927,265625,PDN
MP150,,2005,2000,,235633,8044514,1667041,,205432,7012444,1453198,,30201,1032070,213843,PDN
MP150,,2006,2000,,235633,8044514,1667041,,208028,7096533,1470756,,27605,947981,196285,PDN
MP150,,2007,2000,,235633,8044514,1667041,,214537,7337898,1520213,,21096,706616,146828,PDN
MP150,,2008,2000,,235633,8044514,1667041,,218303,7423765,1539258,,17330,620749,127783,PDN
MP150,,2009,2000,,231967,7750245,1611014,,226421,7506422,1562083,,5546,243823,48931,PDN
MP150,,2010,2000,,231738,7750245,1610785,,228594,7589438,1579028,,3144,160807,31757,PDN
MP150,,2011,2000,,231738,7750245,1610785,,228932,7639934,1588351,,2806,110311,22434,PDN
MP150,,2012,2000,,231738,7750245,1610785,,229076,7661203,1592279,,2662,89042,18506,PDN
MP150,,2013,2000,,229076,7661203,1592279,,229076,7661203,1592279,,0,0,0,PDN
MP150,,2014,2000,,229076,7661203,1592279,,229076,7661203,1592279,,0,0,0,PDN
MP150,,2015,2000,,229076,7661203,1592279,,229076,7661203,1592279,,0,0,0,PDN
MP150,,2016,2000,,229076,7661203,1592279,,229076,7661203,1592279,,0,0,0,PDN
MP150,,2017,2000,,229076,7661203,1592279,,229076,7661203,1592279,,0,0,0,PDN
MP150,,2017,2000,,229076,7661203,1592279,,229076,7661203,1592279,,0,0,0,PDN
MP151,,1981,1979,,17999980,47999900,26540887,,0,0,0,,17999980,47999900,26540887,PDP
MP151,,1982,1979,,17999980,47999900,26540887,,0,0,0,,17999980,47999900,26540887,PDP
MP151,,1983,1979,,6423877,37183431,13040146,,350620,742669,482768,,6073257,36440762,12557378,PDP
MP151,,1984,1979,,8404769,67333127,20385752,,1916189,8616908,3449447,,6488580,58716219,16936305,PDP
MP151,,1985,1979,,48048296,220431333,87270953,,4532775,27605317,9444753,,43515521,192826016,77826200,PDP
MP151,,1986,1979,,48046550,222336365,87608181,,7575961,48918855,16280384,,40470589,173417510,71327797,PDP
MP151,,1987,1979,,47848338,253414901,92939957,,10313691,70861369,22922476,,37534647,182553532,70017481,PDP
MP151,,1988,1979,,47793822,259509259,93969847,,12215021,81320644,26684886,,35578801,178188615,67284961,PDP
MP151,,1989,1979,,31905856,197263520,67006126,,13682120,91303119,29928227,,18223736,105960401,37077899,PDP
MP151,,1990,1979,,31918778,199292566,67380089,,14874707,102225385,33064277,,17044071,97067181,34315812,PDP
MP151,,1991,1979,,32280548,201304874,68099921,,15914462,110188744,35521000,,16366086,91116130,32578921,PDP
MP151,,1992,1979,,22713794,155939755,50461081,,16846200,117738040,37796029,,5867594,38201715,12665052,PDP
MP151,,1993,1979,,22658219,154036934,50066926,,17710681,124477870,39859768,,4947538,29559064,10207158,PDP
MP151,,1994,1979,,22670816,156450811,50509039,,18614476,131984674,42099293,,4056340,24466137,8409746,PDP
MP151,,1995,1979,,22790718,183397101,55423654,,19364687,138813234,44064551,,3426031,44583867,11359103,PDP
MP151,,1996,1979,,22871448,194530451,57485407,,19916245,143898409,45520944,,2955203,50632042,11964463,PDP
MP151,,1997,1979,,23206606,193955885,57718329,,20395993,148909608,46892365,,2810613,45046277,10825964,PDP
MP151,,1998,1979,,23471243,195534080,58263784,,20663767,151106628,47551067,,2807476,44427452,10712717,PDP
MP151,,1999,1979,,26507575,226676744,66841515,,21180341,154091413,48598742,,5327234,72585331,18242773,PDP
MP151,,2000,1979,,27674425,233448126,69213237,,22947763,173295175,53783203,,4726662,60152951,15430034,PDP
MP151,,2001,1979,,27395370,225703104,67556065,,23848647,184806588,56732382,,3546723,40896516,10823683,PDP
MP151,,2002,1979,,28199183,224706789,68182597,,24430658,191101948,58434563,,3768525,33604841,9748034,PDP
MP151,,2003,1979,,26656148,221452167,66060448,,24891495,195079625,59603172,,1764653,26372542,6457276,PDP
MP151,,2004,1979,,26342200,209970370,63703476,,25220080,196562564,60195625,,1122120,13407806,3507851,PDP
MP151,,2005,1979,,26342200,209970370,63703476,,25427982,197567865,60582406,,914218,12402505,3121070,PDP
MP151,,2006,1979,,26341946,210808343,63852327,,25630924,199584985,61144267,,711022,11223358,2708060,PDP
MP151,,2007,1979,,26406296,210885964,63930489,,25714642,200238271,61344228,,691654,10647693,2586261,PDP
MP151,,2008,1979,,26549046,210764602,64051644,,25783627,200641726,61485002,,765419,10122876,2566642,PDP
MP151,,2009,1979,,26340150,209128935,63551700,,25892341,204444195,62270308,,447809,4684740,1281392,PDP
MP151,,2010,1979,,26340862,212509972,64154020,,25957295,205936210,62600744,,383567,6573762,1553275,PDP
MP151,,2011,1979,,26340862,212509972,64154020,,26094568,208329467,63163864,,246294,4180505,990156,PDP
MP151,,2012,1979,,27421258,213114853,65342047,,26248184,209142958,63462230,,1173074,3971895,1879816,PDP
MP151,,2013,1979,,27151336,212039389,64880761,,26568352,209327599,63815252,,582984,2711790,1065510,PDP
MP151,,2014,1979,,27387106,210559739,64853249,,27002693,209911695,64353526,,384413,648044,499723,PDP
MP151,,2015,1979,,27766856,212285566,65540085,,27255250,210659072,64739067,,511606,1626494,801017,PDP
MP151,,2016,1979,,27624698,211475806,65253841,,27357463,211042617,64909526,,267235,433189,344314,PDP
MP151,,2017,1979,,27785207,211850166,65480963,,27559428,211450046,65183987,,225779,400120,296975,PDP
MP151,,2017,1979,,27785207,211850166,65480963,,27559428,211450046,65183987,,225779,400120,296975,PDP
MP154,,1994,1992,,343,3432796,611161,,0,535594,95301,,343,2897202,515860,PDN
MP154,,1995,1992,,343,3432796,611161,,0,1053526,187460,,343,2379270,423701,PDN
MP154,,1996,1992,,343,3432796,611161,,0,1295369,230493,,343,2137427,380668,PDN
MP154,,1997,1992,,343,3432796,611161,,0,1390137,247355,,343,2042659,363806,PDN
MP154,,1998,1992,,343,3432796,611161,,0,1421208,252884,,343,2011588,358277,PDN
MP154,,1999,1992,,162,1615770,287666,,0,1504767,267752,,162,111003,19914,PDN
MP154,,2000,1992,,0,1509279,268555,,0,1509279,268555,,0,0,0,PDN
MP154,,2001,1992,,0,1509279,268555,,0,1509279,268555,,0,0,0,PDN
MP154,,2002,1992,,0,1509279,268555,,0,1509279,268555,,0,0,0,PDN
MP154,,2003,1992,,0,1509279,268555,,0,1509279,268555,,0,0,0,PDN
MP154,,2004,1992,,0,1509279,268555,,0,1509279,268555,,0,0,0,PDN
MP154,,2005,1992,,0,1509279,268555,,0,1509279,268555,,0,0,0,PDN
MP154,,2006,1992,,0,1509279,268555,,0,1509279,268555,,0,0,0,PDN
MP154,,2007,1992,,0,1509279,268555,,0,1509279,268555,,0,0,0,PDN
MP154,,2008,1992,,0,1509279,268555,,0,1509279,268555,,0,0,0,PDN
MP154,,2009,1992,,0,1537313,273543,,0,1537313,273543,,0,0,0,PDN
MP154,,2010,1992,,0,1537313,273543,,0,1537313,273543,,0,0,0,PDN
MP154,,2011,1992,,0,1537313,273543,,0,1537313,273543,,0,0,0,PDN
MP154,,2012,1992,,0,1537313,273543,,0,1537313,273543,,0,0,0,PDN
MP154,,2013,1992,,0,1537313,273543,,0,1537313,273543,,0,0,0,PDN
MP154,,2014,1992,,0,1537313,273543,,0,1537313,273543,,0,0,0,PDN
MP154,,2015,1992,,0,1537313,273543,,0,1537313,273543,,0,0,0,PDN
MP154,,2016,1992,,0,1537313,273543,,0,1537313,273543,,0,0,0,PDN
MP154,,2017,1992,,0,1537313,273543,,0,1537313,273543,,0,0,0,PDN
MP154,,2017,1992,,0,1537313,273543,,0,1537313,273543,,0,0,0,PDN
MP159,,1989,1987,,1389,13891338,2473157,,0,0,0,,1389,13891338,2473157,PDN
MP159,,1990,1987,,1389,13891338,2473157,,384,1392690,248194,,1005,12498648,2224963,PDN
MP159,,1991,1987,,1389,13891338,2473157,,463,2608131,464543,,926,11283207,2008614,PDN
MP159,,1992,1987,,1389,13891338,2473157,,463,2626924,467887,,926,11264414,2005270,PDN
MP159,,1993,1987,,1389,13891338,2473157,,463,2949952,525365,,926,10941386,1947792,PDN
MP159,,1994,1987,,589,4157492,740356,,463,3586939,638708,,126,570553,101648,PDN
MP159,,1995,1987,,1083,9106581,1621471,,463,4241579,755192,,620,4865002,866279,PDN
MP159,,1996,1987,,1113,9106581,1621501,,463,4660744,829777,,650,4445837,791724,PDN
MP159,,1997,1987,,1113,9106581,1621501,,665,5242756,933540,,448,3863825,687961,PDN
MP159,,1998,1987,,1113,9106581,1621501,,665,5538663,986192,,448,3567918,635309,PDN
MP159,,1999,1987,,665,5653662,1006655,,665,5653662,1006655,,0,0,0,PDN
MP159,,2000,1987,,665,5708739,1016455,,665,5708739,1016455,,0,0,0,PDN
MP159,,2001,1987,,665,6079743,1082470,,665,6079743,1082470,,0,0,0,PDN
MP159,,2002,1987,,787,7455897,1327459,,665,6297376,1121195,,122,1158521,206264,PDN
MP159,,2003,1987,,787,7455897,1327459,,665,6643014,1182696,,122,812883,144763,PDN
MP159,,2004,1987,,787,7453395,1327014,,665,6890717,1226771,,122,562678,100243,PDN
MP159,,2005,1987,,665,6890717,1226771,,665,6890717,1226771,,0,0,0,PDN
MP159,,2006,1987,,665,6890717,1226771,,665,6890717,1226771,,0,0,0,PDN
MP159,,2007,1987,,665,6890717,1226771,,665,6890717,1226771,,0,0,0,PDN
MP159,,2008,1987,,665,6890717,1226771,,665,6890717,1226771,,0,0,0,PDN
MP159,,2009,1987,,665,7000761,1246352,,665,7000761,1246352,,0,0,0,PDN
MP159,,2010,1987,,665,7000761,1246352,,665,7000761,1246352,,0,0,0,PDN
MP159,,2011,1987,,665,7000761,1246352,,665,7000761,1246352,,0,0,0,PDN
MP159,,2012,1987,,665,7000761,1246352,,665,7000761,1246352,,0,0,0,PDN
MP159,,2013,1987,,665,7000761,1246352,,665,7000761,1246352,,0,0,0,PDN
MP159,,2014,1987,,665,7000761,1246352,,665,7000761,1246352,,0,0,0,PDN
MP159,,2015,1987,,665,7000761,1246352,,665,7000761,1246352,,0,0,0,PDN
MP159,,2016,1987,,665,7000761,1246352,,665,7000761,1246352,,0,0,0,PDN
MP159,,2017,1987,,665,7000761,1246352,,665,7000761,1246352,,0,0,0,PDN
MP159,,2017,1987,,665,7000761,1246352,,665,7000761,1246352,,0,0,0,PDN
MP162,,1998,1998,,87528,18094223,3307141,,0,0,0,,87528,18094223,3307141,PDN
MP162,,1999,1998,,501903,18094223,3721516,,40897,1757862,353684,,461006,16336361,3367832,PDN
MP162,,2000,1998,,501903,18094223,3721516,,99187,4665377,929325,,402716,13428846,2792191,PDN
MP162,,2001,1998,,501903,18094223,3721516,,107817,5285684,1048330,,394086,12808539,2673186,PDN
MP162,,2002,1998,,501903,18094223,3721516,,108502,5344756,1059526,,393401,12749467,2661990,PDN
MP162,,2003,1998,,195660,5777489,1223683,,109257,5396158,1069427,,86403,381331,154256,PDN
MP162,,2004,1998,,195660,5777489,1223683,,109781,5463814,1081990,,85879,313675,141693,PDN
MP162,,2005,1998,,195660,5777489,1223683,,109878,5565516,1100183,,85782,211973,123500,PDN
MP162,,2006,1998,,196608,5918264,1249680,,110397,5641011,1114136,,86211,277253,135544,PDN
MP162,,2007,1998,,196608,5918264,1249680,,110724,5689693,1123125,,85884,228571,126555,PDN
MP162,,2008,1998,,197072,5986739,1262328,,110928,5721286,1128950,,86144,265453,133378,PDN
MP162,,2009,1998,,196667,5930355,1251890,,110928,5721286,1128950,,85739,209069,122940,PDN
MP162,,2010,1998,,110928,5721286,1128950,,110928,5721286,1128950,,0,0,0,PDN
MP162,,2011,1998,,110928,5721286,1128950,,110928,5721286,1128950,,0,0,0,PDN
MP162,,2012,1998,,110928,5721286,1128950,,110928,5721286,1128950,,0,0,0,PDN
MP162,,2013,1998,,110928,5721286,1128950,,110928,5721286,1128950,,0,0,0,PDN
MP162,,2014,1998,,110928,5721286,1128950,,110928,5721286,1128950,,0,0,0,PDN
MP162,,2015,1998,,110928,5721286,1128950,,110928,5721286,1128950,,0,0,0,PDN
MP162,,2016,1998,,110928,5721286,1128950,,110928,5721286,1128950,,0,0,0,PDN
MP162,,2017,1998,,110928,5721286,1128950,,110928,5721286,1128950,,0,0,0,PDN
MP162,,2017,1998,,110928,5721286,1128950,,110928,5721286,1128950,,0,0,0,PDN
MP163,,1989,1984,,195292,50775985,9230165,,0,0,0,,195292,50775985,9230165,PDN
MP163,,1990,1984,,195292,50775985,9230165,,1187,4046872,721271,,194105,46729113,8508894,PDN
MP163,,1991,1984,,195292,50775985,9230165,,1956,6214534,1107745,,193336,44561451,8122420,PDN
MP163,,1992,1984,,195292,50775985,9230165,,2444,8348279,1487903,,192848,42427706,7742262,PDN
MP163,,1993,1984,,160608,44745372,8122418,,2658,8975899,1599793,,157950,35769473,6522625,PDN
MP163,,1994,1984,,6620,22252156,3966078,,2946,9629445,1716370,,3674,12622711,2249708,PDN
MP163,,1995,1984,,6980,22428280,3997777,,3171,10009752,1784266,,3809,12418528,2213511,PDN
MP163,,1996,1984,,7973,32453626,5782640,,3305,10606033,1890499,,4668,21847593,3892141,PDN
MP163,,1997,1984,,8099,32695632,5825827,,3582,14289937,2546275,,4517,18405695,3279552,PDN
MP163,,1998,1984,,8099,32695632,5825827,,3796,15353893,2735805,,4303,17341739,3090022,PDN
MP163,,1999,1984,,7673,28004497,4990680,,3846,15877860,2829088,,3827,12126637,2161592,PDN
MP163,,2000,1984,,7673,28004497,4990680,,3846,16185882,2883896,,3827,11818615,2106784,PDN
MP163,,2001,1984,,8093,29907226,5329663,,3846,17013200,3031106,,4247,12894026,2298557,PDN
MP163,,2002,1984,,8149,30420866,5421114,,3846,17780549,3167645,,4303,12640317,2253469,PDN
MP163,,2003,1984,,117386,32824075,5957969,,17844,18546511,3317935,,99542,14277564,2640034,PDN
MP163,,2004,1984,,116222,31648333,5747598,,101377,20948112,3828799,,14845,10700221,1918799,PDN
MP163,,2005,1984,,292266,35592704,6625487,,127823,21821165,4010593,,164443,13771539,2614894,PDN
MP163,,2006,1984,,292266,35592704,6625487,,146111,22447705,4140365,,146155,13144999,2485122,PDN
MP163,,2007,1984,,292266,35590394,6625076,,172409,22947929,4255670,,119857,12642465,2369406,PDN
MP163,,2008,1984,,292266,35590394,6625076,,204793,24213949,4513325,,87473,11376445,2111751,PDN
MP163,,2009,1984,,238225,36887719,6801876,,228018,25358873,4740273,,10207,11528846,2061604,PDN
MP163,,2010,1984,,243352,37366305,6892161,,232181,25633683,4793334,,11171,11732622,2098827,PDN
MP163,,2011,1984,,243352,37366305,6892161,,235023,25986358,4858930,,8329,11379947,2033231,PDN
MP163,,2012,1984,,255668,37818547,6984947,,235023,26351646,4923928,,20645,11466901,2061019,PDN
MP163,,2013,1984,,255668,37818547,6984947,,243238,26664361,4987786,,12430,11154186,1997161,PDN
MP163,,2014,1984,,253108,35371432,6546957,,247548,26887133,5031735,,5560,8484299,1515222,PDN
MP163,,2015,1984,,251737,35353101,6542324,,249260,26990633,5051863,,2477,8362468,1490461,PDN
MP163,,2016,1984,,249260,26990633,5051863,,249260,26990633,5051863,,0,0,0,PDN
MP163,,2017,1984,,249260,26990633,5051863,,249260,26990633,5051863,,0,0,0,PDN
MP163,,2017,1984,,249260,26990633,5051863,,249260,26990633,5051863,,0,0,0,PDN
MP164,,1988,1984,,137173,31549867,5751028,,0,1477408,262884,,137173,30072459,5488144,PDN
MP164,,1989,1984,,133401,31999159,5827202,,438,7516436,1337882,,132963,24482723,4489320,PDN
MP164,,1990,1984,,128069,34595375,6283830,,937,13683250,2435679,,127132,20912125,3848151,PDN
MP164,,1991,1984,,128583,39734953,7198859,,1327,18556403,3303178,,127256,21178550,3895681,PDN
MP164,,1992,1984,,3250,40001065,7120877,,1501,21791135,3878927,,1749,18209930,3241950,PDN
MP164,,1993,1984,,3507,40001065,7121134,,1621,23793103,4235269,,1886,16207962,2885865,PDN
MP164,,1994,1984,,3507,40001065,7121134,,1659,25019087,4453454,,1848,14981978,2667680,PDN
MP164,,1995,1984,,4150,48234553,8586811,,1761,26041893,4635550,,2389,22192660,3951261,PDN
MP164,,1996,1984,,3127,36332002,6467896,,1761,26579465,4731203,,1366,9752537,1736693,PDN
MP164,,1997,1984,,3127,36332002,6467896,,1761,28206825,5020769,,1366,8125177,1447127,PDN
MP164,,1998,1984,,3127,36332002,6467896,,1761,30298017,5392867,,1366,6033985,1075029,PDN
MP164,,1999,1984,,3145,36422707,6484054,,1761,31274125,5566552,,1384,5148582,917502,PDN
MP164,,2000,1984,,3284,46861639,8341654,,1761,31632052,5630240,,1523,15229587,2711414,PDN
MP164,,2001,1984,,3284,47036158,8372707,,1761,31728647,5647428,,1523,15307511,2725279,PDN
MP164,,2002,1984,,3284,47036158,8372707,,1761,32466382,5778697,,1523,14569776,2594010,PDN
MP164,,2003,1984,,2095,35147274,6256058,,1761,32908834,5857425,,334,2238440,398633,PDN
MP164,,2004,1984,,2095,35147274,6256058,,1761,33324238,5931341,,334,1823036,324717,PDN
MP164,,2005,1984,,1761,33351105,5936121,,1761,33351105,5936121,,0,0,0,PDN
MP164,,2006,1984,,1761,33351105,5936121,,1761,33351105,5936121,,0,0,0,PDN
MP164,,2007,1984,,1761,33351105,5936121,,1761,33351105,5936121,,0,0,0,PDN
MP164,,2008,1984,,1761,33351105,5936121,,1761,33351105,5936121,,0,0,0,PDN
MP164,,2009,1984,,1761,33946451,6042055,,1761,33946451,6042055,,0,0,0,PDN
MP164,,2010,1984,,1761,33946451,6042055,,1761,33946451,6042055,,0,0,0,PDN
MP164,,2011,1984,,1761,33946451,6042055,,1761,33946451,6042055,,0,0,0,PDN
MP164,,2012,1984,,1761,33946451,6042055,,1761,33946451,6042055,,0,0,0,PDN
MP164,,2013,1984,,1761,33946451,6042055,,1761,33946451,6042055,,0,0,0,PDN
MP164,,2014,1984,,1761,33946451,6042055,,1761,33946451,6042055,,0,0,0,PDN
MP164,,2015,1984,,1761,33946451,6042055,,1761,33946451,6042055,,0,0,0,PDN
MP164,,2016,1984,,1761,33946451,6042055,,1761,33946451,6042055,,0,0,0,PDN
MP164,,2017,1984,,1761,33946451,6042055,,1761,33946451,6042055,,0,0,0,PDN
MP164,,2017,1984,,1761,33946451,6042055,,1761,33946451,6042055,,0,0,0,PDN
MP166,,2005,2006,,686,6849379,1219437,,0,0,0,,686,6849379,1219437,PDN
MP166,,2006,2006,,423,6845022,1218398,,0,288864,51399,,423,6556158,1166999,PDN
MP166,,2007,2006,,423,6845022,1218398,,0,1945784,346225,,423,4899238,872173,PDN
MP166,,2008,2006,,423,8499583,1512804,,0,3198446,569119,,423,5301137,943685,PDN
MP166,,2009,2006,,431,8525423,1517410,,0,3948716,702619,,431,4576707,814792,PDN
MP166,,2010,2006,,431,8525423,1517410,,0,4146124,737744,,431,4379299,779666,PDN
MP166,,2011,2006,,151,5739115,1021346,,0,4231344,752908,,151,1507771,268438,PDN
MP166,,2012,2006,,151,5739115,1021346,,0,4743292,844002,,151,995823,177344,PDN
MP166,,2013,2006,,151,5739115,1021346,,0,5439858,967946,,151,299257,53400,PDN
MP166,,2014,2006,,0,5507184,979926,,0,5507184,979926,,0,0,0,PDN
MP166,,2015,2006,,0,5507184,979926,,0,5507184,979926,,0,0,0,PDN
MP166,,2016,2006,,0,5507184,979926,,0,5507184,979926,,0,0,0,PDN
MP166,,2017,2006,,0,5507184,979926,,0,5507184,979926,,0,0,0,PDN
MP166,,2017,2006,,0,5507184,979926,,0,5507184,979926,,0,0,0,PDN
MP175,,1992,1988,,9761,52938984,9429509,,0,16247,2891,,9761,52922737,9426618,PDN
MP175,,1993,1988,,7939,34722296,6186283,,0,4919747,875400,,7939,29802549,5310883,PDN
MP175,,1994,1988,,7919,34639970,6171615,,0,8081245,1437944,,7919,26558725,4733671,PDN
MP175,,1995,1988,,7919,34639970,6171615,,0,9856716,1753864,,7919,24783254,4417751,PDN
MP175,,1996,1988,,8448,36939788,6581364,,0,10822159,1925651,,8448,26117629,4655713,PDN
MP175,,1997,1988,,8448,36939788,6581364,,0,11496275,2045601,,8448,25443513,4535763,PDN
MP175,,1998,1988,,8448,36939788,6581364,,0,11780071,2096098,,8448,25159717,4485266,PDN
MP175,,1999,1988,,1739,17391767,3096359,,0,12331826,2194275,,1739,5059941,902084,PDN
MP175,,2000,1988,,1739,17391767,3096359,,0,12784972,2274906,,1739,4606795,821453,PDN
MP175,,2001,1988,,1739,17391767,3096359,,0,13177910,2344824,,1739,4213857,751535,PDN
MP175,,2002,1988,,1966,19659691,3500132,,0,13500983,2402310,,1966,6158708,1097822,PDN
MP175,,2003,1988,,1966,19659691,3500132,,0,13789013,2453561,,1966,5870678,1046571,PDN
MP175,,2004,1988,,0,15790276,2809658,,0,13979273,2487415,,0,1811003,322243,PDN
MP175,,2005,1988,,0,15790276,2809658,,0,14105111,2509806,,0,1685165,299852,PDN
MP175,,2006,1988,,0,15790276,2809658,,0,14183656,2523782,,0,1606620,285876,PDN
MP175,,2007,1988,,0,15545921,2766178,,0,14196528,2526073,,0,1349393,240105,PDN
MP175,,2008,1988,,0,15545921,2766178,,0,14260292,2537419,,0,1285629,228759,PDN
MP175,,2009,1988,,0,14608287,2599340,,0,14538047,2586841,,0,70240,12498,PDN
MP175,,2010,1988,,0,15015097,2671726,,0,14563179,2591313,,0,451918,80412,PDN
MP175,,2011,1988,,0,14642603,2605446,,0,14591617,2596373,,0,50986,9072,PDN
MP175,,2012,1988,,0,14642603,2605446,,0,14619548,2601343,,0,23055,4102,PDN
MP175,,2013,1988,,0,14642603,2605446,,0,14642603,2605446,,0,0,0,PDN
MP175,,2014,1988,,0,14642603,2605446,,0,14642603,2605446,,0,0,0,PDN
MP175,,2015,1988,,0,14642603,2605446,,0,14642603,2605446,,0,0,0,PDN
MP175,,2016,1988,,0,14642603,2605446,,0,14642603,2605446,,0,0,0,PDN
MP175,,2017,1988,,0,14642603,2605446,,0,14642603,2605446,,0,0,0,PDN
MP175,,2017,1988,,0,14642603,2605446,,0,14642603,2605446,,0,0,0,PDN
MP178,,1998,1998,,222,2217562,394806,,0,0,0,,222,2217562,394806,PDN
MP178,,1999,1998,,222,2217562,394806,,0,0,0,,222,2217562,394806,PDN
MP178,,2000,1998,,222,2217562,394806,,0,0,0,,222,2217562,394806,PDN
MP178,,2001,1998,,44529,2217562,439113,,0,0,0,,44529,2217562,439113,PDN
MP178,,2002,1998,,44529,2217562,439113,,27221,1311758,260630,,17308,905804,178483,PDN
MP178,,2003,1998,,35478,2784980,531026,,31732,1941186,377139,,3746,843794,153887,PDN
MP178,,2004,1998,,35465,2691170,514321,,34227,2372965,456463,,1238,318205,57858,PDN
MP178,,2005,1998,,37861,2705520,519270,,37664,2449290,473481,,197,256230,45789,PDN
MP178,,2006,1998,,38187,2705520,519596,,38074,2463844,476480,,113,241676,43116,PDN
MP178,,2007,1998,,37866,2463844,476272,,37866,2463844,476272,,0,0,0,PDN
MP178,,2008,1998,,37866,2463844,476272,,37866,2463844,476272,,0,0,0,PDN
MP178,,2009,1998,,37866,2463844,476272,,37866,2463844,476272,,0,0,0,PDN
MP178,,2010,1998,,37866,2463844,476272,,37866,2463844,476272,,0,0,0,PDN
MP178,,2011,1998,,37866,2463844,476272,,37866,2463844,476272,,0,0,0,PDN
MP178,,2012,1998,,37866,2463844,476272,,37866,2463844,476272,,0,0,0,PDN
MP178,,2013,1998,,37866,2463844,476272,,37866,2463844,476272,,0,0,0,PDN
MP178,,2014,1998,,37866,2463844,476272,,37866,2463844,476272,,0,0,0,PDN
MP178,,2015,1998,,37866,2463844,476272,,37866,2463844,476272,,0,0,0,PDN
MP178,,2016,1998,,37866,2463844,476272,,37866,2463844,476272,,0,0,0,PDN
MP178,,2017,1998,,37866,2463844,476272,,37866,2463844,476272,,0,0,0,PDN
MP178,,2017,1998,,37866,2463844,476272,,37866,2463844,476272,,0,0,0,PDN
MP181,,1991,1990,,1909,19088267,3398398,,0,134475,23928,,1909,18953792,3374470,PDN
MP181,,1992,1990,,2087,20866579,3715001,,0,3127188,556439,,2087,17739391,3158562,PDN
MP181,,1993,1990,,2087,20866579,3715001,,40,5408245,962361,,2047,15458334,2752640,PDN
MP181,,1994,1990,,2403,24025685,4277436,,85,6462963,1150078,,2318,17562722,3127358,PDN
MP181,,1995,1990,,2401,24004130,4273599,,252,7824599,1392529,,2149,16179531,2881070,PDN
MP181,,1996,1990,,2441,23816401,4240235,,252,8996413,1601037,,2189,14819988,2639198,PDN
MP181,,1997,1990,,2441,23816401,4240235,,252,9219197,1640679,,2189,14597204,2599556,PDN
MP181,,1998,1990,,2441,23816401,4240235,,252,9311086,1657029,,2189,14505315,2583206,PDN
MP181,,1999,1990,,794,13396171,2384454,,252,9509676,1692365,,542,3886495,692089,PDN
MP181,,2000,1990,,794,14151621,2518876,,252,9723961,1730494,,542,4427660,788382,PDN
MP181,,2001,1990,,794,14167474,2521697,,252,10287308,1830734,,542,3880166,690963,PDN
MP181,,2002,1990,,847,14696194,2615828,,252,11363218,2022177,,595,3332976,593651,PDN
MP181,,2003,1990,,529,11838663,2107053,,252,11677550,2078108,,277,161113,28945,PDN
MP181,,2004,1990,,293,11980388,2132035,,252,11823666,2104107,,41,156722,27928,PDN
MP181,,2005,1990,,324,12292467,2187596,,252,11933764,2123698,,72,358703,63898,PDN
MP181,,2006,1990,,324,12292467,2187596,,252,12084853,2150582,,72,207614,37014,PDN
MP181,,2007,1990,,298,12302379,2189333,,252,12135244,2159548,,46,167135,29785,PDN
MP181,,2008,1990,,267,12136780,2159836,,252,12135244,2159548,,15,1536,288,PDN
MP181,,2009,1990,,252,12321167,2192630,,252,12321167,2192630,,0,0,0,PDN
MP181,,2010,1990,,252,12321167,2192630,,252,12321167,2192630,,0,0,0,PDN
MP181,,2011,1990,,252,12321167,2192630,,252,12321167,2192630,,0,0,0,PDN
MP181,,2012,1990,,252,12321167,2192630,,252,12321167,2192630,,0,0,0,PDN
MP181,,2013,1990,,252,12321167,2192630,,252,12321167,2192630,,0,0,0,PDN
MP181,,2014,1990,,252,12321167,2192630,,252,12321167,2192630,,0,0,0,PDN
MP181,,2015,1990,,252,12321167,2192630,,252,12321167,2192630,,0,0,0,PDN
MP181,,2016,1990,,252,12321167,2192630,,252,12321167,2192630,,0,0,0,PDN
MP181,,2017,1990,,252,12321167,2192630,,252,12321167,2192630,,0,0,0,PDN
MP181,,2017,1990,,252,12321167,2192630,,252,12321167,2192630,,0,0,0,PDN
MP186,,1990,1988,,481,4813514,856978,,0,463034,82390,,481,4350480,774588,PDN
MP186,,1991,1988,,481,4813514,856978,,0,1313566,233731,,481,3499948,623247,PDN
MP186,,1992,1988,,547,5466950,973314,,0,3051043,542890,,547,2415907,430424,PDN
MP186,,1993,1988,,1052,10515966,1872220,,0,4113437,731928,,1052,6402529,1140292,PDN
MP186,,1994,1988,,1317,14445183,2571634,,0,6743231,1199863,,1317,7701952,1371771,PDN
MP186,,1995,1988,,1405,15322955,2727909,,22,9232288,1642778,,1383,6090667,1085131,PDN
MP186,,1996,1988,,947,14934350,2658305,,22,11785455,2097078,,925,3148895,561227,PDN
MP186,,1997,1988,,995,16423093,2923254,,22,13742865,2445372,,973,2680228,477882,PDN
MP186,,1998,1988,,28043,22481827,4028368,,25348,20740031,3715745,,2695,1741796,312623,PDN
MP186,,1999,1988,,45084,33754255,6051179,,44232,30201706,5418201,,852,3552549,632978,PDN
MP186,,2000,1988,,45136,33756055,6051551,,44284,30840506,5531919,,852,2915549,519632,PDN
MP186,,2001,1988,,44284,33610282,6024761,,44284,30907020,5543754,,0,2703262,481007,PDN
MP186,,2002,1988,,44284,33610282,6024761,,44284,30908736,5544059,,0,2701546,480702,PDN
MP186,,2003,1988,,44284,30908736,5544059,,44284,30908736,5544059,,0,0,0,PDN
MP186,,2004,1988,,44284,30908736,5544059,,44284,30908736,5544059,,0,0,0,PDN
MP186,,2005,1988,,44284,30908736,5544059,,44284,30908736,5544059,,0,0,0,PDN
MP186,,2006,1988,,206955,53954768,9807448,,44284,30908736,5544059,,162671,23046032,4263389,PDN
MP186,,2007,1988,,206955,53954768,9807448,,44284,31116580,5581042,,162671,22838188,4226406,PDN
MP186,,2008,1988,,206955,53954768,9807448,,58383,34084934,6123318,,148572,19869834,3684130,PDN
MP186,,2009,1988,,96111,42381703,7637339,,78891,39724005,7147219,,17220,2657698,490120,PDN
MP186,,2010,1988,,97411,42734961,7701498,,80474,40578135,7300784,,16937,2156826,400713,PDN
MP186,,2011,1988,,97411,42734961,7701498,,88082,41353009,7446270,,9329,1381952,255228,PDN
MP186,,2012,1988,,96117,42891827,7728116,,95685,42320932,7626101,,432,570895,102015,PDN
MP186,,2013,1988,,409256,47205627,8808835,,135159,43215031,7824668,,274097,3990596,984167,PDN
MP186,,2014,1988,,183262,47487767,8633044,,153488,44342533,8043619,,29774,3145234,589424,PDN
MP186,,2015,1988,,183262,48072918,8737163,,158143,45240018,8207970,,25119,2832900,529194,PDN
MP186,,2016,1988,,158143,45243471,8208584,,158143,45243471,8208584,,0,0,0,PDN
MP186,,2017,1988,,158143,45243471,8208584,,158143,45243471,8208584,,0,0,0,PDN
MP186,,2017,1988,,158143,45243471,8208584,,158143,45243471,8208584,,0,0,0,PDN
MP198,,1997,1995,,301,3010513,535979,,0,0,0,,301,3010513,535979,PDN
MP198,,1998,1995,,372741,10884030,2309401,,233136,6866790,1454985,,139605,4017240,854416,PDN
MP198,,1999,1995,,537409,17565469,3662937,,428759,13308986,2796906,,108650,4256483,866031,PDN
MP198,,2000,1995,,486730,16086140,3349032,,486730,16086140,3349032,,0,0,0,PDN
MP198,,2001,1995,,495418,16497416,3430901,,495418,16497416,3430901,,0,0,0,PDN
MP198,,2002,1995,,495418,16497416,3430901,,495418,16497416,3430901,,0,0,0,PDN
MP198,,2003,1995,,495418,16497416,3430901,,495418,16497416,3430901,,0,0,0,PDN
MP198,,2004,1995,,495418,16497416,3430901,,495418,16497416,3430901,,0,0,0,PDN
MP198,,2005,1995,,495418,16497416,3430901,,495418,16497416,3430901,,0,0,0,PDN
MP198,,2006,1995,,495418,16497416,3430901,,495418,16497416,3430901,,0,0,0,PDN
MP198,,2007,1995,,495418,16497416,3430901,,495418,16497416,3430901,,0,0,0,PDN
MP198,,2008,1995,,495418,16497416,3430901,,495418,16497416,3430901,,0,0,0,PDN
MP198,,2009,1995,,495418,16559070,3441871,,495418,16559070,3441871,,0,0,0,PDN
MP198,,2010,1995,,495418,16559070,3441871,,495418,16559070,3441871,,0,0,0,PDN
MP198,,2011,1995,,495418,16559070,3441871,,495418,16559070,3441871,,0,0,0,PDN
MP198,,2012,1995,,495418,16559070,3441871,,495418,16559070,3441871,,0,0,0,PDN
MP198,,2013,1995,,495418,16559070,3441871,,495418,16559070,3441871,,0,0,0,PDN
MP198,,2014,1995,,495418,16559070,3441871,,495418,16559070,3441871,,0,0,0,PDN
MP198,,2015,1995,,495418,16559070,3441871,,495418,16559070,3441871,,0,0,0,PDN
MP198,,2016,1995,,495418,16559070,3441871,,495418,16559070,3441871,,0,0,0,PDN
MP198,,2017,1995,,495418,16559070,3441871,,495418,16559070,3441871,,0,0,0,PDN
MP198,,2017,1995,,495418,16559070,3441871,,495418,16559070,3441871,,0,0,0,PDN
MP200,,2006,2006,,4328,43275887,7704664,,0,0,0,,4328,43275887,7704664,PDN
MP200,,2007,2006,,4328,43275887,7704664,,0,0,0,,4328,43275887,7704664,PDN
MP200,,2008,2006,,21479,27523836,4918959,,10558,801554,153183,,10921,26722282,4765776,PDN
MP200,,2009,2006,,27450,28411346,5082850,,18508,2513951,465830,,8942,25897395,4617020,PDN
MP200,,2010,2006,,27450,28442062,5088316,,20555,2735231,507251,,6895,25706831,4581065,PDN
MP200,,2011,2006,,27450,28442062,5088316,,24835,3083093,573428,,2615,25358969,4514888,PDN
MP200,,2012,2006,,41601,31272996,5606192,,34285,4304039,800129,,7316,26968957,4806063,PDN
MP200,,2013,2006,,41601,31272996,5606192,,35872,5366613,990786,,5729,25906383,4615406,PDN
MP200,,2014,2006,,38767,31272996,5603358,,36085,5611497,1034572,,2682,25661499,4568786,PDN
MP200,,2015,2006,,38767,31272996,5603358,,36109,5713725,1052786,,2658,25559271,4550571,PDN
MP200,,2016,2006,,36109,5716325,1053249,,36109,5716325,1053249,,0,0,0,PDN
MP200,,2017,2006,,36109,5716325,1053249,,36109,5716325,1053249,,0,0,0,PDN
MP200,,2017,2006,,36109,5716325,1053249,,36109,5716325,1053249,,0,0,0,PDN
MP202,,1988,1986,,46084,4147528,784078,,0,42889,7631,,46084,4104639,776447,PDN
MP202,,1989,1986,,6948,69481406,12370188,,202,13876028,2469246,,6746,55605378,9900942,PDN
MP202,,1990,1986,,7127,71272411,12689051,,298,22880600,4071579,,6829,48391811,8617472,PDN
MP202,,1991,1986,,9051,90506299,16113375,,540,38400492,6833368,,8511,52105807,9280007,PDN
MP202,,1992,1986,,9156,91555549,16300179,,598,42357620,7537541,,8558,49197929,8762638,PDN
MP202,,1993,1986,,11379,113785453,20257901,,652,45247302,8051773,,10727,68538151,12206128,PDN
MP202,,1994,1986,,4071,59896290,10661774,,785,45814228,8152783,,3286,14082062,2508991,PDN
MP202,,1995,1986,,4071,59892814,10661155,,830,45898315,8167790,,3241,13994499,2493365,PDN
MP202,,1996,1986,,3739,57388060,10215138,,830,46076907,8199568,,2909,11311153,2015570,PDN
MP202,,1997,1986,,830,46095746,8202920,,830,46095746,8202920,,0,0,0,PDN
MP202,,1998,1986,,830,46095746,8202920,,830,46095746,8202920,,0,0,0,PDN
MP202,,1999,1986,,830,46095746,8202920,,830,46095746,8202920,,0,0,0,PDN
MP202,,2000,1986,,830,46095746,8202920,,830,46095746,8202920,,0,0,0,PDN
MP202,,2001,1986,,830,46095746,8202920,,830,46095746,8202920,,0,0,0,PDN
MP202,,2002,1986,,830,46095746,8202920,,830,46095746,8202920,,0,0,0,PDN
MP202,,2003,1986,,830,46095746,8202920,,830,46095746,8202920,,0,0,0,PDN
MP202,,2004,1986,,830,46095746,8202920,,830,46095746,8202920,,0,0,0,PDN
MP202,,2005,1986,,830,46095746,8202920,,830,46095746,8202920,,0,0,0,PDN
MP202,,2006,1986,,830,46095746,8202920,,830,46095746,8202920,,0,0,0,PDN
MP202,,2007,1986,,830,46095746,8202920,,830,46095746,8202920,,0,0,0,PDN
MP202,,2008,1986,,830,46095746,8202920,,830,46095746,8202920,,0,0,0,PDN
MP202,,2009,1986,,830,47018910,8367186,,830,47018910,8367186,,0,0,0,PDN
MP202,,2010,1986,,830,47018910,8367186,,830,47018910,8367186,,0,0,0,PDN
MP202,,2011,1986,,830,47018910,8367186,,830,47018910,8367186,,0,0,0,PDN
MP202,,2012,1986,,830,47018910,8367186,,830,47018910,8367186,,0,0,0,PDN
MP202,,2013,1986,,830,47018910,8367186,,830,47018910,8367186,,0,0,0,PDN
MP202,,2014,1986,,830,47018910,8367186,,830,47018910,8367186,,0,0,0,PDN
MP202,,2015,1986,,830,47018910,8367186,,830,47018910,8367186,,0,0,0,PDN
MP202,,2016,1986,,830,47018910,8367186,,830,47018910,8367186,,0,0,0,PDN
MP202,,2017,1986,,830,47018910,8367186,,830,47018910,8367186,,0,0,0,PDN
MP202,,2017,1986,,830,47018910,8367186,,830,47018910,8367186,,0,0,0,PDN
MP206,,1991,1991,,355,3548941,631839,,0,0,0,,355,3548941,631839,PDN
MP206,,1992,1991,,355,3548941,631839,,0,0,0,,355,3548941,631839,PDN
MP206,,2005,1991,,221,4301149,765550,,0,68713,12227,,221,4232436,753323,PDN
MP206,,2006,1991,,221,4220496,751199,,0,1889710,336247,,221,2330786,414952,PDN
MP206,,2007,1991,,221,4220496,751199,,0,2235264,397734,,221,1985232,353465,PDN
MP206,,2008,1991,,221,4201590,747835,,0,3399032,604810,,221,802558,143025,PDN
MP206,,2009,1991,,23,4675591,831979,,6,4504088,801445,,17,171503,30533,PDN
MP206,,2010,1991,,6,4751881,845537,,6,4698449,836029,,0,53432,9507,PDN
MP206,,2011,1991,,6,4751881,845537,,6,4736486,842797,,0,15395,2739,PDN
MP206,,2012,1991,,6,4751881,845537,,6,4746411,844563,,0,5470,973,PDN
MP206,,2013,1991,,6,4751881,845537,,6,4746411,844563,,0,5470,973,PDN
MP206,,2014,1991,,6,4746411,844563,,6,4746411,844563,,0,0,0,PDN
MP206,,2015,1991,,6,4746411,844563,,6,4746411,844563,,0,0,0,PDN
MP206,,2016,1991,,6,4746411,844563,,6,4746411,844563,,0,0,0,PDN
MP206,,2017,1991,,6,4746411,844563,,6,4746411,844563,,0,0,0,PDN
MP206,,2017,1991,,6,4746411,844563,,6,4746411,844563,,0,0,0,PDN
MP211,,2006,2006,,210,2097916,373505,,0,0,0,,210,2097916,373505,PDN
MP211,,2007,2006,,210,2102490,374319,,0,0,0,,210,2102490,374319,PDN
MP211,,2008,2006,,210,2102490,374319,,0,0,0,,210,2102490,374319,PDN
MP211,,2009,2006,,197,1966415,350093,,0,752740,133940,,197,1213675,216153,PDN
MP211,,2010,2006,,3,1966415,349899,,0,1127515,200625,,3,838900,149273,PDN
MP211,,2011,2006,,3,1966415,349899,,3,1463796,260465,,0,502619,89434,PDN
MP211,,2012,2006,,3,2073674,368984,,3,1810779,322206,,0,262895,46778,PDN
MP211,,2013,2006,,3,2073674,368984,,3,1919768,341599,,0,153906,27385,PDN
MP211,,2014,2006,,3,2073674,368984,,3,1990160,354124,,0,83514,14860,PDN
MP211,,2015,2006,,3,2042722,363477,,3,2042722,363477,,0,0,0,PDN
MP211,,2016,2006,,3,2042722,363477,,3,2042722,363477,,0,0,0,PDN
MP211,,2017,2006,,3,2042722,363477,,3,2042722,363477,,0,0,0,PDN
MP211,,2017,2006,,3,2042722,363477,,3,2042722,363477,,0,0,0,PDN
MP216,,1997,1998,,2415,24145418,4298753,,0,0,0,,2415,24145418,4298753,PDN
MP216,,1998,1998,,1963,19634134,3495581,,0,0,0,,1963,19634134,3495581,PDN
MP216,,1999,1998,,30000,19634134,3523618,,26159,2113025,402142,,3841,17521109,3121476,PDN
MP216,,2000,1998,,27125,2533437,477915,,26644,2321655,439750,,481,211782,38165,PDN
MP216,,2001,1998,,27125,2533437,477915,,26644,2381442,450388,,481,151995,27527,PDN
MP216,,2002,1998,,27125,2533437,477915,,26644,2420829,457396,,481,112608,20519,PDN
MP216,,2003,1998,,27125,2533437,477915,,26644,2434848,459891,,481,98589,18024,PDN
MP216,,2004,1998,,26644,2447707,462179,,26644,2447707,462179,,0,0,0,PDN
MP216,,2005,1998,,26644,2447707,462179,,26644,2447707,462179,,0,0,0,PDN
MP216,,2006,1998,,26644,2447707,462179,,26644,2447707,462179,,0,0,0,PDN
MP216,,2007,1998,,26644,2442989,461340,,26644,2442989,461340,,0,0,0,PDN
MP216,,2008,1998,,26644,2442989,461340,,26644,2442989,461340,,0,0,0,PDN
MP216,,2009,1998,,26644,2442989,461340,,26644,2442989,461340,,0,0,0,PDN
MP216,,2010,1998,,26644,2442989,461340,,26644,2442989,461340,,0,0,0,PDN
MP216,,2011,1998,,26644,2442989,461340,,26644,2442989,461340,,0,0,0,PDN
MP216,,2012,1998,,26644,2442989,461340,,26644,2442989,461340,,0,0,0,PDN
MP216,,2013,1998,,26644,2442989,461340,,26644,2442989,461340,,0,0,0,PDN
MP216,,2014,1998,,26644,2442989,461340,,26644,2442989,461340,,0,0,0,PDN
MP216,,2015,1998,,26644,2442989,461340,,26644,2442989,461340,,0,0,0,PDN
MP216,,2016,1998,,26644,2442989,461340,,26644,2442989,461340,,0,0,0,PDN
MP216,,2017,1998,,26644,2442989,461340,,26644,2442989,461340,,0,0,0,PDN
MP216,,2017,1998,,26644,2442989,461340,,26644,2442989,461340,,0,0,0,PDN
MP217,,1997,1985,,100,1000000,178036,,0,0,0,,100,1000000,178036,PDN
MP217,,1998,1985,,43989,10403511,1895148,,19572,4269868,779335,,24417,6133643,1115813,PDN
MP217,,1999,1985,,27170,6645592,1209660,,27170,6645592,1209660,,0,0,0,PDN
MP217,,2000,1985,,38406,9393910,1709920,,27502,6752381,1228993,,10904,2641529,480927,PDN
MP217,,2001,1985,,27502,6596736,1201298,,27502,6596736,1201298,,0,0,0,PDN
MP217,,2002,1985,,27502,6596736,1201298,,27502,6596736,1201298,,0,0,0,PDN
MP217,,2003,1985,,27502,6596736,1201298,,27502,6596736,1201298,,0,0,0,PDN
MP217,,2004,1985,,27502,6596736,1201298,,27502,6596736,1201298,,0,0,0,PDN
MP217,,2005,1985,,27502,6596736,1201298,,27502,6596736,1201298,,0,0,0,PDN
MP217,,2006,1985,,27502,6596736,1201298,,27502,6596736,1201298,,0,0,0,PDN
MP217,,2007,1985,,27502,6596736,1201298,,27502,6596736,1201298,,0,0,0,PDN
MP217,,2008,1985,,27502,6596736,1201298,,27502,6596736,1201298,,0,0,0,PDN
MP217,,2009,1985,,27502,6652570,1211233,,27502,6652570,1211233,,0,0,0,PDN
MP217,,2010,1985,,27502,6652570,1211233,,27502,6652570,1211233,,0,0,0,PDN
MP217,,2011,1985,,27502,6652570,1211233,,27502,6652570,1211233,,0,0,0,PDN
MP217,,2012,1985,,27502,6652570,1211233,,27502,6652570,1211233,,0,0,0,PDN
MP217,,2013,1985,,27502,6652570,1211233,,27502,6652570,1211233,,0,0,0,PDN
MP217,,2014,1985,,27502,6652570,1211233,,27502,6652570,1211233,,0,0,0,PDN
MP217,,2015,1985,,27502,6652570,1211233,,27502,6652570,1211233,,0,0,0,PDN
MP217,,2016,1985,,27502,6652570,1211233,,27502,6652570,1211233,,0,0,0,PDN
MP217,,2017,1985,,27502,6652570,1211233,,27502,6652570,1211233,,0,0,0,PDN
MP217,,2017,1985,,27502,6652570,1211233,,27502,6652570,1211233,,0,0,0,PDN
MP223,,1995,1995,,388,3882334,691195,,0,0,0,,388,3882334,691195,PDN
MP223,,1996,1995,,536313,38228128,7338471,,93684,3925328,792141,,442629,34302800,6546330,PDN
MP223,,1997,1995,,1146465,60364160,11887419,,615126,26872798,5396763,,531339,33491362,6490656,PDN
MP223,,1998,1995,,3605039,170938723,34021182,,1562261,76604763,15193002,,2042778,94333960,18828180,PDN
MP223,,1999,1995,,3649846,186208054,36782952,,2265052,123967041,24323244,,1384794,62241013,12459708,PDN
MP223,,2000,1995,,3481163,196405974,38428845,,2623817,151020091,29495719,,857346,45385883,8933126,PDN
MP223,,2001,1995,,3481163,196405633,38428785,,2762071,161427322,31485794,,719092,34978311,6942991,PDN
MP223,,2002,1995,,3481163,196405633,38428785,,2797044,163743053,31932819,,684119,32662580,6495966,PDN
MP223,,2003,1995,,2879829,172470672,33568561,,2812510,164773577,32131652,,67319,7697095,1436909,PDN
MP223,,2004,1995,,2871729,171322757,33356205,,2822423,165440854,32260297,,49306,5881903,1095908,PDN
MP223,,2005,1995,,2871579,171728979,33428337,,2830819,166079661,32382360,,40760,5649318,1045977,PDN
MP223,,2006,1995,,2874547,171848482,33452569,,2836613,166718665,32501856,,37934,5129817,950713,PDN
MP223,,2007,1995,,2867297,172272482,33520764,,2839860,167184333,32587962,,27437,5088149,932802,PDN
MP223,,2008,1995,,2867297,172836109,33621053,,2842606,167438562,32635944,,24691,5397547,985109,PDN
MP223,,2009,1995,,2877572,174268948,33886280,,2844688,168835326,32886559,,32884,5433622,999721,PDN
MP223,,2010,1995,,2859964,173573555,33744938,,2847072,169110573,32937921,,12892,4462982,807017,PDN
MP223,,2011,1995,,2847072,169110573,32937921,,2847072,169110573,32937921,,0,0,0,PDN
MP223,,2012,1995,,2847072,169110573,32937921,,2847072,169110573,32937921,,0,0,0,PDN
MP223,,2013,1995,,2847072,169110573,32937921,,2847072,169110573,32937921,,0,0,0,PDN
MP223,,2014,1995,,2847072,169110573,32937921,,2847072,169110573,32937921,,0,0,0,PDN
MP223,,2015,1995,,2847072,169110573,32937921,,2847072,169110573,32937921,,0,0,0,PDN
MP223,,2016,1995,,2847072,169110573,32937921,,2847072,169110573,32937921,,0,0,0,PDN
MP223,,2017,1995,,2847072,169110573,32937921,,2847072,169110573,32937921,,0,0,0,PDN
MP223,,2017,1995,,2847072,169110573,32937921,,2847072,169110573,32937921,,0,0,0,PDN
MP225,,1996,1995,,1025403,74979905,14367023,,449323,30772857,5924920,,576080,44207048,8442103,PDN
MP225,,1997,1995,,1025403,74979905,14367023,,700866,54967422,10481546,,324537,20012483,3885477,PDN
MP225,,1998,1995,,1025403,74979905,14367023,,768941,67162037,12719481,,256462,7817868,1647542,PDN
MP225,,1999,1995,,890516,95631172,17906739,,796361,74173822,13994550,,94155,21457350,3912189,PDN
MP225,,2000,1995,,895018,96644913,18091622,,829314,87113181,16329880,,65704,9531732,1761742,PDN
MP225,,2001,1995,,895511,96452727,18057918,,839988,91004835,17033019,,55523,5447892,1024899,PDN
MP225,,2002,1995,,896166,96211407,18015633,,843151,92857169,17365779,,53015,3354238,649854,PDN
MP225,,2003,1995,,846209,93687146,17516520,,845874,93476332,17478673,,335,210814,37847,PDN
MP225,,2004,1995,,846084,94350077,17634354,,845884,93484078,17480062,,200,865999,154292,PDN
MP225,,2005,1995,,845884,93484078,17480062,,845884,93484078,17480062,,0,0,0,PDN
MP225,,2006,1995,,845884,93484078,17480062,,845884,93484078,17480062,,0,0,0,PDN
MP225,,2007,1995,,845884,93484078,17480062,,845884,93484078,17480062,,0,0,0,PDN
MP225,,2008,1995,,845884,93484078,17480062,,845884,93484078,17480062,,0,0,0,PDN
MP225,,2009,1995,,845884,94761448,17707352,,845884,94761448,17707352,,0,0,0,PDN
MP225,,2010,1995,,845884,94761448,17707352,,845884,94761448,17707352,,0,0,0,PDN
MP225,,2011,1995,,845884,94761448,17707352,,845884,94761448,17707352,,0,0,0,PDN
MP225,,2012,1995,,845884,94761448,17707352,,845884,94761448,17707352,,0,0,0,PDN
MP225,,2013,1995,,845884,94761448,17707352,,845884,94761448,17707352,,0,0,0,PDN
MP225,,2014,1995,,845884,94761448,17707352,,845884,94761448,17707352,,0,0,0,PDN
MP225,,2015,1995,,845884,94761448,17707352,,845884,94761448,17707352,,0,0,0,PDN
MP225,,2016,1995,,845884,94761448,17707352,,845884,94761448,17707352,,0,0,0,PDN
MP225,,2017,1995,,845884,94761448,17707352,,845884,94761448,17707352,,0,0,0,PDN
MP225,,2017,1995,,845884,94761448,17707352,,845884,94761448,17707352,,0,0,0,PDN
MP226,,1997,1997,,67,672309,119695,,0,0,0,,67,672309,119695,PDN
MP226,,1998,1997,,6625,1195377,219326,,4799,874968,160487,,1826,320409,58839,PDN
MP226,,1999,1997,,138570,17601478,3270506,,41296,5995747,1108155,,97274,11605731,2162351,PDN
MP226,,2000,1997,,138570,17601478,3270506,,62458,9341014,1724560,,76112,8260464,1545946,PDN
MP226,,2001,1997,,138572,17601976,3270596,,71819,11380674,2096850,,66753,6221302,1173746,PDN
MP226,,2002,1997,,82023,14774266,2710896,,76791,12800506,2354461,,5232,1973760,356435,PDN
MP226,,2003,1997,,82023,14774266,2710896,,79248,13712587,2519210,,2775,1061679,191686,PDN
MP226,,2004,1997,,82023,14774266,2710896,,81131,14289744,2623790,,892,484522,87106,PDN
MP226,,2005,1997,,82023,14774266,2710896,,81984,14608822,2681419,,39,165444,29477,PDN
MP226,,2006,1997,,83413,14995625,2751674,,83083,14811431,2718569,,330,184194,33105,PDN
MP226,,2007,1997,,83413,14995625,2751674,,83264,14937847,2741244,,149,57778,10430,PDN
MP226,,2008,1997,,83720,15135593,2776886,,83640,15089829,2768663,,80,45764,8223,PDN
MP226,,2009,1997,,84424,15210352,2790892,,84424,15210352,2790892,,0,0,0,PDN
MP226,,2010,1997,,84424,15210352,2790892,,84424,15210352,2790892,,0,0,0,PDN
MP226,,2011,1997,,84424,15210352,2790892,,84424,15210352,2790892,,0,0,0,PDN
MP226,,2012,1997,,84424,15210352,2790892,,84424,15210352,2790892,,0,0,0,PDN
MP226,,2013,1997,,84424,15210352,2790892,,84424,15210352,2790892,,0,0,0,PDN
MP226,,2014,1997,,84424,15210352,2790892,,84424,15210352,2790892,,0,0,0,PDN
MP226,,2015,1997,,84424,15210352,2790892,,84424,15210352,2790892,,0,0,0,PDN
MP226,,2016,1997,,84424,15210352,2790892,,84424,15210352,2790892,,0,0,0,PDN
MP226,,2017,1997,,84424,15210352,2790892,,84424,15210352,2790892,,0,0,0,PDN
MP226,,2017,1997,,84424,15210352,2790892,,84424,15210352,2790892,,0,0,0,PDN
MP227,,1988,1985,,11832,2721452,496076,,0,0,0,,11832,2721452,496076,PDN
MP227,,1989,1985,,11832,2721452,496076,,0,0,0,,11832,2721452,496076,PDN
MP227,,1990,1985,,11832,2721452,496076,,29,253774,45185,,11803,2467678,450891,PDN
MP227,,1991,1985,,11832,2721452,496076,,29,892059,158758,,11803,1829393,337318,PDN
MP227,,1992,1985,,7675,3745214,674083,,60,1371005,244011,,7615,2374209,430072,PDN
MP227,,1993,1985,,280,5448451,969755,,60,1637967,291513,,220,3810484,678242,PDN
MP227,,1994,1985,,280,5435945,967530,,60,1762513,313674,,220,3673432,653856,PDN
MP227,,1995,1985,,280,5435945,967530,,60,1890197,336394,,220,3545748,631136,PDN
MP227,,1996,1985,,280,5435945,967530,,60,1948508,346770,,220,3487437,620760,PDN
MP227,,1997,1985,,280,5435945,967530,,102,2026590,360705,,178,3409355,606825,PDN
MP227,,1998,1985,,280,5435945,967530,,102,2062371,367072,,178,3373574,600458,PDN
MP227,,1999,1985,,683134,18558929,3985435,,39370,7575208,1387272,,643764,10983721,2598163,PDN
MP227,,2000,1985,,156199,30475342,5578858,,65766,12641482,2315140,,90433,17833860,3263718,PDN
MP227,,2001,1985,,156190,30472874,5578410,,75627,15726782,2873987,,80563,14746092,2704423,PDN
MP227,,2002,1985,,156190,30472874,5578410,,80269,17343122,3166234,,75921,13129752,2412176,PDN
MP227,,2003,1985,,156142,30180245,5526292,,83783,18629447,3398631,,72359,11550798,2127661,PDN
MP227,,2004,1985,,91191,24849559,4512821,,88060,20016228,3649666,,3131,4833331,863155,PDN
MP227,,2005,1985,,91191,24849559,4512821,,89981,20675754,3768941,,1210,4173805,743880,PDN
MP227,,2006,1985,,91967,24849559,4513597,,90977,21216316,3866122,,990,3633243,647475,PDN
MP227,,2007,1985,,91967,24849559,4513597,,91507,21413776,3901787,,460,3435783,611810,PDN
MP227,,2008,1985,,92776,24834535,4511732,,92105,21628255,3940549,,671,3206280,571183,PDN
MP227,,2009,1985,,92646,21798050,3971303,,92485,21725844,3958294,,161,72206,13009,PDN
MP227,,2010,1985,,92485,21725844,3958294,,92485,21725844,3958294,,0,0,0,PDN
MP227,,2011,1985,,92485,21725844,3958294,,92485,21725844,3958294,,0,0,0,PDN
MP227,,2012,1985,,92485,21725844,3958294,,92485,21725844,3958294,,0,0,0,PDN
MP227,,2013,1985,,92485,21725844,3958294,,92485,21725844,3958294,,0,0,0,PDN
MP227,,2014,1985,,92485,21725844,3958294,,92485,21725844,3958294,,0,0,0,PDN
MP227,,2015,1985,,92485,21725844,3958294,,92485,21725844,3958294,,0,0,0,PDN
MP227,,2016,1985,,92485,21725844,3958294,,92485,21725844,3958294,,0,0,0,PDN
MP227,,2017,1985,,92485,21725844,3958294,,92485,21725844,3958294,,0,0,0,PDN
MP227,,2017,1985,,92485,21725844,3958294,,92485,21725844,3958294,,0,0,0,PDN
MP233,,2006,1998,,711,7107341,1265362,,0,0,0,,711,7107341,1265362,PDN
MP233,,2007,1998,,929,9288105,1653617,,0,0,0,,929,9288105,1653617,PDN
MP233,,2008,1998,,1002,10022758,1784411,,0,0,0,,1002,10022758,1784411,PDN
MP233,,2009,1998,,760432,14383587,3319789,,162385,2603983,625727,,598047,11779604,2694062,PDN
MP233,,2010,1998,,665254,13530129,3072750,,374469,5111746,1284032,,290785,8418383,1788718,PDN
MP233,,2011,1998,,665254,13530129,3072750,,624778,8142152,2073560,,40476,5387977,999191,PDN
MP233,,2012,1998,,665254,13635036,3091417,,664816,9051272,2275363,,438,4583764,816054,PDN
MP233,,2013,1998,,665254,13635036,3091417,,664842,9238994,2308791,,412,4396042,782626,PDN
MP233,,2014,1998,,664842,9316478,2322578,,664842,9316478,2322578,,0,0,0,PDN
MP233,,2015,1998,,664842,9316478,2322578,,664842,9316478,2322578,,0,0,0,PDN
MP233,,2016,1998,,664842,9316478,2322578,,664842,9316478,2322578,,0,0,0,PDN
MP233,,2017,1998,,664842,9316478,2322578,,664842,9316478,2322578,,0,0,0,PDN
MP233,,2017,1998,,664842,9316478,2322578,,664842,9316478,2322578,,0,0,0,PDN
MP234,,1993,1990,,4515,45150960,8038494,,0,0,0,,4515,45150960,8038494,PDN
MP234,,1994,1990,,4515,45150960,8038494,,0,1685165,299851,,4515,43465795,7738643,PDN
MP234,,1995,1990,,4889,48889111,8704019,,0,2050110,364788,,4889,46839001,8339231,PDN
MP234,,1996,1990,,0,4406490,784073,,0,3325650,591753,,0,1080840,192320,PDN
MP234,,1997,1990,,597,6900433,1228432,,0,5092878,906206,,597,1807555,322226,PDN
MP234,,1998,1990,,0,5590970,994835,,0,5590970,994835,,0,0,0,PDN
MP234,,1999,1990,,0,5590970,994835,,0,5590970,994835,,0,0,0,PDN
MP234,,2000,1990,,0,5590970,994835,,0,5590970,994835,,0,0,0,PDN
MP234,,2001,1990,,0,5590970,994835,,0,5590970,994835,,0,0,0,PDN
MP234,,2002,1990,,0,5590970,994835,,0,5590970,994835,,0,0,0,PDN
MP234,,2003,1990,,0,5590970,994835,,0,5590970,994835,,0,0,0,PDN
MP234,,2004,1990,,0,5590970,994835,,0,5590970,994835,,0,0,0,PDN
MP234,,2005,1990,,0,5590970,994835,,0,5590970,994835,,0,0,0,PDN
MP234,,2006,1990,,0,5590970,994835,,0,5590970,994835,,0,0,0,PDN
MP234,,2007,1990,,0,5590970,994835,,0,5590970,994835,,0,0,0,PDN
MP234,,2008,1990,,0,5590970,994835,,0,5590970,994835,,0,0,0,PDN
MP234,,2009,1990,,0,5702944,1014758,,0,5702944,1014758,,0,0,0,PDN
MP234,,2010,1990,,0,5702944,1014758,,0,5702944,1014758,,0,0,0,PDN
MP234,,2011,1990,,0,5702944,1014758,,0,5702944,1014758,,0,0,0,PDN
MP234,,2012,1990,,0,5702944,1014758,,0,5702944,1014758,,0,0,0,PDN
MP234,,2013,1990,,0,5702944,1014758,,0,5702944,1014758,,0,0,0,PDN
MP234,,2014,1990,,0,5702944,1014758,,0,5702944,1014758,,0,0,0,PDN
MP234,,2015,1990,,0,5702944,1014758,,0,5702944,1014758,,0,0,0,PDN
MP234,,2016,1990,,0,5702944,1014758,,0,5702944,1014758,,0,0,0,PDN
MP234,,2017,1990,,0,5702944,1014758,,0,5702944,1014758,,0,0,0,PDN
MP234,,2017,1990,,0,5702944,1014758,,0,5702944,1014758,,0,0,0,PDN
MP241,,2006,2006,,282,2821646,502354,,0,0,0,,282,2821646,502354,PDN
MP241,,2007,2006,,282,2825494,503039,,0,0,0,,282,2825494,503039,PDN
MP241,,2008,2006,,282,2825494,503039,,0,0,0,,282,2825494,503039,PDN
MP241,,2009,2006,,4280,4374014,782574,,404,1303537,232350,,3876,3070477,550224,PDN
MP241,,2010,2006,,4280,4372786,782355,,2177,2034380,364166,,2103,2338406,418189,PDN
MP241,,2011,2006,,4280,4372786,782355,,3789,2566859,460525,,491,1805927,321830,PDN
MP241,,2012,2006,,4280,4372786,782355,,4106,2634653,472905,,174,1738133,309450,PDN
MP241,,2013,2006,,4106,2634653,472905,,4106,2634653,472905,,0,0,0,PDN
MP241,,2014,2006,,4106,2634653,472905,,4106,2634653,472905,,0,0,0,PDN
MP241,,2015,2006,,4106,2634653,472905,,4106,2634653,472905,,0,0,0,PDN
MP241,,2016,2006,,4106,2634653,472905,,4106,2634653,472905,,0,0,0,PDN
MP241,,2017,2006,,4106,2634653,472905,,4106,2634653,472905,,0,0,0,PDN
MP241,,2017,2006,,4106,2634653,472905,,4106,2634653,472905,,0,0,0,PDN
MP242,,2000,1994,,43667,5776237,1071467,,43176,1580407,324387,,491,4195830,747080,PDN
MP242,,2001,1994,,72290,6409684,1212803,,71828,4505049,873438,,462,1904635,339365,PDN
MP242,,2002,1994,,75701,6473612,1227589,,75257,5319997,1021876,,444,1153615,205713,PDN
MP242,,2003,1994,,74631,5443956,1043306,,74628,5380698,1032048,,3,63258,11258,PDN
MP242,,2004,1994,,74631,5471766,1048255,,74628,5449737,1044332,,3,22029,3923,PDN
MP242,,2005,1994,,74631,5506016,1054349,,74628,5472573,1048395,,3,33443,5954,PDN
MP242,,2006,1994,,74628,5472573,1048395,,74628,5472573,1048395,,0,0,0,PDN
MP242,,2007,1994,,74628,5472573,1048395,,74628,5472573,1048395,,0,0,0,PDN
MP242,,2008,1994,,74628,5472573,1048395,,74628,5472573,1048395,,0,0,0,PDN
MP242,,2009,1994,,74628,5472573,1048395,,74628,5472573,1048395,,0,0,0,PDN
MP242,,2010,1994,,74628,5472573,1048395,,74628,5472573,1048395,,0,0,0,PDN
MP242,,2011,1994,,74628,5472573,1048395,,74628,5472573,1048395,,0,0,0,PDN
MP242,,2012,1994,,74628,5472573,1048395,,74628,5472573,1048395,,0,0,0,PDN
MP242,,2013,1994,,74628,5472573,1048395,,74628,5472573,1048395,,0,0,0,PDN
MP242,,2014,1994,,74628,5472573,1048395,,74628,5472573,1048395,,0,0,0,PDN
MP242,,2015,1994,,74628,5472573,1048395,,74628,5472573,1048395,,0,0,0,PDN
MP242,,2016,1994,,74628,5472573,1048395,,74628,5472573,1048395,,0,0,0,PDN
MP242,,2017,1994,,74628,5472573,1048395,,74628,5472573,1048395,,0,0,0,PDN
MP242,,2017,1994,,74628,5472573,1048395,,74628,5472573,1048395,,0,0,0,PDN
MP243,,1988,1984,,1277248,11411485,3307761,,6293,2097897,379584,,1270955,9313588,2928177,PDN
MP243,,1989,1984,,1277248,24762407,5683370,,19431,6338625,1147300,,1257817,18423782,4536070,PDN
MP243,,1990,1984,,1788141,32710985,7608601,,36431,10153743,1843147,,1751710,22557242,5765454,PDN
MP243,,1991,1984,,2006737,38487428,8855034,,133161,14625140,2735499,,1873576,23862288,6119535,PDN
MP243,,1992,1984,,1252092,45458009,9340706,,161452,19037186,3548852,,1090640,26420823,5791854,PDN
MP243,,1993,1984,,424657,46380664,8677444,,217562,22862728,4285663,,207095,23517936,4391781,PDN
MP243,,1994,1984,,434993,48691261,9098918,,269820,27038256,5080898,,165173,21653005,4018020,PDN
MP243,,1995,1984,,426832,48683100,9089305,,292820,28907622,5436525,,134012,19775478,3652780,PDN
MP243,,1996,1984,,427623,48622481,9079310,,302955,30015506,5643792,,124668,18606975,3435518,PDN
MP243,,1997,1984,,427623,48622481,9079310,,306349,30696881,5768427,,121274,17925600,3310883,PDN
MP243,,1998,1984,,314461,30981593,5827200,,314461,30981593,5827200,,0,0,0,PDN
MP243,,1999,1984,,314461,30981593,5827200,,314461,30981593,5827200,,0,0,0,PDN
MP243,,2000,1984,,314461,30981593,5827200,,314461,30981593,5827200,,0,0,0,PDN
MP243,,2001,1984,,314461,30981593,5827200,,314461,30981593,5827200,,0,0,0,PDN
MP243,,2002,1984,,314461,30981593,5827200,,314461,30981593,5827200,,0,0,0,PDN
MP243,,2003,1984,,314461,30981593,5827200,,314461,30981593,5827200,,0,0,0,PDN
MP243,,2004,1984,,314461,30981593,5827200,,314461,30981593,5827200,,0,0,0,PDN
MP243,,2005,1984,,314461,30981593,5827200,,314461,30981593,5827200,,0,0,0,PDN
MP243,,2006,1984,,314461,30981593,5827200,,314461,30981593,5827200,,0,0,0,PDN
MP243,,2007,1984,,314461,30981593,5827200,,314461,30981593,5827200,,0,0,0,PDN
MP243,,2008,1984,,314461,30981593,5827200,,314461,30981593,5827200,,0,0,0,PDN
MP243,,2009,1984,,314461,31602072,5937605,,314461,31602072,5937605,,0,0,0,PDN
MP243,,2010,1984,,314461,31602072,5937605,,314461,31602072,5937605,,0,0,0,PDN
MP243,,2011,1984,,314461,31602072,5937606,,314461,31602072,5937606,,0,0,0,PDN
MP243,,2012,1984,,314461,31602072,5937606,,314461,31602072,5937606,,0,0,0,PDN
MP243,,2013,1984,,314461,31602072,5937606,,314461,31602072,5937606,,0,0,0,PDN
MP243,,2014,1984,,314461,31602072,5937606,,314461,31602072,5937606,,0,0,0,PDN
MP243,,2015,1984,,314461,31602072,5937606,,314461,31602072,5937606,,0,0,0,PDN
MP243,,2016,1984,,314461,31602072,5937606,,314461,31602072,5937606,,0,0,0,PDN
MP243,,2017,1984,,314461,31602072,5937606,,314461,31602072,5937606,,0,0,0,PDN
MP243,,2017,1984,,314461,31602072,5937606,,314461,31602072,5937606,,0,0,0,PDN
MP245,,1996,1973,,496,4961166,883266,,0,929745,165435,,496,4031421,717831,PDN
MP245,,1997,1973,,420,4768242,848862,,0,2665143,474225,,420,2103099,374637,PDN
MP245,,1998,1973,,529,5904065,1051074,,0,3483134,619775,,529,2420931,431299,PDN
MP245,,1999,1973,,529,5904065,1051074,,0,3895180,693093,,529,2008885,357981,PDN
MP245,,2000,1973,,0,4175689,743005,,0,4175689,743005,,0,0,0,PDN
MP245,,2001,1973,,0,4225439,751857,,0,4225439,751857,,0,0,0,PDN
MP245,,2002,1973,,0,4225439,751857,,0,4225439,751857,,0,0,0,PDN
MP245,,2003,1973,,0,4225439,751857,,0,4225439,751857,,0,0,0,PDN
MP245,,2004,1973,,0,4225439,751857,,0,4225439,751857,,0,0,0,PDN
MP245,,2005,1973,,0,4225439,751857,,0,4225439,751857,,0,0,0,PDN
MP245,,2006,1973,,0,4225439,751857,,0,4225439,751857,,0,0,0,PDN
MP245,,2007,1973,,0,4225439,751857,,0,4225439,751857,,0,0,0,PDN
MP245,,2008,1973,,0,4225439,751857,,0,4225439,751857,,0,0,0,PDN
MP245,,2009,1973,,0,4291287,763574,,0,4291287,763574,,0,0,0,PDN
MP245,,2010,1973,,0,4291287,763574,,0,4291287,763574,,0,0,0,PDN
MP245,,2011,1973,,0,4291287,763574,,0,4291287,763574,,0,0,0,PDN
MP245,,2012,1973,,0,4291287,763574,,0,4291287,763574,,0,0,0,PDN
MP245,,2013,1973,,0,4291287,763574,,0,4291287,763574,,0,0,0,PDN
MP245,,2014,1973,,0,4291287,763574,,0,4291287,763574,,0,0,0,PDN
MP245,,2015,1973,,0,4291287,763574,,0,4291287,763574,,0,0,0,PDN
MP245,,2016,1973,,0,4291287,763574,,0,4291287,763574,,0,0,0,PDN
MP245,,2017,1973,,0,4291287,763574,,0,4291287,763574,,0,0,0,PDN
MP245,,2017,1973,,0,4291287,763574,,0,4291287,763574,,0,0,0,PDN
MP250,,1997,1997,,113,1129434,201080,,0,0,0,,113,1129434,201080,PDN
MP250,,1998,1997,,113,1129434,201080,,0,0,0,,113,1129434,201080,PDN
MP250,,1999,1997,,101535,15530885,2865038,,39070,5156524,956601,,62465,10374361,1908437,PDN
MP250,,2000,1997,,101535,15530885,2865038,,58944,10019072,1841697,,42591,5511813,1023341,PDN
MP250,,2001,1997,,101535,15530885,2865038,,65467,11963503,2194204,,36068,3567382,670834,PDN
MP250,,2002,1997,,101535,15530885,2865038,,69721,12624127,2316007,,31814,2906758,549031,PDN
MP250,,2003,1997,,85975,14167415,2606867,,70165,12877905,2361607,,15810,1289510,245260,PDN
MP250,,2004,1997,,73710,13377650,2454075,,70763,13021644,2387782,,2947,356006,66293,PDN
MP250,,2005,1997,,73710,13377650,2454075,,70763,13104087,2402451,,2947,273563,51624,PDN
MP250,,2006,1997,,77331,13377650,2457696,,71539,13157055,2412652,,5792,220595,45044,PDN
MP250,,2007,1997,,77331,13377650,2457696,,74510,13264829,2434800,,2821,112821,22896,PDN
MP250,,2008,1997,,77933,13493331,2478882,,75015,13338151,2448351,,2918,155180,30531,PDN
MP250,,2009,1997,,78026,13550715,2489185,,75420,13489404,2475670,,2606,61311,13516,PDN
MP250,,2010,1997,,78021,13549637,2488988,,75508,13545710,2485777,,2513,3927,3212,PDN
MP250,,2011,1997,,75508,13545710,2485777,,75508,13545710,2485777,,0,0,0,PDN
MP250,,2012,1997,,75508,13545710,2485777,,75508,13545710,2485777,,0,0,0,PDN
MP250,,2013,1997,,75508,13545710,2485777,,75508,13545710,2485777,,0,0,0,PDN
MP250,,2014,1997,,75508,13545710,2485777,,75508,13545710,2485777,,0,0,0,PDN
MP250,,2015,1997,,75508,13545710,2485777,,75508,13545710,2485777,,0,0,0,PDN
MP250,,2016,1997,,75508,13545710,2485777,,75508,13545710,2485777,,0,0,0,PDN
MP250,,2017,1997,,75508,13545710,2485777,,75508,13545710,2485777,,0,0,0,PDN
MP250,,2017,1997,,75508,13545710,2485777,,75508,13545710,2485777,,0,0,0,PDN
MP252,,1987,1985,,20449,4314705,788190,,0,0,0,,20449,4314705,788190,PDN
MP252,,1988,1985,,20449,4314705,788190,,0,0,0,,20449,4314705,788190,PDN
MP252,,1989,1985,,20449,4314705,788190,,0,0,0,,20449,4314705,788190,PDN
MP252,,1990,1985,,5080,50799552,9044146,,0,0,0,,5080,50799552,9044146,PDN
MP252,,1991,1985,,5080,50799552,9044146,,0,0,0,,5080,50799552,9044146,PDN
MP252,,1992,1985,,74486,50799552,9113552,,13691,9334524,1674638,,60795,41465028,7438914,PDN
MP252,,1993,1985,,74486,50799552,9113552,,24637,31026316,5545334,,49849,19773236,3568218,PDN
MP252,,1994,1985,,63596,113565961,20271062,,37261,48502463,8667592,,26335,65063498,11603470,PDN
MP252,,1995,1985,,95597,118405086,21164118,,65085,71590212,12803557,,30512,46814874,8360561,PDN
MP252,,1996,1985,,118163,144887739,25898899,,82000,91245659,16317882,,36163,53642080,9581017,PDN
MP252,,1997,1985,,118163,144887739,25898899,,90794,104381878,18664082,,27369,40505861,7234817,PDN
MP252,,1998,1985,,118163,144887739,25898899,,87080,112970047,20188512,,31083,31917692,5710387,PDN
MP252,,1999,1985,,118056,133785263,23923263,,87080,118009368,21085188,,30976,15775895,2838075,PDN
MP252,,2000,1985,,119938,135809259,24285287,,87080,120136446,21463672,,32858,15672813,2821615,PDN
MP252,,2001,1985,,120108,136881259,24476204,,87080,121776565,21755508,,33028,15104694,2720696,PDN
MP252,,2002,1985,,120108,136881259,24476204,,87080,122580600,21898575,,33028,14300659,2577629,PDN
MP252,,2003,1985,,112403,135240950,24176629,,87080,122621312,21905819,,25323,12619638,2270810,PDN
MP252,,2004,1985,,87080,122621312,21905819,,87080,122621312,21905819,,0,0,0,PDN
MP252,,2005,1985,,87080,122621312,21905819,,87080,122621312,21905819,,0,0,0,PDN
MP252,,2006,1985,,87080,122621312,21905819,,87080,122621312,21905819,,0,0,0,PDN
MP252,,2007,1985,,87080,122621312,21905819,,87080,122621312,21905819,,0,0,0,PDN
MP252,,2008,1985,,87080,122621312,21905819,,87080,122621312,21905819,,0,0,0,PDN
MP252,,2009,1985,,87080,124832200,22299216,,87080,124832200,22299216,,0,0,0,PDN
MP252,,2010,1985,,87080,124832200,22299216,,87080,124832200,22299216,,0,0,0,PDN
MP252,,2011,1985,,87080,124832200,22299216,,87080,124832200,22299216,,0,0,0,PDN
MP252,,2012,1985,,87080,124832200,22299216,,87080,124832200,22299216,,0,0,0,PDN
MP252,,2013,1985,,87080,124832200,22299216,,87080,124832200,22299216,,0,0,0,PDN
MP252,,2014,1985,,87080,124832200,22299216,,87080,124832200,22299216,,0,0,0,PDN
MP252,,2015,1985,,87080,124832200,22299216,,87080,124832200,22299216,,0,0,0,PDN
MP252,,2016,1985,,87080,124832200,22299216,,87080,124832200,22299216,,0,0,0,PDN
MP252,,2017,1985,,87080,124832200,22299216,,87080,124832200,22299216,,0,0,0,PDN
MP252,,2017,1985,,87080,124832200,22299216,,87080,124832200,22299216,,0,0,0,PDN
MP253,,1975,1972,,1000,0,1000,,0,0,0,,1000,0,1000,PDN
MP253,,1976,1972,,1000,0,1000,,0,0,0,,1000,0,1000,PDN
MP253,,1983,1972,,10000,18000,13203,,9815,16324,12720,,185,1676,483,PDN
MP253,,1984,1972,,9815,16324,12720,,9815,16324,12720,,0,0,0,PDN
MP253,,1985,1972,,9815,16324,12720,,9815,16324,12720,,0,0,0,PDN
MP253,,1986,1972,,9815,16324,12720,,9815,16324,12720,,0,0,0,PDN
MP253,,1987,1972,,9815,16324,12720,,9815,16324,12720,,0,0,0,PDN
MP253,,1988,1972,,726964,2096849,1100069,,54304,324655,112072,,672660,1772194,987997,PDN
MP253,,1989,1972,,3080277,4374130,3858592,,54304,324655,112072,,3025973,4049475,3746520,PDN
MP253,,1990,1972,,3080277,4374130,3858592,,54304,324655,112072,,3025973,4049475,3746520,PDN
MP253,,1991,1972,,3080277,4374130,3858592,,54304,324655,112072,,3025973,4049475,3746520,PDN
MP253,,1992,1972,,3080277,4374130,3858592,,54304,324655,112072,,3025973,4049475,3746520,PDN
MP253,,1993,1972,,3080277,4374130,3858592,,54304,324655,112072,,3025973,4049475,3746520,PDN
MP253,,1994,1972,,54304,324655,112072,,54304,324655,112072,,0,0,0,PDN
MP253,,1995,1972,,54304,324655,112072,,54304,324655,112072,,0,0,0,PDN
MP253,,1996,1972,,54304,324655,112072,,54304,324655,112072,,0,0,0,PDN
MP253,,1997,1972,,54304,324655,112072,,54304,324655,112072,,0,0,0,PDN
MP253,,1998,1972,,54304,324655,112072,,54304,324655,112072,,0,0,0,PDN
MP253,,1999,1972,,54304,324655,112072,,54304,324655,112072,,0,0,0,PDN
MP253,,2000,1972,,54304,324655,112072,,54304,324655,112072,,0,0,0,PDN
MP253,,2001,1972,,54304,324655,112072,,54304,324655,112072,,0,0,0,PDN
MP253,,2002,1972,,54304,324655,112072,,54304,324655,112072,,0,0,0,PDN
MP253,,2003,1972,,54304,324655,112072,,54304,324655,112072,,0,0,0,PDN
MP253,,2004,1972,,54304,324655,112072,,54304,324655,112072,,0,0,0,PDN
MP253,,2005,1972,,54304,324655,112072,,54304,324655,112072,,0,0,0,PDN
MP253,,2006,1972,,54304,324655,112072,,54304,324655,112072,,0,0,0,PDN
MP253,,2007,1972,,54304,324655,112072,,54304,324655,112072,,0,0,0,PDN
MP253,,2008,1972,,54304,324655,112072,,54304,324655,112072,,0,0,0,PDN
MP253,,2009,1972,,54304,331158,113229,,54304,331158,113229,,0,0,0,PDN
MP253,,2010,1972,,54304,331158,113229,,54304,331158,113229,,0,0,0,PDN
MP253,,2011,1972,,54304,331158,113229,,54304,331158,113229,,0,0,0,PDN
MP253,,2012,1972,,54304,331158,113229,,54304,331158,113229,,0,0,0,PDN
MP253,,2013,1972,,54304,331158,113229,,54304,331158,113229,,0,0,0,PDN
MP253,,2014,1972,,54304,331158,113229,,54304,331158,113229,,0,0,0,PDN
MP253,,2015,1972,,54304,331158,113229,,54304,331158,113229,,0,0,0,PDN
MP253,,2016,1972,,54304,331158,113229,,54304,331158,113229,,0,0,0,PDN
MP253,,2017,1972,,54304,331158,113229,,54304,331158,113229,,0,0,0,PDN
MP253,,2017,1972,,54304,331158,113229,,54304,331158,113229,,0,0,0,PDN
MP255,,1994,1990,,1732,17323096,3084133,,623,1002330,178974,,1109,16320766,2905159,PDN
MP255,,1995,1990,,17052,17323096,3099453,,16756,16505976,2953762,,296,817120,145691,PDN
MP255,,1996,1990,,82399,79926819,14304253,,29975,29388756,5259291,,52424,50538063,9044962,PDN
MP255,,1997,1990,,87676,84772085,15171677,,41730,40307655,7213911,,45946,44464430,7957766,PDN
MP255,,1998,1990,,91246,94446058,16896594,,64080,63836504,11422889,,27166,30609554,5473705,PDN
MP255,,1999,1990,,171128,194514506,34782250,,83006,91050482,16284159,,88122,103464024,18498091,PDN
MP255,,2000,1990,,171128,194514483,34782246,,98574,113241221,20248257,,72554,81273262,14533989,PDN
MP255,,2001,1990,,171128,194514483,34782246,,108950,129464789,23145389,,62178,65049694,11636857,PDN
MP255,,2002,1990,,171128,194514483,34782246,,116173,141708445,25331199,,54955,52806038,9451047,PDN
MP255,,2003,1990,,165811,186202826,33297986,,121527,151676637,27110252,,44284,34526189,6187734,PDN
MP255,,2004,1990,,132553,186202826,33264728,,124485,158419156,28312947,,8068,27783670,4951781,PDN
MP255,,2005,1990,,132553,186202826,33264728,,126269,163249947,29174302,,6284,22952879,4090426,PDN
MP255,,2006,1990,,132553,186202826,33264728,,127845,168074804,30034394,,4708,18128022,3230334,PDN
MP255,,2007,1990,,132553,186202826,33264728,,128982,171551483,30654157,,3571,14651343,2610571,PDN
MP255,,2008,1990,,132553,186202826,33264728,,129966,174283889,31141334,,2587,11918937,2123394,PDN
MP255,,2009,1990,,133329,182438428,32595682,,130639,177497736,31713865,,2690,4940692,881817,PDN
MP255,,2010,1990,,132915,182438428,32595268,,131202,178885950,31961441,,1713,3552478,633827,PDN
MP255,,2011,1990,,132915,182438428,32595268,,131577,180072218,32172896,,1338,2366210,422372,PDN
MP255,,2012,1990,,132915,182438428,32595268,,131840,180957494,32330681,,1075,1480934,264587,PDN
MP255,,2013,1990,,132915,182438428,32595268,,132112,181528112,32432487,,803,910316,162781,PDN
MP255,,2014,1990,,132112,181528112,32432487,,132112,181528112,32432487,,0,0,0,PDN
MP255,,2015,1990,,132112,181528112,32432487,,132112,181528112,32432487,,0,0,0,PDN
MP255,,2016,1990,,132112,181528112,32432487,,132112,181528112,32432487,,0,0,0,PDN
MP255,,2017,1990,,132112,181528112,32432487,,132112,181528112,32432487,,0,0,0,PDN
MP255,,2017,1990,,132112,181528112,32432487,,132112,181528112,32432487,,0,0,0,PDN
MP256,,1997,1990,,0,17516945,3116894,,0,0,0,,0,17516945,3116894,PDN
MP256,,1998,1990,,0,17516945,3116894,,0,0,0,,0,17516945,3116894,PDN
MP256,,1999,1990,,0,21552844,3835026,,0,5240149,932411,,0,16312695,2902615,PDN
MP256,,2000,1990,,253535,21740607,4121970,,0,6545951,1164760,,253535,15194656,2957210,PDN
MP256,,2001,1990,,0,6559654,1167198,,0,6559654,1167198,,0,0,0,PDN
MP256,,2002,1990,,0,6559654,1167198,,0,6559654,1167198,,0,0,0,PDN
MP256,,2003,1990,,0,6559654,1167198,,0,6559654,1167198,,0,0,0,PDN
MP256,,2004,1990,,0,6559654,1167198,,0,6559654,1167198,,0,0,0,PDN
MP256,,2005,1990,,0,6559654,1167198,,0,6559654,1167198,,0,0,0,PDN
MP256,,2006,1990,,0,6559654,1167198,,0,6559654,1167198,,0,0,0,PDN
MP256,,2007,1990,,0,6559654,1167198,,0,6559654,1167198,,0,0,0,PDN
MP256,,2008,1990,,0,6559654,1167198,,0,6559654,1167198,,0,0,0,PDN
MP256,,2009,1990,,0,6559654,1167198,,0,6559654,1167198,,0,0,0,PDN
MP256,,2010,1990,,0,6559654,1167198,,0,6559654,1167198,,0,0,0,PDN
MP256,,2011,1990,,0,6559654,1167198,,0,6559654,1167198,,0,0,0,PDN
MP256,,2012,1990,,0,6559654,1167198,,0,6559654,1167198,,0,0,0,PDN
MP256,,2013,1990,,0,6559654,1167198,,0,6559654,1167198,,0,0,0,PDN
MP256,,2014,1990,,0,6559654,1167198,,0,6559654,1167198,,0,0,0,PDN
MP256,,2015,1990,,0,6559654,1167198,,0,6559654,1167198,,0,0,0,PDN
MP256,,2016,1990,,0,6559654,1167198,,0,6559654,1167198,,0,0,0,PDN
MP256,,2017,1990,,0,6559654,1167198,,0,6559654,1167198,,0,0,0,PDN
MP256,,2017,1990,,0,6559654,1167198,,0,6559654,1167198,,0,0,0,PDN
MP259,,1994,1990,,8489,84895674,15114481,,0,15306,2723,,8489,84880368,15111758,PDP
MP259,,1995,1990,,246632,95209886,17187893,,113174,12175228,2279585,,133458,83034658,14908308,PDP
MP259,,1996,1990,,2325745,120390093,23747470,,816724,39232821,7797653,,1509021,81157272,15949817,PDP
MP259,,1997,1990,,2999009,136436931,27276043,,1807577,71399472,14512109,,1191432,65037459,12763934,PDP
MP259,,1998,1990,,3443990,161380774,32159430,,2201348,98664255,19757265,,1242642,62716519,12402165,PDP
MP259,,1999,1990,,4836772,194481893,39442091,,2846366,126185713,25299340,,1990406,68296180,14142751,PDP
MP259,,2000,1990,,4400014,183493442,37050093,,3301519,143632139,28858839,,1098495,39861303,8191254,PDP
MP259,,2001,1990,,4993740,194389113,39582550,,3555791,154227913,30998480,,1437949,40161200,8584070,PDP
MP259,,2002,1990,,4928777,197311202,40037532,,3867238,167907514,33744020,,1061539,29403688,6293512,PDP
MP259,,2003,1990,,4894334,207173691,41757980,,4093775,180999592,36300108,,800559,26174099,5457872,PDP
MP259,,2004,1990,,4937076,205073240,41426976,,4266160,191438296,38329914,,670916,13634944,3097062,PDP
MP259,,2005,1990,,5559930,242356503,48683863,,4418719,199421042,39902890,,1141211,42935461,8780973,PDP
MP259,,2006,1990,,5559930,242356503,48683863,,4519006,206435582,41251316,,1040924,35920921,7432547,PDP
MP259,,2007,1990,,5559930,242356503,48683863,,4588067,212300987,42364043,,971863,30055516,6319820,PDP
MP259,,2008,1990,,5599777,242356503,48723710,,4630310,216948054,43233167,,969467,25408449,5490543,PDP
MP259,,2009,1990,,5221377,238823669,47716692,,4662674,222371180,44230500,,558703,16452489,3486192,PDP
MP259,,2010,1990,,5205102,239543551,47828510,,4689611,225553855,44823748,,515491,13989696,3004761,PDP
MP259,,2011,1990,,5205102,239543551,47828510,,4710673,228037024,45286655,,494429,11506527,2541854,PDP
MP259,,2012,1990,,5204486,239836342,47879992,,4721376,230035195,45652906,,483110,9801147,2227086,PDP
MP259,,2013,1990,,5204486,239836342,47879992,,4730217,231664046,45951577,,474269,8172296,1928414,PDP
MP259,,2014,1990,,4883754,236958690,47047221,,4736461,232776167,46155707,,147293,4182523,891513,PDP
MP259,,2015,1990,,4919581,237270967,47138614,,4768809,233778059,46366328,,150772,3492908,772286,PDP
MP259,,2016,1990,,5074123,239210879,47638335,,4810538,234975620,46621147,,263585,4235259,1017189,PDP
MP259,,2017,1990,,4835420,237078894,47020277,,4816126,235626144,46742486,,19294,1452750,277789,PDP
MP259,,2017,1990,,4835420,237078894,47020277,,4816126,235626144,46742486,,19294,1452750,277789,PDP
MP261,,1997,1996,,8080609,60011783,18758862,,1500,0,1500,,8079109,60011783,18757362,PDN
MP261,,1998,1996,,8194653,74047862,21370429,,435279,17414424,3533931,,7759374,56633438,17836498,PDN
MP261,,1999,1996,,7427320,57903087,17730360,,505285,21948030,4410628,,6922035,35955057,13319732,PDN
MP261,,2000,1996,,7460368,54897258,17228563,,537993,22902352,4613145,,6922375,31994906,12615418,PDN
MP261,,2001,1996,,7461290,54926934,17234766,,542637,23357328,4698745,,6918653,31569606,12536021,PDN
MP261,,2002,1996,,1230048,30696491,6692057,,550023,23935506,4809010,,680025,6760985,1883047,PDN
MP261,,2003,1996,,1240365,30733945,6709038,,558525,24178125,4860682,,681840,6555820,1848356,PDN
MP261,,2004,1996,,1240365,30733945,6709038,,561112,24249432,4875958,,679253,6484513,1833080,PDN
MP261,,2005,1996,,1240365,30733945,6709038,,562147,24258179,4878549,,678218,6475766,1830489,PDN
MP261,,2006,1996,,1230406,30261388,6614995,,562147,24258179,4878549,,668259,6003209,1736446,PDN
MP261,,2007,1996,,561660,24258179,4878062,,561660,24258179,4878062,,0,0,0,PDN
MP261,,2008,1996,,561660,24258179,4878062,,561660,24258179,4878062,,0,0,0,PDN
MP261,,2009,1996,,561660,24463121,4914530,,561660,24463121,4914530,,0,0,0,PDN
MP261,,2010,1996,,561660,24463121,4914530,,561660,24463121,4914530,,0,0,0,PDN
MP261,,2011,1996,,561660,24463121,4914530,,561660,24463121,4914530,,0,0,0,PDN
MP261,,2012,1996,,561660,24463121,4914530,,561660,24463121,4914530,,0,0,0,PDN
MP261,,2013,1996,,561660,24463121,4914530,,561660,24463121,4914530,,0,0,0,PDN
MP261,,2014,1996,,561660,24463121,4914530,,561660,24463121,4914530,,0,0,0,PDN
MP261,,2015,1996,,561660,24463121,4914530,,561660,24463121,4914530,,0,0,0,PDN
MP261,,2016,1996,,561660,24463121,4914530,,561660,24463121,4914530,,0,0,0,PDN
MP261,,2017,1996,,561660,24463121,4914530,,561660,24463121,4914530,,0,0,0,PDN
MP261,,2017,1996,,561660,24463121,4914530,,561660,24463121,4914530,,0,0,0,PDN
MP262,,1994,1990,,898,8983090,1599313,,0,0,0,,898,8983090,1599313,PDN
MP262,,1995,1990,,809,8094499,1441111,,0,3437341,611627,,809,4657158,829484,PDN
MP262,,1996,1990,,1538,15379683,2738136,,0,10092660,1795847,,1538,5287023,942289,PDN
MP262,,1997,1990,,248,15987149,2844936,,0,13510152,2403942,,248,2476997,440994,PDN
MP262,,1998,1990,,0,13539542,2409171,,0,13539542,2409171,,0,0,0,PDN
MP262,,1999,1990,,0,13539542,2409171,,0,13539542,2409171,,0,0,0,PDN
MP262,,2000,1990,,0,13539542,2409171,,0,13539542,2409171,,0,0,0,PDN
MP262,,2001,1990,,0,13539542,2409171,,0,13539542,2409171,,0,0,0,PDN
MP262,,2002,1990,,0,13539542,2409171,,0,13539542,2409171,,0,0,0,PDN
MP262,,2003,1990,,0,13539542,2409171,,0,13539542,2409171,,0,0,0,PDN
MP262,,2004,1990,,0,13539542,2409171,,0,13539542,2409171,,0,0,0,PDN
MP262,,2005,1990,,0,13539542,2409171,,0,13539542,2409171,,0,0,0,PDN
MP262,,2006,1990,,0,13539542,2409171,,0,13539542,2409171,,0,0,0,PDN
MP262,,2007,1990,,0,13539542,2409171,,0,13539542,2409171,,0,0,0,PDN
MP262,,2008,1990,,0,13539542,2409171,,0,13539542,2409171,,0,0,0,PDN
MP262,,2009,1990,,0,13810698,2457419,,0,13810698,2457419,,0,0,0,PDN
MP262,,2010,1990,,0,13810698,2457419,,0,13810698,2457419,,0,0,0,PDN
MP262,,2011,1990,,0,13810698,2457419,,0,13810698,2457419,,0,0,0,PDN
MP262,,2012,1990,,0,13810698,2457419,,0,13810698,2457419,,0,0,0,PDN
MP262,,2013,1990,,0,13810698,2457419,,0,13810698,2457419,,0,0,0,PDN
MP262,,2014,1990,,0,13810698,2457419,,0,13810698,2457419,,0,0,0,PDN
MP262,,2015,1990,,0,13810698,2457419,,0,13810698,2457419,,0,0,0,PDN
MP262,,2016,1990,,0,13810698,2457419,,0,13810698,2457419,,0,0,0,PDN
MP262,,2017,1990,,0,13810698,2457419,,0,13810698,2457419,,0,0,0,PDN
MP262,,2017,1990,,0,13810698,2457419,,0,13810698,2457419,,0,0,0,PDN
MP265,,1975,1967,,144068,14406830,2707561,,0,0,0,,144068,14406830,2707561,PDP
MP265,,1976,1967,,144068,14406830,2707561,,0,0,0,,144068,14406830,2707561,PDP
MP265,,1977,1967,,144068,14406830,2707561,,0,0,0,,144068,14406830,2707561,PDP
MP265,,1985,1967,,332196,9279708,1983390,,105280,1832410,431332,,226916,7447298,1552058,PDP
MP265,,1986,1967,,332196,9279708,1983390,,159995,2710959,642372,,172201,6568749,1341018,PDP
MP265,,1987,1967,,864109,14823750,3501787,,175135,3015244,711655,,688974,11808506,2790132,PDP
MP265,,1988,1967,,397821,6759159,1600518,,305013,5689843,1317441,,92808,1069316,283077,PDP
MP265,,1989,1967,,705649,11933746,2829091,,405103,8503990,1918268,,300546,3429756,910823,PDP
MP265,,1990,1967,,705649,11933746,2829091,,467280,10622510,2357406,,238369,1311236,471685,PDP
MP265,,1991,1967,,973346,16433746,3897500,,525186,12632019,2772876,,448160,3801727,1124624,PDP
MP265,,1992,1967,,973346,16433746,3897500,,543528,13459282,2938418,,429818,2974464,959082,PDP
MP265,,1993,1967,,741472,18533746,4039292,,567217,14157960,3086427,,174255,4375786,952865,PDP
MP265,,1994,1967,,741472,18533746,4039292,,581347,14908710,3234142,,160125,3625036,805150,PDP
MP265,,1995,1967,,741472,18533746,4039292,,599821,15656431,3385663,,141651,2877315,653629,PDP
MP265,,1996,1967,,741472,18533746,4039292,,615460,16165821,3491941,,126012,2367925,547351,PDP
MP265,,1997,1967,,615543,16165899,3492037,,615543,16165899,3492037,,0,0,0,PDP
MP265,,1998,1967,,615543,16165899,3492037,,615543,16165899,3492037,,0,0,0,PDP
MP265,,1999,1967,,818296,90915667,16995461,,615543,16165899,3492037,,202753,74749768,13503424,PDP
MP265,,2000,1967,,2238102,127917732,24999264,,965363,24258207,5281770,,1272739,103659525,19717494,PDP
MP265,,2001,1967,,4034504,150095998,30741977,,1668677,43912309,9482255,,2365827,106183689,21259722,PDP
MP265,,2002,1967,,4289271,157941575,32392754,,2227422,60940923,13071003,,2061849,97000652,19321751,PDP
MP265,,2003,1967,,3485960,132112080,26993448,,2454765,67616092,14486098,,1031195,64495988,12507350,PDP
MP265,,2004,1967,,3048589,127531786,25741078,,2567818,71434008,15278496,,480771,56097778,10462582,PDP
MP265,,2005,1967,,3064198,129558684,26117345,,2695510,75032966,16046572,,368688,54525718,10070773,PDP
MP265,,2006,1967,,3270307,137725311,27776590,,2902361,80100916,17155193,,367946,57624395,10621397,PDP
MP265,,2007,1967,,3161306,107190863,22234413,,2949355,82168611,17570104,,211951,25022252,4664309,PDP
MP265,,2008,1967,,3159458,107076972,22212300,,2990749,84945427,18105594,,168709,22131545,4106706,PDP
MP265,,2009,1967,,3412360,107147871,22477818,,3114909,87817175,18740741,,297451,19330696,3737077,PDP
MP265,,2010,1967,,3397802,107523644,22530123,,3210791,90481892,19310772,,187011,17041752,3219351,PDP
MP265,,2011,1967,,3489428,112503848,23507906,,3282473,92801974,19795278,,206955,19701874,3712627,PDP
MP265,,2012,1967,,3489428,112503848,23507906,,3333001,94701658,20183828,,156427,17802190,3324078,PDP
MP265,,2013,1967,,3489428,112503848,23507906,,3370203,96499868,20540996,,119225,16003980,2966908,PDP
MP265,,2014,1967,,3419970,144704686,29168133,,3396610,97809638,20800458,,23360,46895048,8367675,PDP
MP265,,2015,1967,,3642838,142456813,28991024,,3445193,103571936,21874361,,197645,38884877,7116661,PDP
MP265,,2016,1967,,3530775,132915187,27181163,,3476212,110597975,23155564,,54563,22317212,4025597,PDP
MP265,,2017,1967,,3538824,132673980,27146292,,3482019,112086325,23426203,,56805,20587655,3720089,PDP
MP265,,2017,1967,,3538824,132673980,27146292,,3482019,112086325,23426203,,56805,20587655,3720089,PDP
MP267,,1999,2000,,595,5947778,1058918,,0,0,0,,595,5947778,1058918,PDN
MP267,,2000,2000,,595,5947778,1058918,,1,1305013,232210,,594,4642765,826708,PDN
MP267,,2001,2000,,2203,22029599,3922060,,1,2669027,474917,,2202,19360572,3447143,PDN
MP267,,2002,2000,,2203,22029599,3922060,,1,3532319,628528,,2202,18497280,3293532,PDN
MP267,,2003,2000,,10,4696650,835713,,1,3929964,699283,,9,766686,136430,PDN
MP267,,2004,2000,,10,4696650,835713,,1,4135729,735896,,9,560921,99817,PDN
MP267,,2005,2000,,10,4696650,835713,,1,4202767,747824,,9,493883,87889,PDN
MP267,,2006,2000,,10,4696650,835713,,1,4295007,764237,,9,401643,71476,PDN
MP267,,2007,2000,,10,4696650,835713,,1,4535053,806950,,9,161597,28763,PDN
MP267,,2008,2000,,10,4696650,835713,,1,4380749,779494,,9,315901,56219,PDN
MP267,,2009,2000,,1,4384879,780229,,1,4384879,780229,,0,0,0,PDN
MP267,,2010,2000,,1,4384879,780229,,1,4384879,780229,,0,0,0,PDN
MP267,,2011,2000,,1,4384879,780229,,1,4384879,780229,,0,0,0,PDN
MP267,,2012,2000,,1,4384879,780229,,1,4384879,780229,,0,0,0,PDN
MP267,,2013,2000,,1,4384879,780229,,1,4384879,780229,,0,0,0,PDN
MP267,,2014,2000,,1,4384879,780229,,1,4384879,780229,,0,0,0,PDN
MP267,,2015,2000,,1,4384879,780229,,1,4384879,780229,,0,0,0,PDN
MP267,,2016,2000,,1,4384879,780229,,1,4384879,780229,,0,0,0,PDN
MP267,,2017,2000,,1,4384879,780229,,1,4384879,780229,,0,0,0,PDN
MP267,,2017,2000,,1,4384879,780229,,1,4384879,780229,,0,0,0,PDN
MP273,,1986,1967,,28259,4917013,903172,,0,0,0,,28259,4917013,903172,PDP
MP273,,1987,1967,,28259,4917013,903172,,0,0,0,,28259,4917013,903172,PDP
MP273,,1989,1967,,1485,14850242,2643877,,0,0,0,,1485,14850242,2643877,PDP
MP273,,1990,1967,,1903,14850242,2644295,,683,2561325,456435,,1220,12288917,2187860,PDP
MP273,,1991,1967,,10680,29112839,5190900,,4252,11395025,2031837,,6428,17717814,3159063,PDP
MP273,,1992,1967,,15001,46112839,8220132,,7890,23602690,4207657,,7111,22510149,4012475,PDP
MP273,,1993,1967,,15001,46112839,8220132,,9211,28911368,5153583,,5790,17201471,3066549,PDP
MP273,,1994,1967,,15118,47280423,8428005,,9647,30372729,5414047,,5471,16907694,3013958,PDP
MP273,,1995,1967,,11989,40539679,7225455,,9647,31523545,5618819,,2342,9016134,1606636,PDP
MP273,,1996,1967,,9647,31781829,5664777,,9647,31780773,5664589,,0,1056,188,PDP
MP273,,1997,1967,,9647,31781829,5664777,,9647,31781829,5664777,,0,0,0,PDP
MP273,,1998,1967,,9647,31781829,5664777,,9647,31781829,5664777,,0,0,0,PDP
MP273,,1999,1967,,9647,31781829,5664777,,9647,31781829,5664777,,0,0,0,PDP
MP273,,2000,1967,,9647,31781829,5664777,,9647,31781829,5664777,,0,0,0,PDP
MP273,,2001,1967,,9647,31781829,5664777,,9647,31781829,5664777,,0,0,0,PDP
MP273,,2002,1967,,9647,31781829,5664777,,9647,31781829,5664777,,0,0,0,PDP
MP273,,2003,1967,,360801,47358205,8787528,,175702,39218983,7154169,,185099,8139222,1633359,PDP
MP273,,2004,1967,,360801,47358205,8787528,,339322,46074667,8537661,,21479,1283538,249867,PDP
MP273,,2005,1967,,686729,57764209,10965058,,356175,46611820,8650093,,330554,11152389,2314965,PDP
MP273,,2006,1967,,913484,66826229,12804272,,521840,52638760,9888167,,391644,14187469,2916105,PDP
MP273,,2007,1967,,913484,66826229,12804272,,707019,59378564,11272600,,206465,7447665,1531672,PDP
MP273,,2008,1967,,913484,66826229,12804272,,758893,61584854,11717052,,154591,5241375,1087220,PDP
MP273,,2009,1967,,1087650,78536536,15062123,,877840,66999945,12799539,,209810,11536591,2262584,PDP
MP273,,2010,1967,,1136548,80336720,15431338,,943370,70127814,13421629,,193178,10208906,2009709,PDP
MP273,,2011,1967,,1136548,80336720,15431338,,995025,73216284,14022834,,141523,7120436,1408504,PDP
MP273,,2012,1967,,1136548,80336720,15431338,,1042756,75734397,14518627,,93792,4602323,912711,PDP
MP273,,2013,1967,,1178199,81687216,15713291,,1109107,78400817,15059431,,69092,3286399,653860,PDP
MP273,,2014,1967,,1164460,80402703,15470991,,1154383,80067440,15401259,,10077,335263,69732,PDP
MP273,,2015,1967,,1162459,80348550,15459354,,1162459,80348550,15459354,,0,0,0,PDP
MP273,,2016,1967,,3073797,153724827,30426969,,1162459,80348550,15459354,,1911338,73376277,14967615,PDP
MP273,,2017,1967,,3073797,153724827,30426969,,1172821,80872157,15562885,,1900976,72852670,14864085,PDP
MP273,,2017,1967,,3073797,153724827,30426969,,1172821,80872157,15562885,,1900976,72852670,14864085,PDP
MP277,,1999,1970,,2805,28045489,4993106,,0,0,0,,2805,28045489,4993106,PDN
MP277,,2000,1970,,134123,8622017,1668290,,18887,1885257,354342,,115236,6736760,1313948,PDN
MP277,,2001,1970,,291572,12596845,2533003,,117885,6154659,1213020,,173687,6442186,1319983,PDN
MP277,,2002,1970,,291545,12596781,2532965,,185854,7322851,1488852,,105691,5273930,1044113,PDN
MP277,,2003,1970,,313086,13185201,2659207,,227161,7810552,1616939,,85925,5374649,1042268,PDN
MP277,,2004,1970,,259433,9460599,1942814,,241105,8193991,1699111,,18328,1266608,243703,PDN
MP277,,2005,1970,,259433,10579261,2141864,,244471,8699464,1792418,,14962,1879797,349446,PDN
MP277,,2006,1970,,268419,10583030,2151520,,254219,8903079,1838397,,14200,1679951,313123,PDN
MP277,,2007,1970,,278145,11833353,2383724,,268932,9832300,2018452,,9213,2001053,365272,PDN
MP277,,2008,1970,,279108,11840584,2385973,,277891,10312939,2112934,,1217,1527645,273039,PDN
MP277,,2009,1970,,279110,13529713,2686532,,278812,10978068,2232205,,298,2551645,454327,PDN
MP277,,2010,1970,,279110,15204683,2984569,,278812,12057546,2424282,,298,3147137,560287,PDN
MP277,,2011,1970,,279110,15204683,2984569,,278812,12139496,2438864,,298,3065187,545705,PDN
MP277,,2012,1970,,293215,15103717,2980708,,288570,12168144,2453720,,4645,2935573,526989,PDN
MP277,,2013,1970,,293215,15103717,2980708,,292954,12174747,2459278,,261,2928970,521430,PDN
MP277,,2014,1970,,299696,13331267,2671807,,296664,12181139,2464126,,3032,1150128,207681,PDN
MP277,,2015,1970,,305999,13332373,2678307,,305884,12184843,2474005,,115,1147530,204302,PDN
MP277,,2016,1970,,305884,12184843,2474005,,305884,12184843,2474005,,0,0,0,PDN
MP277,,2017,1970,,305884,12184843,2474005,,305884,12184843,2474005,,0,0,0,PDN
MP277,,2017,1970,,305884,12184843,2474005,,305884,12184843,2474005,,0,0,0,PDN
MP280,,1998,1997,,1547103,26152552,6200582,,0,0,0,,1547103,26152552,6200582,PDP
MP280,,1999,1997,,8144934,116466466,28868504,,2035140,22600385,6056561,,6109794,93866081,22811943,PDP
MP280,,2000,1997,,8894349,125607848,31244500,,4313398,53850816,13895394,,4580951,71757032,17349106,PDP
MP280,,2001,1997,,13433470,135432009,37531692,,6525220,77205931,20262930,,6908250,58226078,17268762,PDP
MP280,,2002,1997,,14939624,150172513,41660712,,9289660,93698470,25961986,,5649964,56474043,15698726,PDP
MP280,,2003,1997,,14946947,149913433,41621935,,11324789,109162831,30748780,,3622158,40750602,10873155,PDP
MP280,,2004,1997,,16260236,152510657,43397364,,12660627,119597574,33941334,,3599609,32913083,9456030,PDP
MP280,,2005,1997,,18790281,160753185,47394051,,14085219,128038869,36867936,,4705062,32714316,10526115,PDP
MP280,,2006,1997,,18782044,159949712,47242847,,15878533,136091330,40094072,,2903511,23858382,7148775,PDP
MP280,,2007,1997,,18782044,159949712,47242847,,16889271,140031140,41805844,,1892773,19918572,5437003,PDP
MP280,,2008,1997,,18782044,160271809,47300159,,17417822,143172186,42893300,,1364222,17099623,4406859,PDP
MP280,,2009,1997,,18870291,164787531,48191918,,17686884,145836541,43636447,,1183407,18950990,4555469,PDP
MP280,,2010,1997,,19378499,167378660,49161179,,17895674,147866881,44206508,,1482825,19511779,4954672,PDP
MP280,,2011,1997,,19378499,167378660,49161179,,18273433,149767425,44922441,,1105066,17611235,4238738,PDP
MP280,,2012,1997,,19180573,166844835,48868267,,18684228,151245948,45596318,,496345,15598887,3271948,PDP
MP280,,2013,1997,,20318609,165200104,49713646,,19099308,152880195,46302190,,1219301,12319909,3411456,PDP
MP280,,2014,1997,,20328920,165207192,49725219,,19438131,155964702,47189858,,890789,9242490,2535360,PDP
MP280,,2015,1997,,20403343,166508956,50031273,,19748265,158502291,47951520,,655078,8006665,2079753,PDP
MP280,,2016,1997,,17867347,158898390,46141081,,17441806,155561801,45121840,,425541,3336589,1019241,PDP
MP280,,2017,1997,,17867347,158898390,46141081,,17723754,157505584,45749658,,143593,1392806,391424,PDP
MP280,,2017,1997,,17867347,158898390,46141081,,17723754,157505584,45749658,,143593,1392806,391424,PDP
MP283,,1998,1997,,640379,10625952,2531118,,0,127971,22771,,640379,10497981,2508347,PDP
MP283,,1999,1997,,3253809,23576293,7448879,,552444,5442275,1520820,,2701365,18134018,5928059,PDP
MP283,,2000,1997,,2434578,28564678,7517261,,1008063,11869225,3120025,,1426515,16695453,4397236,PDP
MP283,,2001,1997,,3232752,36289870,9690024,,1658035,19401971,5110343,,1574717,16887899,4579681,PDP
MP283,,2002,1997,,4059368,45644339,12181137,,2061013,25169065,6539494,,1998355,20475274,5641643,PDP
MP283,,2003,1997,,3278678,37876280,10018230,,2326254,28707373,7434327,,952424,9168907,2583903,PDP
MP283,,2004,1997,,3278652,37685062,9984179,,2447176,30887250,7943128,,831476,6797812,2041051,PDP
MP283,,2005,1997,,3451031,38285521,10263401,,2499694,31859847,8168706,,951337,6425674,2094695,PDP
MP283,,2006,1997,,3313191,38385645,10143377,,2526760,32343774,8281880,,786431,6041871,1861497,PDP
MP283,,2007,1997,,3146250,38057201,9917994,,2527804,32365713,8286828,,618446,5691488,1631166,PDP
MP283,,2008,1997,,4401648,65654184,16083887,,2572262,33097094,8461425,,1829386,32557090,7622462,PDP
MP283,,2009,1997,,6049684,64742026,17569617,,3154016,37836150,9886427,,2895668,26905876,7683190,PDP
MP283,,2010,1997,,4985901,60124444,15684201,,3621719,44226218,11491153,,1364182,15898226,4193049,PDP
MP283,,2011,1997,,4985901,60124444,15684201,,4019449,48945326,12728582,,966452,11179118,2955620,PDP
MP283,,2012,1997,,5293771,70141287,17774428,,4231759,51517069,13398497,,1062012,18624218,4375931,PDP
MP283,,2013,1997,,5286132,69971604,17736596,,4321910,53566813,13853371,,964222,16404791,3883225,PDP
MP283,,2014,1997,,5522958,71836692,18305288,,4522185,56057573,14496842,,1000773,15779119,3808446,PDP
MP283,,2015,1997,,5522958,71836692,18305288,,4672017,58123558,15014286,,850941,13713134,3291001,PDP
MP283,,2016,1997,,5259990,65911155,16987953,,4779747,59837681,15427021,,480243,6073474,1560932,PDP
MP283,,2017,1997,,5259982,65911055,16987927,,4869418,61150289,15750252,,390564,4760766,1237676,PDP
MP283,,2017,1997,,5259982,65911055,16987927,,4869418,61150289,15750252,,390564,4760766,1237676,PDP
MP286,,2001,1997,,312,3121885,555808,,0,0,0,,312,3121885,555808,PDN
MP286,,2002,1997,,312,3121885,555808,,0,0,0,,312,3121885,555808,PDN
MP286,,2003,1997,,312,3121885,555808,,0,0,0,,312,3121885,555808,PDN
MP286,,2004,1997,,313,3127075,556732,,0,843331,150059,,313,2283744,406673,PDN
MP286,,2005,1997,,0,939694,167205,,0,939694,167205,,0,0,0,PDN
MP286,,2006,1997,,0,939694,167205,,0,939694,167205,,0,0,0,PDN
MP286,,2007,1997,,0,939694,167205,,0,939694,167205,,0,0,0,PDN
MP286,,2008,1997,,0,939694,167205,,0,939694,167205,,0,0,0,PDN
MP286,,2009,1997,,0,939694,167205,,0,939694,167205,,0,0,0,PDN
MP286,,2010,1997,,0,939694,167205,,0,939694,167205,,0,0,0,PDN
MP286,,2011,1997,,0,939694,167205,,0,939694,167205,,0,0,0,PDN
MP286,,2012,1997,,0,939694,167205,,0,939694,167205,,0,0,0,PDN
MP286,,2013,1997,,0,939694,167205,,0,939694,167205,,0,0,0,PDN
MP286,,2014,1997,,0,939694,167205,,0,939694,167205,,0,0,0,PDN
MP286,,2015,1997,,0,939694,167205,,0,939694,167205,,0,0,0,PDN
MP286,,2016,1997,,0,939694,167205,,0,939694,167205,,0,0,0,PDN
MP286,,2017,1997,,0,939694,167205,,0,939694,167205,,0,0,0,PDN
MP286,,2017,1997,,0,939694,167205,,0,939694,167205,,0,0,0,PDN
MP287,,2001,2003,,1704778,3681210,2359798,,0,0,0,,1704778,3681210,2359798,PDP
MP287,,2003,2003,,2034747,4018806,2749837,,19022,80891,33415,,2015725,3937915,2716422,PDP
MP287,,2004,2003,,1789314,3575230,2425476,,342462,960198,513316,,1446852,2615032,1912160,PDP
MP287,,2005,2003,,1789314,3980879,2497655,,473702,1254439,696912,,1315612,2726440,1800743,PDP
MP287,,2006,2003,,1243654,2673473,1719361,,607248,1754224,919388,,636406,919249,799973,PDP
MP287,,2007,2003,,1245039,2786468,1740852,,735036,1930141,1078477,,510003,856327,662375,PDP
MP287,,2008,2003,,1777516,3176669,2342760,,887734,2089752,1259576,,889782,1086917,1083184,PDP
MP287,,2009,2003,,1677242,2856628,2185539,,1228229,2388420,1653216,,449013,468208,532324,PDP
MP287,,2010,2003,,1764948,2841796,2270605,,1409749,2612994,1874695,,355199,228802,395912,PDP
MP287,,2011,2003,,1793072,2917876,2312267,,1521809,2666611,1996295,,271263,251265,315972,PDP
MP287,,2012,2003,,1954089,2859199,2462844,,1685661,2720750,2169780,,268428,138449,293063,PDP
MP287,,2013,2003,,2076481,2943318,2600204,,1934914,2822219,2437088,,141567,121099,163115,PDP
MP287,,2014,2003,,2065493,2925490,2586043,,1996545,2849581,2503588,,68948,75909,82455,PDP
MP287,,2015,2003,,2422602,3314147,3012309,,2095873,2933523,2617853,,326729,380624,394455,PDP
MP287,,2016,2003,,2368050,3340944,2962525,,2233453,3145745,2793195,,134597,195199,169331,PDP
MP287,,2017,2003,,2744638,3653854,3394790,,2357171,3331298,2949929,,387467,322556,444862,PDP
MP287,,2017,2003,,2744638,3653854,3394790,,2357171,3331298,2949929,,387467,322556,444862,PDP
MP290,,1975,1967,,17000000,19992000,20557295,,9175990,7752693,10555473,,7824010,12239307,10001822,PDP
MP290,,1976,1967,,17000000,19992000,20557295,,10501423,12531841,12731288,,6498577,7460159,7826007,PDP
MP290,,1977,1967,,17000000,19992000,20557295,,11578043,15151181,14273983,,5421957,4840819,6283312,PDP
MP290,,1978,1967,,17000000,21998000,20914235,,12750473,17120841,15796886,,4249527,4877159,5117349,PDP
MP290,,1979,1967,,17000000,21998000,20914235,,14752016,19138393,18157424,,2247984,2859607,2756811,PDP
MP290,,1980,1967,,23100000,28500000,28171174,,17119420,22592009,21139350,,5980580,5907991,7031824,PDP
MP290,,1981,1967,,30911616,49160917,39659110,,18806257,24117149,23097565,,12105359,25043768,16561545,PDP
MP290,,1982,1967,,31149551,50877133,40202422,,20476251,25628428,25036470,,10673300,25248705,15165952,PDP
MP290,,1983,1967,,33796038,53577323,43329369,,22026320,27024361,26834925,,11769718,26552962,16494444,PDP
MP290,,1984,1967,,35684131,53718124,45242516,,23292231,28210610,28311912,,12391900,25507514,16930604,PDP
MP290,,1985,1967,,38168042,56014550,48135044,,24699332,29692548,29982704,,13468710,26322002,18152340,PDP
MP290,,1986,1967,,38534196,56853954,48650558,,25853727,31086824,31385190,,12680469,25767130,17265368,PDP
MP290,,1987,1967,,41761901,58836300,52230994,,26842482,32620450,32646833,,14919419,26215850,19584161,PDP
MP290,,1988,1967,,42473121,58989758,52969519,,28217560,34687750,34389758,,14255561,24302008,18579761,PDP
MP290,,1989,1967,,42512603,60769660,53325710,,29325878,36378492,35798919,,13186725,24391168,17526791,PDP
MP290,,1990,1967,,42655883,60937978,53498940,,30364246,37529292,37042056,,12291637,23408686,16456884,PDP
MP290,,1991,1967,,35463476,41639392,42872620,,31518065,38632265,38392134,,3945411,3007127,4480486,PDP
MP290,,1992,1967,,39050990,67071033,50985338,,32769346,42173969,40273611,,6281644,24897064,10711727,PDP
MP290,,1993,1967,,45422933,78258188,59347877,,35547617,51628693,44734217,,9875316,26629495,14613660,PDP
MP290,,1994,1967,,45779902,79407539,59909357,,37783898,58419589,48178843,,7996004,20987950,11730514,PDP
MP290,,1995,1967,,48179289,83825152,63094796,,39645297,62193212,50711705,,8533992,21631940,12383091,PDP
MP290,,1996,1967,,49979508,87941739,65627504,,41575149,67570143,53598306,,8404359,20371596,12029198,PDP
MP290,,1997,1967,,47930541,94322705,64713940,,43416810,74007817,56585461,,4513731,20314888,8128479,PDP
MP290,,1998,1967,,48980574,95106359,65903414,,45096466,78829660,59123096,,3884108,16276699,6780318,PDP
MP290,,1999,1967,,50380078,97683466,67761478,,46800124,84100013,61764539,,3579954,13583453,5996939,PDP
MP290,,2000,1967,,66281207,137138701,90683111,,62080004,98024023,79522001,,4201203,39114678,11161110,PDP
MP290,,2001,1967,,54565252,131635469,77987933,,50074460,102165206,68253322,,4490792,29470263,9734611,PDP
MP290,,2002,1967,,55208699,133476362,78958941,,51354606,114125709,71661672,,3854093,19350653,7297269,PDP
MP290,,2003,1967,,55438166,136731797,79767667,,52324146,119974177,73671864,,3114020,16757620,6095803,PDP
MP290,,2004,1967,,56181360,130098645,79330585,,53179303,122974175,75060829,,3002057,7124470,4269756,PDP
MP290,,2005,1967,,58370234,132885592,82015357,,54293048,124488684,76444059,,4077186,8396908,5571298,PDP
MP290,,2006,1967,,59537884,135812418,83703795,,55606913,127990501,78381023,,3930971,7821917,5322772,PDP
MP290,,2007,1967,,60013665,141756469,85237236,,56622676,132684647,80232044,,3390989,9071822,5005192,PDP
MP290,,2008,1967,,60189682,142718072,85584357,,57590981,137351466,82030744,,2598701,5366606,3553613,PDP
MP290,,2009,1967,,61346806,146387971,87394482,,58499602,141858372,83741299,,2847204,4529599,3653185,PDP
MP290,,2010,1967,,61534630,147051103,87700302,,59185128,143797782,84771921,,2349502,3253321,2928384,PDP
MP290,,2011,1967,,61524363,147043853,87688743,,59813576,145137231,85638701,,1710787,1906622,2050044,PDP
MP290,,2012,1967,,61596094,147805760,87896045,,60340451,146143622,86344649,,1255643,1662138,1551394,PDP
MP290,,2013,1967,,62292186,148913830,88789305,,60815869,147070248,86984948,,1476317,1843582,1804358,PDP
MP290,,2014,1967,,62420415,149060497,88943633,,61282520,147824215,87585758,,1137895,1236282,1357872,PDP
MP290,,2015,1967,,63224656,150362017,89979461,,61852700,148527121,88281007,,1371956,1834896,1698449,PDP
MP290,,2016,1967,,63086519,150258464,89822897,,62453749,149340017,89026702,,632770,918447,796193,PDP
MP290,,2017,1967,,63633546,150666897,90442601,,62926640,149919181,89602648,,706906,747716,839952,PDP
MP290,,2017,1967,,63633546,150666897,90442601,,62926640,149919181,89602648,,706906,747716,839952,PDP
MP299,,1975,1962,,67000000,39999000,74117260,,26601833,11971344,28731965,,40398167,28027656,45385295,PDP
MP299,,1976,1962,,59000000,38999000,65939324,,29043922,13788952,31497472,,29956078,25210048,34441852,PDP
MP299,,1977,1962,,59000000,38999000,65939324,,31290749,15919261,34123358,,27709251,23079739,31815966,PDP
MP299,,1978,1962,,85275951,68450802,97455809,,34885122,24750947,39289205,,50390829,43699855,58166604,PDP
MP299,,1979,1962,,85550071,69208231,97864703,,37723823,27204081,42564407,,47826248,42004150,55300296,PDP
MP299,,1980,1962,,86815761,70841598,99421028,,40301641,28891498,45442477,,46514120,41950100,53978551,PDP
MP299,,1981,1962,,86158449,69813886,98580849,,43456023,31446570,49051498,,42702426,38367316,49529351,PDP
MP299,,1982,1962,,86706295,70498339,99250483,,45817056,33137678,51713440,,40889239,37360661,47537043,PDP
MP299,,1983,1962,,88963718,73966972,102125101,,47842226,34675998,54012332,,41121492,39290974,48112769,PDP
MP299,,1984,1962,,87022491,71841156,99805615,,49597466,36064967,56014720,,37425025,35776189,43790895,PDP
MP299,,1985,1962,,94550646,81435542,109040956,,51162991,37306531,57801164,,43387655,44129011,51239792,PDP
MP299,,1986,1962,,96830176,84025675,111781364,,52530336,38043690,59299676,,44299840,45981985,52481688,PDP
MP299,,1987,1962,,96157155,81597765,110676330,,54500137,38936241,61428294,,41657018,42661524,49248036,PDP
MP299,,1988,1962,,101690066,85148237,116840998,,56587435,40384349,63773262,,45102631,44763888,53067736,PDP
MP299,,1989,1962,,103447158,86971910,118922587,,58900311,41665062,66314023,,44546847,45306848,52608564,PDP
MP299,,1990,1962,,83023019,61904421,94038041,,61531589,43511815,69273905,,21491430,18392606,24764136,PDP
MP299,,1991,1962,,125186574,71238619,137862485,,64616220,45527988,72717285,,60570354,25710631,65145200,PDP
MP299,,1992,1962,,126061744,72744690,139005639,,77028431,49479312,85832579,,49033313,23265378,53173060,PDP
MP299,,1993,1962,,122030704,68630150,134242474,,86364020,52705701,95742259,,35666684,15924449,38500215,PDP
MP299,,1994,1962,,135026996,97285759,152337629,,94602564,57320549,104801950,,40424432,39965210,47535679,PDP
MP299,,1995,1962,,147330826,102923088,165644543,,102292226,62110091,113343844,,45038600,40812997,52300699,PDP
MP299,,1996,1962,,151679602,112732827,171738824,,109448557,68729280,121677966,,42231045,44003547,50060858,PDP
MP299,,1997,1962,,143777588,128651926,166669390,,116079313,74102909,129264884,,27698275,54549017,37404506,PDP
MP299,,1998,1962,,142572531,126405204,165064560,,121216616,78175315,135126814,,21355915,48229889,29937746,PDP
MP299,,1999,1962,,139134854,106510502,158086901,,125846737,83033344,140621353,,13288117,23477158,17465548,PDP
MP299,,2000,1962,,147465519,104339181,166031210,,130136836,88267805,145842851,,17328683,16071376,20188359,PDP
MP299,,2001,1962,,151486185,109719817,171009284,,134331218,92008158,150702776,,17154967,17711659,20306508,PDP
MP299,,2002,1962,,155642515,112944297,175739365,,138136236,95418647,155114643,,17506279,17525650,20624722,PDP
MP299,,2003,1962,,156757499,113042786,176871874,,142242849,98374050,159747128,,14514650,14668736,17124746,PDP
MP299,,2004,1962,,158404104,109661973,177916911,,145080961,100062023,162885591,,13323143,9599950,15031320,PDP
MP299,,2005,1962,,159948645,110286247,179572532,,147403199,101173382,165405580,,12545446,9112865,14166952,PDP
MP299,,2006,1962,,165884437,110614941,185566811,,150082313,102334698,168291334,,15802124,8280243,17275477,PDP
MP299,,2007,1962,,166104763,110991537,185854147,,152835647,103420628,171237894,,13269116,7570909,14616253,PDP
MP299,,2008,1962,,167636308,111031296,187392766,,154632643,104068512,173150172,,13003665,6962784,14242594,PDP
MP299,,2009,1962,,167128791,111467580,186962882,,156421335,106253591,175327665,,10707456,5213989,11635210,PDP
MP299,,2010,1962,,167278486,111769187,187166244,,157265948,106512281,176218309,,10012538,5256906,10947932,PDP
MP299,,2011,1962,,174858440,115529698,195415326,,159566977,107738956,178737611,,15291463,7790742,16677717,PDP
MP299,,2012,1962,,174793258,115464368,195338518,,161408495,108792644,180766616,,13384763,6671724,14571904,PDP
MP299,,2013,1962,,168905066,114153736,189217119,,163210998,109993818,182782852,,5694068,4159918,6434265,PDP
MP299,,2014,1962,,170714756,114927517,191164494,,165085250,111314982,184892186,,5629506,3612535,6272305,PDP
MP299,,2015,1962,,172538810,117725268,193486368,,167022122,113465977,187211799,,5516688,4259291,6274572,PDP
MP299,,2016,1962,,173365679,119075388,194553468,,168519067,115449835,189061741,,4846612,3625553,5491729,PDP
MP299,,2017,1962,,174334755,120433250,195764157,,169574417,116404011,190286873,,4760338,4029239,5477282,PDP
MP299,,2017,1962,,174334755,120433250,195764157,,169574417,116404011,190286873,,4760338,4029239,5477282,PDP
MP306,,1975,1967,,77000000,79926000,91221708,,37288243,27934754,42258840,,39711757,51991246,48962868,PDN
MP306,,1976,1967,,77000000,79926000,91221708,,42077928,32808187,47915684,,34922072,47117813,43306024,PDN
MP306,,1977,1967,,77000000,79926000,91221708,,48156647,38664806,55036506,,28843353,41261194,36185202,PDN
MP306,,1978,1967,,77000000,79926000,91221708,,52495551,43501586,60236047,,24504449,36424414,30985661,PDN
MP306,,1979,1967,,90749575,110984886,110497775,,54884819,58365088,65270066,,35864756,52619798,45227709,PDN
MP306,,1980,1967,,90002000,101046397,107981786,,58305175,61081955,69173850,,31696825,39964442,38807936,PDN
MP306,,1981,1967,,87778501,100429720,105648558,,61034742,63847868,72395573,,26743759,36581852,33252985,PDN
MP306,,1982,1967,,90848693,104563579,109454312,,64430640,67138544,76377000,,26418053,37425035,33077312,PDN
MP306,,1983,1967,,99629915,116952573,120439981,,67153230,70915224,79771597,,32476685,46037349,40668384,PDN
MP306,,1984,1967,,102760023,126681690,125301249,,69609302,74286996,82827629,,33150721,52394694,42473620,PDN
MP306,,1985,1967,,110905071,137947873,135450956,,72219411,77421813,85995534,,38685660,60526060,49455422,PDN
MP306,,1986,1967,,111906066,145179141,137738653,,74484008,80321348,88776063,,37422058,64857793,48962590,PDN
MP306,,1987,1967,,112869477,144360318,138556366,,76526961,82898899,91277655,,36342516,61461419,47278711,PDN
MP306,,1988,1967,,116969466,151472235,143921821,,78397133,85385027,93590198,,38572333,66087208,50331623,PDN
MP306,,1989,1967,,115679424,146914434,141820782,,80013029,87907732,95654974,,35666395,59006702,46165808,PDN
MP306,,1990,1967,,96625953,119210639,117837810,,81265867,89588292,97206844,,15360086,29622347,20630966,PDN
MP306,,1991,1967,,96625953,119210639,117837810,,82270844,90697343,98409161,,14355109,28513296,19428649,PDN
MP306,,1992,1967,,98434386,126581343,120957757,,83372672,91804242,99707946,,15061714,34777101,21249811,PDN
MP306,,1993,1967,,96261127,113543015,116464510,,84431801,92675676,100922135,,11829326,20867339,15542375,PDN
MP306,,1994,1967,,124456212,169879963,154683963,,85922349,93961180,102641420,,38533863,75918783,52042543,PDN
MP306,,1995,1967,,125026681,171358661,155517546,,87008848,94664359,103853040,,38017833,76694302,51664506,PDN
MP306,,1996,1967,,102167217,119693180,123464936,,88103758,95478864,105092880,,14063459,24214316,18372056,PDN
MP306,,1997,1967,,100678698,119345419,121914538,,89073007,96194710,106189503,,11605691,23150709,15725035,PDN
MP306,,1998,1967,,101538536,119502453,122802318,,90102810,97210831,107400111,,11435726,22291622,15402207,PDN
MP306,,1999,1967,,99772806,118830649,120917050,,90963351,98134562,108425017,,8809455,20696087,12492033,PDN
MP306,,2000,1967,,99680390,113600610,119894022,,91784844,99148274,109426886,,7895546,14452336,10467136,PDN
MP306,,2001,1967,,100019421,113967013,120298249,,92750725,100058801,110554782,,7268696,13908212,9743467,PDN
MP306,,2002,1967,,101813525,114962640,122269511,,93647203,100897141,111600431,,8166322,14065499,10669080,PDN
MP306,,2003,1967,,101636818,117018886,122458684,,94504050,101772359,112613011,,7132768,15246527,9845673,PDN
MP306,,2004,1967,,102812394,119233565,124028331,,95371489,104407841,113949397,,7440905,14825724,10078934,PDN
MP306,,2005,1967,,102859361,118643193,123970249,,95500779,104471240,114089968,,7358582,14171953,9880281,PDN
MP306,,2006,1967,,102903391,119265316,124124977,,95814534,105818702,114643485,,7088857,13446614,9481492,PDN
MP306,,2007,1967,,100086532,117218126,120943850,,96091221,106471835,115036387,,3995311,10746291,5907463,PDN
MP306,,2008,1967,,99973150,117360181,120855744,,96288701,106681671,115271205,,3684449,10678510,5584539,PDN
MP306,,2009,1967,,99267556,116940246,120075432,,96367424,108689976,115707279,,2900132,8250270,4368152,PDN
MP306,,2010,1967,,98624763,112916881,118716737,,96367424,108689976,115707279,,2257339,4226905,3009458,PDN
MP306,,2011,1967,,96367530,108691868,115707722,,96367530,108691868,115707722,,0,0,0,PDN
MP306,,2012,1967,,96367530,108691868,115707722,,96367530,108691868,115707722,,0,0,0,PDN
MP306,,2013,1967,,96367530,108691868,115707722,,96367530,108691868,115707722,,0,0,0,PDN
MP306,,2014,1967,,96367530,108691868,115707722,,96367530,108691868,115707722,,0,0,0,PDN
MP306,,2015,1967,,96367530,108691868,115707722,,96367530,108691868,115707722,,0,0,0,PDN
MP306,,2016,1967,,96367530,108691868,115707722,,96367530,108691868,115707722,,0,0,0,PDN
MP306,,2017,1967,,96367530,108691868,115707722,,96367530,108691868,115707722,,0,0,0,PDN
MP306,,2017,1967,,96367530,108691868,115707722,,96367530,108691868,115707722,,0,0,0,PDN
MP308,,1985,1983,,307033,3130363,864037,,0,0,0,,307033,3130363,864037,PDP
MP308,,1986,1983,,307033,3130363,864037,,0,0,0,,307033,3130363,864037,PDP
MP308,,1987,1983,,307033,3130363,864037,,0,0,0,,307033,3130363,864037,PDP
MP308,,2012,1983,,3306045,3705902,3965458,,505666,1078991,697657,,2800379,2626911,3267801,PDP
MP308,,2013,1983,,3306045,3705902,3965458,,1500584,2226109,1896689,,1805461,1479793,2068769,PDP
MP308,,2014,1983,,3545712,3761967,4215101,,2391198,2936419,2913692,,1154514,825548,1301409,PDP
MP308,,2015,1983,,3551365,3788961,4225557,,2960703,3182939,3527062,,590662,606022,698495,PDP
MP308,,2016,1983,,4142112,3659975,4793353,,3472803,3421639,4081635,,669309,238336,711718,PDP
MP308,,2017,1983,,4164412,3683363,4819814,,3904222,3589249,4542878,,260190,94114,276936,PDP
MP308,,2017,1983,,4164412,3683363,4819814,,3904222,3589249,4542878,,260190,94114,276936,PDP
MP310,,1982,1981,,2700000,2200000,3091459,,0,0,0,,2700000,2200000,3091459,PDP
MP310,,1983,1981,,173602,3472050,791404,,0,0,0,,173602,3472050,791404,PDP
MP310,,1984,1981,,173602,3472050,791404,,0,0,0,,173602,3472050,791404,PDP
MP310,,1985,1981,,5000001,3050001,5542706,,2263336,1289314,2492751,,2736665,1760687,3049955,PDP
MP310,,1986,1981,,19069016,13434874,21459563,,4440763,2406995,4869054,,14628253,11027879,16590509,PDP
MP310,,1987,1981,,19069016,13434874,21459563,,5796356,2987734,6327981,,13272660,10447140,15131582,PDP
MP310,,1988,1981,,19860456,21071014,23609747,,6442920,3503734,7066360,,13417536,17567280,16543387,PDP
MP310,,1989,1981,,19860456,21071014,23609747,,8599405,4817255,9456568,,11261051,16253759,14153179,PDP
MP310,,1990,1981,,19860456,21071014,23609747,,9944048,5431687,10910540,,9916408,15639327,12699207,PDP
MP310,,1991,1981,,20231218,21260102,24014154,,11015424,5938102,12072026,,9215794,15322000,11942128,PDP
MP310,,1992,1981,,20231218,21260102,24014154,,12047735,6478998,13200582,,8183483,14781104,10813572,PDP
MP310,,1993,1981,,19424882,13385356,21806618,,13327914,7483361,14659473,,6096968,5901995,7147145,PDP
MP310,,1994,1981,,20564188,15667385,23351979,,15462490,9581774,17167432,,5101698,6085611,6184547,PDP
MP310,,1995,1981,,22763613,18333873,26025868,,17502926,11394745,19530461,,5260687,6939128,6495407,PDP
MP310,,1996,1981,,32559309,21650060,36411633,,20040739,13355008,22417075,,12518570,8295052,13994558,PDP
MP310,,1997,1981,,30396675,20435916,34032959,,22221501,14844943,24862950,,8175174,5590973,9170009,PDP
MP310,,1998,1981,,30472722,20522860,34124476,,23811214,16142414,26683530,,6661508,4380446,7440946,PDP
MP310,,1999,1981,,30692063,20925876,34415528,,25200332,17697918,28349428,,5491731,3227958,6066100,PDP
MP310,,2000,1981,,32222462,22002725,36137538,,26111673,18378668,29381899,,6110789,3624057,6755639,PDP
MP310,,2001,1981,,32341742,22363927,36321088,,27015530,19082115,30410924,,5326212,3281812,5910164,PDP
MP310,,2002,1981,,32965343,23378550,37125227,,27772041,19705590,31278374,,5193302,3672960,5846853,PDP
MP310,,2003,1981,,33065388,23510575,37248764,,28522139,20555653,32179729,,4543249,2954922,5069035,PDP
MP310,,2004,1981,,33733084,24033892,38009577,,29115751,21535297,32947654,,4617333,2498595,5061923,PDP
MP310,,2005,1981,,34414941,25087615,38878929,,29625947,22323603,33598118,,4788994,2764012,5280811,PDP
MP310,,2006,1981,,34463998,25292478,38964439,,30193069,22657235,34224605,,4270929,2635243,4739834,PDP
MP310,,2007,1981,,34463998,25292478,38964439,,30946007,23103301,35056915,,3517991,2189177,3907524,PDP
MP310,,2008,1981,,34763155,25788189,39351801,,31483611,23462687,35658466,,3279544,2325502,3693335,PDP
MP310,,2009,1981,,35463130,33910965,41497108,,32058254,25319607,36563522,,3404876,8591358,4933588,PDP
MP310,,2010,1981,,39293473,34596822,45449490,,32587208,27492259,37479070,,6706265,7104563,7970422,PDP
MP310,,2011,1981,,39244643,35437979,45550332,,33087842,28911808,38232292,,6156801,6526171,7318042,PDP
MP310,,2012,1981,,39290271,36112918,45716056,,33509128,29166486,38698892,,5781143,6946432,7017164,PDP
MP310,,2013,1981,,39477852,35162581,45734538,,34249718,30008869,39589374,,5228134,5153712,6145168,PDP
MP310,,2014,1981,,38607690,34695660,44781295,,35095929,31263076,40658754,,3511761,3432584,4122541,PDP
MP310,,2015,1981,,38967970,34869145,45172442,,35714618,31821623,41376828,,3253352,3047522,3795617,PDP
MP310,,2016,1981,,38901698,34709464,45077759,,36317988,32314618,42067920,,2583710,2394846,3009840,PDP
MP310,,2017,1981,,38923939,35166622,45181345,,36921759,32705840,42741303,,2002180,2460782,2440042,PDP
MP310,,2017,1981,,38923939,35166622,45181345,,36921759,32705840,42741303,,2002180,2460782,2440042,PDP
MP311,,1978,1977,,61628428,46384613,69881918,,0,0,0,,61628428,46384613,69881918,PDP
MP311,,1979,1977,,61628428,46384613,69881918,,0,0,0,,61628428,46384613,69881918,PDP
MP311,,1980,1977,,61628428,46384613,69881918,,611,1766,925,,61627817,46382847,69880993,PDP
MP311,,1981,1977,,61628428,46384613,69881918,,1621577,1898884,1959457,,60006851,44485729,67922461,PDP
MP311,,1982,1977,,61628428,46647305,69928660,,7455505,6828042,8670459,,54172923,39819263,61258201,PDP
MP311,,1983,1977,,77787677,79073144,91857631,,13510215,13540329,15919526,,64277462,65532815,75938105,PDP
MP311,,1984,1977,,83819444,90221853,99873154,,20780611,20279743,24389106,,63038833,69942110,75484048,PDP
MP311,,1985,1977,,88652106,94478043,105463146,,27049425,26066263,31687550,,61602681,68411780,73775596,PDP
MP311,,1986,1977,,92543708,97908881,109965217,,33421800,31844684,39088114,,59121908,66064197,70877103,PDP
MP311,,1987,1977,,94247860,98860403,111838679,,39124094,36833184,45678041,,55123766,62027219,66160638,PDP
MP311,,1988,1977,,99096416,103713511,117550777,,44218668,40135491,51360214,,54877748,63578020,66190563,PDP
MP311,,1989,1977,,104422704,107387538,123530807,,48176725,42973006,55823167,,56245979,64414532,67707640,PDP
MP311,,1990,1977,,81002654,77874313,94859293,,52764995,46570125,61051494,,28237659,31304188,33807799,PDP
MP311,,1991,1977,,82085432,79117221,96163229,,57252597,50519359,66241807,,24832835,28597862,29921422,PDP
MP311,,1992,1977,,105381760,106955729,124413029,,61474045,54638485,71196195,,43907715,52317244,53216834,PDP
MP311,,1993,1977,,99559752,92363532,115994544,,65073102,58742367,75525480,,34486650,33621165,40469064,PDP
MP311,,1994,1977,,112236187,120547737,133685962,,68805862,63439983,80094115,,43430325,57107754,53591847,PDP
MP311,,1995,1977,,101213821,101861833,119338702,,71949033,66363154,83757423,,29264788,35498679,35581279,PDP
MP311,,1996,1977,,95918250,96843262,113150147,,74965705,69155930,87271031,,20952545,27687332,25879116,PDP
MP311,,1997,1977,,96050973,96743310,113265085,,77804228,71407374,90510166,,18246745,25335936,22754919,PDP
MP311,,1998,1977,,94266489,96440395,111426702,,80555481,74260565,93769105,,13711008,22179830,17657597,PDP
MP311,,1999,1977,,100492629,96331191,117633410,,83529255,78962689,97579556,,16963374,17368502,20053854,PDP
MP311,,2000,1977,,100250670,98054237,117698043,,86022396,83402950,100862779,,14228274,14651287,16835264,PDP
MP311,,2001,1977,,102000123,114656783,122401686,,88405506,89583899,104345702,,13594617,25072884,18055984,PDP
MP311,,2002,1977,,103795418,119126115,124992236,,90662417,95182066,107598728,,13133001,23944049,17393508,PDP
MP311,,2003,1977,,102517613,119027804,123696938,,93246186,102145434,111421530,,9271427,16882370,12275408,PDP
MP311,,2004,1977,,104249109,120293999,125653735,,95049666,106346039,113972449,,9199443,13947960,11681286,PDP
MP311,,2005,1977,,105434943,118332075,126490472,,96372053,108838334,115738305,,9062890,9493741,10752167,PDP
MP311,,2006,1977,,105432929,116816195,126218729,,96755461,108990664,116148818,,8677468,7825531,10069911,PDP
MP311,,2007,1977,,106730191,118428414,127802863,,98378049,111355613,118192215,,8352142,7072801,9610648,PDP
MP311,,2008,1977,,106923431,118428767,127996165,,99750622,112360717,119743632,,7172809,6068050,8252533,PDP
MP311,,2009,1977,,108491193,123382591,130445391,,100924129,114820332,121354793,,7567064,8562259,9090598,PDP
MP311,,2010,1977,,107837673,123056092,129733775,,102476093,116665293,123235042,,5361580,6390799,6498733,PDP
MP311,,2011,1977,,110322741,126803501,132885642,,104489541,119696903,125787922,,5833200,7106598,7097720,PDP
MP311,,2012,1977,,111419947,130791788,134692507,,105822440,121169722,127382889,,5597507,9622066,7309618,PDP
MP311,,2013,1977,,111501255,130833478,134781233,,106988341,123398438,128945358,,4512914,7435040,5835875,PDP
MP311,,2014,1977,,113863510,130918977,137158700,,108289998,124755415,130488470,,5573512,6163562,6670229,PDP
MP311,,2015,1977,,114381286,134887566,138382630,,110346988,126720949,132895200,,4034298,8166617,5487434,PDP
MP311,,2016,1977,,115028742,130681921,138281754,,112065426,128403232,134912977,,2963316,2278689,3368777,PDP
MP311,,2017,1977,,115479531,131836229,138937935,,113435907,129963284,136561048,,2043624,1872945,2376888,PDP
MP311,,2017,1977,,115479531,131836229,138937935,,113435907,129963284,136561048,,2043624,1872945,2376888,PDP
MU016A,,1977,1976,,22827,22826580,4084496,,0,0,0,,22827,22826580,4084496,PDN
MU016A,,1978,1976,,21417,21416500,3832182,,0,0,0,,21417,21416500,3832182,PDN
MU016A,,1979,1976,,21417,21416500,3832182,,0,0,0,,21417,21416500,3832182,PDN
MU016A,,1980,1976,,21417,21416500,3832182,,0,0,0,,21417,21416500,3832182,PDN
MU016A,,1981,1976,,21417,21416500,3832182,,0,0,0,,21417,21416500,3832182,PDN
MU016A,,1982,1976,,21417,21416500,3832182,,0,0,0,,21417,21416500,3832182,PDN
MU016A,,1983,1976,,21417,21416500,3832182,,0,0,0,,21417,21416500,3832182,PDN
MU016A,,1984,1976,,21417,21416500,3832182,,0,0,0,,21417,21416500,3832182,PDN
MU016A,,1985,1976,,97974,21417000,3908828,,0,0,0,,97974,21417000,3908828,PDN
MU016A,,1986,1976,,97974,21417000,3908828,,0,0,0,,97974,21417000,3908828,PDN
MU016A,,1987,1976,,97974,21417000,3908828,,0,0,0,,97974,21417000,3908828,PDN
MU016A,,1988,1976,,0,41644866,7410119,,0,0,0,,0,41644866,7410119,PDN
MU016A,,1989,1976,,0,41644866,7410119,,0,0,0,,0,41644866,7410119,PDN
MU016A,,1990,1976,,978,47428819,8440270,,97,6967182,1239809,,881,40461637,7200461,PDN
MU016A,,1991,1976,,1364,63846921,11362026,,283,21112392,3756936,,1081,42734529,7605090,PDN
MU016A,,1992,1976,,1448,70957497,12627337,,364,32855239,5846492,,1084,38102258,6780845,PDN
MU016A,,1993,1976,,1649,71019141,12638507,,466,39766320,7076324,,1183,31252821,5562183,PDN
MU016A,,1994,1976,,2008,66594606,11851582,,570,44476407,7914521,,1438,22118199,3937061,PDN
MU016A,,1995,1976,,2008,66594606,11851582,,630,48138605,8566218,,1378,18456001,3285364,PDN
MU016A,,1996,1976,,3030,63738697,11344435,,661,50891293,9056051,,2369,12847404,2288384,PDN
MU016A,,1997,1976,,1696,63267878,11259326,,679,52564830,9353852,,1017,10703048,1905474,PDN
MU016A,,1998,1976,,1698,63165952,11241191,,723,53564328,9531742,,975,9601624,1709449,PDN
MU016A,,1999,1976,,27275,67075382,11962396,,723,54411522,9682488,,26552,12663860,2279908,PDN
MU016A,,2000,1976,,1322,62533142,11128216,,723,56065053,9976711,,599,6468089,1151505,PDN
MU016A,,2001,1976,,3101,67293932,11977110,,723,57401132,10214448,,2378,9892800,1762662,PDN
MU016A,,2002,1976,,3101,67293932,11977110,,723,58296629,10373789,,2378,8997303,1603321,PDN
MU016A,,2003,1976,,3101,67304693,11979025,,723,58521558,10413812,,2378,8783135,1565213,PDN
MU016A,,2004,1976,,723,58521558,10413812,,723,58521558,10413812,,0,0,0,PDN
MU016A,,2005,1976,,723,58521558,10413812,,723,58521558,10413812,,0,0,0,PDN
MU016A,,2006,1976,,723,58521558,10413812,,723,58521558,10413812,,0,0,0,PDN
MU016A,,2007,1976,,723,58521558,10413812,,723,58521558,10413812,,0,0,0,PDN
MU016A,,2008,1976,,723,58521558,10413812,,723,58521558,10413812,,0,0,0,PDN
MU016A,,2009,1976,,723,59588478,10603656,,723,59588478,10603656,,0,0,0,PDN
MU016A,,2010,1976,,723,59588478,10603656,,723,59588478,10603656,,0,0,0,PDN
MU016A,,2011,1976,,723,59588478,10603656,,723,59588478,10603656,,0,0,0,PDN
MU016A,,2012,1976,,723,59588478,10603656,,723,59588478,10603656,,0,0,0,PDN
MU016A,,2013,1976,,723,59588478,10603656,,723,59588478,10603656,,0,0,0,PDN
MU016A,,2014,1976,,723,59588478,10603656,,723,59588478,10603656,,0,0,0,PDN
MU016A,,2015,1976,,723,59588478,10603656,,723,59588478,10603656,,0,0,0,PDN
MU016A,,2016,1976,,723,59588478,10603656,,723,59588478,10603656,,0,0,0,PDN
MU016A,,2017,1976,,723,59588478,10603656,,723,59588478,10603656,,0,0,0,PDN
MU016A,,2017,1976,,723,59588478,10603656,,723,59588478,10603656,,0,0,0,PDN
MU031A,,1980,1978,,7000,7000000,1252552,,0,0,0,,7000,7000000,1252552,PDN
MU031A,,1983,1978,,506297,10125900,2308059,,0,0,0,,506297,10125900,2308059,PDN
MU031A,,1984,1978,,506297,10125900,2308059,,0,0,0,,506297,10125900,2308059,PDN
MU031A,,1985,1978,,324264,70910233,12941743,,0,0,0,,324264,70910233,12941743,PDN
MU031A,,1986,1978,,324264,70910233,12941743,,0,0,0,,324264,70910233,12941743,PDN
MU031A,,1987,1978,,324264,70910233,12941743,,0,0,0,,324264,70910233,12941743,PDN
MU031A,,1988,1978,,335954,73465590,13408123,,0,0,0,,335954,73465590,13408123,PDN
MU031A,,1989,1978,,799215,162522143,29717746,,15389,5273503,953735,,783826,157248640,28764011,PDN
MU031A,,1990,1978,,824218,167511508,30630536,,78715,25516287,4618980,,745503,141995221,26011556,PDN
MU031A,,1991,1978,,685510,148172434,27050712,,112165,40138213,7254196,,573345,108034221,19796516,PDN
MU031A,,1992,1978,,704971,227475036,41180956,,165444,59838752,10812909,,539527,167636284,30368047,PDN
MU031A,,1993,1978,,747910,243841052,44135998,,215753,79579954,14375887,,532157,164261098,29760111,PDN
MU031A,,1994,1978,,754496,247416439,44778773,,271298,97129355,17554101,,483198,150287084,27224672,PDN
MU031A,,1995,1978,,711781,252019162,45555048,,313808,111550121,20162584,,397973,140469041,25392464,PDN
MU031A,,1996,1978,,806728,273273423,49431892,,372592,130564175,23604652,,434136,142709248,25827240,PDN
MU031A,,1997,1978,,996593,281758467,51131552,,418756,146791185,26538184,,577837,134967282,24593368,PDN
MU031A,,1998,1978,,1004693,286950056,52063422,,455102,161951763,29272142,,549591,124998293,22791280,PDN
MU031A,,1999,1978,,1006216,307983577,55807564,,497077,175291522,31687739,,509139,132692055,24119825,PDN
MU031A,,2000,1978,,1032574,318723683,57744973,,546030,193686297,35009784,,486544,125037386,22735189,PDN
MU031A,,2001,1978,,1576669,459002858,83249775,,599640,211119580,38165402,,977029,247883278,45084373,PDN
MU031A,,2002,1978,,1191782,363059917,65793190,,635088,226686394,40970745,,556694,136373523,24822445,PDN
MU031A,,2003,1978,,1191786,363060361,65793273,,654673,234251868,42336500,,537113,128808493,23456773,PDN
MU031A,,2004,1978,,838473,327933924,59189705,,671530,241126663,43576630,,166943,86807261,15613075,PDN
MU031A,,2005,1978,,808030,293321359,53000443,,686371,247132013,44660039,,121659,46189346,8340404,PDN
MU031A,,2006,1978,,812603,293417895,53022193,,697777,251085036,45374830,,114826,42332859,7647363,PDN
MU031A,,2007,1978,,841947,305275217,55161381,,707510,254771844,46040578,,134437,50503373,9120803,PDN
MU031A,,2008,1978,,805776,291736584,52716200,,717500,258405907,46697199,,88276,33330677,6019001,PDN
MU031A,,2009,1978,,778433,285158828,51518437,,722203,263960158,47690202,,56230,21198670,3828235,PDN
MU031A,,2010,1978,,778433,285158828,51518437,,724136,265530593,47971572,,54297,19628235,3546866,PDN
MU031A,,2011,1978,,778433,285158828,51518437,,727374,266485882,48144789,,51059,18672946,3373648,PDN
MU031A,,2012,1978,,730774,267680529,48360760,,727638,267230169,48277490,,3136,450360,83269,PDN
MU031A,,2013,1978,,730774,267680529,48360760,,727641,267680334,48357594,,3133,195,3168,PDN
MU031A,,2014,1978,,730774,267680529,48360760,,730774,267680529,48360760,,0,0,0,PDN
MU031A,,2015,1978,,730774,267680529,48360760,,730774,267680529,48360760,,0,0,0,PDN
MU031A,,2016,1978,,730774,267680529,48360760,,730774,267680529,48360760,,0,0,0,PDN
MU031A,,2017,1978,,730774,267680529,48360760,,730774,267680529,48360760,,0,0,0,PDN
MU031A,,2017,1978,,730774,267680529,48360760,,730774,267680529,48360760,,0,0,0,PDN
MU053A,,1982,1979,,9700,9700000,1735679,,0,0,0,,9700,9700000,1735679,PDN
MU053A,,1983,1979,,9700,9700000,1735679,,0,0,0,,9700,9700000,1735679,PDN
MU053A,,1984,1979,,9700,9700000,1735679,,0,0,0,,9700,9700000,1735679,PDN
MU053A,,1985,1979,,33770,4847037,896232,,451,65020,12020,,33319,4782017,884212,PDN
MU053A,,1986,1979,,94244,12758923,2364515,,1044,118151,22067,,93200,12640772,2342448,PDN
MU053A,,1987,1979,,110627,14089791,2617707,,1665,166952,31372,,108962,13922839,2586335,PDN
MU053A,,1988,1979,,110627,14089791,2617707,,4093,486690,90693,,106534,13603101,2527014,PDN
MU053A,,1989,1979,,4316,505115,94194,,4316,505115,94194,,0,0,0,PDN
MU053A,,1990,1979,,4316,505115,94194,,4316,505115,94194,,0,0,0,PDN
MU053A,,1991,1979,,4316,505115,94194,,4316,505115,94194,,0,0,0,PDN
MU053A,,1992,1979,,4316,505115,94194,,4316,505115,94194,,0,0,0,PDN
MU053A,,1993,1979,,4316,505115,94194,,4316,505115,94194,,0,0,0,PDN
MU053A,,1994,1979,,4316,505115,94194,,4316,505115,94194,,0,0,0,PDN
MU053A,,1995,1979,,4316,505115,94194,,4316,505115,94194,,0,0,0,PDN
MU053A,,1996,1979,,4316,505115,94194,,4316,505115,94194,,0,0,0,PDN
MU053A,,1997,1979,,4316,505115,94194,,4316,505115,94194,,0,0,0,PDN
MU053A,,1998,1979,,4316,505115,94194,,4316,505115,94194,,0,0,0,PDN
MU053A,,1999,1979,,4316,505115,94194,,4316,505115,94194,,0,0,0,PDN
MU053A,,2000,1979,,4316,505115,94194,,4316,505115,94194,,0,0,0,PDN
MU053A,,2001,1979,,4316,505115,94194,,4316,505115,94194,,0,0,0,PDN
MU053A,,2002,1979,,4316,505115,94194,,4316,505115,94194,,0,0,0,PDN
MU053A,,2003,1979,,4316,505115,94194,,4316,505115,94194,,0,0,0,PDN
MU053A,,2004,1979,,4316,505115,94194,,4316,505115,94194,,0,0,0,PDN
MU053A,,2005,1979,,4316,505115,94194,,4316,505115,94194,,0,0,0,PDN
MU053A,,2006,1979,,4316,505115,94194,,4316,505115,94194,,0,0,0,PDN
MU053A,,2007,1979,,4316,505115,94194,,4316,505115,94194,,0,0,0,PDN
MU053A,,2008,1979,,4316,505115,94194,,4316,505115,94194,,0,0,0,PDN
MU053A,,2009,1979,,4316,515231,95995,,4316,515231,95995,,0,0,0,PDN
MU053A,,2010,1979,,4316,515231,95995,,4316,515231,95995,,0,0,0,PDN
MU053A,,2011,1979,,4316,515231,95995,,4316,515231,95995,,0,0,0,PDN
MU053A,,2012,1979,,4316,515231,95995,,4316,515231,95995,,0,0,0,PDN
MU053A,,2013,1979,,4316,515231,95995,,4316,515231,95995,,0,0,0,PDN
MU053A,,2014,1979,,4316,515231,95995,,4316,515231,95995,,0,0,0,PDN
MU053A,,2015,1979,,4316,515231,95995,,4316,515231,95995,,0,0,0,PDN
MU053A,,2016,1979,,4316,515231,95995,,4316,515231,95995,,0,0,0,PDN
MU053A,,2017,1979,,4316,515231,95995,,4316,515231,95995,,0,0,0,PDN
MU053A,,2017,1979,,4316,515231,95995,,4316,515231,95995,,0,0,0,PDN
MU085A,,1976,1976,,0,174300000,31014235,,0,0,0,,0,174300000,31014235,PDP
MU085A,,1977,1976,,307969,171253290,30780085,,0,0,0,,307969,171253290,30780085,PDP
MU085A,,1978,1976,,307969,171253290,30780085,,0,0,0,,307969,171253290,30780085,PDP
MU085A,,1979,1976,,307969,171253290,30780085,,0,0,0,,307969,171253290,30780085,PDP
MU085A,,1980,1976,,307969,171253290,30780085,,0,0,0,,307969,171253290,30780085,PDP
MU085A,,1981,1976,,307969,171253290,30780085,,0,0,0,,307969,171253290,30780085,PDP
MU085A,,1982,1976,,361147,171253290,30833263,,105751,12619716,2351252,,255396,158633574,28482011,PDP
MU085A,,1983,1976,,2343861,265074238,49510096,,290268,32555853,6083124,,2053593,232518385,43426972,PDP
MU085A,,1984,1976,,2343861,265074238,49510096,,460199,50766048,9493304,,1883662,214308190,40016792,PDP
MU085A,,1985,1976,,2392297,271814446,50757857,,586928,64098717,11992394,,1805369,207715729,38765463,PDP
MU085A,,1986,1976,,2801532,266014582,50135088,,720899,74998514,14065830,,2080633,191016068,36069258,PDP
MU085A,,1987,1976,,3097682,276766412,52344375,,841282,83752787,15743913,,2256400,193013625,36600462,PDP
MU085A,,1988,1976,,3109707,279952685,52923352,,1040580,98879964,18634880,,2069127,181072721,34288472,PDP
MU085A,,1989,1976,,3143856,284979752,53851997,,1240980,118250295,22281958,,1902876,166729457,31570039,PDP
MU085A,,1990,1976,,3233011,298054826,56267678,,1346109,130878535,24634105,,1886902,167176291,31633573,PDP
MU085A,,1991,1976,,2446322,256222350,48037487,,1419751,142249336,26731021,,1026571,113973014,21306466,PDP
MU085A,,1992,1976,,2374183,244120989,45812081,,1483697,153730625,28837901,,890486,90390364,16974180,PDP
MU085A,,1993,1976,,2379385,245285569,46024504,,1520223,161988559,30343810,,859162,83297010,15680694,PDP
MU085A,,1994,1976,,2379385,245285569,46024504,,1538602,166624309,31187056,,840783,78661260,14837448,PDP
MU085A,,1995,1976,,2308900,261410458,48823216,,1566093,172519778,32263562,,742807,88890680,16559654,PDP
MU085A,,1996,1976,,2355988,268588157,50147475,,1620450,182358501,34068582,,735538,86229656,16078893,PDP
MU085A,,1997,1976,,2415165,275599321,51454190,,1661039,191355972,35710144,,754126,84243349,15744046,PDP
MU085A,,1998,1976,,2421439,277604299,51817222,,1698885,200239452,37328681,,722554,77364847,14488541,PDP
MU085A,,1999,1976,,2436106,290644588,54152225,,1726790,206956119,38551722,,709316,83688469,15600503,PDP
MU085A,,2000,1976,,2410180,289808097,53977457,,1750757,212638292,39586752,,659423,77169805,14390705,PDP
MU085A,,2001,1976,,2415986,290436749,54095123,,1769889,217159587,40410385,,646097,73277162,13684738,PDP
MU085A,,2002,1976,,2443774,296728457,55242432,,1787132,221087397,41126526,,656642,75641060,14115906,PDP
MU085A,,2003,1976,,2444272,296743369,55245583,,1802753,223992211,41659018,,641519,72751158,13586565,PDP
MU085A,,2004,1976,,1962738,250868712,46601299,,1809392,226126033,42045341,,153346,24742679,4555958,PDP
MU085A,,2005,1976,,1962738,250868712,46601299,,1812765,227192836,42238537,,149973,23675876,4362762,PDP
MU085A,,2006,1976,,1969333,255359255,47406923,,1819567,229923342,42731194,,149766,25435913,4675729,PDP
MU085A,,2007,1976,,1972455,255530866,47440581,,1825980,232614247,43216415,,146475,22916619,4224166,PDP
MU085A,,2008,1976,,1973083,263990211,48946430,,1851210,237202326,44058030,,121873,26787885,4888400,PDP
MU085A,,2009,1976,,1995220,270511547,50128946,,1876085,246456685,45729587,,119135,24054862,4399359,PDP
MU085A,,2010,1976,,1969528,267308262,49533275,,1885331,249652405,46307467,,84197,17655857,3225808,PDP
MU085A,,2011,1976,,2023574,268183640,49743083,,1898882,252775635,46876753,,124692,15408005,2866331,PDP
MU085A,,2012,1976,,2023574,268183640,49743083,,1914715,255736175,47419373,,108859,12447465,2323712,PDP
MU085A,,2013,1976,,2023574,268183640,49743083,,1932990,258656256,47957235,,90584,9527384,1785848,PDP
MU085A,,2014,1976,,2029700,274096753,50801365,,1960668,261964988,48573655,,69032,12131765,2227710,PDP
MU085A,,2015,1976,,2031795,275744620,51096674,,1977794,265119380,49152061,,54001,10625240,1944614,PDP
MU085A,,2016,1976,,2025511,278442684,51570473,,1986982,268252489,49718743,,38529,10190195,1851731,PDP
MU085A,,2017,1976,,2037668,278276986,51553146,,1996031,270015995,50041582,,41637,8260991,1511564,PDP
MU085A,,2017,1976,,2037668,278276986,51553146,,1996031,270015995,50041582,,41637,8260991,1511564,PDP
MU090A,,1979,1976,,10000,10000000,1789359,,0,0,0,,10000,10000000,1789359,PDN
MU090A,,1980,1976,,10000,10000000,1789359,,0,0,0,,10000,10000000,1789359,PDN
MU090A,,1981,1976,,10000,10000000,1789359,,0,0,0,,10000,10000000,1789359,PDN
MU090A,,1982,1976,,10000,10000000,1789359,,0,0,0,,10000,10000000,1789359,PDN
MU090A,,1983,1976,,10000,10000000,1789359,,0,0,0,,10000,10000000,1789359,PDN
MU090A,,1984,1976,,10000,10000000,1789359,,75,38047,6845,,9925,9961953,1782514,PDN
MU090A,,1985,1976,,111,63613,11430,,111,63613,11430,,0,0,0,PDN
MU090A,,1986,1976,,111,63613,11430,,111,63613,11430,,0,0,0,PDN
MU090A,,1987,1976,,111,63613,11430,,111,63613,11430,,0,0,0,PDN
MU090A,,1988,1976,,111,63613,11430,,111,63613,11430,,0,0,0,PDN
MU090A,,1989,1976,,111,63613,11430,,111,63613,11430,,0,0,0,PDN
MU090A,,1990,1976,,111,63613,11430,,111,63613,11430,,0,0,0,PDN
MU090A,,1991,1976,,111,63613,11430,,111,63613,11430,,0,0,0,PDN
MU090A,,1992,1976,,111,63613,11430,,111,63613,11430,,0,0,0,PDN
MU090A,,1993,1976,,111,63613,11430,,111,63613,11430,,0,0,0,PDN
MU090A,,1994,1976,,111,63613,11430,,111,63613,11430,,0,0,0,PDN
MU090A,,1995,1976,,111,63613,11430,,111,63613,11430,,0,0,0,PDN
MU090A,,1996,1976,,111,63613,11430,,111,63613,11430,,0,0,0,PDN
MU090A,,1997,1976,,111,63613,11430,,111,63613,11430,,0,0,0,PDN
MU090A,,1998,1976,,111,63613,11430,,111,63613,11430,,0,0,0,PDN
MU090A,,1999,1976,,111,63613,11430,,111,63613,11430,,0,0,0,PDN
MU090A,,2000,1976,,111,63613,11430,,111,63613,11430,,0,0,0,PDN
MU090A,,2001,1976,,111,63613,11430,,111,63613,11430,,0,0,0,PDN
MU090A,,2002,1976,,111,63613,11430,,111,63613,11430,,0,0,0,PDN
MU090A,,2003,1976,,111,63613,11430,,111,63613,11430,,0,0,0,PDN
MU090A,,2004,1976,,111,63613,11430,,111,63613,11430,,0,0,0,PDN
MU090A,,2005,1976,,111,63613,11430,,111,63613,11430,,0,0,0,PDN
MU090A,,2006,1976,,111,63613,11430,,111,63613,11430,,0,0,0,PDN
MU090A,,2007,1976,,111,63613,11430,,111,63613,11430,,0,0,0,PDN
MU090A,,2008,1976,,111,63613,11430,,111,63613,11430,,0,0,0,PDN
MU090A,,2009,1976,,111,64887,11657,,111,64887,11657,,0,0,0,PDN
MU090A,,2010,1976,,111,64887,11657,,111,64887,11657,,0,0,0,PDN
MU090A,,2011,1976,,111,64887,11657,,111,64887,11657,,0,0,0,PDN
MU090A,,2012,1976,,111,64887,11657,,111,64887,11657,,0,0,0,PDN
MU090A,,2013,1976,,111,64887,11657,,111,64887,11657,,0,0,0,PDN
MU090A,,2014,1976,,111,64887,11657,,111,64887,11657,,0,0,0,PDN
MU090A,,2015,1976,,111,64887,11657,,111,64887,11657,,0,0,0,PDN
MU090A,,2016,1976,,111,64887,11657,,111,64887,11657,,0,0,0,PDN
MU090A,,2017,1976,,111,64887,11657,,111,64887,11657,,0,0,0,PDN
MU090A,,2017,1976,,111,64887,11657,,111,64887,11657,,0,0,0,PDN
MU111A,,1982,1978,,43300,43300420,7748001,,0,0,0,,43300,43300420,7748001,PDN
MU111A,,1983,1978,,43300,43300420,7748001,,0,0,0,,43300,43300420,7748001,PDN
MU111A,,1984,1978,,43300,43300420,7748001,,0,0,0,,43300,43300420,7748001,PDN
MU111A,,1985,1978,,2242636,142643619,27624063,,27615,5220018,956444,,2215021,137423601,26667619,PDN
MU111A,,1986,1978,,11055616,342856728,72062151,,157299,30915811,5658333,,10898317,311940917,66403818,PDN
MU111A,,1987,1978,,11055616,342856728,72062151,,237477,47928056,8765601,,10818139,294928672,63296550,PDN
MU111A,,1988,1978,,5570140,334743708,65133077,,299890,62833849,11480290,,5270250,271909859,53652787,PDN
MU111A,,1989,1978,,5560986,334743708,65123923,,343530,72295481,13207495,,5217456,262448227,51916428,PDN
MU111A,,1990,1978,,5553868,332338734,64688874,,375137,79893455,14591054,,5178731,252445279,50097820,PDN
MU111A,,1991,1978,,2987028,200516731,38666162,,443383,91648933,16751022,,2543645,108867798,21915140,PDN
MU111A,,1992,1978,,2987028,200516731,38666162,,625583,111816864,20521822,,2361445,88699867,18144340,PDN
MU111A,,1993,1978,,3155293,209147522,40370155,,744311,124447974,22888079,,2410982,84699548,17482076,PDN
MU111A,,1994,1978,,3393750,227351815,43847810,,834062,132984178,24496727,,2559688,94367637,19351083,PDN
MU111A,,1995,1978,,3693235,240574010,46499998,,902308,141361774,26055649,,2790927,99212236,20444349,PDN
MU111A,,1996,1978,,1813662,236903110,43967240,,973107,149525893,27579138,,840555,87377217,16388102,PDN
MU111A,,1997,1978,,1812102,236776592,43943168,,1027616,155361034,28671928,,784486,81415558,15271240,PDN
MU111A,,1998,1978,,1984114,249422118,46365274,,1072022,159775236,29501779,,912092,89646882,16863495,PDN
MU111A,,1999,1978,,1750889,229355011,42561389,,1114022,163691648,30240650,,636867,65663363,12320739,PDN
MU111A,,2000,1978,,13294064,361458111,77610454,,1137562,166784151,30814457,,12156502,194673960,46795997,PDN
MU111A,,2001,1978,,13288482,367828843,78738454,,1155354,169701601,31351368,,12133128,198127242,47387086,PDN
MU111A,,2002,1978,,13288482,367828843,78738454,,1167754,171527155,31688600,,12120728,196301688,47049854,PDN
MU111A,,2003,1978,,13288482,367828843,78738454,,1175340,172568782,31881529,,12113142,195260061,46856925,PDN
MU111A,,2004,1978,,12511868,259118176,58618305,,1178876,173496406,32050123,,11332992,85621770,26568182,PDN
MU111A,,2005,1978,,12510973,250165059,57024328,,1182085,174421127,32217873,,11328888,75743932,24806455,PDN
MU111A,,2006,1978,,12521558,251704149,57308773,,1184357,174947590,32313821,,11337201,76756559,24994952,PDN
MU111A,,2007,1978,,12524350,251619720,57296542,,1190981,176176410,32539097,,11333369,75443310,24757445,PDN
MU111A,,2008,1978,,1234125,185247235,34196266,,1196458,177213176,32729052,,37667,8034059,1467214,PDN
MU111A,,2009,1978,,1227080,188936828,34845733,,1203461,181223505,33449636,,23619,7713323,1396096,PDN
MU111A,,2010,1978,,1209325,182898341,33753515,,1206824,181981478,33587869,,2501,916863,165643,PDN
MU111A,,2011,1978,,1209325,182898341,33753515,,1208321,182586173,33696965,,1004,312168,56550,PDN
MU111A,,2012,1978,,1209325,182898341,33753515,,1209325,182898341,33753515,,0,0,0,PDN
MU111A,,2013,1978,,1209325,182898341,33753515,,1209325,182898341,33753515,,0,0,0,PDN
MU111A,,2014,1978,,1209325,182898341,33753515,,1209325,182898341,33753515,,0,0,0,PDN
MU111A,,2015,1978,,1209325,182898341,33753515,,1209325,182898341,33753515,,0,0,0,PDN
MU111A,,2016,1978,,1209325,182898341,33753515,,1209325,182898341,33753515,,0,0,0,PDN
MU111A,,2017,1978,,1209325,182898341,33753515,,1209325,182898341,33753515,,0,0,0,PDN
MU111A,,2017,1978,,1209325,182898341,33753515,,1209325,182898341,33753515,,0,0,0,PDN
MU124A,,1993,1981,,769,7691283,1369325,,0,0,0,,769,7691283,1369325,PDN
MU124A,,1994,1981,,769,7691283,1369325,,213,2224966,396114,,556,5466317,973211,PDN
MU124A,,1995,1981,,769,7691283,1369325,,407,4386080,780848,,362,3305203,588477,PDN
MU124A,,1996,1981,,1539,11882011,2115776,,680,6150979,1095160,,859,5731032,1020616,PDN
MU124A,,1997,1981,,1539,11882011,2115776,,683,6882491,1225326,,856,4999520,890450,PDN
MU124A,,1998,1981,,8984,17798310,3175943,,2174,8844548,1575937,,6810,8953762,1600006,PDN
MU124A,,1999,1981,,8984,17798310,3175943,,4568,11922144,2125946,,4416,5876166,1049997,PDN
MU124A,,2000,1981,,9023,18219955,3251008,,5611,13412056,2392098,,3412,4807899,858910,PDN
MU124A,,2001,1981,,7152,15482348,2762018,,6410,14452821,2578086,,742,1029527,183932,PDN
MU124A,,2002,1981,,7152,15482348,2762018,,6817,14864092,2651673,,335,618256,110345,PDN
MU124A,,2003,1981,,7152,15482348,2762018,,6817,14894936,2657161,,335,587412,104857,PDN
MU124A,,2004,1981,,6817,14894936,2657161,,6817,14894936,2657161,,0,0,0,PDN
MU124A,,2005,1981,,6817,14894936,2657161,,6817,14894936,2657161,,0,0,0,PDN
MU124A,,2006,1981,,6817,14894936,2657161,,6817,14894936,2657161,,0,0,0,PDN
MU124A,,2007,1981,,6817,14894936,2657161,,6817,14894936,2657161,,0,0,0,PDN
MU124A,,2008,1981,,6817,14894936,2657161,,6817,14894936,2657161,,0,0,0,PDN
MU124A,,2009,1981,,6817,15045147,2683889,,6817,15045147,2683889,,0,0,0,PDN
MU124A,,2010,1981,,6817,15045147,2683889,,6817,15045147,2683889,,0,0,0,PDN
MU124A,,2011,1981,,6817,15045147,2683889,,6817,15045147,2683889,,0,0,0,PDN
MU124A,,2012,1981,,6817,15045147,2683889,,6817,15045147,2683889,,0,0,0,PDN
MU124A,,2013,1981,,6817,15045147,2683889,,6817,15045147,2683889,,0,0,0,PDN
MU124A,,2014,1981,,6817,15045147,2683889,,6817,15045147,2683889,,0,0,0,PDN
MU124A,,2015,1981,,6817,15045147,2683889,,6817,15045147,2683889,,0,0,0,PDN
MU124A,,2016,1981,,6817,15045147,2683889,,6817,15045147,2683889,,0,0,0,PDN
MU124A,,2017,1981,,6817,15045147,2683889,,6817,15045147,2683889,,0,0,0,PDN
MU124A,,2017,1981,,6817,15045147,2683889,,6817,15045147,2683889,,0,0,0,PDN
MU726,,2001,2000,,1488268,3449547,2102066,,0,0,0,,1488268,3449547,2102066,PDP
MU726,,2002,2000,,1488268,3449547,2102066,,0,0,0,,1488268,3449547,2102066,PDP
MU726,,2003,2000,,1488268,3449547,2102066,,0,0,0,,1488268,3449547,2102066,PDP
MU726,,2004,2000,,1488268,3449547,2102066,,0,0,0,,1488268,3449547,2102066,PDP
MU726,,2005,2000,,7792205,7384256,9106129,,154015,73620,167115,,7638190,7310636,8939014,PDP
MU726,,2006,2000,,9098665,9651360,10815988,,622710,368720,688319,,8475955,9282640,10127669,PDP
MU726,,2007,2000,,4346444,5312817,5291785,,1344089,843017,1494092,,3002355,4469800,3797693,PDP
MU726,,2008,2000,,3224041,2126178,3602364,,1745365,1095641,1940319,,1478676,1030537,1662045,PDP
MU726,,2009,2000,,3220597,2201421,3612309,,1990984,1203542,2205138,,1229613,997879,1407170,PDP
MU726,,2010,2000,,2974135,2979510,3504297,,2155495,1284372,2384031,,818640,1695138,1120266,PDP
MU726,,2011,2000,,2974135,2979510,3504297,,2318313,1398661,2567186,,655822,1580849,937113,PDP
MU726,,2012,2000,,2974135,2979510,3504297,,2437539,1481482,2701149,,536596,1498028,803149,PDP
MU726,,2013,2000,,2974135,2979510,3504297,,2497514,1520488,2768064,,476621,1459022,736235,PDP
MU726,,2014,2000,,2974135,2979510,3504297,,2503211,1526233,2774784,,470924,1453277,729514,PDP
MU726,,2015,2000,,2851718,2910259,3369558,,2526825,1535510,2800047,,324893,1374749,569510,PDP
MU726,,2016,2000,,2878023,2910884,3395974,,2577911,1550173,2853743,,300112,1360711,542231,PDP
MU726,,2017,2000,,2876990,2921035,3396747,,2622713,1568541,2901813,,254277,1352494,494934,PDP
MU726,,2017,2000,,2876990,2921035,3396747,,2622713,1568541,2901813,,254277,1352494,494934,PDP
MU738,,1995,1985,,1246,12462055,2218694,,0,0,0,,1246,12462055,2218694,PDN
MU738,,1996,1985,,2251,33843539,6024233,,8,1826605,325027,,2243,32016934,5699206,PDN
MU738,,1997,1985,,3912,33843539,6025894,,232,2951401,525392,,3680,30892138,5500502,PDN
MU738,,1998,1985,,232,3046216,542263,,232,3046216,542263,,0,0,0,PDN
MU738,,1999,1985,,232,3046216,542263,,232,3046216,542263,,0,0,0,PDN
MU738,,2000,1985,,232,3046216,542263,,232,3046216,542263,,0,0,0,PDN
MU738,,2001,1985,,232,3046216,542263,,232,3046216,542263,,0,0,0,PDN
MU738,,2002,1985,,232,3046216,542263,,232,3046216,542263,,0,0,0,PDN
MU738,,2003,1985,,232,3046216,542263,,232,3046216,542263,,0,0,0,PDN
MU738,,2004,1985,,232,3046216,542263,,232,3046216,542263,,0,0,0,PDN
MU738,,2005,1985,,232,3046216,542263,,232,3046216,542263,,0,0,0,PDN
MU738,,2006,1985,,232,3046216,542263,,232,3046216,542263,,0,0,0,PDN
MU738,,2007,1985,,232,3046216,542263,,232,3046216,542263,,0,0,0,PDN
MU738,,2008,1985,,232,3046216,542263,,232,3046216,542263,,0,0,0,PDN
MU738,,2009,1985,,232,3107202,553115,,232,3107202,553115,,0,0,0,PDN
MU738,,2010,1985,,232,3107202,553115,,232,3107202,553115,,0,0,0,PDN
MU738,,2011,1985,,232,3107202,553115,,232,3107202,553115,,0,0,0,PDN
MU738,,2012,1985,,232,3107202,553115,,232,3107202,553115,,0,0,0,PDN
MU738,,2013,1985,,232,3107202,553115,,232,3107202,553115,,0,0,0,PDN
MU738,,2014,1985,,232,3107202,553115,,232,3107202,553115,,0,0,0,PDN
MU738,,2015,1985,,232,3107202,553115,,232,3107202,553115,,0,0,0,PDN
MU738,,2016,1985,,232,3107202,553115,,232,3107202,553115,,0,0,0,PDN
MU738,,2017,1985,,232,3107202,553115,,232,3107202,553115,,0,0,0,PDN
MU738,,2017,1985,,232,3107202,553115,,232,3107202,553115,,0,0,0,PDN
MU739,,1986,1984,,98258,34849887,6299306,,4032,1487760,268758,,94226,33362127,6030548,PDN
MU739,,1987,1984,,98258,34849887,6299306,,26392,9126735,1650366,,71866,25723152,4648940,PDN
MU739,,1988,1984,,211270,65734558,11907811,,62351,18838969,3414481,,148919,46895589,8493330,PDN
MU739,,1989,1984,,224821,70272470,12728819,,90309,27055211,4904403,,134512,43217259,7824416,PDN
MU739,,1990,1984,,258022,86348096,15622452,,116145,34928398,6331162,,141877,51419698,9291290,PDN
MU739,,1991,1984,,253775,84881460,15357238,,131050,39808679,7214445,,122725,45072781,8142793,PDN
MU739,,1992,1984,,224826,77000616,13926003,,145397,47463825,8590917,,79429,29536791,5335086,PDN
MU739,,1993,1984,,244465,83837848,15162232,,159845,54068990,9780662,,84620,29768858,5381570,PDN
MU739,,1994,1984,,244465,83837848,15162232,,174462,59031389,10678268,,70003,24806459,4483964,PDN
MU739,,1995,1984,,231637,84623406,15289183,,185670,63778995,11534246,,45967,20844411,3754937,PDN
MU739,,1996,1984,,251413,88457491,15991180,,194813,67613441,12225674,,56600,20844050,3765506,PDN
MU739,,1997,1984,,264556,91240352,16499494,,201143,69222222,12518264,,63413,22018130,3981230,PDN
MU739,,1998,1984,,264556,91240352,16499494,,207123,71070319,12853087,,57433,20170033,3646407,PDN
MU739,,1999,1984,,259408,89145416,16121582,,211057,72202026,13058393,,48351,16943390,3063189,PDN
MU739,,2000,1984,,236062,78744472,14247534,,213642,73111381,13222785,,22420,5633091,1024749,PDN
MU739,,2001,1984,,226556,77255378,13973065,,216323,73951995,13375041,,10233,3303383,598024,PDN
MU739,,2002,1984,,226556,77255378,13973065,,218624,74415415,13459801,,7932,2839963,513264,PDN
MU739,,2003,1984,,231045,77518465,14024366,,224121,75087437,13584875,,6924,2431028,439491,PDN
MU739,,2004,1984,,229977,77290642,13982760,,226530,75642932,13686126,,3447,1647710,296634,PDN
MU739,,2005,1984,,231136,77520991,14024907,,228553,76170771,13782071,,2583,1350220,242836,PDN
MU739,,2006,1984,,231136,77520991,14024907,,229956,76476980,13837960,,1180,1044011,186947,PDN
MU739,,2007,1984,,233500,77749328,14067900,,231066,76732102,13884465,,2434,1017226,183435,PDN
MU739,,2008,1984,,239956,78297599,14171913,,232663,77174283,13964742,,7293,1123316,207171,PDN
MU739,,2009,1984,,234316,78960898,14284300,,233575,78712927,14239436,,741,247971,44864,PDN
MU739,,2010,1984,,234316,78960898,14284300,,234072,78886901,14270889,,244,73997,13410,PDN
MU739,,2011,1984,,234316,78960898,14284300,,234316,78960898,14284300,,0,0,0,PDN
MU739,,2012,1984,,234316,78960898,14284300,,234316,78960898,14284300,,0,0,0,PDN
MU739,,2013,1984,,234316,78960898,14284300,,234316,78960898,14284300,,0,0,0,PDN
MU739,,2014,1984,,234316,78960898,14284300,,234316,78960898,14284300,,0,0,0,PDN
MU739,,2015,1984,,234316,78960898,14284300,,234316,78960898,14284300,,0,0,0,PDN
MU739,,2016,1984,,234316,78960898,14284300,,234316,78960898,14284300,,0,0,0,PDN
MU739,,2017,1984,,234316,78960898,14284300,,234316,78960898,14284300,,0,0,0,PDN
MU739,,2017,1984,,234316,78960898,14284300,,234316,78960898,14284300,,0,0,0,PDN
MU752,,1988,1987,,0,7094509,1262368,,0,0,0,,0,7094509,1262368,PDN
MU752,,1989,1987,,14621,7094509,1276989,,3536,1419711,256154,,11085,5674798,1020835,PDN
MU752,,1990,1987,,14621,7094509,1276989,,6368,3013560,542589,,8253,4080949,734400,PDN
MU752,,1991,1987,,14621,7094509,1276989,,7206,4413380,792505,,7415,2681129,484484,PDN
MU752,,1992,1987,,14621,7094509,1276989,,7386,4803093,862029,,7235,2291416,414960,PDN
MU752,,1993,1987,,14621,7094509,1276989,,7631,4918390,882789,,6990,2176119,394200,PDN
MU752,,1994,1987,,11050,7123218,1278527,,7651,4989955,895543,,3399,2133263,382984,PDN
MU752,,1995,1987,,10304,7116502,1276585,,7731,5249690,941840,,2573,1866812,334745,PDN
MU752,,1996,1987,,7731,5249690,941840,,7731,5249690,941840,,0,0,0,PDN
MU752,,1997,1987,,7731,5249690,941840,,7731,5249690,941840,,0,0,0,PDN
MU752,,1998,1987,,7731,5249690,941840,,7731,5249690,941840,,0,0,0,PDN
MU752,,1999,1987,,7731,5249690,941840,,7731,5249690,941840,,0,0,0,PDN
MU752,,2000,1987,,7731,5249690,941840,,7731,5249690,941840,,0,0,0,PDN
MU752,,2001,1987,,7731,5249690,941840,,7731,5249690,941840,,0,0,0,PDN
MU752,,2002,1987,,7731,5249690,941840,,7731,5249690,941840,,0,0,0,PDN
MU752,,2003,1987,,7731,5249690,941840,,7731,5249690,941840,,0,0,0,PDN
MU752,,2004,1987,,7731,5249690,941840,,7731,5249690,941840,,0,0,0,PDN
MU752,,2005,1987,,7731,5249690,941840,,7731,5249690,941840,,0,0,0,PDN
MU752,,2006,1987,,7731,5249690,941840,,7731,5249690,941840,,0,0,0,PDN
MU752,,2007,1987,,7731,5249690,941840,,7731,5249690,941840,,0,0,0,PDN
MU752,,2008,1987,,7731,5249690,941840,,7731,5249690,941840,,0,0,0,PDN
MU752,,2009,1987,,7731,5354827,960548,,7731,5354827,960548,,0,0,0,PDN
MU752,,2010,1987,,7731,5354827,960548,,7731,5354827,960548,,0,0,0,PDN
MU752,,2011,1987,,7731,5354827,960548,,7731,5354827,960548,,0,0,0,PDN
MU752,,2012,1987,,7731,5354827,960548,,7731,5354827,960548,,0,0,0,PDN
MU752,,2013,1987,,7731,5354827,960548,,7731,5354827,960548,,0,0,0,PDN
MU752,,2014,1987,,7731,5354827,960548,,7731,5354827,960548,,0,0,0,PDN
MU752,,2015,1987,,7731,5354827,960548,,7731,5354827,960548,,0,0,0,PDN
MU752,,2016,1987,,7731,5354827,960548,,7731,5354827,960548,,0,0,0,PDN
MU752,,2017,1987,,7731,5354827,960548,,7731,5354827,960548,,0,0,0,PDN
MU752,,2017,1987,,7731,5354827,960548,,7731,5354827,960548,,0,0,0,PDN
MU754,,1987,1985,,101419,25843570,4699919,,0,0,0,,101419,25843570,4699919,PDN
MU754,,1989,1985,,219927,43985285,8046490,,0,0,0,,219927,43985285,8046490,PDN
MU754,,1990,1985,,219927,43985285,8046490,,8428,2006042,365375,,211499,41979243,7681115,PDN
MU754,,1991,1985,,219927,43985285,8046490,,20448,6776930,1226307,,199479,37208355,6820183,PDN
MU754,,1992,1985,,219927,43985285,8046490,,29818,10455077,1890152,,190109,33530208,6156338,PDN
MU754,,1993,1985,,219927,43985285,8046490,,29818,13374180,2409565,,190109,30611105,5636925,PDN
MU754,,1994,1985,,219927,43985285,8046490,,32208,15454703,2782155,,187719,28530582,5264335,PDN
MU754,,1995,1985,,45718,23909000,4299988,,41073,17194733,3100634,,4645,6714267,1199354,PDN
MU754,,1996,1985,,58750,23909000,4313020,,45431,18902603,3408883,,13319,5006397,904137,PDN
MU754,,1997,1985,,173871,33336905,6105705,,50039,20758327,3743691,,123832,12578578,2362014,PDN
MU754,,1998,1985,,173871,33336905,6105705,,52603,22488102,4054045,,121268,10848803,2051660,PDN
MU754,,1999,1985,,202444,40300318,7373319,,53778,24014115,4326752,,148666,16286203,3046567,PDN
MU754,,2000,1985,,122096,34581692,6275422,,56283,25284032,4555221,,65813,9297660,1720201,PDN
MU754,,2001,1985,,122048,34574306,6274060,,56727,26064511,4694540,,65321,8509795,1579520,PDN
MU754,,2002,1985,,122048,34574306,6274060,,57410,26478075,4768811,,64638,8096231,1505249,PDN
MU754,,2003,1985,,122098,34582533,6275573,,57430,26532776,4778565,,64668,8049757,1497008,PDN
MU754,,2004,1985,,122098,34582533,6275573,,57975,26648041,4799619,,64123,7934492,1475954,PDN
MU754,,2005,1985,,122098,34582533,6275573,,58197,27228287,4903088,,63901,7354246,1372485,PDN
MU754,,2006,1985,,122098,34582533,6275573,,58394,27620954,4973154,,63704,6961579,1302419,PDN
MU754,,2007,1985,,90956,31131699,5630404,,58781,27922969,5027281,,32175,3208730,603123,PDN
MU754,,2008,1985,,58856,28038719,5047952,,58856,28038719,5047952,,0,0,0,PDN
MU754,,2009,1985,,58856,28480182,5126504,,58856,28480182,5126504,,0,0,0,PDN
MU754,,2010,1985,,58856,28480182,5126504,,58856,28480182,5126504,,0,0,0,PDN
MU754,,2011,1985,,58856,28480182,5126504,,58856,28480182,5126504,,0,0,0,PDN
MU754,,2012,1985,,58856,28480182,5126504,,58856,28480182,5126504,,0,0,0,PDN
MU754,,2013,1985,,58856,28480182,5126504,,58856,28480182,5126504,,0,0,0,PDN
MU754,,2014,1985,,58856,28480182,5126504,,58856,28480182,5126504,,0,0,0,PDN
MU754,,2015,1985,,58856,28480182,5126504,,58856,28480182,5126504,,0,0,0,PDN
MU754,,2016,1985,,58856,28480182,5126504,,58856,28480182,5126504,,0,0,0,PDN
MU754,,2017,1985,,58856,28480182,5126504,,58856,28480182,5126504,,0,0,0,PDN
MU754,,2017,1985,,58856,28480182,5126504,,58856,28480182,5126504,,0,0,0,PDN
MU755,,1979,1977,,28000,28000000,5010206,,0,0,0,,28000,28000000,5010206,PDN
MU755,,1980,1977,,28000,28000000,5010206,,0,0,0,,28000,28000000,5010206,PDN
MU755,,1981,1977,,28000,28000000,5010206,,0,0,0,,28000,28000000,5010206,PDN
MU755,,1982,1977,,28000,28000000,5010206,,7047,1580416,288260,,20953,26419584,4721946,PDN
MU755,,1983,1977,,67927,26187056,4727546,,21902,8081329,1459861,,46025,18105727,3267685,PDN
MU755,,1984,1977,,51016,19947029,3600309,,22248,9471392,1707549,,28768,10475637,1892760,PDN
MU755,,1985,1977,,51016,19947029,3600309,,23761,10062137,1814177,,27255,9884892,1786132,PDN
MU755,,1986,1977,,51016,19947029,3600309,,25290,10730389,1934612,,25726,9216640,1665697,PDN
MU755,,1987,1977,,51016,19947029,3600309,,25770,10887947,1963127,,25246,9059082,1637182,PDN
MU755,,1988,1977,,25770,10887947,1963127,,25770,10887947,1963127,,0,0,0,PDN
MU755,,1989,1977,,25770,10887947,1963127,,25770,10887947,1963127,,0,0,0,PDN
MU755,,1990,1977,,25770,10887947,1963127,,25770,10887947,1963127,,0,0,0,PDN
MU755,,1991,1977,,25770,10887947,1963127,,25770,10887947,1963127,,0,0,0,PDN
MU755,,1992,1977,,25770,10887947,1963127,,25770,10887947,1963127,,0,0,0,PDN
MU755,,1993,1977,,25770,10887947,1963127,,25770,10887947,1963127,,0,0,0,PDN
MU755,,1994,1977,,25770,10887947,1963127,,25770,10887947,1963127,,0,0,0,PDN
MU755,,1995,1977,,25770,10887947,1963127,,25770,10887947,1963127,,0,0,0,PDN
MU755,,1996,1977,,25770,10887947,1963127,,25770,10887947,1963127,,0,0,0,PDN
MU755,,1997,1977,,25770,10887947,1963127,,25770,10887947,1963127,,0,0,0,PDN
MU755,,1998,1977,,25770,10887947,1963127,,25770,10887947,1963127,,0,0,0,PDN
MU755,,1999,1977,,25770,10887947,1963127,,25770,10887947,1963127,,0,0,0,PDN
MU755,,2000,1977,,25770,10887947,1963127,,25770,10887947,1963127,,0,0,0,PDN
MU755,,2001,1977,,25770,10887947,1963127,,25770,10887947,1963127,,0,0,0,PDN
MU755,,2002,1977,,25770,10887947,1963127,,25770,10887947,1963127,,0,0,0,PDN
MU755,,2003,1977,,25770,10887947,1963127,,25770,10887947,1963127,,0,0,0,PDN
MU755,,2004,1977,,25770,10887947,1963127,,25770,10887947,1963127,,0,0,0,PDN
MU755,,2005,1977,,25770,10887947,1963127,,25770,10887947,1963127,,0,0,0,PDN
MU755,,2006,1977,,25770,10887947,1963127,,25770,10887947,1963127,,0,0,0,PDN
MU755,,2007,1977,,25770,10887947,1963127,,25770,10887947,1963127,,0,0,0,PDN
MU755,,2008,1977,,25770,10887947,1963127,,25770,10887947,1963127,,0,0,0,PDN
MU755,,2009,1977,,25770,11106003,2001927,,25770,11106003,2001927,,0,0,0,PDN
MU755,,2010,1977,,25770,11106003,2001927,,25770,11106003,2001927,,0,0,0,PDN
MU755,,2011,1977,,25770,11106003,2001927,,25770,11106003,2001927,,0,0,0,PDN
MU755,,2012,1977,,25770,11106003,2001927,,25770,11106003,2001927,,0,0,0,PDN
MU755,,2013,1977,,25770,11106003,2001927,,25770,11106003,2001927,,0,0,0,PDN
MU755,,2014,1977,,25770,11106003,2001927,,25770,11106003,2001927,,0,0,0,PDN
MU755,,2015,1977,,25770,11106003,2001927,,25770,11106003,2001927,,0,0,0,PDN
MU755,,2016,1977,,25770,11106003,2001927,,25770,11106003,2001927,,0,0,0,PDN
MU755,,2017,1977,,25770,11106003,2001927,,25770,11106003,2001927,,0,0,0,PDN
MU755,,2017,1977,,25770,11106003,2001927,,25770,11106003,2001927,,0,0,0,PDN
MU756,,1989,1988,,28977,7157190,1302498,,58,28166,5070,,28919,7129024,1297428,PDN
MU756,,1990,1988,,28977,7157190,1302498,,207,229634,41067,,28770,6927556,1261431,PDN
MU756,,1991,1988,,6572,1941629,352058,,274,278260,49786,,6298,1663369,302272,PDN
MU756,,1992,1988,,274,278260,49786,,274,278260,49786,,0,0,0,PDN
MU756,,1993,1988,,274,278260,49786,,274,278260,49786,,0,0,0,PDN
MU756,,1994,1988,,274,278260,49786,,274,278260,49786,,0,0,0,PDN
MU756,,1995,1988,,274,278260,49786,,274,278260,49786,,0,0,0,PDN
MU756,,1996,1988,,274,278260,49786,,274,278260,49786,,0,0,0,PDN
MU756,,1997,1988,,274,278260,49786,,274,278260,49786,,0,0,0,PDN
MU756,,1998,1988,,274,278260,49786,,274,278260,49786,,0,0,0,PDN
MU756,,1999,1988,,274,278260,49786,,274,278260,49786,,0,0,0,PDN
MU756,,2000,1988,,274,278260,49786,,274,278260,49786,,0,0,0,PDN
MU756,,2001,1988,,274,278260,49786,,274,278260,49786,,0,0,0,PDN
MU756,,2002,1988,,274,278260,49786,,274,278260,49786,,0,0,0,PDN
MU756,,2003,1988,,274,278260,49786,,274,278260,49786,,0,0,0,PDN
MU756,,2004,1988,,274,278260,49786,,274,278260,49786,,0,0,0,PDN
MU756,,2005,1988,,274,278260,49786,,274,278260,49786,,0,0,0,PDN
MU756,,2006,1988,,274,278260,49786,,274,278260,49786,,0,0,0,PDN
MU756,,2007,1988,,274,278260,49786,,274,278260,49786,,0,0,0,PDN
MU756,,2008,1988,,274,278260,49786,,274,278260,49786,,0,0,0,PDN
MU756,,2009,1988,,274,283832,50778,,274,283832,50778,,0,0,0,PDN
MU756,,2010,1988,,274,283832,50778,,274,283832,50778,,0,0,0,PDN
MU756,,2011,1988,,274,283832,50778,,274,283832,50778,,0,0,0,PDN
MU756,,2012,1988,,274,283832,50778,,274,283832,50778,,0,0,0,PDN
MU756,,2013,1988,,274,283832,50778,,274,283832,50778,,0,0,0,PDN
MU756,,2014,1988,,274,283832,50778,,274,283832,50778,,0,0,0,PDN
MU756,,2015,1988,,274,283832,50778,,274,283832,50778,,0,0,0,PDN
MU756,,2016,1988,,274,283832,50778,,274,283832,50778,,0,0,0,PDN
MU756,,2017,1988,,274,283832,50778,,274,283832,50778,,0,0,0,PDN
MU756,,2017,1988,,274,283832,50778,,274,283832,50778,,0,0,0,PDN
MU757,,1976,1976,,0,16300000,2900356,,0,0,0,,0,16300000,2900356,PDN
MU757,,1977,1976,,0,16300000,2900356,,0,0,0,,0,16300000,2900356,PDN
MU757,,1978,1976,,0,16300000,2900356,,0,0,0,,0,16300000,2900356,PDN
MU757,,1979,1976,,0,16300000,2900356,,0,0,0,,0,16300000,2900356,PDN
MU757,,1980,1976,,106297,106294750,19019954,,0,0,0,,106297,106294750,19019954,PDN
MU757,,1981,1976,,106297,106294750,19019954,,0,0,0,,106297,106294750,19019954,PDN
MU757,,1982,1976,,235863,106294750,19149520,,63542,5862639,1106716,,172321,100432111,18042804,PDN
MU757,,1983,1976,,245368,128530007,23115476,,100734,37216033,6722804,,144634,91313974,16392672,PDN
MU757,,1984,1976,,251833,160473267,28805795,,89639,73380697,13146703,,162194,87092570,15659092,PDN
MU757,,1985,1976,,237348,186402227,33405004,,109816,107571080,19250578,,127532,78831147,14154426,PDN
MU757,,1986,1976,,231212,239246591,42801780,,132903,141819374,25367667,,98309,97427217,17434113,PDN
MU757,,1987,1976,,231212,239246591,42801780,,147498,167986583,30038349,,83714,71260008,12763431,PDN
MU757,,1988,1976,,231218,239446343,42837329,,157110,186245661,33296907,,74108,53200682,9540422,PDN
MU757,,1989,1976,,231192,239747562,42890901,,166016,200789287,35893647,,65176,38958275,6997254,PDN
MU757,,1990,1976,,234041,264651251,47325011,,172927,211232455,37758773,,61114,53418796,9566238,PDN
MU757,,1991,1976,,235817,268048476,47931275,,180166,218948395,39138955,,55651,49100081,8792320,PDN
MU757,,1992,1976,,240858,268048476,47936316,,184909,224738357,40173940,,55949,43310119,7762376,PDN
MU757,,1993,1976,,231385,260682022,46616086,,189362,229987541,41112412,,42023,30694481,5503674,PDN
MU757,,1994,1976,,231385,260682022,46616086,,198159,239460275,42806749,,33226,21221747,3809337,PDN
MU757,,1995,1976,,232422,261816741,46819031,,204137,245522912,43891488,,28285,16293829,2927543,PDN
MU757,,1996,1976,,222950,262310835,46897476,,208303,251205742,44906834,,14647,11105093,1990642,PDN
MU757,,1997,1976,,232591,277182159,49553260,,211305,255994451,45761919,,21286,21187708,3791341,PDN
MU757,,1998,1976,,231311,288232621,51518254,,212900,260568859,46577466,,18411,27663762,4940788,PDN
MU757,,1999,1976,,223905,276257062,49379966,,214262,264294181,47241696,,9643,11962881,2138270,PDN
MU757,,2000,1976,,220147,272889005,48776909,,215425,267388207,47793398,,4722,5500798,983511,PDN
MU757,,2001,1976,,221444,278034947,49693854,,216073,270593827,48364441,,5371,7441120,1329413,PDN
MU757,,2002,1976,,221444,278034947,49693854,,217405,272622874,48726813,,4039,5412073,967041,PDN
MU757,,2003,1976,,221444,278034947,49693854,,217690,273994185,48971104,,3754,4040762,722750,PDN
MU757,,2004,1976,,221444,278034947,49693854,,218037,275224874,49190435,,3407,2810073,503419,PDN
MU757,,2005,1976,,227704,283404011,50655464,,218916,277069183,49519482,,8788,6334828,1135982,PDN
MU757,,2006,1976,,227704,283404011,50655464,,223873,280787181,50186005,,3831,2616830,469459,PDN
MU757,,2007,1976,,229356,284793621,50904378,,226920,283721070,50711096,,2436,1072551,193282,PDN
MU757,,2008,1976,,231814,291202363,52047181,,228250,286014123,51120443,,3564,5188240,926738,PDN
MU757,,2009,1976,,229664,294126125,52565272,,228840,291647017,52123326,,824,2479108,441946,PDN
MU757,,2010,1976,,229664,294126125,52565272,,229269,292542344,52283065,,395,1583781,282207,PDN
MU757,,2011,1976,,229664,294126065,52565261,,229658,293990885,52541202,,6,135180,24059,PDN
MU757,,2012,1976,,229664,294126065,52565261,,229664,294126065,52565261,,0,0,0,PDN
MU757,,2013,1976,,229664,294126065,52565261,,229664,294126065,52565261,,0,0,0,PDN
MU757,,2014,1976,,229664,294126065,52565261,,229664,294126065,52565261,,0,0,0,PDN
MU757,,2015,1976,,229664,294126065,52565261,,229664,294126065,52565261,,0,0,0,PDN
MU757,,2016,1976,,229664,294126065,52565261,,229664,294126065,52565261,,0,0,0,PDN
MU757,,2017,1976,,229664,294126065,52565261,,229664,294126065,52565261,,0,0,0,PDN
MU757,,2017,1976,,229664,294126065,52565261,,229664,294126065,52565261,,0,0,0,PDN
MU759,,1995,1994,,246657,48363743,8852305,,23954,4753478,869769,,222703,43610265,7982536,PDN
MU759,,1996,1994,,408417,63119308,11639611,,62773,13220703,2415211,,345644,49898605,9224400,PDN
MU759,,1997,1994,,549625,86838993,16001403,,91321,19806996,3615698,,458304,67031997,12385705,PDN
MU759,,1998,1994,,614819,91399482,16878072,,118203,24867113,4542956,,496616,66532369,12335116,PDN
MU759,,1999,1994,,611537,89589489,16552727,,125659,27695030,5053600,,485878,61894459,11499127,PDN
MU759,,2000,1994,,327895,52673178,9700347,,132849,30382113,5538919,,195046,22291065,4161428,PDN
MU759,,2001,1994,,512530,65395007,12148652,,141592,32868963,5990162,,370938,32526044,6158490,PDN
MU759,,2002,1994,,512534,65431760,12155196,,143285,34511152,6284059,,369249,30920608,5871137,PDN
MU759,,2003,1994,,513460,65949395,12248228,,158782,36807148,6708097,,354678,29142247,5540131,PDN
MU759,,2004,1994,,519603,66140914,12288449,,160147,38329271,6980302,,359456,27811643,5308147,PDN
MU759,,2005,1994,,318605,55176249,10136443,,160720,41328001,7514457,,157885,13848248,2621986,PDN
MU759,,2006,1994,,312513,55596401,10205111,,162360,43289491,7865116,,150153,12306910,2339995,PDN
MU759,,2007,1994,,312847,55941094,10266778,,164120,45197459,8206372,,148727,10743635,2060406,PDN
MU759,,2008,1994,,313434,56262238,10324508,,164812,45643958,8286513,,148622,10618280,2037995,PDN
MU759,,2009,1994,,164869,46139885,8374812,,164869,46139885,8374812,,0,0,0,PDN
MU759,,2010,1994,,168736,46698813,8478133,,168592,46680187,8474674,,144,18626,3458,PDN
MU759,,2011,1994,,168736,46698813,8478133,,168736,46698813,8478133,,0,0,0,PDN
MU759,,2012,1994,,168736,46698813,8478133,,168736,46698813,8478133,,0,0,0,PDN
MU759,,2013,1994,,168736,46698813,8478133,,168736,46698813,8478133,,0,0,0,PDN
MU759,,2014,1994,,168736,46698813,8478133,,168736,46698813,8478133,,0,0,0,PDN
MU759,,2015,1994,,168736,46698813,8478133,,168736,46698813,8478133,,0,0,0,PDN
MU759,,2016,1994,,168736,46698813,8478133,,168736,46698813,8478133,,0,0,0,PDN
MU759,,2017,1994,,168736,46698813,8478133,,168736,46698813,8478133,,0,0,0,PDN
MU759,,2017,1994,,168736,46698813,8478133,,168736,46698813,8478133,,0,0,0,PDN
MU781,,1988,1987,,72560,18503035,3364915,,0,0,0,,72560,18503035,3364915,PDN
MU781,,1989,1987,,72560,18503035,3364915,,19995,3286998,604870,,52565,15216037,2760045,PDN
MU781,,1990,1987,,117540,18503035,3409895,,46001,7615653,1401099,,71539,10887382,2008796,PDN
MU781,,1991,1987,,109545,18503035,3401900,,64538,11294319,2074203,,45007,7208716,1327697,PDN
MU781,,1992,1987,,98165,18465480,3383838,,68526,12109410,2223225,,29639,6356070,1160613,PDN
MU781,,1993,1987,,201240,26631772,4939989,,96314,17406712,3193594,,104926,9225060,1746395,PDN
MU781,,1994,1987,,207564,28963235,5361165,,128827,22199496,4078915,,78737,6763739,1282250,PDN
MU781,,1995,1987,,218519,32257872,5958354,,139514,23791874,4372944,,79005,8465998,1585410,PDN
MU781,,1996,1987,,139514,23791874,4372944,,139514,23791874,4372944,,0,0,0,PDN
MU781,,1997,1987,,139514,23791874,4372944,,139514,23791874,4372944,,0,0,0,PDN
MU781,,1998,1987,,139638,23895697,4391541,,139638,23895697,4391541,,0,0,0,PDN
MU781,,1999,1987,,141216,25216898,4628209,,139746,23982408,4407078,,1470,1234490,221131,PDN
MU781,,2000,1987,,139957,23982744,4407349,,139746,23982408,4407078,,211,336,271,PDN
MU781,,2001,1987,,139957,23982744,4407349,,139957,23982744,4407349,,0,0,0,PDN
MU781,,2002,1987,,139957,23982744,4407349,,139957,23982744,4407349,,0,0,0,PDN
MU781,,2003,1987,,139957,23982744,4407349,,139957,23982744,4407349,,0,0,0,PDN
MU781,,2004,1987,,139957,23982744,4407349,,139957,23982744,4407349,,0,0,0,PDN
MU781,,2005,1987,,139957,23982744,4407349,,139957,23982744,4407349,,0,0,0,PDN
MU781,,2006,1987,,139957,23982744,4407349,,139957,23982744,4407349,,0,0,0,PDN
MU781,,2007,1987,,139957,23982744,4407349,,139957,23982744,4407349,,0,0,0,PDN
MU781,,2008,1987,,139957,23982744,4407349,,139957,23982744,4407349,,0,0,0,PDN
MU781,,2009,1987,,139957,24459227,4492134,,139957,24459227,4492134,,0,0,0,PDN
MU781,,2010,1987,,139957,24459227,4492134,,139957,24459227,4492134,,0,0,0,PDN
MU781,,2011,1987,,139957,24459227,4492134,,139957,24459227,4492134,,0,0,0,PDN
MU781,,2012,1987,,139957,24459227,4492134,,139957,24459227,4492134,,0,0,0,PDN
MU781,,2013,1987,,139957,24459227,4492134,,139957,24459227,4492134,,0,0,0,PDN
MU781,,2014,1987,,139957,24459227,4492134,,139957,24459227,4492134,,0,0,0,PDN
MU781,,2015,1987,,139957,24459227,4492134,,139957,24459227,4492134,,0,0,0,PDN
MU781,,2016,1987,,139957,24459227,4492134,,139957,24459227,4492134,,0,0,0,PDN
MU781,,2017,1987,,139957,24459227,4492134,,139957,24459227,4492134,,0,0,0,PDN
MU781,,2017,1987,,139957,24459227,4492134,,139957,24459227,4492134,,0,0,0,PDN
MU782,,1994,1984,,26112,57130464,10191675,,276,616459,109966,,25836,56514005,10081709,PDN
MU782,,1995,1984,,26659,57811184,10313347,,2344,6261740,1116533,,24315,51549444,9196814,PDN
MU782,,1996,1984,,19606,65064028,11596835,,3374,9449781,1684830,,16232,55614247,9912005,PDN
MU782,,1997,1984,,24506,65064028,11601735,,4093,12537090,2234892,,20413,52526938,9366843,PDN
MU782,,1998,1984,,24092,68056931,12133866,,4899,15144963,2699732,,19193,52911968,9434134,PDN
MU782,,1999,1984,,21742,57869331,10318776,,5095,15746569,2806976,,16647,42122762,7511800,PDN
MU782,,2000,1984,,11613,40376446,7196034,,5685,17216216,3069069,,5928,23160230,4126965,PDN
MU782,,2001,1984,,11468,40294257,7181265,,6103,18896404,3368452,,5365,21397853,3812813,PDN
MU782,,2002,1984,,13528,41219817,7348015,,6719,20583026,3669179,,6809,20636791,3678836,PDN
MU782,,2003,1984,,13528,41219817,7348015,,7225,22159113,3950128,,6303,19060704,3397887,PDN
MU782,,2004,1984,,14207,41527766,7403489,,7561,23117242,4120949,,6646,18410524,3282540,PDN
MU782,,2005,1984,,14207,41527766,7403489,,8303,24928030,4443896,,5904,16599736,2959593,PDN
MU782,,2006,1984,,14207,41527766,7403489,,8372,25285632,4507595,,5835,16242134,2895894,PDN
MU782,,2007,1984,,13125,40189531,7164287,,8372,25285632,4507595,,4753,14903899,2656692,PDN
MU782,,2008,1984,,9369,28316900,5047963,,8385,25335632,4516505,,984,2981268,531458,PDN
MU782,,2009,1984,,8627,26637277,4748355,,8488,25988068,4632699,,139,649209,115657,PDN
MU782,,2010,1984,,8627,26637277,4748355,,8509,26269386,4682776,,118,367891,65579,PDN
MU782,,2011,1984,,8627,26637277,4748355,,8585,26608055,4743114,,42,29222,5242,PDN
MU782,,2012,1984,,8627,26637277,4748355,,8627,26637277,4748355,,0,0,0,PDN
MU782,,2013,1984,,8627,26637277,4748355,,8627,26637277,4748355,,0,0,0,PDN
MU782,,2014,1984,,8627,26637277,4748355,,8627,26637277,4748355,,0,0,0,PDN
MU782,,2015,1984,,8627,26637277,4748355,,8627,26637277,4748355,,0,0,0,PDN
MU782,,2016,1984,,8627,26637277,4748355,,8627,26637277,4748355,,0,0,0,PDN
MU782,,2017,1984,,8627,26637277,4748355,,8627,26637277,4748355,,0,0,0,PDN
MU782,,2017,1984,,8627,26637277,4748355,,8627,26637277,4748355,,0,0,0,PDN
MU784,,1986,1984,,65885,14362911,2621563,,0,0,0,,65885,14362911,2621563,PDN
MU784,,1987,1984,,65885,14362911,2621563,,0,0,0,,65885,14362911,2621563,PDN
MU784,,1988,1984,,187383,40849430,7455965,,0,0,0,,187383,40849430,7455965,PDN
MU784,,1989,1984,,187383,40849430,7455965,,13814,4211009,763104,,173569,36638421,6692861,PDN
MU784,,1990,1984,,187383,40849430,7455965,,28197,8444944,1530856,,159186,32404486,5925109,PDN
MU784,,1991,1984,,159425,40849430,7428007,,38431,13233903,2393218,,120994,27615527,5034789,PDN
MU784,,1992,1984,,156865,40849430,7425447,,43693,15769876,2849721,,113172,25079554,4575726,PDN
MU784,,1993,1984,,160524,44361974,8054114,,52208,20219593,3650000,,108316,24142381,4404114,PDN
MU784,,1994,1984,,119039,46057223,8314274,,58655,24188635,4362683,,60384,21868588,3951591,PDN
MU784,,1995,1984,,116811,48066936,8669647,,66329,27679129,4991441,,50482,20387807,3678206,PDN
MU784,,1996,1984,,156040,63951661,11535339,,77758,33456449,6030863,,78282,30495212,5504476,PDN
MU784,,1997,1984,,180440,74419287,13422306,,84667,36587190,6594843,,95773,37832097,6827463,PDN
MU784,,1998,1984,,180440,74419287,13422306,,95411,42902684,7729341,,85029,31516603,5692965,PDN
MU784,,1999,1984,,180440,74419287,13422306,,106437,49526671,8919012,,74003,24892616,4503294,PDN
MU784,,2000,1984,,119129,62160887,11179785,,111570,55224661,9938022,,7559,6936226,1241763,PDN
MU784,,2001,1984,,119083,62130265,11174290,,116598,60215704,10831136,,2485,1914561,343154,PDN
MU784,,2002,1984,,145673,76890757,13827302,,123477,64412090,11584703,,22196,12478667,2242599,PDN
MU784,,2003,1984,,145654,76878581,13825117,,129150,67015319,12053584,,16504,9863262,1771533,PDN
MU784,,2004,1984,,145654,76878581,13825117,,130040,67298520,12104866,,15614,9580061,1720251,PDN
MU784,,2005,1984,,145654,76878581,13825117,,130233,67555748,12150829,,15421,9322833,1674288,PDN
MU784,,2006,1984,,144081,76474788,13751695,,130233,67569899,12153347,,13848,8904889,1598348,PDN
MU784,,2007,1984,,130094,67573615,12153869,,130094,67573615,12153869,,0,0,0,PDN
MU784,,2008,1984,,130094,67573615,12153869,,130094,67573615,12153869,,0,0,0,PDN
MU784,,2009,1984,,130094,68382846,12297861,,130094,68382846,12297861,,0,0,0,PDN
MU784,,2010,1984,,130094,68382846,12297861,,130094,68382846,12297861,,0,0,0,PDN
MU784,,2011,1984,,130094,68382846,12297861,,130094,68382846,12297861,,0,0,0,PDN
MU784,,2012,1984,,130094,68382846,12297861,,130094,68382846,12297861,,0,0,0,PDN
MU784,,2013,1984,,130094,68382846,12297861,,130094,68382846,12297861,,0,0,0,PDN
MU784,,2014,1984,,130094,68382846,12297861,,130094,68382846,12297861,,0,0,0,PDN
MU784,,2015,1984,,130094,68382846,12297861,,130094,68382846,12297861,,0,0,0,PDN
MU784,,2016,1984,,130094,68382846,12297861,,130094,68382846,12297861,,0,0,0,PDN
MU784,,2017,1984,,130094,68382846,12297861,,130094,68382846,12297861,,0,0,0,PDN
MU784,,2017,1984,,130094,68382846,12297861,,130094,68382846,12297861,,0,0,0,PDN
MU785,,1992,1989,,147986,36996317,6730961,,49,786499,139995,,147937,36209818,6590966,PDN
MU785,,1993,1989,,66751,40663809,7302304,,537,13275340,2362697,,66214,27388469,4939607,PDN
MU785,,1994,1989,,63301,55789774,9990307,,3119,21091810,3756110,,60182,34697964,6234197,PDN
MU785,,1995,1989,,63447,57250962,10250451,,7822,30163498,5374992,,55625,27087464,4875459,PDN
MU785,,1996,1989,,17639,63116989,11248420,,8583,34129449,6081439,,9056,28987540,5166981,PDN
MU785,,1997,1989,,18398,68232582,12159427,,9344,39809562,7092896,,9054,28423020,5066531,PDN
MU785,,1998,1989,,18398,68232582,12159427,,9890,43260538,7707495,,8508,24972044,4451932,PDN
MU785,,1999,1989,,15780,65281033,11631622,,10084,45419747,8091890,,5696,19861286,3539732,PDN
MU785,,2000,1989,,12316,56772355,10114159,,10133,46598771,8301729,,2183,10173584,1812430,PDN
MU785,,2001,1989,,13940,62162368,11074860,,10259,47512531,8464446,,3681,14649837,2610414,PDN
MU785,,2002,1989,,14719,65295843,11633196,,10306,49624448,8840279,,4413,15671395,2792917,PDN
MU785,,2003,1989,,15058,68688105,12237141,,10400,54314590,9674918,,4658,14373515,2562223,PDN
MU785,,2004,1989,,15058,68688105,12237141,,10400,55457239,9878236,,4658,13230866,2358905,PDN
MU785,,2005,1989,,14571,63468034,11307815,,10400,56040149,9981957,,4171,7427885,1325858,PDN
MU785,,2006,1989,,14571,63468034,11307815,,10400,56102342,9993023,,4171,7365692,1314792,PDN
MU785,,2007,1989,,10400,56102342,9993023,,10400,56102342,9993023,,0,0,0,PDN
MU785,,2008,1989,,10400,56102342,9993023,,10400,56102342,9993023,,0,0,0,PDN
MU785,,2009,1989,,10400,56952200,10144243,,10400,56952200,10144243,,0,0,0,PDN
MU785,,2010,1989,,10400,56952200,10144243,,10400,56952200,10144243,,0,0,0,PDN
MU785,,2011,1989,,10400,56952200,10144243,,10400,56952200,10144243,,0,0,0,PDN
MU785,,2012,1989,,10400,56952200,10144243,,10400,56952200,10144243,,0,0,0,PDN
MU785,,2013,1989,,10400,56952200,10144243,,10400,56952200,10144243,,0,0,0,PDN
MU785,,2014,1989,,10400,56952200,10144243,,10400,56952200,10144243,,0,0,0,PDN
MU785,,2015,1989,,10400,56952200,10144243,,10400,56952200,10144243,,0,0,0,PDN
MU785,,2016,1989,,10400,56952200,10144243,,10400,56952200,10144243,,0,0,0,PDN
MU785,,2017,1989,,10400,56952200,10144243,,10400,56952200,10144243,,0,0,0,PDN
MU785,,2017,1989,,10400,56952200,10144243,,10400,56952200,10144243,,0,0,0,PDN
MU789,,1994,1993,,54472,31321421,5627679,,6307,1315643,240407,,48165,30005778,5387272,PDN
MU789,,1995,1993,,42785,30081890,5395434,,18907,7426682,1340381,,23878,22655208,4055053,PDN
MU789,,1996,1993,,42007,20759225,3735819,,19505,7850500,1416391,,22502,12908725,2319428,PDN
MU789,,1997,1993,,42007,20759225,3735819,,19612,8281617,1493209,,22395,12477608,2242610,PDN
MU789,,1998,1993,,44149,21870369,3935674,,21754,9387711,1692165,,22395,12482658,2243509,PDN
MU789,,1999,1993,,33468,16601458,2987464,,24019,10750158,1936859,,9449,5851300,1050605,PDN
MU789,,2000,1993,,26495,11852107,2135411,,24259,10856963,1956103,,2236,995144,179308,PDN
MU789,,2001,1993,,24259,10856963,1956103,,24259,10856963,1956103,,0,0,0,PDN
MU789,,2002,1993,,24259,10856963,1956103,,24259,10856963,1956103,,0,0,0,PDN
MU789,,2003,1993,,24259,10856963,1956103,,24259,10856963,1956103,,0,0,0,PDN
MU789,,2004,1993,,24259,10856963,1956103,,24259,10856963,1956103,,0,0,0,PDN
MU789,,2005,1993,,24259,10856963,1956103,,24259,10856963,1956103,,0,0,0,PDN
MU789,,2006,1993,,24259,10856963,1956103,,24259,10856963,1956103,,0,0,0,PDN
MU789,,2007,1993,,24259,10856963,1956103,,24259,10856963,1956103,,0,0,0,PDN
MU789,,2008,1993,,24259,10856963,1956103,,24259,10856963,1956103,,0,0,0,PDN
MU789,,2009,1993,,24259,11042766,1989163,,24259,11042766,1989163,,0,0,0,PDN
MU789,,2010,1993,,24259,11042766,1989163,,24259,11042766,1989163,,0,0,0,PDN
MU789,,2011,1993,,24259,11042766,1989163,,24259,11042766,1989163,,0,0,0,PDN
MU789,,2012,1993,,24259,11042766,1989163,,24259,11042766,1989163,,0,0,0,PDN
MU789,,2013,1993,,24259,11042766,1989163,,24259,11042766,1989163,,0,0,0,PDN
MU789,,2014,1993,,24259,11042766,1989163,,24259,11042766,1989163,,0,0,0,PDN
MU789,,2015,1993,,24259,11042766,1989163,,24259,11042766,1989163,,0,0,0,PDN
MU789,,2016,1993,,24259,11042766,1989163,,24259,11042766,1989163,,0,0,0,PDN
MU789,,2017,1993,,24259,11042766,1989163,,24259,11042766,1989163,,0,0,0,PDN
MU789,,2017,1993,,24259,11042766,1989163,,24259,11042766,1989163,,0,0,0,PDN
MU791,,1984,1982,,1229,12283255,2186862,,0,0,0,,1229,12283255,2186862,PDN
MU791,,1985,1982,,1229,12283255,2186862,,0,0,0,,1229,12283255,2186862,PDN
MU791,,1986,1982,,1229,12283255,2186862,,0,0,0,,1229,12283255,2186862,PDN
MU791,,1987,1982,,90659,23118022,4204186,,0,0,0,,90659,23118022,4204186,PDN
MU791,,1988,1982,,90659,23118022,4204186,,0,0,0,,90659,23118022,4204186,PDN
MU791,,1989,1982,,90757,24098797,4378799,,5614,3265542,586671,,85143,20833255,3792128,PDN
MU791,,1990,1982,,90076,24318204,4417159,,7166,5594778,1002678,,82910,18723426,3414481,PDN
MU791,,1991,1982,,89942,24133269,4384118,,7765,6797050,1217205,,82177,17336219,3166913,PDN
MU791,,1992,1982,,14000,14546111,2602276,,8028,7763009,1389346,,5972,6783102,1212930,PDN
MU791,,1993,1982,,14000,14546111,2602276,,8037,7993970,1430452,,5963,6552141,1171824,PDN
MU791,,1994,1982,,14000,14546111,2602276,,8037,8059835,1442171,,5963,6486276,1160105,PDN
MU791,,1995,1982,,13960,14504774,2594881,,8037,8100289,1449370,,5923,6404485,1145511,PDN
MU791,,1996,1982,,13380,13574063,2428694,,8037,8108012,1450744,,5343,5466051,977950,PDN
MU791,,1997,1982,,8037,8114120,1451831,,8037,8114120,1451831,,0,0,0,PDN
MU791,,1998,1982,,8037,8114120,1451831,,8037,8114120,1451831,,0,0,0,PDN
MU791,,1999,1982,,8037,8114120,1451831,,8037,8114120,1451831,,0,0,0,PDN
MU791,,2000,1982,,8037,8114120,1451831,,8037,8114120,1451831,,0,0,0,PDN
MU791,,2001,1982,,8037,8114120,1451831,,8037,8114120,1451831,,0,0,0,PDN
MU791,,2002,1982,,8037,8114120,1451831,,8037,8114120,1451831,,0,0,0,PDN
MU791,,2003,1982,,8037,8114120,1451831,,8037,8114120,1451831,,0,0,0,PDN
MU791,,2004,1982,,8037,8114120,1451831,,8037,8114120,1451831,,0,0,0,PDN
MU791,,2005,1982,,8037,8114120,1451831,,8037,8114120,1451831,,0,0,0,PDN
MU791,,2006,1982,,8037,8114120,1451831,,8037,8114120,1451831,,0,0,0,PDN
MU791,,2007,1982,,8037,8114120,1451831,,8037,8114120,1451831,,0,0,0,PDN
MU791,,2008,1982,,8037,8114120,1451831,,8037,8114120,1451831,,0,0,0,PDN
MU791,,2009,1982,,8037,8276631,1480747,,8037,8276631,1480747,,0,0,0,PDN
MU791,,2010,1982,,8037,8276631,1480747,,8037,8276631,1480747,,0,0,0,PDN
MU791,,2011,1982,,8037,8276631,1480747,,8037,8276631,1480747,,0,0,0,PDN
MU791,,2012,1982,,8037,8276631,1480747,,8037,8276631,1480747,,0,0,0,PDN
MU791,,2013,1982,,8037,8276631,1480747,,8037,8276631,1480747,,0,0,0,PDN
MU791,,2014,1982,,8037,8276631,1480747,,8037,8276631,1480747,,0,0,0,PDN
MU791,,2015,1982,,8037,8276631,1480747,,8037,8276631,1480747,,0,0,0,PDN
MU791,,2016,1982,,8037,8276631,1480747,,8037,8276631,1480747,,0,0,0,PDN
MU791,,2017,1982,,8037,8276631,1480747,,8037,8276631,1480747,,0,0,0,PDN
MU791,,2017,1982,,8037,8276631,1480747,,8037,8276631,1480747,,0,0,0,PDN
MU805,,1993,1993,,62991,256927493,45779627,,118,386116,68822,,62873,256541377,45710805,PDN
MU805,,1994,1993,,86129,323638012,57672964,,4121,30857770,5494827,,82008,292780242,52178137,PDN
MU805,,1995,1993,,79301,326803631,58229413,,5827,81402356,14490232,,73474,245401275,43739181,PDN
MU805,,1996,1993,,50986,234861721,41841328,,11583,114639361,20410046,,39403,120222360,21431282,PDN
MU805,,1997,1993,,64599,241074883,42960486,,24488,148234379,26400712,,40111,92840504,16559774,PDN
MU805,,1998,1993,,63571,248757572,44326484,,34230,171052270,30470577,,29341,77705302,13855907,PDN
MU805,,1999,1993,,52295,239060413,42589735,,37561,187339793,33372044,,14734,51720620,9217691,PDN
MU805,,2000,1993,,48316,235423756,41938664,,40270,194694924,34683495,,8046,40728832,7255169,PDN
MU805,,2001,1993,,89202,242355931,43213033,,40397,196032240,34921578,,48805,46323691,8291455,PDN
MU805,,2002,1993,,105776,244248697,43566398,,40461,198242126,35314861,,65315,46006571,8251537,PDN
MU805,,2003,1993,,109217,270458398,48233487,,41274,199196229,35485443,,67943,71262169,12748044,PDN
MU805,,2004,1993,,100840,231966138,41375953,,42497,200162303,35658565,,58343,31803835,5717388,PDN
MU805,,2005,1993,,44147,226919049,40421202,,42522,200980460,35804170,,1625,25938589,4617032,PDN
MU805,,2006,1993,,138238,247456495,44169643,,42525,201203853,35843922,,95713,46252642,8325721,PDN
MU805,,2007,1993,,138238,247457821,44169879,,54283,203554556,36273955,,83955,43903265,7895924,PDN
MU805,,2008,1993,,55726,204646522,36469698,,55726,204646522,36469698,,0,0,0,PDN
MU805,,2009,1993,,55726,207928184,37053625,,55726,207928184,37053625,,0,0,0,PDN
MU805,,2010,1993,,55726,207928184,37053625,,55726,207928184,37053625,,0,0,0,PDN
MU805,,2011,1993,,55726,207928184,37053625,,55726,207928184,37053625,,0,0,0,PDN
MU805,,2012,1993,,55726,207928184,37053625,,55726,207928184,37053625,,0,0,0,PDN
MU805,,2013,1993,,55726,207928184,37053625,,55726,207928184,37053625,,0,0,0,PDN
MU805,,2014,1993,,55726,207928184,37053625,,55726,207928184,37053625,,0,0,0,PDN
MU805,,2015,1993,,55726,207928184,37053625,,55726,207928184,37053625,,0,0,0,PDN
MU805,,2016,1993,,55726,207928184,37053625,,55726,207928184,37053625,,0,0,0,PDN
MU805,,2017,1993,,55726,207928184,37053625,,55726,207928184,37053625,,0,0,0,PDN
MU805,,2017,1993,,55726,207928184,37053625,,55726,207928184,37053625,,0,0,0,PDN
MU807,,1997,1994,,35750,17206590,3097421,,4189,1783825,321596,,31561,15422765,2775825,PDN
MU807,,1998,1994,,35750,17206590,3097421,,6893,3409925,613641,,28857,13796665,2483780,PDN
MU807,,1999,1994,,35755,17208867,3097831,,6893,3409925,613641,,28862,13798942,2484190,PDN
MU807,,2000,1994,,27124,13809663,2484359,,7951,4183773,752395,,19173,9625890,1731964,PDN
MU807,,2001,1994,,8028,4438587,797812,,8028,4438587,797812,,0,0,0,PDN
MU807,,2002,1994,,8028,4438587,797812,,8028,4438587,797812,,0,0,0,PDN
MU807,,2003,1994,,8028,4438587,797812,,8028,4438587,797812,,0,0,0,PDN
MU807,,2004,1994,,8028,4438587,797812,,8028,4438587,797812,,0,0,0,PDN
MU807,,2005,1994,,8028,4438587,797812,,8028,4438587,797812,,0,0,0,PDN
MU807,,2006,1994,,8028,4438587,797812,,8028,4438587,797812,,0,0,0,PDN
MU807,,2007,1994,,8028,4438587,797812,,8028,4438587,797812,,0,0,0,PDN
MU807,,2008,1994,,8028,4438587,797812,,8028,4438587,797812,,0,0,0,PDN
MU807,,2009,1994,,8028,4496615,808137,,8028,4496615,808137,,0,0,0,PDN
MU807,,2010,1994,,8028,4496615,808137,,8028,4496615,808137,,0,0,0,PDN
MU807,,2011,1994,,8028,4496615,808137,,8028,4496615,808137,,0,0,0,PDN
MU807,,2012,1994,,8028,4496615,808137,,8028,4496615,808137,,0,0,0,PDN
MU807,,2013,1994,,8028,4496615,808137,,8028,4496615,808137,,0,0,0,PDN
MU807,,2014,1994,,8028,4496615,808137,,8028,4496615,808137,,0,0,0,PDN
MU807,,2015,1994,,8028,4496615,808137,,8028,4496615,808137,,0,0,0,PDN
MU807,,2016,1994,,8028,4496615,808137,,8028,4496615,808137,,0,0,0,PDN
MU807,,2017,1994,,8028,4496615,808137,,8028,4496615,808137,,0,0,0,PDN
MU807,,2017,1994,,8028,4496615,808137,,8028,4496615,808137,,0,0,0,PDN
MU831,,1976,1975,,0,8800000,1565836,,0,0,0,,0,8800000,1565836,PDN
MU831,,1977,1975,,0,8800000,1565836,,0,0,0,,0,8800000,1565836,PDN
MU831,,1978,1975,,2568,8799300,1568280,,0,0,0,,2568,8799300,1568280,PDN
MU831,,1979,1975,,2568,8799300,1568280,,0,0,0,,2568,8799300,1568280,PDN
MU831,,1980,1975,,2568,8799300,1568280,,0,0,0,,2568,8799300,1568280,PDN
MU831,,1981,1975,,2568,8799300,1568280,,0,0,0,,2568,8799300,1568280,PDN
MU831,,1982,1975,,2568,8799300,1568280,,0,0,0,,2568,8799300,1568280,PDN
MU831,,1983,1975,,25165,11058983,1992956,,0,0,0,,25165,11058983,1992956,PDN
MU831,,1984,1975,,25165,11058983,1992956,,0,0,0,,25165,11058983,1992956,PDN
MU831,,1985,1975,,104852,24926374,4540150,,0,0,0,,104852,24926374,4540150,PDN
MU831,,1986,1975,,67786,77132054,13792351,,984,1197567,214074,,66802,75934487,13578277,PDN
MU831,,1987,1975,,68736,78960379,14118626,,3878,9525691,1698841,,64858,69434688,12419785,PDN
MU831,,1988,1975,,65150,77915156,13929057,,5877,14874687,2652618,,59273,63040469,11276439,PDN
MU831,,1989,1975,,53864,78669942,14052074,,6828,18751128,3343328,,47036,59918814,10708746,PDN
MU831,,1990,1975,,41783,74443753,13288002,,8444,23950335,4270069,,33339,50493418,9017933,PDN
MU831,,1991,1975,,42333,74369588,13275356,,9361,28011246,4993568,,32972,46358342,8281788,PDN
MU831,,1992,1975,,41687,72932554,13019010,,10347,31896079,5685806,,31340,41036475,7333204,PDN
MU831,,1993,1975,,14506,50820266,9057258,,10908,35411029,6311803,,3598,15409237,2745455,PDN
MU831,,1994,1975,,14532,51093826,9105960,,11256,37078393,6608835,,3276,14015433,2497125,PDN
MU831,,1995,1975,,14532,51093826,9105960,,11256,38167035,6802543,,3276,12926791,2303417,PDN
MU831,,1996,1975,,13674,48676149,8674910,,11256,39267475,6998351,,2418,9408674,1676559,PDN
MU831,,1997,1975,,13674,48676149,8674910,,11256,40050349,7137653,,2418,8625800,1537257,PDN
MU831,,1998,1975,,13674,48676149,8674910,,11256,40535945,7224058,,2418,8140204,1450852,PDN
MU831,,1999,1975,,13068,47306435,8430583,,11256,40839741,7278114,,1812,6466694,1152469,PDN
MU831,,2000,1975,,11256,40888812,7286845,,11256,40888812,7286845,,0,0,0,PDN
MU831,,2001,1975,,11256,40888812,7286845,,11256,40888812,7286845,,0,0,0,PDN
MU831,,2002,1975,,11256,40888812,7286845,,11256,40888812,7286845,,0,0,0,PDN
MU831,,2003,1975,,11256,40888812,7286845,,11256,40888812,7286845,,0,0,0,PDN
MU831,,2004,1975,,11256,40888812,7286845,,11256,40888812,7286845,,0,0,0,PDN
MU831,,2005,1975,,11256,40888812,7286845,,11256,40888812,7286845,,0,0,0,PDN
MU831,,2006,1975,,11256,40888812,7286845,,11256,40888812,7286845,,0,0,0,PDN
MU831,,2007,1975,,11256,40888812,7286845,,11256,40888812,7286845,,0,0,0,PDN
MU831,,2008,1975,,11256,40888812,7286845,,11256,40888812,7286845,,0,0,0,PDN
MU831,,2009,1975,,11256,41697936,7430820,,11256,41697936,7430820,,0,0,0,PDN
MU831,,2010,1975,,11256,41697936,7430820,,11256,41697936,7430820,,0,0,0,PDN
MU831,,2011,1975,,11256,41697936,7430820,,11256,41697936,7430820,,0,0,0,PDN
MU831,,2012,1975,,11256,41697936,7430820,,11256,41697936,7430820,,0,0,0,PDN
MU831,,2013,1975,,11256,41697936,7430820,,11256,41697936,7430820,,0,0,0,PDN
MU831,,2014,1975,,11256,41697936,7430820,,11256,41697936,7430820,,0,0,0,PDN
MU831,,2015,1975,,11256,41697936,7430820,,11256,41697936,7430820,,0,0,0,PDN
MU831,,2016,1975,,11256,41697936,7430820,,11256,41697936,7430820,,0,0,0,PDN
MU831,,2017,1975,,11256,41697936,7430820,,11256,41697936,7430820,,0,0,0,PDN
MU831,,2017,1975,,11256,41697936,7430820,,11256,41697936,7430820,,0,0,0,PDN
MU847,,1986,1984,,108223,23592371,4306154,,0,0,0,,108223,23592371,4306154,PDN
MU847,,1987,1984,,132667,33829817,6152207,,0,0,0,,132667,33829817,6152207,PDN
MU847,,1988,1984,,132667,33829817,6152207,,0,0,0,,132667,33829817,6152207,PDN
MU847,,1989,1984,,132667,33829817,6152207,,0,416751,74155,,132667,33413066,6078052,PDN
MU847,,1990,1984,,132667,33829817,6152207,,5141,7903919,1411532,,127526,25925898,4740675,PDN
MU847,,1991,1984,,120499,33829817,6140039,,12827,10080100,1806439,,107672,23749717,4333600,PDN
MU847,,1992,1984,,59092,31192333,5609329,,14045,12249678,2193703,,45047,18942655,3415626,PDN
MU847,,1993,1984,,60799,33590382,6037735,,16207,14499782,2596239,,44592,19090600,3441496,PDN
MU847,,1994,1984,,60799,33590382,6037735,,17030,15794104,2827369,,43769,17796278,3210366,PDN
MU847,,1995,1984,,61029,33553196,6031349,,17684,16400495,2935922,,43345,17152701,3095427,PDN
MU847,,1996,1984,,31477,28810544,5157908,,21109,19361480,3466212,,10368,9449064,1691696,PDN
MU847,,1997,1984,,162827,37288792,6797843,,22209,20742799,3713099,,140618,16545993,3084744,PDN
MU847,,1998,1984,,163351,37610235,6855564,,23387,21520656,3852685,,139964,16089579,3002879,PDN
MU847,,1999,1984,,23421,21580632,3863391,,23421,21580632,3863391,,0,0,0,PDN
MU847,,2000,1984,,23421,21580632,3863391,,23421,21580632,3863391,,0,0,0,PDN
MU847,,2001,1984,,23421,21580632,3863391,,23421,21580632,3863391,,0,0,0,PDN
MU847,,2002,1984,,23421,21580632,3863391,,23421,21580632,3863391,,0,0,0,PDN
MU847,,2003,1984,,23421,21580632,3863391,,23421,21580632,3863391,,0,0,0,PDN
MU847,,2004,1984,,23421,21580632,3863391,,23421,21580632,3863391,,0,0,0,PDN
MU847,,2005,1984,,23421,21580632,3863391,,23421,21580632,3863391,,0,0,0,PDN
MU847,,2006,1984,,23421,21580632,3863391,,23421,21580632,3863391,,0,0,0,PDN
MU847,,2007,1984,,23421,21580632,3863391,,23421,21580632,3863391,,0,0,0,PDN
MU847,,2008,1984,,23421,21580632,3863391,,23421,21580632,3863391,,0,0,0,PDN
MU847,,2009,1984,,23421,22010648,3939906,,23421,22010648,3939906,,0,0,0,PDN
MU847,,2010,1984,,23421,22010648,3939906,,23421,22010648,3939906,,0,0,0,PDN
MU847,,2011,1984,,23421,22010648,3939906,,23421,22010648,3939906,,0,0,0,PDN
MU847,,2012,1984,,23421,22010648,3939906,,23421,22010648,3939906,,0,0,0,PDN
MU847,,2013,1984,,23421,22010648,3939906,,23421,22010648,3939906,,0,0,0,PDN
MU847,,2014,1984,,23421,22010648,3939906,,23421,22010648,3939906,,0,0,0,PDN
MU847,,2015,1984,,23421,22010648,3939906,,23421,22010648,3939906,,0,0,0,PDN
MU847,,2016,1984,,23421,22010648,3939906,,23421,22010648,3939906,,0,0,0,PDN
MU847,,2017,1984,,23421,22010648,3939906,,23421,22010648,3939906,,0,0,0,PDN
MU847,,2017,1984,,23421,22010648,3939906,,23421,22010648,3939906,,0,0,0,PDN
MU859,,1995,1980,,32864,34245182,6126313,,0,0,0,,32864,34245182,6126313,PDN
MU859,,1996,1980,,795564,41267382,8138515,,54270,2341839,470967,,741294,38925543,7667548,PDN
MU859,,1997,1980,,905274,43767686,8693118,,117951,5659453,1124971,,787323,38108233,7568147,PDN
MU859,,1998,1980,,905274,43767686,8693118,,171642,8489663,1682258,,733632,35278023,7010860,PDN
MU859,,1999,1980,,427469,35767909,6791866,,215750,10635750,2108232,,211719,25132159,4683634,PDN
MU859,,2000,1980,,349471,28685866,5453718,,254301,12521972,2482410,,95170,16163894,2971308,PDN
MU859,,2001,1980,,342333,28364272,5389356,,282714,14024583,2778191,,59619,14339689,2611165,PDN
MU859,,2002,1980,,342333,28364272,5389356,,301598,15049910,2979518,,40735,13314362,2409838,PDN
MU859,,2003,1980,,342333,28364272,5389356,,310541,15838630,3128803,,31792,12525642,2260553,PDN
MU859,,2004,1980,,342333,28364272,5389356,,326328,16286114,3224213,,16005,12078158,2165143,PDN
MU859,,2005,1980,,442346,33440052,6392533,,391722,20217625,3989164,,50624,13222427,2403369,PDN
MU859,,2006,1980,,457601,34426839,6583373,,409794,21783493,4285860,,47807,12643346,2297513,PDN
MU859,,2007,1980,,514362,37331500,7156978,,417542,22137268,4356558,,96820,15194232,2800420,PDN
MU859,,2008,1980,,502977,25467914,5034634,,421532,22362504,4400625,,81445,3105410,634009,PDN
MU859,,2009,1980,,421532,22590175,4441137,,421532,22590175,4441137,,0,0,0,PDN
MU859,,2010,1980,,421532,22590175,4441137,,421532,22590175,4441137,,0,0,0,PDN
MU859,,2011,1980,,421532,22590175,4441137,,421532,22590175,4441137,,0,0,0,PDN
MU859,,2012,1980,,421532,22590175,4441137,,421532,22590175,4441137,,0,0,0,PDN
MU859,,2013,1980,,421532,22590175,4441137,,421532,22590175,4441137,,0,0,0,PDN
MU859,,2014,1980,,421532,22590175,4441137,,421532,22590175,4441137,,0,0,0,PDN
MU859,,2015,1980,,421532,22590175,4441137,,421532,22590175,4441137,,0,0,0,PDN
MU859,,2016,1980,,421532,22590175,4441137,,421532,22590175,4441137,,0,0,0,PDN
MU859,,2017,1980,,421532,22590175,4441137,,421532,22590175,4441137,,0,0,0,PDN
MU859,,2017,1980,,421532,22590175,4441137,,421532,22590175,4441137,,0,0,0,PDN
MU868,,1986,1984,,11215,2444945,446259,,0,0,0,,11215,2444945,446259,PDN
MU868,,1987,1984,,11215,2444945,446259,,0,0,0,,11215,2444945,446259,PDN
MU868,,1990,1984,,339968,80824042,14721470,,0,0,0,,339968,80824042,14721470,PDN
MU868,,1991,1984,,343455,87155465,15851545,,1204,5218491,929761,,342251,81936974,14921784,PDN
MU868,,1992,1984,,349680,87155465,15857770,,5639,11860208,2115996,,344041,75295257,13741774,PDN
MU868,,1993,1984,,30531,64596990,11524657,,5639,13248994,2363111,,24892,51347996,9161546,PDN
MU868,,1994,1984,,30531,64596990,11524657,,6002,15174284,2706053,,24529,49422706,8818604,PDN
MU868,,1995,1984,,30531,64596990,11524657,,7548,15487620,2763352,,22983,49109370,8761305,PDN
MU868,,1996,1984,,32299,53584184,9566851,,9091,17246731,3077904,,23208,36337453,6488947,PDN
MU868,,1997,1984,,32299,53584184,9566851,,9997,19270083,3438837,,22302,34314101,6128014,PDN
MU868,,1998,1984,,32299,53584184,9566851,,10077,19542357,3487365,,22222,34041827,6079486,PDN
MU868,,1999,1984,,18174,32741909,5844136,,10414,19998666,3568895,,7760,12743243,2275241,PDN
MU868,,2000,1984,,18174,32741909,5844136,,11355,21117336,3768888,,6819,11624573,2075248,PDN
MU868,,2001,1984,,19937,37931476,6769310,,12281,22354313,3989917,,7656,15577163,2779393,PDN
MU868,,2002,1984,,141713,50710094,9164861,,12921,23492754,4193126,,128792,27217340,4971735,PDN
MU868,,2003,1984,,141713,50710094,9164861,,13046,23934039,4271772,,128667,26776055,4893089,PDN
MU868,,2004,1984,,13046,23934039,4271772,,13046,23934039,4271772,,0,0,0,PDN
MU868,,2005,1984,,13046,23934039,4271772,,13046,23934039,4271772,,0,0,0,PDN
MU868,,2006,1984,,13046,23934039,4271772,,13046,23934039,4271772,,0,0,0,PDN
MU868,,2007,1984,,13046,23934039,4271772,,13046,23934039,4271772,,0,0,0,PDN
MU868,,2008,1984,,13046,23934039,4271772,,13046,23934039,4271772,,0,0,0,PDN
MU868,,2009,1984,,13046,24324187,4341192,,13046,24324187,4341192,,0,0,0,PDN
MU868,,2010,1984,,13046,24324187,4341192,,13046,24324187,4341192,,0,0,0,PDN
MU868,,2011,1984,,13046,24324187,4341192,,13046,24324187,4341192,,0,0,0,PDN
MU868,,2012,1984,,13046,24324187,4341192,,13046,24324187,4341192,,0,0,0,PDN
MU868,,2013,1984,,13046,24324187,4341192,,13046,24324187,4341192,,0,0,0,PDN
MU868,,2014,1984,,13046,24324187,4341192,,13046,24324187,4341192,,0,0,0,PDN
MU868,,2015,1984,,13046,24324187,4341192,,13046,24324187,4341192,,0,0,0,PDN
MU868,,2016,1984,,13046,24324187,4341192,,13046,24324187,4341192,,0,0,0,PDN
MU868,,2017,1984,,13046,24324187,4341192,,13046,24324187,4341192,,0,0,0,PDN
MU868,,2017,1984,,13046,24324187,4341192,,13046,24324187,4341192,,0,0,0,PDN
PE881,,1993,1989,,494,4935517,878700,,0,0,0,,494,4935517,878700,PDN
PE881,,1994,1989,,492,4918046,875589,,0,0,0,,492,4918046,875589,PDN
PE881,,1995,1989,,492,4918046,875589,,0,0,0,,492,4918046,875589,PDN
PE881,,1996,1989,,0,4918046,875097,,0,0,0,,0,4918046,875097,PDN
PE881,,1997,1989,,0,4918046,875097,,0,0,0,,0,4918046,875097,PDN
PE881,,1998,1989,,0,4918046,875097,,0,0,0,,0,4918046,875097,PDN
PE881,,1999,1989,,0,4576515,814327,,0,1672974,297682,,0,2903541,516645,PDN
PE881,,2000,1989,,0,4576515,814327,,0,3068703,546033,,0,1507812,268294,PDN
PE881,,2001,1989,,0,4576515,814327,,0,3863192,687401,,0,713323,126926,PDN
PE881,,2002,1989,,0,5953770,1059390,,0,4479430,797052,,0,1474340,262338,PDN
PE881,,2003,1989,,0,5953770,1059390,,0,4958919,882370,,0,994851,177020,PDN
PE881,,2004,1989,,0,5865063,1043606,,0,5250771,934301,,0,614292,109305,PDN
PE881,,2005,1989,,0,5865063,1043606,,0,5502166,979033,,0,362897,64573,PDN
PE881,,2006,1989,,0,5865063,1043606,,0,5775380,1027648,,0,89683,15958,PDN
PE881,,2007,1989,,0,7395710,1315963,,0,6094090,1084358,,0,1301620,231605,PDN
PE881,,2008,1989,,0,7395710,1315963,,0,6518873,1159942,,0,876837,156021,PDN
PE881,,2009,1989,,0,7395710,1315963,,0,7000416,1245626,,0,395294,70337,PDN
PE881,,2010,1989,,0,7395710,1315963,,0,7319032,1302319,,0,76678,13644,PDN
PE881,,2011,1989,,0,7652086,1361581,,0,7493807,1333418,,0,158279,28164,PDN
PE881,,2012,1989,,0,7652086,1361581,,0,7620348,1355934,,0,31738,5647,PDN
PE881,,2013,1989,,0,7652086,1361581,,0,7652086,1361581,,0,0,0,PDN
PE881,,2014,1989,,0,7652086,1361581,,0,7652086,1361581,,0,0,0,PDN
PE881,,2015,1989,,0,7652086,1361581,,0,7652086,1361581,,0,0,0,PDN
PE881,,2016,1989,,0,7652086,1361581,,0,7652086,1361581,,0,0,0,PDN
PE881,,2017,1989,,0,7652086,1361581,,0,7652086,1361581,,0,0,0,PDN
PE881,,2017,1989,,0,7652086,1361581,,0,7652086,1361581,,0,0,0,PDN
PL002,,1984,1982,,119350,4774012,968818,,0,0,0,,119350,4774012,968818,PDN
PL002,,1985,1982,,119350,4774012,968818,,26294,1058625,214661,,93056,3715387,754157,PDN
PL002,,1986,1982,,41579,1724397,348411,,41579,1724397,348411,,0,0,0,PDN
PL002,,1987,1982,,41579,1724397,348411,,41579,1724397,348411,,0,0,0,PDN
PL002,,1988,1982,,41579,1724397,348411,,41579,1724397,348411,,0,0,0,PDN
PL002,,1989,1982,,41579,1724397,348411,,41579,1724397,348411,,0,0,0,PDN
PL002,,1990,1982,,41579,1724397,348411,,41579,1724397,348411,,0,0,0,PDN
PL002,,1991,1982,,41579,1724397,348411,,41579,1724397,348411,,0,0,0,PDN
PL002,,1992,1982,,41579,1724397,348411,,41579,1724397,348411,,0,0,0,PDN
PL002,,1993,1982,,41579,1724397,348411,,41579,1724397,348411,,0,0,0,PDN
PL002,,1994,1982,,41579,1724397,348411,,41579,1724397,348411,,0,0,0,PDN
PL002,,1995,1982,,41579,1724397,348411,,41579,1724397,348411,,0,0,0,PDN
PL002,,1996,1982,,41579,1724397,348411,,41579,1724397,348411,,0,0,0,PDN
PL002,,1997,1982,,462153,20296535,4073636,,134271,5611765,1132806,,327882,14684770,2940830,PDN
PL002,,1998,1982,,462153,20296535,4073636,,193924,8826845,1764537,,268229,11469690,2309099,PDN
PL002,,1999,1982,,466105,12909563,2763180,,322956,10319173,2159108,,143149,2590390,604072,PDN
PL002,,2000,1982,,466105,12909563,2763180,,340956,10618661,2230397,,125149,2290902,532783,PDN
PL002,,2001,1982,,485795,12564707,2721508,,393151,11131391,2373826,,92644,1433316,347682,PDN
PL002,,2002,1982,,485795,12564707,2721508,,418935,11472064,2460228,,66860,1092643,261280,PDN
PL002,,2003,1982,,485795,12564707,2721508,,437298,11862262,2548021,,48497,702445,173487,PDN
PL002,,2004,1982,,444690,12108056,2599148,,440193,11975609,2571084,,4497,132447,28064,PDN
PL002,,2005,1982,,467474,13375742,2847499,,454633,13080494,2782123,,12841,295248,65376,PDN
PL002,,2006,1982,,467474,13375742,2847499,,459563,13149305,2799297,,7911,226437,48202,PDN
PL002,,2007,1982,,467474,13375742,2847499,,464449,13231493,2818807,,3025,144249,28692,PDN
PL002,,2008,1982,,471235,13392084,2854168,,467483,13311197,2836023,,3752,80887,18145,PDN
PL002,,2009,1982,,471235,13564592,2884863,,469001,13514744,2873759,,2234,49848,11104,PDN
PL002,,2010,1982,,471235,13564592,2884863,,471082,13564107,2884624,,153,485,239,PDN
PL002,,2011,1982,,471235,13564592,2884863,,471235,13564592,2884863,,0,0,0,PDN
PL002,,2012,1982,,471235,13564592,2884863,,471235,13564592,2884863,,0,0,0,PDN
PL002,,2013,1982,,471235,13564592,2884863,,471235,13564592,2884863,,0,0,0,PDN
PL002,,2014,1982,,471235,13564592,2884863,,471235,13564592,2884863,,0,0,0,PDN
PL002,,2015,1982,,471235,13564592,2884863,,471235,13564592,2884863,,0,0,0,PDN
PL002,,2016,1982,,471235,13564592,2884863,,471235,13564592,2884863,,0,0,0,PDN
PL002,,2017,1982,,471235,13564592,2884863,,471235,13564592,2884863,,0,0,0,PDN
PL002,,2017,1982,,471235,13564592,2884863,,471235,13564592,2884863,,0,0,0,PDN
PL005,,1995,1994,,1166109,9491442,2854978,,0,0,0,,1166109,9491442,2854978,PDP
PL005,,1996,1994,,1138787,8848686,2713286,,121258,7365129,1431779,,1017529,1483557,1281507,PDP
PL005,,1997,1994,,1291549,14862461,3936115,,183437,9918671,1948325,,1108112,4943790,1987790,PDP
PL005,,1998,1994,,1046740,16255573,3939191,,253612,13339633,2627212,,793128,2915940,1311979,PDP
PL005,,1999,1994,,2535025,31174635,8082113,,381214,17373716,3472623,,2153811,13800919,4609490,PDP
PL005,,2000,1994,,3393235,83983219,18336868,,882580,23501013,5064255,,2510655,60482206,13272613,PDP
PL005,,2001,1994,,4331332,126820142,26897194,,1498773,43543675,9246758,,2832559,83276467,17650436,PDP
PL005,,2002,1994,,4352304,128370539,27194037,,1792158,55369936,11644460,,2560146,73000603,15549577,PDP
PL005,,2003,1994,,3755757,135799215,27919318,,1981273,65959428,13717826,,1774484,69839787,14201492,PDP
PL005,,2004,1994,,3227161,95421681,20206108,,2148254,72641025,15073703,,1078907,22780656,5132405,PDP
PL005,,2005,1994,,3009032,92985396,19554476,,2198514,74696348,15489679,,810518,18289048,4064797,PDP
PL005,,2006,1994,,2669679,92506709,19129948,,2413726,78050258,16301672,,255953,14456451,2828276,PDP
PL005,,2007,1994,,3010333,97730082,20400027,,2571174,83060665,17350652,,439159,14669417,3049375,PDP
PL005,,2008,1994,,3011657,97744885,20403985,,2748690,88917433,18570297,,262967,8827452,1833688,PDP
PL005,,2009,1994,,3073612,98787842,20651520,,2864548,91516545,19148632,,209064,7271297,1502889,PDP
PL005,,2010,1994,,3021503,93696220,19693429,,2933016,92921123,19467026,,88487,775097,226405,PDP
PL005,,2011,1994,,3021503,93696220,19693429,,2990356,93492508,19626036,,31147,203712,67395,PDP
PL005,,2012,1994,,3021586,93908071,19731209,,3004759,93607094,19660827,,16827,300977,70382,PDP
PL005,,2013,1994,,3021409,94044198,19755254,,3011902,93662089,19677755,,9507,382109,77498,PDP
PL005,,2014,1994,,3016715,94025052,19747153,,3015841,93731501,19694045,,874,293551,53108,PDP
PL005,,2015,1994,,3089479,100454446,20963938,,3023990,94454142,19830778,,65489,6000304,1133159,PDP
PL005,,2016,1994,,3089479,100454446,20963938,,3030848,95086670,19950185,,58631,5367776,1013752,PDP
PL005,,2017,1994,,3089479,100454446,20963938,,3032295,95204047,19972518,,57184,5250399,991419,PDP
PL005,,2017,1994,,3089479,100454446,20963938,,3032295,95204047,19972518,,57184,5250399,991419,PDP
PL006,,1993,1993,,1150469,53125173,10603347,,142911,4731326,984784,,1007558,48393847,9618563,PDN
PL006,,1994,1993,,1150469,53125173,10603347,,418693,16532395,3360400,,731776,36592778,7242947,PDN
PL006,,1995,1993,,1149964,53101925,10598705,,566295,27193466,5404990,,583669,25908459,5193715,PDN
PL006,,1996,1993,,1149964,53101925,10598705,,609768,35461212,6919592,,540196,17640713,3679113,PDN
PL006,,1997,1993,,1149964,53101925,10598705,,626369,39921674,7729870,,523595,13180251,2868835,PDN
PL006,,1998,1993,,936650,61406954,11863154,,638672,43189433,8323624,,297978,18217521,3539530,PDN
PL006,,1999,1993,,936650,61406954,11863154,,646132,45732789,8783639,,290518,15674165,3079515,PDN
PL006,,2000,1993,,974977,64473080,12447055,,667893,47960876,9201857,,307084,16512204,3245198,PDN
PL006,,2001,1993,,856345,59126046,11376994,,683238,49105019,9420786,,173107,10021027,1956208,PDN
PL006,,2002,1993,,856353,59126401,11377065,,750045,52027157,10007546,,106308,7099244,1369519,PDN
PL006,,2003,1993,,898899,61914880,11915782,,793925,54288410,10453784,,104974,7626470,1461998,PDN
PL006,,2004,1993,,865309,60086588,11556873,,823316,56615784,10897299,,41993,3470804,659574,PDN
PL006,,2005,1993,,869511,60065251,11557278,,838751,57903103,11141794,,30760,2162148,415484,PDN
PL006,,2006,1993,,869511,60065251,11557278,,851936,58827789,11319514,,17575,1237462,237764,PDN
PL006,,2007,1993,,869511,60065251,11557278,,852447,58899458,11332778,,17064,1165793,224500,PDN
PL006,,2008,1993,,887085,61516301,11833046,,854955,59010441,11355033,,32130,2505860,478013,PDN
PL006,,2009,1993,,890985,62597958,12029413,,861146,60643697,11651840,,29839,1954261,377573,PDN
PL006,,2010,1993,,890985,62597958,12029413,,865605,61175102,11750855,,25380,1422856,278557,PDN
PL006,,2011,1993,,890985,62597958,12029413,,869568,61724256,11852533,,21417,873702,176880,PDN
PL006,,2012,1993,,890985,62597958,12029413,,870678,61799795,11867084,,20307,798163,162329,PDN
PL006,,2013,1993,,890985,62597958,12029413,,872137,61962366,11897470,,18848,635592,131943,PDN
PL006,,2014,1993,,890985,62597958,12029413,,874488,62077374,11920285,,16497,520584,109128,PDN
PL006,,2015,1993,,890985,62597958,12029413,,875002,62141451,11932201,,15983,456507,97212,PDN
PL006,,2016,1993,,876886,62429141,11985275,,875317,62184260,11940133,,1569,244881,45142,PDN
PL006,,2017,1993,,875723,62230172,11948708,,875723,62230172,11948708,,0,0,0,PDN
PL006,,2017,1993,,875723,62230172,11948708,,875723,62230172,11948708,,0,0,0,PDN
PL013,,1978,1976,,7300425,13911262,9775739,,0,0,0,,7300425,13911262,9775739,PDP
PL013,,1979,1976,,7723787,36062366,14140578,,1602031,8070409,3038047,,6121756,27991957,11102531,PDP
PL013,,1980,1976,,8329091,45723653,16464972,,3206280,13277078,5568749,,5122811,32446575,10896223,PDP
PL013,,1981,1976,,8471919,50853065,17520507,,4591970,18694041,7918312,,3879949,32159024,9602195,PDP
PL013,,1982,1976,,8634394,50853065,17682982,,5537846,22576293,9554980,,3096548,28276772,8128002,PDP
PL013,,1983,1976,,12088436,56206831,22089651,,6531830,26261945,11204774,,5556606,29944886,10884877,PDP
PL013,,1984,1976,,12017560,61569954,22973068,,7125046,29705309,12410688,,4892514,31864645,10562380,PDP
PL013,,1985,1976,,9623893,43967891,17447361,,7499960,32569857,13295308,,2123933,11398034,4152053,PDP
PL013,,1986,1976,,10110190,69599490,22494441,,7734594,34396862,13855032,,2375596,35202628,8639409,PDP
PL013,,1987,1976,,10110190,69599490,22494441,,7904818,36058105,14320851,,2205372,33541385,8173590,PDP
PL013,,1988,1976,,15190197,110631204,34875465,,10601945,56921117,20730258,,4588252,53710087,14145207,PDP
PL013,,1989,1976,,15285094,115647327,35862910,,10977700,59645329,21590748,,4307394,56001998,14272162,PDP
PL013,,1990,1976,,15400724,115647169,35978512,,11268212,61428056,22198471,,4132512,54219113,13780041,PDP
PL013,,1991,1976,,15299066,114897912,35743534,,11534366,62919978,22730092,,3764700,51977934,13013442,PDP
PL013,,1992,1976,,15270850,116235855,35953386,,11850851,64421456,23313744,,3419999,51814399,12639642,PDP
PL013,,1993,1976,,15196223,110154805,34796722,,12074091,65581794,23743449,,3122132,44573011,11053273,PDP
PL013,,1994,1976,,15411520,102126560,33583506,,12563305,67767669,24621609,,2848215,34358891,8961897,PDP
PL013,,1995,1976,,16445187,102365304,34659654,,13363397,70651451,25934830,,3081790,31713853,8724824,PDP
PL013,,1996,1976,,15141883,110464266,34797446,,11528437,73003593,24518400,,3613446,37460673,10279046,PDP
PL013,,1997,1976,,14636364,113232281,34784457,,11790213,75492236,25222995,,2846151,37740045,9561462,PDP
PL013,,1998,1976,,15019433,116038580,35666867,,11984885,76977054,25681870,,3034548,39061526,9984997,PDP
PL013,,1999,1976,,14937238,114134806,35245922,,12140522,77729058,25971315,,2796716,36405748,9274607,PDP
PL013,,2000,1976,,14939368,113839888,35195576,,12287340,78651834,26282328,,2652028,35188054,8913248,PDP
PL013,,2001,1976,,15681466,100059314,33485614,,12392507,79056216,26459449,,3288959,21003098,7026165,PDP
PL013,,2002,1976,,15695758,101006184,33668389,,12509829,80870251,26899553,,3185929,20135933,6768836,PDP
PL013,,2003,1976,,15570437,100092745,33380534,,12669737,82612107,27369400,,2900700,17480638,6011134,PDP
PL013,,2004,1976,,15127548,95787230,32171539,,12817432,83649952,27701765,,2310116,12137278,4469774,PDP
PL013,,2005,1976,,14913474,96411059,32068466,,12937695,84960780,28055272,,1975779,11450279,4013194,PDP
PL013,,2006,1976,,16301286,124167289,38395109,,13119589,87475554,28684634,,3181697,36691735,9710475,PDP
PL013,,2007,1976,,16329773,125972873,38744875,,13342799,90656467,29473843,,2986974,35316406,9271032,PDP
PL013,,2008,1976,,16329773,125972873,38744875,,13693867,97528895,31047763,,2635906,28443978,7697112,PDP
PL013,,2009,1976,,16252968,123699743,38263597,,13936278,105216525,32658080,,2316690,18483218,5605520,PDP
PL013,,2010,1976,,16252968,123699743,38263597,,14145800,109856082,33693146,,2107168,13843661,4570454,PDP
PL013,,2011,1976,,16252968,123699743,38263597,,14315449,111515260,34158020,,1937519,12184483,4105576,PDP
PL013,,2012,1976,,16405202,123689509,38414011,,14499793,114196448,34819444,,1905409,9493061,3594565,PDP
PL013,,2013,1976,,16349699,122127526,38080575,,14646382,115914222,35271687,,1703317,6213304,2808888,PDP
PL013,,2014,1976,,16349699,122127526,38080575,,14767683,117071787,35598961,,1582016,5055739,2481613,PDP
PL013,,2015,1976,,16349699,122127526,38080575,,14851073,118057467,35857739,,1498626,4070059,2222836,PDP
PL013,,2016,1976,,16349699,122127526,38080575,,14862513,118802502,36001747,,1487186,3325024,2078828,PDP
PL013,,2017,1976,,16275612,123057686,38171997,,14879561,119292961,36106066,,1396051,3764725,2065931,PDP
PL013,,2017,1976,,16275612,123057686,38171997,,14879561,119292961,36106066,,1396051,3764725,2065931,PDP
PL015,,1993,1979,,5236,5235711,936857,,0,1405371,250066,,5236,3830340,686791,PDN
PL015,,1994,1979,,5212,5211914,932599,,0,2744756,488391,,5212,2467158,444208,PDN
PL015,,1995,1979,,5212,5211914,932599,,0,3950152,702874,,5212,1261762,229725,PDN
PL015,,1996,1979,,0,6068667,1079834,,0,5018799,893025,,0,1049868,186809,PDN
PL015,,1997,1979,,0,6068667,1079834,,0,5335510,949379,,0,733157,130455,PDN
PL015,,1998,1979,,0,6068667,1079834,,0,5367349,955044,,0,701318,124790,PDN
PL015,,1999,1979,,0,6068667,1079834,,0,5423606,965054,,0,645061,114780,PDN
PL015,,2000,1979,,505712,17626627,3642123,,18716,6204716,1122758,,486996,11421911,2519365,PDN
PL015,,2001,1979,,501937,17311421,3582261,,30086,6442151,1176376,,471851,10869270,2405885,PDN
PL015,,2002,1979,,501988,17483419,3612917,,33848,6802124,1244190,,468140,10681295,2368727,PDN
PL015,,2003,1979,,501988,17483419,3612917,,33930,7098739,1297051,,468058,10384680,2315866,PDN
PL015,,2004,1979,,501988,17483419,3612917,,33930,7314653,1335470,,468058,10168766,2277447,PDN
PL015,,2005,1979,,198604,13457495,2593176,,40311,7734662,1416585,,158293,5722833,1176591,PDN
PL015,,2006,1979,,198604,13457495,2593176,,43658,7870305,1444068,,154946,5587190,1149108,PDN
PL015,,2007,1979,,259301,14186233,2783542,,49884,8245256,1517011,,209417,5940977,1266531,PDN
PL015,,2008,1979,,259301,14186233,2783542,,50425,8422233,1549043,,208876,5764000,1234499,PDN
PL015,,2009,1979,,261926,14113640,2773249,,65530,8841062,1638672,,196396,5272578,1134577,PDN
PL015,,2010,1979,,261926,14113640,2773249,,66905,9187656,1701720,,195021,4925984,1071531,PDN
PL015,,2011,1979,,261926,14113640,2773249,,66905,9514561,1759888,,195021,4599079,1013363,PDN
PL015,,2012,1979,,66905,9547934,1765826,,66905,9547934,1765826,,0,0,0,PDN
PL015,,2013,1979,,66905,9547934,1765826,,66905,9547934,1765826,,0,0,0,PDN
PL015,,2014,1979,,66905,9547934,1765826,,66905,9547934,1765826,,0,0,0,PDN
PL015,,2015,1979,,66905,9547934,1765826,,66905,9547934,1765826,,0,0,0,PDN
PL015,,2016,1979,,66905,9547934,1765826,,66905,9547934,1765826,,0,0,0,PDN
PL015,,2017,1979,,66905,9547934,1765826,,66905,9547934,1765826,,0,0,0,PDN
PL015,,2017,1979,,66905,9547934,1765826,,66905,9547934,1765826,,0,0,0,PDN
PL017,,2000,1999,,68457,5507240,1048393,,8961,965978,180843,,59496,4541262,867550,PDN
PL017,,2001,1999,,154953,9019106,1759776,,23869,2316572,436070,,131084,6702534,1323706,PDN
PL017,,2002,1999,,172060,9608803,1881811,,61458,4307694,827952,,110602,5301109,1053859,PDN
PL017,,2003,1999,,170788,9501473,1861442,,95888,5572136,1087371,,74900,3929337,774071,PDN
PL017,,2004,1999,,147459,8183068,1603521,,115190,6290449,1234487,,32269,1892619,369034,PDN
PL017,,2005,1999,,129998,7634392,1488431,,119978,6548329,1285161,,10020,1086063,203270,PDN
PL017,,2006,1999,,130544,7776318,1514230,,121586,6755132,1323567,,8958,1021186,190663,PDN
PL017,,2007,1999,,132445,8040675,1563170,,123021,6880782,1347359,,9424,1159893,215811,PDN
PL017,,2008,1999,,132445,8040675,1563170,,123475,6901510,1351502,,8970,1139165,211668,PDN
PL017,,2009,1999,,133168,8088986,1572489,,123475,6920098,1354809,,9693,1168888,217680,PDN
PL017,,2010,1999,,133168,8088986,1572489,,123475,6920866,1354946,,9693,1168120,217543,PDN
PL017,,2011,1999,,123475,6920866,1354946,,123475,6920866,1354946,,0,0,0,PDN
PL017,,2012,1999,,123475,6920866,1354946,,123475,6920866,1354946,,0,0,0,PDN
PL017,,2013,1999,,123475,6920866,1354946,,123475,6920866,1354946,,0,0,0,PDN
PL017,,2014,1999,,123475,6920866,1354946,,123475,6920866,1354946,,0,0,0,PDN
PL017,,2015,1999,,123475,6920866,1354946,,123475,6920866,1354946,,0,0,0,PDN
PL017,,2016,1999,,123475,6920866,1354946,,123475,6920866,1354946,,0,0,0,PDN
PL017,,2017,1999,,123475,6920866,1354946,,123475,6920866,1354946,,0,0,0,PDN
PL017,,2017,1999,,123475,6920866,1354946,,123475,6920866,1354946,,0,0,0,PDN
PL018,,1981,1979,,12000,12000000,2147231,,0,0,0,,12000,12000000,2147231,PDN
PL018,,1982,1979,,423962,29996232,5761370,,60566,4285176,823053,,363396,25711056,4938317,PDN
PL018,,1983,1979,,327253,32725237,6150249,,112620,8942076,1703737,,214633,23783161,4446512,PDN
PL018,,1984,1979,,361026,35097754,6606178,,156049,14067574,2659176,,204977,21030180,3947002,PDN
PL018,,1985,1979,,418334,41071567,7726442,,193700,18219974,3435688,,224634,22851593,4290754,PDN
PL018,,1986,1979,,418334,41071567,7726442,,213133,20533326,3866750,,205201,20538241,3859692,PDN
PL018,,1987,1979,,418334,41071567,7726442,,229679,22021982,4148181,,188655,19049585,3578261,PDN
PL018,,1988,1979,,424618,41624501,7831113,,245669,23802531,4480995,,178949,17821970,3350118,PDN
PL018,,1989,1979,,447688,44005771,8277896,,251324,24520124,4614335,,196364,19485647,3663561,PDN
PL018,,1990,1979,,251324,24520124,4614335,,251324,24520124,4614335,,0,0,0,PDN
PL018,,1991,1979,,251324,24520124,4614335,,251324,24520124,4614335,,0,0,0,PDN
PL018,,1992,1979,,251324,24520124,4614335,,251324,24520124,4614335,,0,0,0,PDN
PL018,,1993,1979,,251324,24520124,4614335,,251324,24520124,4614335,,0,0,0,PDN
PL018,,1994,1979,,251324,24520124,4614335,,251324,24520124,4614335,,0,0,0,PDN
PL018,,1995,1979,,251324,24520124,4614335,,251324,24520124,4614335,,0,0,0,PDN
PL018,,1996,1979,,251324,24520124,4614335,,251324,24520124,4614335,,0,0,0,PDN
PL018,,1997,1979,,251324,24520124,4614335,,251324,24520124,4614335,,0,0,0,PDN
PL018,,1998,1979,,251324,24520124,4614335,,251324,24520124,4614335,,0,0,0,PDN
PL018,,1999,1979,,320631,28727826,5432344,,313650,26387214,5008884,,6981,2340612,423460,PDN
PL018,,2000,1979,,325528,30369667,5729383,,318117,27780046,5261186,,7411,2589621,468197,PDN
PL018,,2001,1979,,330974,31221105,5886331,,323507,29467001,5566746,,7467,1754104,319585,PDN
PL018,,2002,1979,,330974,31221105,5886331,,330751,31081090,5861194,,223,140015,25137,PDN
PL018,,2003,1979,,333359,34503035,6472689,,331509,32227097,6065868,,1850,2275938,406821,PDN
PL018,,2004,1979,,333359,34503035,6472689,,332868,33648646,6320172,,491,854389,152517,PDN
PL018,,2005,1979,,335297,34808286,6528942,,334293,34200177,6419734,,1004,608109,109208,PDN
PL018,,2006,1979,,335297,34808286,6528942,,334717,34471628,6468459,,580,336658,60483,PDN
PL018,,2007,1979,,335297,34808286,6528942,,334717,34788165,6524782,,580,20121,4160,PDN
PL018,,2008,1979,,335297,34808286,6528942,,334717,34788248,6524797,,580,20038,4145,PDN
PL018,,2009,1979,,334717,35279304,6612173,,334717,35279304,6612173,,0,0,0,PDN
PL018,,2010,1979,,334717,35279304,6612173,,334717,35279304,6612173,,0,0,0,PDN
PL018,,2011,1979,,334717,35279304,6612175,,334717,35279304,6612175,,0,0,0,PDN
PL018,,2012,1979,,334717,35279304,6612175,,334717,35279304,6612175,,0,0,0,PDN
PL018,,2013,1979,,400765,43403264,8123767,,349291,37236942,6975083,,51474,6166322,1148684,PDN
PL018,,2014,1979,,400765,43403264,8123767,,355403,38626206,7228395,,45362,4777058,895372,PDN
PL018,,2015,1979,,400765,43403264,8123767,,357175,39205165,7333185,,43590,4198099,790583,PDN
PL018,,2016,1979,,400765,43403264,8123767,,357186,39227166,7337111,,43579,4176098,786657,PDN
PL018,,2017,1979,,400765,43403264,8123767,,357186,39227166,7337111,,43579,4176098,786657,PDN
PL018,,2017,1979,,400765,43403264,8123767,,357186,39227166,7337111,,43579,4176098,786657,PDN
PL020,,1975,1951,,35000000,49980000,43893238,,22878975,40104884,30015075,,12121025,9875116,13878163,PDP
PL020,,1976,1951,,35000000,49980000,43893238,,24781578,42453607,32335601,,10218422,7526393,11557637,PDP
PL020,,1977,1951,,36283841,101333580,54314727,,26542965,50239623,35482400,,9740876,51093957,18832327,PDP
PL020,,1978,1951,,36621352,121353580,58214516,,28466853,62571376,39600550,,8154499,58782204,18613966,PDP
PL020,,1979,1951,,54758014,206168500,91442800,,32687400,82819928,47424042,,22070614,123348572,44018758,PDP
PL020,,1980,1951,,60632448,256233942,106225676,,36979616,118008084,57977496,,23652832,138225858,48248180,PDP
PL020,,1981,1951,,64982478,289487234,116492662,,40238436,157113880,68194642,,24744042,132373354,48298020,PDP
PL020,,1982,1951,,68632188,307807717,123402244,,44054552,196530273,79024351,,24577636,111277444,44377893,PDP
PL020,,1983,1951,,85318492,489519028,172421522,,47367874,219443663,86414789,,37950618,270075365,86006733,PDP
PL020,,1984,1951,,92465205,504881322,182301739,,50898582,238244460,93290835,,41566623,266636862,89010904,PDP
PL020,,1985,1951,,100491409,529310884,194674840,,55268484,256700589,100944745,,45222925,272610295,93730095,PDP
PL020,,1986,1951,,115751460,572671690,217650337,,60371416,287691354,111562048,,55380044,284980336,106088289,PDP
PL020,,1987,1951,,108098339,595259870,214016465,,64518525,316495293,120834413,,43579814,278764577,93182052,PDP
PL020,,1988,1951,,107914834,554675384,206611522,,66455487,327156243,124668342,,41459347,227519141,81943180,PDP
PL020,,1989,1951,,100195747,519080866,192558890,,70149580,349257652,132295070,,30046167,169823214,60263820,PDP
PL020,,1990,1951,,97087805,512833081,188339243,,73081335,370718478,139045477,,24006470,142114603,49293766,PDP
PL020,,1991,1951,,97501309,511644777,188541305,,76236554,394176106,146374651,,21264755,117468671,42166654,PDP
PL020,,1992,1951,,98514038,519616706,190972527,,78806462,415083861,152664800,,19707576,104532845,38307727,PDP
PL020,,1993,1951,,100695958,544930985,197658767,,81765896,443116061,160612170,,18930062,101814924,37046597,PDP
PL020,,1994,1951,,102800046,568778137,204006120,,84826493,469356489,168341883,,17973553,99421648,35664237,PDP
PL020,,1995,1951,,102472481,580353603,205738247,,87982222,489588960,175097695,,14490259,90764643,30640552,PDP
PL020,,1996,1951,,106512841,600452414,213354908,,93260276,511450092,184265630,,13252565,89002322,29089278,PDP
PL020,,1997,1951,,107140436,595134415,213036239,,95400068,523320349,188517568,,11740368,71814066,24518671,PDP
PL020,,1998,1951,,109220910,616002906,218829968,,97387577,532882811,192206583,,11833333,83120095,26623385,PDP
PL020,,1999,1951,,108994530,610871069,217690450,,99213231,544306737,196064964,,9781299,66564332,21625486,PDP
PL020,,2000,1951,,111610018,617316705,221452848,,100809731,552905625,199191515,,10800287,64411080,22261333,PDP
PL020,,2001,1951,,110993188,617019094,220783063,,101510846,564966725,202038733,,9482342,52052369,18744330,PDP
PL020,,2002,1951,,113088494,625506929,224388659,,103016766,574928466,205317205,,10071728,50578463,19071454,PDP
PL020,,2003,1951,,113364791,629597519,225392819,,103287452,579370193,206378234,,10077339,50227326,19014585,PDP
PL020,,2004,1951,,112057206,661142809,229698275,,105525953,590113489,210528353,,6531253,71029320,19169922,PDP
PL020,,2005,1951,,114014670,658749455,231229876,,106558446,597029877,212791520,,7456224,61719578,18438356,PDP
PL020,,2006,1951,,114173906,662903914,232128339,,108115666,604817222,215734389,,6058240,58086692,16393950,PDP
PL020,,2007,1951,,118359516,682279059,239761484,,109197049,616117865,218826562,,9162467,66161194,20934922,PDP
PL020,,2008,1951,,118359577,682277936,239761345,,110347212,625036441,221563661,,8012365,57241495,18197684,PDP
PL020,,2009,1951,,117900173,678458581,238622344,,111576589,642718171,225939261,,6323584,35740410,12683085,PDP
PL020,,2010,1951,,118301084,678662052,239059459,,112298061,647386842,227491455,,6003023,31275210,11568003,PDP
PL020,,2011,1951,,118304149,678973296,239117905,,112681546,648914446,228146756,,5622603,30058850,10971149,PDP
PL020,,2012,1951,,116114886,660714497,233679745,,113084020,649767574,228701032,,3030866,10946923,4978716,PDP
PL020,,2013,1951,,116226700,661819604,233988198,,113435765,650383037,229162288,,2790935,11436567,4825910,PDP
PL020,,2014,1951,,116159695,660694827,233721055,,113774703,651053944,229620603,,2384992,9640883,4100449,PDP
PL020,,2015,1951,,115761179,659764448,233156993,,114007541,651574192,229946016,,1753638,8190256,3210977,PDP
PL020,,2016,1951,,115728865,659327256,233046885,,114286222,652123452,230322427,,1442643,7203804,2724456,PDP
PL020,,2017,1951,,115742699,659334850,233062071,,114577681,652713360,230718850,,1165018,6621490,2343215,PDP
PL020,,2017,1951,,115742699,659334850,233062071,,114577681,652713360,230718850,,1165018,6621490,2343215,PDP
PL023,,1975,1962,,13000000,19994000,16557651,,8877076,15591567,11651376,,4122924,4402433,4906275,PDP
PL023,,1976,1962,,25512802,49823609,34378213,,9275419,15842199,12094316,,16237383,33981410,22283897,PDP
PL023,,1977,1962,,25538502,49955592,34427397,,9682014,16222923,12568655,,15856488,33732669,21858742,PDP
PL023,,1978,1962,,25712434,51272493,34835653,,10164537,17542357,13285953,,15547897,33730136,21549700,PDP
PL023,,1979,1962,,24265497,51605273,33447930,,10300695,18671925,13623102,,13964802,32933348,19824828,PDP
PL023,,1980,1962,,24265497,51605273,33447930,,10492995,19943176,14041603,,13772502,31662097,19406327,PDP
PL023,,1981,1962,,24359664,53536816,33885788,,10756302,20288782,14366406,,13603362,33248034,19519382,PDP
PL023,,1982,1962,,14435791,26144183,19087781,,10976117,20754032,14669005,,3459674,5390151,4418776,PDP
PL023,,1983,1962,,16034910,27380303,20906850,,11117304,21091841,14870301,,4917606,6288462,6036549,PDP
PL023,,1984,1962,,16039572,27380303,20911512,,11405456,21480779,15227659,,4634116,5899524,5683853,PDP
PL023,,1985,1962,,15935752,27604300,20847549,,11704373,21872146,15596214,,4231379,5732154,5251335,PDP
PL023,,1986,1962,,15859544,26913095,20648351,,12106959,22367078,16086866,,3752585,4546017,4561485,PDP
PL023,,1987,1962,,15859544,26913095,20648351,,12362686,22747260,16410241,,3496858,4165835,4238110,PDP
PL023,,1988,1962,,15859544,26913095,20648351,,12491026,22957887,16576059,,3368518,3955208,4072292,PDP
PL023,,1989,1962,,15987024,26913255,20775859,,12545104,23057608,16647881,,3441920,3855647,4127978,PDP
PL023,,1990,1962,,15396506,27723508,20329515,,12770235,23509297,16953384,,2626271,4214211,3376131,PDP
PL023,,1991,1962,,15489550,27744574,20426307,,13175850,23937549,17435200,,2313700,3807025,2991107,PDP
PL023,,1992,1962,,15568775,31230467,21125798,,13479620,24217939,17788862,,2089155,7012528,3336936,PDP
PL023,,1993,1962,,15809591,31397199,21396281,,13719847,24584475,18094309,,2089744,6812724,3301972,PDP
PL023,,1994,1962,,15905250,31397442,21491983,,13933909,24889813,18362701,,1971341,6507629,3129282,PDP
PL023,,1995,1962,,15486392,33055731,21368195,,14131400,26254380,18802998,,1354992,6801351,2565197,PDP
PL023,,1996,1962,,15640161,33871924,21667194,,14342558,27839297,19296170,,1297603,6032627,2371024,PDP
PL023,,1997,1962,,17806710,56925898,27935873,,14683158,29903488,20004063,,3123552,27022410,7931810,PDP
PL023,,1998,1962,,19933574,97162717,37222314,,15881651,46927526,24231745,,4051923,50235191,12990569,PDP
PL023,,1999,1962,,19646035,102905974,37956707,,17033599,69566349,29411953,,2612436,33339625,8544754,PDP
PL023,,2000,1962,,24637559,147479345,50879435,,17962427,88039754,33627864,,6675132,59439591,17251571,PDP
PL023,,2001,1962,,25508393,180884013,57694160,,19283700,108896664,38660331,,6224693,71987349,19033829,PDP
PL023,,2002,1962,,25818501,184514499,58650262,,20273361,126465753,42776164,,5545140,58048746,15874098,PDP
PL023,,2003,1962,,26772112,191382281,60825899,,21256192,142618872,46633215,,5515920,48763409,14192684,PDP
PL023,,2004,1962,,27060409,194235194,61621831,,22149771,153487402,49460697,,4910638,40747792,12161134,PDP
PL023,,2005,1962,,26548150,187191997,59856335,,22655374,159369735,51012978,,3892776,27822262,8843357,PDP
PL023,,2006,1962,,26957741,205108650,63453942,,23016458,164350700,52260355,,3941283,40757950,11193587,PDP
PL023,,2007,1962,,26984378,196145761,61885759,,23319712,167952316,53204466,,3664666,28193445,8681293,PDP
PL023,,2008,1962,,27119903,196846586,62145986,,23473024,169423043,53619473,,3646879,27423543,8526513,PDP
PL023,,2009,1962,,24724479,188770787,58313587,,23688803,171439979,54194137,,1035676,17330808,4119450,PDP
PL023,,2010,1962,,24724479,188770787,58313587,,23734064,172147996,54365380,,990415,16622791,3948207,PDP
PL023,,2011,1962,,24909478,188654926,58477970,,23792109,172288035,54448343,,1117369,16366891,4029627,PDP
PL023,,2012,1962,,24113928,173548353,54994418,,23911221,172546628,54613468,,202707,1001725,380950,PDP
PL023,,2013,1962,,24113928,173548352,54994418,,23964396,172710184,54695745,,149532,838168,298673,PDP
PL023,,2014,1962,,24113928,173548352,54994418,,23998797,172917751,54767080,,115131,630601,227338,PDP
PL023,,2015,1962,,24113928,173548352,54994418,,24009970,173000322,54792945,,103958,548030,201473,PDP
PL023,,2016,1962,,24259165,173986521,55217623,,24168990,173400382,55023153,,90175,586139,194471,PDP
PL023,,2017,1962,,24582003,175396697,55791381,,24284418,173799560,55209608,,297585,1597137,581774,PDP
PL023,,2017,1962,,24582003,175396697,55791381,,24284418,173799560,55209608,,297585,1597137,581774,PDP
PN010A,,1991,1987,,17053,51484061,9177918,,2021,7574729,1349838,,15032,43909332,7828080,PDN
PN010A,,1992,1987,,18554,55987890,9980812,,4409,14937958,2662409,,14145,41049932,7318403,PDN
PN010A,,1993,1987,,18554,55987890,9980812,,6144,21509648,3833484,,12410,34478242,6147328,PDN
PN010A,,1994,1987,,18554,55987890,9980812,,7417,25035387,4462112,,11137,30952503,5518700,PDN
PN010A,,1995,1987,,18506,53791385,9589927,,8046,27479568,4897649,,10460,26311817,4692278,PDN
PN010A,,1996,1987,,14369,46752513,8333321,,8520,29615437,5278171,,5849,17137076,3055150,PDN
PN010A,,1997,1987,,14492,55163919,9830136,,9474,33187617,5914744,,5018,21976302,3915392,PDN
PN010A,,1998,1987,,17445,64184738,11438217,,10545,38753157,6906125,,6900,25431581,4532092,PDN
PN010A,,1999,1987,,18080,66004019,11762567,,10914,42599253,7590852,,7166,23404766,4171715,PDN
PN010A,,2000,1987,,19107,66559862,11862499,,11745,48502837,8642143,,7362,18057025,3220356,PDN
PN010A,,2001,1987,,20665,75011159,13367846,,13017,55600846,9906406,,7648,19410313,3461440,PDN
PN010A,,2002,1987,,20665,75011159,13367846,,13500,60169095,10719745,,7165,14842064,2648101,PDN
PN010A,,2003,1987,,17923,110719267,19718860,,13642,62620758,11156126,,4281,48098509,8562734,PDN
PN010A,,2004,1987,,28843,106435425,18967531,,19328,73788045,13148873,,9515,32647380,5818658,PDN
PN010A,,2005,1987,,31025,113047730,20146279,,25220,82951149,14785211,,5805,30096581,5361068,PDN
PN010A,,2006,1987,,42865,120988821,21571125,,32713,94951949,16928078,,10152,26036872,4643047,PDN
PN010A,,2007,1987,,41182,111145027,19817877,,36277,102021386,18189549,,4905,9123641,1628328,PDN
PN010A,,2008,1987,,43789,125103008,22304111,,38594,105633791,18834642,,5195,19469217,3469469,PDN
PN010A,,2009,1987,,40636,118964491,21208694,,38973,108103885,19274539,,1663,10860606,1934157,PDN
PN010A,,2010,1987,,39706,120423006,21467286,,39419,111101834,19808428,,287,9321172,1658858,PDN
PN010A,,2011,1987,,39706,119502617,21303516,,39683,112892684,20127348,,23,6609933,1176168,PDN
PN010A,,2012,1987,,39706,119502617,21303516,,39706,114289233,20375868,,0,5213384,927647,PDN
PN010A,,2013,1987,,39706,120527425,21485866,,39706,115686684,20624524,,0,4840741,861341,PDN
PN010A,,2014,1987,,39706,118646634,21151205,,39706,116807940,20824036,,0,1838694,327169,PDN
PN010A,,2015,1987,,39706,117185164,20891157,,39706,117185164,20891157,,0,0,0,PDN
PN010A,,2016,1987,,39706,117185164,20891157,,39706,117185164,20891157,,0,0,0,PDN
PN010A,,2017,1987,,39706,117185164,20891157,,39706,117185164,20891157,,0,0,0,PDN
PN010A,,2017,1987,,39706,117185164,20891157,,39706,117185164,20891157,,0,0,0,PDN
PN012A,,2001,2001,,445,4454164,793001,,61,381534,67950,,384,4072630,725051,PDN
PN012A,,2002,2001,,261,4487723,798788,,252,3434106,611303,,9,1053617,187485,PDN
PN012A,,2003,2001,,261,4487723,798788,,261,4487723,798788,,0,0,0,PDN
PN012A,,2004,2001,,261,4487723,798788,,261,4487723,798788,,0,0,0,PDN
PN012A,,2005,2001,,261,4487723,798788,,261,4487723,798788,,0,0,0,PDN
PN012A,,2006,2001,,261,4487723,798788,,261,4487723,798788,,0,0,0,PDN
PN012A,,2007,2001,,261,4487723,798788,,261,4487723,798788,,0,0,0,PDN
PN012A,,2008,2001,,261,4487723,798788,,261,4487723,798788,,0,0,0,PDN
PN012A,,2009,2001,,261,4487723,798788,,261,4487723,798788,,0,0,0,PDN
PN012A,,2010,2001,,261,4487723,798788,,261,4487723,798788,,0,0,0,PDN
PN012A,,2011,2001,,261,4487723,798788,,261,4487723,798788,,0,0,0,PDN
PN012A,,2012,2001,,261,4487723,798788,,261,4487723,798788,,0,0,0,PDN
PN012A,,2013,2001,,261,4487723,798788,,261,4487723,798788,,0,0,0,PDN
PN012A,,2014,2001,,261,4487723,798788,,261,4487723,798788,,0,0,0,PDN
PN012A,,2015,2001,,261,4487723,798788,,261,4487723,798788,,0,0,0,PDN
PN012A,,2016,2001,,261,4487723,798788,,261,4487723,798788,,0,0,0,PDN
PN012A,,2017,2001,,261,4487723,798788,,261,4487723,798788,,0,0,0,PDN
PN012A,,2017,2001,,261,4487723,798788,,261,4487723,798788,,0,0,0,PDN
PN042A,,1981,1979,,70000,70000000,12525516,,0,0,0,,70000,70000000,12525516,PDN
PN042A,,1982,1979,,70000,70000000,12525516,,469,7212270,1283791,,69531,62787730,11241725,PDN
PN042A,,1983,1979,,1079952,107995153,20296171,,2002,16495428,2937132,,1077950,91499725,17359039,PDN
PN042A,,1984,1979,,12182,92538371,16478084,,3612,28384232,5054187,,8570,64154139,11423897,PDN
PN042A,,1985,1979,,12182,92538371,16478084,,4923,42674304,7598216,,7259,49864067,8879868,PDN
PN042A,,1986,1979,,12224,93344344,16621538,,5696,54113122,9634365,,6528,39231222,6987173,PDN
PN042A,,1987,1979,,12224,93344344,16621538,,7123,61075227,10874601,,5101,32269117,5746937,PDN
PN042A,,1988,1979,,12224,93344344,16621538,,7544,67586833,12033671,,4680,25757511,4587867,PDN
PN042A,,1989,1979,,11009,93344344,16620323,,7948,75467989,13436416,,3061,17876355,3183907,PDN
PN042A,,1990,1979,,12135,105889642,18853708,,8307,80614492,14352523,,3828,25275150,4501185,PDN
PN042A,,1991,1979,,11253,105889642,18852826,,8624,87245457,15532727,,2629,18644185,3320099,PDN
PN042A,,1992,1979,,11124,112094145,19956701,,9021,95375173,16979692,,2103,16718972,2977009,PDN
PN042A,,1993,1979,,11401,125006700,22254586,,9272,101044126,17988654,,2129,23962574,4265932,PDN
PN042A,,1994,1979,,11401,125006700,22254586,,9449,104158503,18542990,,1952,20848197,3711596,PDN
PN042A,,1995,1979,,11745,126953956,22601417,,9793,107088344,19064658,,1952,19865612,3536759,PDN
PN042A,,1996,1979,,13082,127287372,22662081,,10164,108341842,19288072,,2918,18945530,3374009,PDN
PN042A,,1997,1979,,13082,127287372,22662081,,10355,108995253,19404528,,2727,18292119,3257553,PDN
PN042A,,1998,1979,,10370,109040215,19412543,,10370,109040215,19412543,,0,0,0,PDN
PN042A,,1999,1979,,10370,109040215,19412543,,10370,109040215,19412543,,0,0,0,PDN
PN042A,,2000,1979,,10370,109040215,19412543,,10370,109040215,19412543,,0,0,0,PDN
PN042A,,2001,1979,,10370,109040215,19412543,,10370,109040215,19412543,,0,0,0,PDN
PN042A,,2002,1979,,10370,109040215,19412543,,10370,109040215,19412543,,0,0,0,PDN
PN042A,,2003,1979,,10370,109040215,19412543,,10370,109040215,19412543,,0,0,0,PDN
PN042A,,2004,1979,,10370,109040215,19412543,,10370,109040215,19412543,,0,0,0,PDN
PN042A,,2005,1979,,10370,109040215,19412543,,10370,109040215,19412543,,0,0,0,PDN
PN042A,,2006,1979,,10370,109040215,19412543,,10370,109040215,19412543,,0,0,0,PDN
PN042A,,2007,1979,,10370,109040215,19412543,,10370,109040215,19412543,,0,0,0,PDN
PN042A,,2008,1979,,10370,109040215,19412543,,10370,109040215,19412543,,0,0,0,PDN
PN042A,,2009,1979,,10370,111223996,19801116,,10370,111223996,19801116,,0,0,0,PDN
PN042A,,2010,1979,,10370,111223996,19801116,,10370,111223996,19801116,,0,0,0,PDN
PN042A,,2011,1979,,10370,111223996,19801116,,10370,111223996,19801116,,0,0,0,PDN
PN042A,,2012,1979,,10370,111223996,19801116,,10370,111223996,19801116,,0,0,0,PDN
PN042A,,2013,1979,,10370,111223996,19801116,,10370,111223996,19801116,,0,0,0,PDN
PN042A,,2014,1979,,10370,111223996,19801116,,10370,111223996,19801116,,0,0,0,PDN
PN042A,,2015,1979,,10370,111223996,19801116,,10370,111223996,19801116,,0,0,0,PDN
PN042A,,2016,1979,,10370,111223996,19801116,,10370,111223996,19801116,,0,0,0,PDN
PN042A,,2017,1979,,10370,111223996,19801116,,10370,111223996,19801116,,0,0,0,PDN
PN042A,,2017,1979,,10370,111223996,19801116,,10370,111223996,19801116,,0,0,0,PDN
PN058A,,1986,1984,,9350,9574349,1712971,,0,0,0,,9350,9574349,1712971,PDN
PN058A,,1987,1984,,9350,9574349,1712971,,0,0,0,,9350,9574349,1712971,PDN
PN058A,,1989,1984,,13977,16771408,2998213,,0,0,0,,13977,16771408,2998213,PDN
PN058A,,1990,1984,,1768,17678022,3147324,,0,5622862,1000509,,1768,12055160,2146815,PDN
PN058A,,1991,1984,,2347,23461308,4176957,,0,9227509,1641906,,2347,14233799,2535051,PDN
PN058A,,1992,1984,,2347,23461308,4176957,,0,10480533,1864864,,2347,12980775,2312093,PDN
PN058A,,1993,1984,,0,11504969,2047148,,0,11504969,2047148,,0,0,0,PDN
PN058A,,1994,1984,,0,11504969,2047148,,0,11504969,2047148,,0,0,0,PDN
PN058A,,1995,1984,,0,11504969,2047148,,0,11504969,2047148,,0,0,0,PDN
PN058A,,1996,1984,,0,11504969,2047148,,0,11504969,2047148,,0,0,0,PDN
PN058A,,1997,1984,,0,11504969,2047148,,0,11504969,2047148,,0,0,0,PDN
PN058A,,1998,1984,,0,11504969,2047148,,0,11504969,2047148,,0,0,0,PDN
PN058A,,1999,1984,,0,11504969,2047148,,0,11504969,2047148,,0,0,0,PDN
PN058A,,2000,1984,,0,11504969,2047148,,0,11504969,2047148,,0,0,0,PDN
PN058A,,2001,1984,,0,11504969,2047148,,0,11504969,2047148,,0,0,0,PDN
PN058A,,2002,1984,,0,11504969,2047148,,0,11504969,2047148,,0,0,0,PDN
PN058A,,2003,1984,,0,11504969,2047148,,0,11504969,2047148,,0,0,0,PDN
PN058A,,2004,1984,,0,11504969,2047148,,0,11504969,2047148,,0,0,0,PDN
PN058A,,2005,1984,,0,11504969,2047148,,0,11504969,2047148,,0,0,0,PDN
PN058A,,2006,1984,,0,11504969,2047148,,0,11504969,2047148,,0,0,0,PDN
PN058A,,2007,1984,,0,11504969,2047148,,0,11504969,2047148,,0,0,0,PDN
PN058A,,2008,1984,,0,11504969,2047148,,0,11504969,2047148,,0,0,0,PDN
PN058A,,2009,1984,,0,11735380,2088147,,0,11735380,2088147,,0,0,0,PDN
PN058A,,2010,1984,,0,11735380,2088147,,0,11735380,2088147,,0,0,0,PDN
PN058A,,2011,1984,,0,11735380,2088147,,0,11735380,2088147,,0,0,0,PDN
PN058A,,2012,1984,,0,11735380,2088147,,0,11735380,2088147,,0,0,0,PDN
PN058A,,2013,1984,,0,11735380,2088147,,0,11735380,2088147,,0,0,0,PDN
PN058A,,2014,1984,,0,11735380,2088147,,0,11735380,2088147,,0,0,0,PDN
PN058A,,2015,1984,,0,11735380,2088147,,0,11735380,2088147,,0,0,0,PDN
PN058A,,2016,1984,,0,11735380,2088147,,0,11735380,2088147,,0,0,0,PDN
PN058A,,2017,1984,,0,11735380,2088147,,0,11735380,2088147,,0,0,0,PDN
PN058A,,2017,1984,,0,11735380,2088147,,0,11735380,2088147,,0,0,0,PDN
PN059A,,1989,1989,,44405,17983727,3244356,,0,0,0,,44405,17983727,3244356,PDN
PN059A,,1990,1989,,44405,17983727,3244356,,0,0,0,,44405,17983727,3244356,PDN
PN059A,,1991,1989,,44405,17983727,3244356,,5215,2079893,375303,,39190,15903834,2869053,PDN
PN059A,,1992,1989,,44405,17983727,3244356,,12497,4947492,892834,,31908,13036235,2351522,PDN
PN059A,,1993,1989,,44405,17983727,3244356,,13757,5510851,994335,,30648,12472876,2250021,PDN
PN059A,,1994,1989,,44405,17983727,3244356,,13758,5510977,994359,,30647,12472750,2249997,PDN
PN059A,,1995,1989,,16173,10947733,1964168,,13758,5511119,994384,,2415,5436614,969784,PDN
PN059A,,1996,1989,,16165,10944609,1963604,,13758,5511220,994402,,2407,5433389,969202,PDN
PN059A,,1997,1989,,16064,10680583,1916524,,14018,6955440,1251641,,2046,3725143,664883,PDN
PN059A,,1998,1989,,16064,10680583,1916524,,14018,8581344,1540948,,2046,2099239,375576,PDN
PN059A,,1999,1989,,14121,10086567,1808884,,14018,8948580,1606292,,103,1137987,202592,PDN
PN059A,,2000,1989,,14158,10093355,1810128,,14018,9129101,1638413,,140,964254,171715,PDN
PN059A,,2001,1989,,18142,13446698,2410793,,14018,9159778,1643872,,4124,4286920,766921,PDN
PN059A,,2002,1989,,18056,13418488,2405687,,14018,9247374,1659458,,4038,4171114,746229,PDN
PN059A,,2003,1989,,18061,13423189,2406528,,14018,9818026,1760998,,4043,3605163,645530,PDN
PN059A,,2004,1989,,14072,13048336,2335840,,14018,10193724,1827848,,54,2854612,507992,PDN
PN059A,,2005,1989,,14072,13048336,2335840,,14018,10718008,1921137,,54,2330328,414703,PDN
PN059A,,2006,1989,,14072,13048336,2335840,,14018,11225548,2011446,,54,1822788,324394,PDN
PN059A,,2007,1989,,14072,13048336,2335840,,14018,11515215,2062989,,54,1533121,272851,PDN
PN059A,,2008,1989,,14018,13437347,2405005,,14018,11697380,2095402,,0,1739967,309603,PDN
PN059A,,2009,1989,,14018,12137465,2173708,,14018,11969238,2143775,,0,168227,29934,PDN
PN059A,,2010,1989,,14018,12137465,2173708,,14018,12078783,2163267,,0,58682,10442,PDN
PN059A,,2011,1989,,14018,12137465,2173708,,14018,12137465,2173708,,0,0,0,PDN
PN059A,,2012,1989,,14018,12137465,2173708,,14018,12137465,2173708,,0,0,0,PDN
PN059A,,2013,1989,,14018,12137465,2173708,,14018,12137465,2173708,,0,0,0,PDN
PN059A,,2014,1989,,14018,12137465,2173708,,14018,12137465,2173708,,0,0,0,PDN
PN059A,,2015,1989,,14018,12137465,2173708,,14018,12137465,2173708,,0,0,0,PDN
PN059A,,2016,1989,,14018,12137465,2173708,,14018,12137465,2173708,,0,0,0,PDN
PN059A,,2017,1989,,14018,12137465,2173708,,14018,12137465,2173708,,0,0,0,PDN
PN059A,,2017,1989,,14018,12137465,2173708,,14018,12137465,2173708,,0,0,0,PDN
PN072A,,1986,1984,,913,934576,167208,,0,0,0,,913,934576,167208,PDN
PN072A,,1987,1984,,913,934576,167208,,0,0,0,,913,934576,167208,PDN
PN072A,,1990,1984,,245,2452836,436693,,0,0,0,,245,2452836,436693,PDN
PN072A,,1991,1984,,245,2452836,436693,,0,559047,99475,,245,1893789,337218,PDN
PN072A,,1992,1984,,378,3782792,673473,,0,1967789,350140,,378,1815003,323333,PDN
PN072A,,1993,1984,,850,8497875,1512927,,0,5006279,890797,,850,3491596,622130,PDN
PN072A,,1994,1984,,850,8497875,1512927,,0,6840573,1217184,,850,1657302,295743,PDN
PN072A,,1995,1984,,491,8457298,1505348,,0,7864711,1399415,,491,592587,105933,PDN
PN072A,,1996,1984,,0,8187519,1456854,,0,8187519,1456854,,0,0,0,PDN
PN072A,,1997,1984,,0,8187519,1456854,,0,8187519,1456854,,0,0,0,PDN
PN072A,,1998,1984,,0,8187519,1456854,,0,8187519,1456854,,0,0,0,PDN
PN072A,,1999,1984,,0,8187519,1456854,,0,8187519,1456854,,0,0,0,PDN
PN072A,,2000,1984,,0,8187519,1456854,,0,8187519,1456854,,0,0,0,PDN
PN072A,,2001,1984,,0,8187519,1456854,,0,8187519,1456854,,0,0,0,PDN
PN072A,,2002,1984,,0,8187519,1456854,,0,8187519,1456854,,0,0,0,PDN
PN072A,,2003,1984,,0,8187519,1456854,,0,8187519,1456854,,0,0,0,PDN
PN072A,,2004,1984,,0,8187519,1456854,,0,8187519,1456854,,0,0,0,PDN
PN072A,,2005,1984,,0,8187519,1456854,,0,8187519,1456854,,0,0,0,PDN
PN072A,,2006,1984,,0,8187519,1456854,,0,8187519,1456854,,0,0,0,PDN
PN072A,,2007,1984,,0,8187519,1456854,,0,8187519,1456854,,0,0,0,PDN
PN072A,,2008,1984,,0,8187519,1456854,,0,8187519,1456854,,0,0,0,PDN
PN072A,,2009,1984,,0,8351487,1486030,,0,8351487,1486030,,0,0,0,PDN
PN072A,,2010,1984,,0,8351487,1486030,,0,8351487,1486030,,0,0,0,PDN
PN072A,,2011,1984,,0,8351487,1486030,,0,8351487,1486030,,0,0,0,PDN
PN072A,,2012,1984,,0,8351487,1486030,,0,8351487,1486030,,0,0,0,PDN
PN072A,,2013,1984,,0,8351487,1486030,,0,8351487,1486030,,0,0,0,PDN
PN072A,,2014,1984,,0,8351487,1486030,,0,8351487,1486030,,0,0,0,PDN
PN072A,,2015,1984,,0,8351487,1486030,,0,8351487,1486030,,0,0,0,PDN
PN072A,,2016,1984,,0,8351487,1486030,,0,8351487,1486030,,0,0,0,PDN
PN072A,,2017,1984,,0,8351487,1486030,,0,8351487,1486030,,0,0,0,PDN
PN072A,,2017,1984,,0,8351487,1486030,,0,8351487,1486030,,0,0,0,PDN
PN1010,,1999,1999,,9505,950561,178644,,10,263950,46976,,9495,686611,131668,PDN
PN1010,,2000,1999,,1366,17788936,3166657,,236,3184781,566923,,1130,14604155,2599734,PDN
PN1010,,2001,1999,,48653,10441308,1906537,,421,5618160,1000094,,48232,4823148,906443,PDN
PN1010,,2002,1999,,48653,10441308,1906537,,452,5977234,1064017,,48201,4464074,842520,PDN
PN1010,,2003,1999,,452,5977234,1064017,,452,5977234,1064017,,0,0,0,PDN
PN1010,,2004,1999,,452,5977234,1064017,,452,5977234,1064017,,0,0,0,PDN
PN1010,,2005,1999,,452,5977234,1064017,,452,5977234,1064017,,0,0,0,PDN
PN1010,,2006,1999,,452,5977234,1064017,,452,5977234,1064017,,0,0,0,PDN
PN1010,,2007,1999,,452,5977234,1064017,,452,5977234,1064017,,0,0,0,PDN
PN1010,,2008,1999,,452,5977234,1064017,,452,5977234,1064017,,0,0,0,PDN
PN1010,,2009,1999,,452,5977234,1064017,,452,5977234,1064017,,0,0,0,PDN
PN1010,,2010,1999,,452,5977234,1064017,,452,5977234,1064017,,0,0,0,PDN
PN1010,,2011,1999,,452,5977234,1064017,,452,5977234,1064017,,0,0,0,PDN
PN1010,,2012,1999,,452,5977234,1064017,,452,5977234,1064017,,0,0,0,PDN
PN1010,,2013,1999,,452,5977234,1064017,,452,5977234,1064017,,0,0,0,PDN
PN1010,,2014,1999,,452,5977234,1064017,,452,5977234,1064017,,0,0,0,PDN
PN1010,,2015,1999,,452,5977234,1064017,,452,5977234,1064017,,0,0,0,PDN
PN1010,,2016,1999,,452,5977234,1064017,,452,5977234,1064017,,0,0,0,PDN
PN1010,,2017,1999,,452,5977234,1064017,,452,5977234,1064017,,0,0,0,PDN
PN1010,,2017,1999,,452,5977234,1064017,,452,5977234,1064017,,0,0,0,PDN
PN912,,2001,2001,,733,7334674,1305835,,0,662666,117912,,733,6672008,1187923,PDN
PN912,,2002,2001,,795,7943708,1414266,,0,3486156,620312,,795,4457552,793954,PDN
PN912,,2003,2001,,795,7943708,1414266,,0,5437977,967612,,795,2505731,446654,PDN
PN912,,2004,2001,,795,7943708,1414266,,0,6608680,1175922,,795,1335028,238344,PDN
PN912,,2005,2001,,795,7943925,1414305,,0,7303319,1299523,,795,640606,114782,PDN
PN912,,2006,2001,,798,7978508,1420461,,0,7626749,1357073,,798,351759,63388,PDN
PN912,,2007,2001,,0,7761553,1381059,,0,7761553,1381059,,0,0,0,PDN
PN912,,2008,2001,,0,7993034,1422248,,0,7955086,1415496,,0,37948,6752,PDN
PN912,,2009,2001,,0,7993034,1422248,,0,7993034,1422248,,0,0,0,PDN
PN912,,2010,2001,,0,7993034,1422248,,0,7993034,1422248,,0,0,0,PDN
PN912,,2011,2001,,0,7993034,1422248,,0,7993034,1422248,,0,0,0,PDN
PN912,,2012,2001,,0,7993034,1422248,,0,7993034,1422248,,0,0,0,PDN
PN912,,2013,2001,,0,7993034,1422248,,0,7993034,1422248,,0,0,0,PDN
PN912,,2014,2001,,0,7993034,1422248,,0,7993034,1422248,,0,0,0,PDN
PN912,,2015,2001,,0,7993034,1422248,,0,7993034,1422248,,0,0,0,PDN
PN912,,2016,2001,,0,7993034,1422248,,0,7993034,1422248,,0,0,0,PDN
PN912,,2017,2001,,0,7993034,1422248,,0,7993034,1422248,,0,0,0,PDN
PN912,,2017,2001,,0,7993034,1422248,,0,7993034,1422248,,0,0,0,PDN
PN913,,2004,1980,,82,11802718,2100210,,0,0,0,,82,11802718,2100210,PDN
PN913,,2005,1980,,82,11802718,2100210,,0,0,0,,82,11802718,2100210,PDN
PN913,,2006,1980,,1878,5142727,916954,,1519,3880925,692075,,359,1261802,224879,PDN
PN913,,2007,1980,,1878,5142727,916954,,1878,5142727,916954,,0,0,0,PDN
PN913,,2008,1980,,1878,5142727,916954,,1878,5142727,916954,,0,0,0,PDN
PN913,,2009,1980,,1878,5142727,916954,,1878,5142727,916954,,0,0,0,PDN
PN913,,2010,1980,,1878,5142727,916954,,1878,5142727,916954,,0,0,0,PDN
PN913,,2011,1980,,1878,5142727,916954,,1878,5142727,916954,,0,0,0,PDN
PN913,,2012,1980,,1878,5142727,916954,,1878,5142727,916954,,0,0,0,PDN
PN913,,2013,1980,,1878,5142727,916954,,1878,5142727,916954,,0,0,0,PDN
PN913,,2014,1980,,1878,5142727,916954,,1878,5142727,916954,,0,0,0,PDN
PN913,,2015,1980,,1878,5142727,916954,,1878,5142727,916954,,0,0,0,PDN
PN913,,2016,1980,,1878,5142727,916954,,1878,5142727,916954,,0,0,0,PDN
PN913,,2017,1980,,1878,5142727,916954,,1878,5142727,916954,,0,0,0,PDN
PN913,,2017,1980,,1878,5142727,916954,,1878,5142727,916954,,0,0,0,PDN
PN967,,1979,1976,,26000,26000000,4652335,,0,0,0,,26000,26000000,4652335,PDN
PN967,,1980,1976,,26000,26000000,4652335,,0,0,0,,26000,26000000,4652335,PDN
PN967,,1981,1976,,26000,26000000,4652335,,0,0,0,,26000,26000000,4652335,PDN
PN967,,1982,1976,,26000,26000000,4652335,,12588,4969359,896816,,13412,21030641,3755519,PDN
PN967,,1983,1976,,248759,42636811,7835380,,43180,16585163,2994277,,205579,26051648,4841103,PDN
PN967,,1984,1976,,252701,43031003,7909463,,59296,27794177,5004879,,193405,15236826,2904584,PDN
PN967,,1985,1976,,147766,73565661,13237741,,76588,39167152,7045832,,71178,34398509,6191909,PDN
PN967,,1986,1976,,144940,79613729,14311084,,92407,47881072,8612171,,52533,31732657,5698913,PDN
PN967,,1987,1976,,148154,79613729,14314298,,97677,51929688,9337835,,50477,27684041,4976463,PDN
PN967,,1988,1976,,145383,78133698,14048176,,100124,55182122,9919007,,45259,22951576,4129169,PDN
PN967,,1989,1976,,153595,98976939,17765150,,102735,59780468,10739829,,50860,39196471,7025321,PDN
PN967,,1990,1976,,379469,98976939,17991024,,109667,64278228,11547074,,269802,34698711,6443950,PDN
PN967,,1991,1976,,364595,99525216,18073708,,142849,69131546,12443836,,221746,30393670,5629872,PDN
PN967,,1992,1976,,366511,100082239,18174739,,183009,73536122,13267728,,183502,26546117,4907011,PDN
PN967,,1993,1976,,335633,96290232,17469126,,224629,77104581,13944305,,111004,19185651,3524821,PDN
PN967,,1994,1976,,340177,100230855,18174849,,231941,80322903,14524272,,108236,19907952,3650577,PDN
PN967,,1995,1976,,473088,99623398,18199671,,233248,81322074,14703368,,239840,18301324,3496303,PDN
PN967,,1996,1976,,233362,81633947,14758975,,233362,81633947,14758975,,0,0,0,PDN
PN967,,1997,1976,,233362,81633947,14758975,,233362,81633947,14758975,,0,0,0,PDN
PN967,,1998,1976,,233362,81633947,14758975,,233362,81633947,14758975,,0,0,0,PDN
PN967,,1999,1976,,233362,81633947,14758975,,233362,81633947,14758975,,0,0,0,PDN
PN967,,2000,1976,,233362,81633947,14758975,,233362,81633947,14758975,,0,0,0,PDN
PN967,,2001,1976,,233362,81633947,14758975,,233362,81633947,14758975,,0,0,0,PDN
PN967,,2002,1976,,233362,81633947,14758975,,233362,81633947,14758975,,0,0,0,PDN
PN967,,2003,1976,,233362,81633947,14758975,,233362,81633947,14758975,,0,0,0,PDN
PN967,,2004,1976,,233362,81633947,14758975,,233362,81633947,14758975,,0,0,0,PDN
PN967,,2005,1976,,233362,81633947,14758975,,233362,81633947,14758975,,0,0,0,PDN
PN967,,2006,1976,,233362,81633947,14758975,,233362,81633947,14758975,,0,0,0,PDN
PN967,,2007,1976,,233362,81633947,14758975,,233362,81633947,14758975,,0,0,0,PDN
PN967,,2008,1976,,233362,81633947,14758975,,233362,81633947,14758975,,0,0,0,PDN
PN967,,2009,1976,,233362,83268828,15049881,,233362,83268828,15049881,,0,0,0,PDN
PN967,,2010,1976,,233362,83268828,15049881,,233362,83268828,15049881,,0,0,0,PDN
PN967,,2011,1976,,233362,83268828,15049881,,233362,83268828,15049881,,0,0,0,PDN
PN967,,2012,1976,,233362,83268828,15049881,,233362,83268828,15049881,,0,0,0,PDN
PN967,,2013,1976,,233362,83268828,15049881,,233362,83268828,15049881,,0,0,0,PDN
PN967,,2014,1976,,233362,83268828,15049881,,233362,83268828,15049881,,0,0,0,PDN
PN967,,2015,1976,,233362,83268828,15049881,,233362,83268828,15049881,,0,0,0,PDN
PN967,,2016,1976,,233362,83268828,15049881,,233362,83268828,15049881,,0,0,0,PDN
PN967,,2017,1976,,233362,83268828,15049881,,233362,83268828,15049881,,0,0,0,PDN
PN967,,2017,1976,,233362,83268828,15049881,,233362,83268828,15049881,,0,0,0,PDN
PN969,,1986,1984,,4486,4592930,821733,,0,0,0,,4486,4592930,821733,PDN
PN969,,1987,1984,,4486,4592930,821733,,0,0,0,,4486,4592930,821733,PDN
PN969,,1988,1984,,103779,111869374,20009362,,9814,12105893,2163887,,93965,99763481,17845475,PDN
PN969,,1989,1984,,103779,111869374,20009362,,23160,30008407,5362734,,80619,81860967,14646628,PDN
PN969,,1990,1984,,111803,125852872,22505552,,35464,49358004,8818027,,76339,76494868,13687525,PDN
PN969,,1991,1984,,103045,168101502,30014344,,41006,66906744,11946121,,62039,101194758,18068223,PDN
PN969,,1992,1984,,103078,167869805,29973150,,45228,78843275,14074280,,57850,89026530,15898870,PDN
PN969,,1993,1984,,102344,172518911,30799659,,48851,89464144,15967738,,53493,83054767,14831921,PDN
PN969,,1994,1984,,103158,186637229,33312629,,52890,98278549,17540176,,50268,88358680,15772453,PDN
PN969,,1995,1984,,91168,170484179,30426431,,55576,109933951,19616777,,35592,60550228,10809654,PDN
PN969,,1996,1984,,88045,173429163,30947327,,58094,123823290,22090708,,29951,49605873,8856619,PDN
PN969,,1997,1984,,91519,177065748,31597880,,61837,134144584,23930980,,29682,42921164,7666900,PDN
PN969,,1998,1984,,91482,178695758,31887880,,64262,141126641,25175764,,27220,37569117,6712116,PDN
PN969,,1999,1984,,120945,189249529,33795238,,65567,148921962,26564137,,55378,40327567,7231101,PDN
PN969,,2000,1984,,119105,187981001,33567682,,67074,156993425,28001847,,52031,30987576,5565835,PDN
PN969,,2001,1984,,138893,195559798,34936010,,68716,163959367,29242981,,70177,31600431,5693029,PDN
PN969,,2002,1984,,112935,186255211,33254432,,69001,166056410,29616405,,43934,20198801,3638027,PDN
PN969,,2003,1984,,113117,201571404,35979915,,69607,168847875,30113713,,43510,32723529,5866202,PDN
PN969,,2004,1984,,72246,184850647,32963820,,70128,171653300,30613420,,2118,13197347,2350400,PDN
PN969,,2005,1984,,72134,183733167,32764868,,70376,174054605,31040946,,1758,9678562,1723922,PDN
PN969,,2006,1984,,72192,183733167,32764926,,70573,175758266,31344286,,1619,7974901,1420640,PDN
PN969,,2007,1984,,73382,184490759,32900919,,70738,177252240,31610282,,2644,7238519,1290637,PDN
PN969,,2008,1984,,74941,200356331,35725534,,70972,178632255,31856071,,3969,21724076,3869463,PDN
PN969,,2009,1984,,74469,199281936,35533887,,71041,184131591,32834668,,3428,15150345,2699218,PDN
PN969,,2010,1984,,74469,199281936,35533887,,71490,186602081,33274707,,2979,12679855,2259181,PDN
PN969,,2011,1984,,73815,200394077,35731122,,71773,188620267,33634097,,2042,11773810,2097026,PDN
PN969,,2012,1984,,74837,200412269,35735381,,71930,190249493,33924153,,2907,10162776,1811229,PDN
PN969,,2013,1984,,73832,199867144,35637379,,71874,191262335,34104318,,1958,8604809,1533063,PDN
PN969,,2014,1984,,72222,191585668,34162197,,72222,191585668,34162197,,0,0,0,PDN
PN969,,2015,1984,,72222,191585668,34162197,,72222,191585668,34162197,,0,0,0,PDN
PN969,,2016,1984,,72222,191585668,34162197,,72222,191585668,34162197,,0,0,0,PDN
PN969,,2017,1984,,72222,191585668,34162197,,72222,191585668,34162197,,0,0,0,PDN
PN969,,2017,1984,,72222,191585668,34162197,,72222,191585668,34162197,,0,0,0,PDN
PN996,,1991,1991,,2542,25417088,4525156,,0,135576,24124,,2542,25281512,4501032,PDN
PN996,,1992,1991,,2542,25417088,4525156,,1129,2814379,501908,,1413,22602709,4023248,PDN
PN996,,1993,1991,,11352,25417088,4533966,,2422,5574172,994268,,8930,19842916,3539698,PDN
PN996,,1994,1991,,11352,25417088,4533966,,3993,8081779,1442032,,7359,17335309,3091934,PDN
PN996,,1995,1991,,11366,25448399,4539551,,5032,10378548,1851749,,6334,15069851,2687802,PDN
PN996,,1996,1991,,11355,25421807,4534808,,5901,12887382,2299029,,5454,12534425,2235779,PDN
PN996,,1997,1991,,11343,25395215,4530065,,6425,15012177,2677631,,4918,10383038,1852434,PDN
PN996,,1998,1991,,11343,25395215,4530065,,6727,15769937,2812766,,4616,9625278,1717299,PDN
PN996,,1999,1991,,7870,17222203,3072319,,6906,16106304,2872796,,964,1115899,199523,PDN
PN996,,2000,1991,,7870,17222203,3072319,,7142,16602815,2961380,,728,619388,110939,PDN
PN996,,2001,1991,,7142,16602815,2961380,,7142,16602815,2961380,,0,0,0,PDN
PN996,,2002,1991,,7142,16602815,2961380,,7142,16602815,2961380,,0,0,0,PDN
PN996,,2003,1991,,7142,19310141,3443110,,7142,16605933,2961934,,0,2704208,481176,PDN
PN996,,2004,1991,,7413,19310141,3443381,,7377,17620190,3142642,,36,1689951,300739,PDN
PN996,,2005,1991,,7379,18346475,3271876,,7379,18346475,3271876,,0,0,0,PDN
PN996,,2006,1991,,7379,18346475,3271876,,7379,18346475,3271876,,0,0,0,PDN
PN996,,2007,1991,,7379,18346475,3271876,,7379,18346475,3271876,,0,0,0,PDN
PN996,,2008,1991,,7379,18346475,3271876,,7379,18346475,3271876,,0,0,0,PDN
PN996,,2009,1991,,7379,18659998,3327664,,7379,18659998,3327664,,0,0,0,PDN
PN996,,2010,1991,,7379,18659998,3327664,,7379,18659998,3327664,,0,0,0,PDN
PN996,,2011,1991,,7379,18659998,3327664,,7379,18659998,3327664,,0,0,0,PDN
PN996,,2012,1991,,7379,18659998,3327664,,7379,18659998,3327664,,0,0,0,PDN
PN996,,2013,1991,,7379,18659998,3327664,,7379,18659998,3327664,,0,0,0,PDN
PN996,,2014,1991,,7379,18659998,3327664,,7379,18659998,3327664,,0,0,0,PDN
PN996,,2015,1991,,7379,18659998,3327664,,7379,18659998,3327664,,0,0,0,PDN
PN996,,2016,1991,,7379,18659998,3327664,,7379,18659998,3327664,,0,0,0,PDN
PN996,,2017,1991,,7379,18659998,3327664,,7379,18659998,3327664,,0,0,0,PDN
PN996,,2017,1991,,7379,18659998,3327664,,7379,18659998,3327664,,0,0,0,PDN
PN998,,2005,2006,,93,934824,166432,,0,0,0,,93,934824,166432,PDN
PN998,,2006,2006,,77,764089,136036,,0,0,0,,77,764089,136036,PDN
PN998,,2007,2006,,0,754931,134329,,0,727309,129414,,0,27622,4915,PDN
PN998,,2008,2006,,0,924607,164521,,0,924607,164521,,0,0,0,PDN
PN998,,2009,2006,,0,924607,164521,,0,924607,164521,,0,0,0,PDN
PN998,,2010,2006,,0,924607,164521,,0,924607,164521,,0,0,0,PDN
PN998,,2011,2006,,0,924607,164521,,0,924607,164521,,0,0,0,PDN
PN998,,2012,2006,,0,924607,164521,,0,924607,164521,,0,0,0,PDN
PN998,,2013,2006,,0,924607,164521,,0,924607,164521,,0,0,0,PDN
PN998,,2014,2006,,0,924607,164521,,0,924607,164521,,0,0,0,PDN
PN998,,2015,2006,,0,924607,164521,,0,924607,164521,,0,0,0,PDN
PN998,,2016,2006,,0,924607,164521,,0,924607,164521,,0,0,0,PDN
PN998,,2017,2006,,0,924607,164521,,0,924607,164521,,0,0,0,PDN
PN998,,2017,2006,,0,924607,164521,,0,924607,164521,,0,0,0,PDN
PS1073,,2006,2006,,275,6679940,1188876,,0,0,0,,275,6679940,1188876,PDN
PS1073,,2007,2006,,0,18605656,3310615,,0,3466614,616835,,0,15139042,2693780,PDN
PS1073,,2008,2006,,0,18748922,3336107,,0,7670742,1364901,,0,11078180,1971206,PDN
PS1073,,2009,2006,,0,11040015,1964415,,0,9686533,1723581,,0,1353482,240834,PDN
PS1073,,2010,2006,,0,11040015,1964415,,0,10413438,1852924,,0,626577,111490,PDN
PS1073,,2011,2006,,0,11040015,1964415,,0,10934033,1945557,,0,105982,18858,PDN
PS1073,,2012,2006,,0,11040015,1964415,,0,11040015,1964415,,0,0,0,PDN
PS1073,,2013,2006,,0,11040015,1964415,,0,11040015,1964415,,0,0,0,PDN
PS1073,,2014,2006,,0,11040015,1964415,,0,11040015,1964415,,0,0,0,PDN
PS1073,,2015,2006,,0,11040015,1964415,,0,11040015,1964415,,0,0,0,PDN
PS1073,,2016,2006,,0,11040015,1964415,,0,11040015,1964415,,0,0,0,PDN
PS1073,,2017,2006,,0,11040015,1964415,,0,11040015,1964415,,0,0,0,PDN
PS1073,,2017,2006,,0,11040015,1964415,,0,11040015,1964415,,0,0,0,PDN
PS1111,,2008,2007,,0,6286505,1118595,,0,0,0,,0,6286505,1118595,PDN
PS1111,,2009,2007,,0,3023787,538040,,0,785441,139758,,0,2238346,398282,PDN
PS1111,,2010,2007,,0,3023787,538040,,0,2097227,373172,,0,926560,164868,PDN
PS1111,,2011,2007,,0,3023787,538040,,0,3023787,538040,,0,0,0,PDN
PS1111,,2012,2007,,0,3023787,538040,,0,3023787,538040,,0,0,0,PDN
PS1111,,2013,2007,,0,3023787,538040,,0,3023787,538040,,0,0,0,PDN
PS1111,,2014,2007,,0,3023787,538040,,0,3023787,538040,,0,0,0,PDN
PS1111,,2015,2007,,0,3023787,538040,,0,3023787,538040,,0,0,0,PDN
PS1111,,2016,2007,,0,3023787,538040,,0,3023787,538040,,0,0,0,PDN
PS1111,,2017,2007,,0,3023787,538040,,0,3023787,538040,,0,0,0,PDN
PS1111,,2017,2007,,0,3023787,538040,,0,3023787,538040,,0,0,0,PDN
PS1113,,2006,2006,,545,5442777,969011,,0,0,0,,545,5442777,969011,PDN
PS1113,,2007,2006,,36,4902627,872390,,0,3177896,565462,,36,1724731,306928,PDN
PS1113,,2008,2006,,575,10238859,1822436,,0,3417023,608011,,575,6821836,1214425,PDN
PS1113,,2009,2006,,0,3563888,634144,,0,3430833,610469,,0,133055,23675,PDN
PS1113,,2010,2006,,0,3563888,634144,,0,3563888,634144,,0,0,0,PDN
PS1113,,2011,2006,,0,3563888,634144,,0,3563888,634144,,0,0,0,PDN
PS1113,,2012,2006,,0,3563888,634144,,0,3563888,634144,,0,0,0,PDN
PS1113,,2013,2006,,0,3563888,634144,,0,3563888,634144,,0,0,0,PDN
PS1113,,2014,2006,,0,3563888,634144,,0,3563888,634144,,0,0,0,PDN
PS1113,,2015,2006,,0,3563888,634144,,0,3563888,634144,,0,0,0,PDN
PS1113,,2016,2006,,0,3563888,634144,,0,3563888,634144,,0,0,0,PDN
PS1113,,2017,2006,,0,3563888,634144,,0,3563888,634144,,0,0,0,PDN
PS1113,,2017,2006,,0,3563888,634144,,0,3563888,634144,,0,0,0,PDN
PS1133,,2006,2006,,812,8604641,1531887,,0,0,0,,812,8604641,1531887,PDN
PS1133,,2007,2006,,0,12753298,2269270,,0,2346910,417600,,0,10406388,1851670,PDN
PS1133,,2008,2006,,0,7347278,1307345,,0,4727736,841234,,0,2619542,466111,PDN
PS1133,,2009,2006,,0,6541156,1163907,,0,6068513,1079807,,0,472643,84101,PDN
PS1133,,2010,2006,,0,6541156,1163907,,0,6506885,1157809,,0,34271,6098,PDN
PS1133,,2011,2006,,0,6541156,1163907,,0,6541156,1163907,,0,0,0,PDN
PS1133,,2012,2006,,0,6541156,1163907,,0,6541156,1163907,,0,0,0,PDN
PS1133,,2013,2006,,0,6541156,1163907,,0,6541156,1163907,,0,0,0,PDN
PS1133,,2014,2006,,0,6541156,1163907,,0,6541156,1163907,,0,0,0,PDN
PS1133,,2015,2006,,0,6541156,1163907,,0,6541156,1163907,,0,0,0,PDN
PS1133,,2016,2006,,0,6541156,1163907,,0,6541156,1163907,,0,0,0,PDN
PS1133,,2017,2006,,0,6541156,1163907,,0,6541156,1163907,,0,0,0,PDN
PS1133,,2017,2006,,0,6541156,1163907,,0,6541156,1163907,,0,0,0,PDN
PS1152,,2005,2005,,0,10810714,1923615,,0,108900,19377,,0,10701814,1904238,PDN
PS1152,,2006,2005,,0,10810714,1923615,,0,2700335,480487,,0,8110379,1443128,PDN
PS1152,,2007,2005,,0,3801840,676484,,0,3801840,676484,,0,0,0,PDN
PS1152,,2008,2005,,0,3801840,676484,,0,3801840,676484,,0,0,0,PDN
PS1152,,2009,2005,,0,3801840,676484,,0,3801840,676484,,0,0,0,PDN
PS1152,,2010,2005,,0,3801840,676484,,0,3801840,676484,,0,0,0,PDN
PS1152,,2011,2005,,0,3801840,676484,,0,3801840,676484,,0,0,0,PDN
PS1152,,2012,2005,,0,3801840,676484,,0,3801840,676484,,0,0,0,PDN
PS1152,,2013,2005,,0,3801840,676484,,0,3801840,676484,,0,0,0,PDN
PS1152,,2014,2005,,0,3801840,676484,,0,3801840,676484,,0,0,0,PDN
PS1152,,2015,2005,,0,3801840,676484,,0,3801840,676484,,0,0,0,PDN
PS1152,,2016,2005,,0,3801840,676484,,0,3801840,676484,,0,0,0,PDN
PS1152,,2017,2005,,0,3801840,676484,,0,3801840,676484,,0,0,0,PDN
PS1152,,2017,2005,,0,3801840,676484,,0,3801840,676484,,0,0,0,PDN
PS1166,,2005,2005,,0,18356053,3266202,,0,375409,66799,,0,17980644,3199403,PDN
PS1166,,2006,2005,,0,18354461,3265918,,0,6630877,1179871,,0,11723584,2086047,PDN
PS1166,,2007,2005,,0,18354461,3265918,,0,11900796,2117579,,0,6453665,1148339,PDN
PS1166,,2008,2005,,0,31660157,5633480,,0,14766357,2627466,,0,16893800,3006014,PDN
PS1166,,2009,2005,,0,18660218,3320324,,0,17375571,3091739,,0,1284647,228584,PDN
PS1166,,2010,2005,,0,18660218,3320324,,0,18601315,3309843,,0,58903,10480,PDN
PS1166,,2011,2005,,0,18660218,3320324,,0,18660218,3320324,,0,0,0,PDN
PS1166,,2012,2005,,0,18660218,3320324,,0,18660218,3320324,,0,0,0,PDN
PS1166,,2013,2005,,0,18660218,3320324,,0,18660218,3320324,,0,0,0,PDN
PS1166,,2014,2005,,0,18660218,3320324,,0,18660218,3320324,,0,0,0,PDN
PS1166,,2015,2005,,0,18660218,3320324,,0,18660218,3320324,,0,0,0,PDN
PS1166,,2016,2005,,0,18660218,3320324,,0,18660218,3320324,,0,0,0,PDN
PS1166,,2017,2005,,0,18660218,3320324,,0,18660218,3320324,,0,0,0,PDN
PS1166,,2017,2005,,0,18660218,3320324,,0,18660218,3320324,,0,0,0,PDN
SA007,,1985,1984,,84206,1649160,377651,,9069,157046,37013,,75137,1492114,340638,PDN
SA007,,1986,1984,,475399,8445448,1978148,,9560,169834,39780,,465839,8275614,1938368,PDN
SA007,,1987,1984,,15868,235583,57787,,15868,235583,57787,,0,0,0,PDN
SA007,,1988,1984,,15868,235583,57787,,15868,235583,57787,,0,0,0,PDN
SA007,,1989,1984,,15868,235583,57787,,15868,235583,57787,,0,0,0,PDN
SA007,,1990,1984,,15868,235583,57787,,15868,235583,57787,,0,0,0,PDN
SA007,,1991,1984,,15868,235583,57787,,15868,235583,57787,,0,0,0,PDN
SA007,,1992,1984,,15868,235583,57787,,15868,235583,57787,,0,0,0,PDN
SA007,,1993,1984,,15868,235583,57787,,15868,235583,57787,,0,0,0,PDN
SA007,,1994,1984,,15868,235583,57787,,15868,235583,57787,,0,0,0,PDN
SA007,,1995,1984,,15868,235583,57787,,15868,235583,57787,,0,0,0,PDN
SA007,,1996,1984,,15868,235583,57787,,15868,235583,57787,,0,0,0,PDN
SA007,,1997,1984,,15868,235583,57787,,15868,235583,57787,,0,0,0,PDN
SA007,,1998,1984,,15868,235583,57787,,15868,235583,57787,,0,0,0,PDN
SA007,,1999,1984,,15868,235583,57787,,15868,235583,57787,,0,0,0,PDN
SA007,,2000,1984,,15868,235583,57787,,15868,235583,57787,,0,0,0,PDN
SA007,,2001,1984,,76437,6292414,1196084,,15868,235583,57787,,60569,6056831,1138297,PDN
SA007,,2002,1984,,76437,6292414,1196084,,15868,235583,57787,,60569,6056831,1138297,PDN
SA007,,2003,1984,,73751,6722446,1269916,,53515,3725396,716397,,20236,2997050,553519,PDN
SA007,,2004,1984,,73751,6722446,1269916,,68202,6133664,1159601,,5549,588782,110315,PDN
SA007,,2005,1984,,81824,8868465,1659843,,79989,8247299,1547480,,1835,621166,112363,PDN
SA007,,2006,1984,,81824,8868465,1659843,,81824,8868465,1659843,,0,0,0,PDN
SA007,,2007,1984,,81824,8868465,1659843,,81824,8868465,1659843,,0,0,0,PDN
SA007,,2008,1984,,81824,8868465,1659843,,81824,8868465,1659843,,0,0,0,PDN
SA007,,2009,1984,,81824,8873184,1660682,,81824,8873184,1660682,,0,0,0,PDN
SA007,,2010,1984,,81824,8873184,1660682,,81824,8873184,1660682,,0,0,0,PDN
SA007,,2011,1984,,81824,8873184,1660682,,81824,8873184,1660682,,0,0,0,PDN
SA007,,2012,1984,,81824,8873184,1660682,,81824,8873184,1660682,,0,0,0,PDN
SA007,,2013,1984,,81824,8873184,1660682,,81824,8873184,1660682,,0,0,0,PDN
SA007,,2014,1984,,81824,8873184,1660682,,81824,8873184,1660682,,0,0,0,PDN
SA007,,2015,1984,,81824,8873184,1660682,,81824,8873184,1660682,,0,0,0,PDN
SA007,,2016,1984,,81824,8873184,1660682,,81824,8873184,1660682,,0,0,0,PDN
SA007,,2017,1984,,81824,8873184,1660682,,81824,8873184,1660682,,0,0,0,PDN
SA007,,2017,1984,,81824,8873184,1660682,,81824,8873184,1660682,,0,0,0,PDN
SA010,,1982,1979,,2098984,145893666,28058711,,537,34657,6704,,2098447,145859009,28052007,PDN
SA010,,1983,1979,,2098984,145893666,28058711,,816,159199,29143,,2098168,145734467,28029568,PDN
SA010,,1984,1979,,2098984,145893666,28058711,,40282,2585157,500274,,2058702,143308509,27558437,PDN
SA010,,1985,1979,,2098984,145893666,28058711,,217110,17979919,3416384,,1881874,127913747,24642327,PDN
SA010,,1986,1979,,2098984,145893682,28058714,,524537,33047874,6404942,,1574447,112845808,21653772,PDN
SA010,,1987,1979,,2216346,145893682,28176076,,741772,48417192,9356931,,1474574,97476490,18819145,PDN
SA010,,1988,1979,,2216346,145893682,28176076,,938317,62491568,12057813,,1278029,83402114,16118263,PDN
SA010,,1989,1979,,2257890,155323561,29895534,,1123685,77150379,14851510,,1134205,78173182,15044024,PDN
SA010,,1990,1979,,2257890,155323561,29895534,,1276864,88151504,16962185,,981026,67172057,12933349,PDN
SA010,,1991,1979,,2629404,165633424,32101544,,1433344,98654231,18987478,,1196060,66979193,13114066,PDN
SA010,,1992,1979,,2632639,165633424,32104779,,1540591,106849227,20552909,,1092048,58784197,11551870,PDN
SA010,,1993,1979,,2642998,169206629,32750939,,1648747,114286983,21984509,,994251,54919646,10766430,PDN
SA010,,1994,1979,,2646181,170588075,32999931,,1746984,120817258,23244717,,899197,49770817,9755214,PDN
SA010,,1995,1979,,2458068,168140232,32376259,,1826462,126851515,24397906,,631606,41288717,7978353,PDN
SA010,,1996,1979,,3700256,271742830,52053073,,2071357,149545471,28680871,,1628899,122197359,23372202,PDN
SA010,,1997,1979,,4024909,279859147,53821910,,2220300,163389323,31293133,,1804609,116469824,22528777,PDN
SA010,,1998,1979,,4340869,338796332,64624914,,2320809,173365242,33168717,,2020060,165431090,31456197,PDN
SA010,,1999,1979,,4068275,333192166,63355137,,2388417,181205050,34631308,,1679858,151987116,28723829,PDN
SA010,,2000,1979,,2744813,220890346,42049145,,2443712,187210298,35755153,,301101,33680048,6293992,PDN
SA010,,2001,1979,,3291757,245196093,46920955,,2553710,192985238,36892720,,738047,52210855,10028235,PDN
SA010,,2002,1979,,3288982,244909098,46867113,,2635673,198910496,38029000,,653309,45998602,8838113,PDN
SA010,,2003,1979,,3339344,255536698,48808507,,2714931,207556560,39646703,,624413,47980138,9161804,PDN
SA010,,2004,1979,,3341375,255845770,48865533,,2744082,212916469,40629575,,597293,42929301,8235958,PDN
SA010,,2005,1979,,3192460,239515853,45810939,,2779602,216435047,41291176,,412858,23080806,4519763,PDN
SA010,,2006,1979,,3275709,243648112,46629466,,2849754,220806386,42139147,,425955,22841726,4490319,PDN
SA010,,2007,1979,,3336426,240725649,46170171,,2888255,223790196,42708575,,448171,16935453,3461596,PDN
SA010,,2008,1979,,3264224,236521902,45349972,,2899322,225238280,42977308,,364902,11283622,2372664,PDN
SA010,,2009,1979,,3043177,235299046,44911334,,2911156,229981581,43833145,,132021,5317465,1078189,PDN
SA010,,2010,1979,,3043177,235299046,44911334,,2926030,231007721,44030607,,117147,4291325,880728,PDN
SA010,,2011,1979,,3004088,237415703,45248875,,2940586,231881263,44200597,,63502,5534440,1048278,PDN
SA010,,2012,1979,,3004088,237415703,45248875,,2949397,232808619,44374418,,54691,4607084,874457,PDN
SA010,,2013,1979,,3004088,237415703,45248875,,2954796,233432933,44490905,,49292,3982770,757970,PDN
SA010,,2014,1979,,3004088,237415703,45248875,,2960697,234088447,44613445,,43391,3327256,635429,PDN
SA010,,2015,1979,,3004088,237415703,45248875,,2969077,234839503,44755465,,35011,2576200,493410,PDN
SA010,,2016,1979,,3004088,237415703,45248875,,2975032,235340899,44850637,,29056,2074804,398238,PDN
SA010,,2017,1979,,2975032,235340899,44850637,,2975032,235340899,44850637,,0,0,0,PDN
SA010,,2017,1979,,2975032,235340899,44850637,,2975032,235340899,44850637,,0,0,0,PDN
SA011,,1981,1980,,84000,84000000,15030619,,0,0,0,,84000,84000000,15030619,PDN
SA011,,1982,1980,,106891,53833628,9685828,,8263,216431,46774,,98628,53617197,9639054,PDN
SA011,,1983,1980,,142021,42140541,7640338,,47687,3053239,590968,,94334,39087302,7049370,PDN
SA011,,1984,1980,,142021,42140541,7640338,,61630,4626115,884782,,80391,37514426,6755556,PDN
SA011,,1985,1980,,155645,42745106,7761536,,67364,5947474,1125633,,88281,36797632,6635903,PDN
SA011,,1986,1980,,155645,42745106,7761536,,74631,6990417,1318477,,81014,35754689,6443059,PDN
SA011,,1987,1980,,155645,42745106,7761536,,76999,7417052,1396759,,78646,35328054,6364777,PDN
SA011,,1988,1980,,155645,42745106,7761536,,77811,7558882,1422808,,77834,35186224,6338728,PDN
SA011,,1989,1980,,257044,46839499,8591474,,79087,7661033,1442260,,177957,39178466,7149214,PDN
SA011,,1990,1980,,87318,7984413,1508032,,87318,7984413,1508032,,0,0,0,PDN
SA011,,1991,1980,,87318,7984413,1508032,,87318,7984413,1508032,,0,0,0,PDN
SA011,,1992,1980,,87318,7984413,1508032,,87318,7984413,1508032,,0,0,0,PDN
SA011,,1993,1980,,87318,7984413,1508032,,87318,7984413,1508032,,0,0,0,PDN
SA011,,1994,1980,,87318,7984413,1508032,,87318,7984413,1508032,,0,0,0,PDN
SA011,,1995,1980,,87318,7984413,1508032,,87318,7984413,1508032,,0,0,0,PDN
SA011,,1996,1980,,87318,7984413,1508032,,87318,7984413,1508032,,0,0,0,PDN
SA011,,1997,1980,,87318,7984413,1508032,,87318,7984413,1508032,,0,0,0,PDN
SA011,,1998,1980,,87318,7984413,1508032,,87318,7984413,1508032,,0,0,0,PDN
SA011,,1999,1980,,87318,7984413,1508032,,87318,7984413,1508032,,0,0,0,PDN
SA011,,2000,1980,,104043,16346799,3012726,,87318,7984413,1508032,,16725,8362386,1504694,PDN
SA011,,2001,1980,,87318,7984413,1508032,,87318,7984413,1508032,,0,0,0,PDN
SA011,,2002,1980,,87318,7984413,1508032,,87318,7984413,1508032,,0,0,0,PDN
SA011,,2003,1980,,87318,7984413,1508032,,87318,7984413,1508032,,0,0,0,PDN
SA011,,2004,1980,,87318,7984413,1508032,,87318,7984413,1508032,,0,0,0,PDN
SA011,,2005,1980,,87318,7984413,1508032,,87318,7984413,1508032,,0,0,0,PDN
SA011,,2006,1980,,87318,7984413,1508032,,87318,7984413,1508032,,0,0,0,PDN
SA011,,2007,1980,,156510,10987816,2111637,,90911,8086497,1529789,,65599,2901319,581848,PDN
SA011,,2008,1980,,156510,10987816,2111637,,154460,10809130,2077793,,2050,178686,33844,PDN
SA011,,2009,1980,,155133,11087976,2128081,,155133,11087976,2128081,,0,0,0,PDN
SA011,,2010,1980,,155133,11087976,2128081,,155133,11087976,2128081,,0,0,0,PDN
SA011,,2011,1980,,155133,11087976,2128081,,155133,11087976,2128081,,0,0,0,PDN
SA011,,2012,1980,,155133,11087976,2128081,,155133,11087976,2128081,,0,0,0,PDN
SA011,,2013,1980,,155133,11087976,2128081,,155133,11087976,2128081,,0,0,0,PDN
SA011,,2014,1980,,155133,11087976,2128081,,155133,11087976,2128081,,0,0,0,PDN
SA011,,2015,1980,,155133,11087976,2128081,,155133,11087976,2128081,,0,0,0,PDN
SA011,,2016,1980,,155133,11087976,2128081,,155133,11087976,2128081,,0,0,0,PDN
SA011,,2017,1980,,155133,11087976,2128081,,155133,11087976,2128081,,0,0,0,PDN
SA011,,2017,1980,,155133,11087976,2128081,,155133,11087976,2128081,,0,0,0,PDN
SA013,,1981,1979,,300000,30000000,5638078,,149245,1110003,346754,,150755,28889997,5291324,PDP
SA013,,1982,1979,,1267017,30000000,6605095,,428688,4154728,1167963,,838329,25845272,5437132,PDP
SA013,,1983,1979,,5047809,34684650,11219455,,794447,7194158,2074546,,4253362,27490492,9144909,PDP
SA013,,1984,1979,,5436367,39280551,12425789,,1139558,10571223,3020559,,4296809,28709328,9405230,PDP
SA013,,1985,1979,,2931065,23658457,7140755,,1367510,12158572,3530957,,1563555,11499885,3609798,PDP
SA013,,1986,1979,,3770286,26047497,8405072,,1750794,13511765,4155023,,2019492,12535732,4250049,PDP
SA013,,1987,1979,,3770286,26047497,8405072,,1977873,14013676,4471410,,1792413,12033821,3933662,PDP
SA013,,1988,1979,,3809361,33901658,9841684,,2144552,14971572,4808533,,1664809,18930086,5033151,PDP
SA013,,1989,1979,,3253540,29380298,8481351,,2260780,15226774,4970170,,992760,14153524,3511181,PDP
SA013,,1990,1979,,3253540,29380298,8481351,,2405602,15334888,5134230,,847938,14045410,3347121,PDP
SA013,,1991,1979,,3253540,29380298,8481351,,2553951,15524988,5316404,,699589,13855310,3164947,PDP
SA013,,1992,1979,,3203033,28819581,8331072,,2688129,15678715,5477936,,514904,13140866,2853136,PDP
SA013,,1993,1979,,3171225,16328357,6076627,,2835030,15828677,5651521,,336195,499680,425106,PDP
SA013,,1994,1979,,3171225,16328356,6076626,,2958347,15964614,5799026,,212878,363742,277600,PDP
SA013,,1995,1979,,3171225,16328356,6076626,,3086744,16136205,5957955,,84481,192151,118671,PDP
SA013,,1996,1979,,5199369,33839319,11220600,,3234357,16367532,6146729,,1965012,17471787,5073871,PDP
SA013,,1997,1979,,6463591,36506067,12959332,,3452713,16837271,6448669,,3010878,19668796,6510663,PDP
SA013,,1998,1979,,6424715,36270615,12878561,,3618777,17656384,6760482,,2805938,18614231,6118079,PDP
SA013,,1999,1979,,4987961,23062203,9091556,,3781802,18297203,7037532,,1206159,4765000,2054024,PDP
SA013,,2000,1979,,4983200,22093240,8914381,,3937589,18690176,7263243,,1045611,3403064,1651138,PDP
SA013,,2001,1979,,4904622,19910983,8447502,,4164144,18879397,7523467,,740478,1031586,924035,PDP
SA013,,2002,1979,,4904622,19910983,8447502,,4362955,19071855,7756524,,541667,839128,690978,PDP
SA013,,2003,1979,,4904622,19910983,8447502,,4536313,19210448,7954542,,368309,700535,492960,PDP
SA013,,2004,1979,,4904622,19910983,8447502,,4700723,19348367,8143493,,203899,562616,304009,PDP
SA013,,2005,1979,,4910594,20376448,8536296,,4816487,19466644,8280303,,94107,909804,255993,PDP
SA013,,2006,1979,,5381684,21160428,9146885,,4935912,19581053,8420085,,445772,1579375,726800,PDP
SA013,,2007,1979,,5137574,20236473,8738370,,5026937,19659891,8525138,,110637,576582,213232,PDP
SA013,,2008,1979,,6229330,24008127,10501239,,5092214,19743826,8605350,,1137116,4264301,1895889,PDP
SA013,,2009,1979,,6287697,22784388,10341858,,5244365,21526825,9074761,,1043332,1257563,1267098,PDP
SA013,,2010,1979,,6287779,22799483,10344626,,5449013,21946056,9354005,,838766,853427,990621,PDP
SA013,,2011,1979,,6301599,22865200,10370139,,5604542,22111044,9538891,,697057,754156,831248,PDP
SA013,,2012,1979,,6301599,22865200,10370139,,5731415,22233900,9687625,,570184,631300,682514,PDP
SA013,,2013,1979,,6301599,22865200,10370139,,5796197,22285241,9761543,,505402,579959,608597,PDP
SA013,,2014,1979,,6154986,22632681,10182153,,5886813,22354526,9864487,,268173,278155,317667,PDP
SA013,,2015,1979,,6282472,22765025,10333188,,6001564,22458272,9997699,,280908,306753,335491,PDP
SA013,,2016,1979,,6283187,23578467,10478643,,6085551,22675714,10120377,,197636,902753,358268,PDP
SA013,,2017,1979,,6286253,24073430,10569782,,6133678,23182257,10258636,,152575,891173,311147,PDP
SA013,,2017,1979,,6286253,24073430,10569782,,6133678,23182257,10258636,,152575,891173,311147,PDP
SA017,,1980,1980,,22400,22400000,4008165,,0,0,0,,22400,22400000,4008165,PDN
SA017,,1981,1980,,250000,28000000,5232206,,102397,13462627,2497882,,147603,14537373,2734324,PDN
SA017,,1982,1980,,2580430,378865526,69994225,,339469,61871926,11348709,,2240961,316993600,58645516,PDN
SA017,,1983,1980,,2772926,428982504,79104332,,542010,113010290,20650603,,2230916,315972214,58453729,PDN
SA017,,1984,1980,,2854198,445958810,82206299,,680983,151437110,27627088,,2173215,294521700,54579211,PDN
SA017,,1985,1980,,2862478,478181830,87948213,,784341,184024546,33528922,,2078137,294157284,54419291,PDN
SA017,,1986,1980,,2511741,470121245,86163208,,837302,202735661,36911263,,1674439,267385584,49251945,PDN
SA017,,1987,1980,,1165372,328676196,59648681,,882855,222982029,40559373,,282517,105694167,19089308,PDN
SA017,,1988,1980,,1194957,333557685,60546858,,911953,234260013,42595229,,283004,99297672,17951629,PDN
SA017,,1989,1980,,1200180,330347172,59980816,,955277,240171740,43690462,,244903,90175432,16290354,PDN
SA017,,1990,1980,,1223777,334759682,60789557,,968511,243897411,44366627,,255266,90862271,16422930,PDN
SA017,,1991,1980,,1208156,324783492,58998813,,979455,246959361,44922402,,228701,77824131,14076411,PDN
SA017,,1992,1980,,1398866,275567059,50432151,,1046130,248364244,45239056,,352736,27202815,5193095,PDN
SA017,,1993,1980,,1388958,275760804,50456717,,1085879,249522559,45484911,,303079,26238245,4971806,PDN
SA017,,1994,1980,,1454518,279428606,51174911,,1098562,251704693,45885874,,355956,27723913,5289037,PDN
SA017,,1995,1980,,1455339,281929704,51620767,,1102057,252601517,46048946,,353282,29328187,5571821,PDN
SA017,,1996,1980,,1281690,277062144,50581004,,1103979,252970355,46116498,,177711,24091789,4464506,PDN
SA017,,1997,1980,,1727382,288204454,53009313,,1107611,254328074,46361717,,619771,33876380,6647596,PDN
SA017,,1998,1980,,1727382,288204454,53009313,,1111903,256493599,46751333,,615479,31710855,6257980,PDN
SA017,,1999,1980,,1727382,288204454,53009313,,1114349,258430191,47098369,,613033,29774263,5910944,PDN
SA017,,2000,1980,,1852025,356905488,65358340,,1122345,261251928,47608453,,729680,95653560,17749887,PDN
SA017,,2001,1980,,1435447,358713188,65263416,,1130210,263264574,47974440,,305237,95448614,17288976,PDN
SA017,,2002,1980,,1446902,359145996,65351883,,1136898,265065632,48301601,,310004,94080364,17050282,PDN
SA017,,2003,1980,,1446902,359145996,65351883,,1138411,265912270,48453762,,308491,93233726,16898121,PDN
SA017,,2004,1980,,1303969,345424473,62767399,,1139996,266330356,48529739,,163973,79094117,14237660,PDN
SA017,,2005,1980,,1411790,354294512,64453518,,1141326,266551705,48570455,,270464,87742807,15883063,PDN
SA017,,2006,1980,,1413638,354474588,64487408,,1147658,267180839,48688733,,265980,87293749,15798675,PDN
SA017,,2007,1980,,1330603,349331880,63489300,,1167891,271539232,49484480,,162712,77792648,14004820,PDN
SA017,,2008,1980,,1197735,274995969,50129402,,1180792,272285201,49630116,,16943,2710768,499286,PDN
SA017,,2009,1980,,1197789,280144725,51045608,,1185008,278171536,50681725,,12781,1973189,363882,PDN
SA017,,2010,1980,,1197789,280144725,51045608,,1189574,278487630,50742536,,8215,1657095,303071,PDN
SA017,,2011,1980,,1191893,278793129,50799215,,1191880,278759217,50793167,,13,33912,6047,PDN
SA017,,2012,1980,,1191893,278793129,50799215,,1191893,278789753,50798614,,0,3376,601,PDN
SA017,,2013,1980,,1191893,278793129,50799215,,1191893,278793129,50799215,,0,0,0,PDN
SA017,,2014,1980,,1191893,278793129,50799215,,1191893,278793129,50799215,,0,0,0,PDN
SA017,,2015,1980,,1191893,278793129,50799215,,1191893,278793129,50799215,,0,0,0,PDN
SA017,,2016,1980,,1191893,278793129,50799215,,1191893,278793129,50799215,,0,0,0,PDN
SA017,,2017,1980,,1191893,278793129,50799215,,1191893,278793129,50799215,,0,0,0,PDN
SA017,,2017,1980,,1191893,278793129,50799215,,1191893,278793129,50799215,,0,0,0,PDN
SM006,,1975,1962,,36000000,199980000,71583630,,25521201,122021927,47233288,,10478799,77958073,24350342,PDP
SM006,,1976,1962,,30000000,159990000,58467972,,26561401,130995818,49870265,,3438599,28994182,8597707,PDP
SM006,,1977,1962,,30000000,159990000,58467972,,27358865,138024029,51918301,,2641135,21965971,6549671,PDP
SM006,,1978,1962,,31007881,154283126,58460395,,26231447,130248989,49407424,,4776434,24034137,9052971,PDP
SM006,,1979,1962,,31221361,155245328,58845085,,26760068,134331495,50662469,,4461293,20913833,8182616,PDP
SM006,,1980,1962,,31590661,159766788,60018915,,27277281,138729217,51962195,,4313380,21037571,8056720,PDP
SM006,,1981,1962,,32508248,166216844,62084199,,28828723,151282267,55747276,,3679525,14934577,6336923,PDP
SM006,,1982,1962,,33360343,174965324,64492963,,29489197,156788770,57387555,,3871146,18176554,7105408,PDP
SM006,,1983,1962,,38748385,193681465,73211279,,30312413,161351412,59022629,,8435972,32330053,14188650,PDP
SM006,,1984,1962,,39445925,197167944,74529189,,30838078,165712677,60324319,,8607847,31455267,14204870,PDP
SM006,,1985,1962,,35111435,187132664,68409062,,31616999,169122337,61709942,,3494436,18010327,6699120,PDP
SM006,,1986,1962,,35026433,187855534,68452685,,32209474,171731954,62766761,,2816959,16123580,5685924,PDP
SM006,,1987,1962,,35640888,194035429,70166765,,32755502,174746145,63849122,,2885386,19289284,6317643,PDP
SM006,,1988,1962,,35432948,189254659,69108154,,33344923,178256183,65063105,,2088025,10998476,4045049,PDP
SM006,,1989,1962,,36749077,203243214,72913350,,33934052,180378721,66029910,,2815025,22864493,6883440,PDP
SM006,,1990,1962,,36963084,205430253,73516510,,34541809,183801813,67246758,,2421275,21628440,6269752,PDP
SM006,,1991,1962,,37121667,209086907,74325743,,35155477,189456204,68866545,,1966190,19630703,5459198,PDP
SM006,,1992,1962,,37330133,211121308,74896202,,35651963,194741843,70303536,,1678170,16379465,4592666,PDP
SM006,,1993,1962,,38821206,218541629,77707617,,36214119,198186158,71478560,,2607087,20355471,6229057,PDP
SM006,,1994,1962,,38860968,218751737,77784765,,36562731,201374340,72394464,,2298237,17377397,5390301,PDP
SM006,,1995,1962,,38868576,222127739,78393085,,36869249,204943624,73336086,,1999327,17184115,5056999,PDP
SM006,,1996,1962,,40877323,237583146,83151904,,37225036,207929704,74223204,,3652287,29653442,8928700,PDP
SM006,,1997,1962,,39111102,246290528,82935039,,37925684,219801261,77036229,,1185418,26489267,5898810,PDP
SM006,,1998,1962,,38914709,240295265,81671874,,38246851,226862449,78613835,,667858,13432816,3058039,PDP
SM006,,1999,1962,,39222978,241709678,82231818,,38523616,230964114,79620433,,699362,10745564,2611385,PDP
SM006,,2000,1962,,40572459,243866125,83965008,,38811239,233425348,80345998,,1761220,10440777,3619010,PDP
SM006,,2001,1962,,40769459,257260246,86545303,,39084266,238062807,81444196,,1685193,19197439,5101107,PDP
SM006,,2002,1962,,40857811,259757893,87078076,,39444311,242087429,82520366,,1413500,17670464,4557710,PDP
SM006,,2003,1962,,40729659,252772654,85706999,,39614942,244563073,83131503,,1114717,8209581,2575496,PDP
SM006,,2004,1962,,40177204,249661721,84600998,,39750668,246272906,83571470,,426536,3388815,1029528,PDP
SM006,,2005,1962,,40162622,249465163,84551441,,39821699,247399392,83842943,,340923,2065771,708498,PDP
SM006,,2006,1962,,40222232,251609119,84992538,,39821938,247678373,83892823,,400294,3930746,1099715,PDP
SM006,,2007,1962,,40222232,251609119,84992538,,39833536,248175865,83992943,,388696,3433254,999595,PDP
SM006,,2008,1962,,40254985,251824617,85063636,,37347126,228355094,77979705,,2907859,23469523,7083931,PDP
SM006,,2009,1962,,39938734,239643104,82579856,,39617232,238776168,82104095,,321502,866936,475761,PDP
SM006,,2010,1962,,40165806,254352417,85424243,,39909016,253286746,84977832,,256790,1065671,446411,PDP
SM006,,2011,1962,,40461312,256426454,86088795,,39909016,253286746,84977832,,552296,3139708,1110963,PDP
SM006,,2012,1962,,40461312,256426454,86088795,,39974022,253808892,85135747,,487290,2617562,953048,PDP
SM006,,2013,1962,,40461312,256426454,86088795,,40101018,254200467,85332418,,360294,2225987,756377,PDP
SM006,,2014,1962,,40465444,257397094,86265637,,40200573,254507870,85486668,,264871,2889224,778967,PDP
SM006,,2015,1962,,40501562,261008848,86944416,,40274064,255198809,85683102,,227498,5810039,1261313,PDP
SM006,,2016,1962,,40668517,262539213,87383679,,40350267,255566481,85824727,,318250,6972732,1558949,PDP
SM006,,2017,1962,,40663028,262618118,87392227,,40444662,256241720,86039271,,218366,6376398,1352957,PDP
SM006,,2017,1962,,40663028,262618118,87392227,,40444662,256241720,86039271,,218366,6376398,1352957,PDP
SM009,,1975,1965,,4000000,25000000,8448399,,135746,1646980,428803,,3864254,23353020,8019596,PDP
SM009,,1976,1965,,2000000,25000000,6448399,,220304,2820533,722178,,1779696,22179467,5726221,PDP
SM009,,1977,1965,,2000000,25000000,6448399,,323386,5056655,1223147,,1676614,19943345,5225252,PDP
SM009,,1978,1965,,1121867,18039050,4331662,,529975,8451020,2033715,,591892,9588030,2297947,PDP
SM009,,1979,1965,,1620116,33113971,7512282,,748752,12972900,3057097,,871364,20141071,4455185,PDP
SM009,,1980,1965,,8875178,62195718,19942032,,961255,18523549,4257260,,7913923,43672169,15684772,PDP
SM009,,1981,1965,,8875178,62195718,19942032,,1112119,22128098,5049503,,7763059,40067620,14892529,PDP
SM009,,1982,1965,,8893834,75681898,22360364,,1259964,26641030,6000361,,7633870,49040868,16360003,PDP
SM009,,1983,1965,,10436417,117782546,31394165,,1370500,30809473,6852613,,9065917,86973073,24541552,PDP
SM009,,1984,1965,,13263497,127974422,36034746,,1461270,35043244,7696723,,11802227,92931178,28338023,PDP
SM009,,1985,1965,,10754120,85607033,25986688,,2384024,39828892,9471015,,8370096,45778141,16515673,PDP
SM009,,1986,1965,,11190944,98435809,28706213,,3623106,44743997,11584671,,7567838,53691812,17121542,PDP
SM009,,1987,1965,,10888242,97032639,28153836,,4539772,49224255,13298536,,6348470,47808384,14855300,PDP
SM009,,1988,1965,,10994908,97554335,28353331,,5328365,52655474,14697666,,5666543,44898861,13655665,PDP
SM009,,1989,1965,,11456518,97789784,28856835,,5851916,54948132,15629164,,5604602,42841652,13227671,PDP
SM009,,1990,1965,,10152362,81053810,24574748,,6459051,57397657,16672157,,3693311,23656153,7902591,PDP
SM009,,1991,1965,,10091408,79485250,24234691,,6960825,59521303,17551804,,3130583,19963947,6682887,PDP
SM009,,1992,1965,,10758119,83136956,25551172,,7519039,62064720,18562583,,3239080,21072236,6988589,PDP
SM009,,1993,1965,,14469679,135630339,38603191,,8913511,78130668,22815765,,5556168,57499671,15787426,PDP
SM009,,1994,1965,,14418533,135548951,38537563,,10308600,96724885,27519434,,4109933,38824066,11018129,PDP
SM009,,1995,1965,,13967249,136965197,38338280,,11589481,114994993,32051224,,2377768,21970204,6287056,PDP
SM009,,1996,1965,,16974673,181901144,49341425,,13000287,134419255,36918304,,3974386,47481889,12423121,PDP
SM009,,1997,1965,,15682174,180159133,47738959,,13884057,144214999,39545089,,1798117,35944134,8193870,PDP
SM009,,1998,1965,,15998135,181318303,48261178,,14530454,155559678,42210112,,1467681,25758625,6051066,PDP
SM009,,1999,1965,,15830828,175827560,47116871,,14937003,160471381,43490630,,893825,15356179,3626241,PDP
SM009,,2000,1965,,18818909,229719829,59694323,,15469266,169518385,45632680,,3349643,60201444,14061643,PDP
SM009,,2001,1965,,19391586,251737147,64184672,,16110477,182151507,48521777,,3281109,69585640,15662895,PDP
SM009,,2002,1965,,19157263,251318010,63875770,,16785191,197768443,51975305,,2372072,53549567,11900465,PDP
SM009,,2003,1965,,19611633,261897587,66212628,,17336866,212261999,55105905,,2274767,49635588,11106723,PDP
SM009,,2004,1965,,18708558,246557282,62579960,,17723704,220532790,56964414,,984854,26024492,5615546,PDP
SM009,,2005,1965,,21315917,262889941,68093487,,17846667,222942845,57516212,,3469250,39947096,10577275,PDP
SM009,,2006,1965,,23015565,293796659,75292551,,18590035,231195916,59728098,,4425530,62600743,15564453,PDP
SM009,,2007,1965,,23015818,293796941,75292854,,19478833,243767940,62853911,,3536985,50029001,12438943,PDP
SM009,,2008,1965,,22112523,283063605,72479713,,19902002,250711917,64512663,,2210521,32351688,7967050,PDP
SM009,,2009,1965,,22153049,285679776,72985754,,20278472,258595404,66291894,,1874577,27084372,6693860,PDP
SM009,,2010,1965,,22153049,285679776,72985754,,20413111,260675880,66796723,,1739938,25003896,6189030,PDP
SM009,,2011,1965,,21506750,268427653,69269682,,20417032,260692638,66803626,,1089718,7735015,2466055,PDP
SM009,,2012,1965,,21517897,268350038,69267018,,20636531,262310885,67311071,,881366,6039153,1955949,PDP
SM009,,2013,1965,,21517897,268350038,69267018,,20811795,263456569,67690193,,706102,4893469,1576826,PDP
SM009,,2014,1965,,21517897,268350038,69267018,,20912984,263983599,67885160,,604913,4366439,1381859,PDP
SM009,,2015,1965,,21517897,268350038,69267018,,20971694,264322280,68004133,,546203,4027758,1262886,PDP
SM009,,2016,1965,,21546978,268848067,69384717,,21008518,264660563,68101150,,538460,4187504,1283567,PDP
SM009,,2017,1965,,21546978,268848067,69384717,,21056840,265011610,68211936,,490138,3836457,1172782,PDP
SM009,,2017,1965,,21546978,268848067,69384717,,21056840,265011610,68211936,,490138,3836457,1172782,PDP
SM016,,1975,1966,,1090909,36000000,7496603,,312090,9808060,2057296,,778819,26191940,5439307,PDN
SM016,,1976,1966,,1000000,20000000,4558719,,331683,10348899,2173124,,668317,9651101,2385595,PDN
SM016,,1977,1966,,1487917,20017225,5049701,,390349,9731785,2121983,,1097568,10285440,2927718,PDN
SM016,,1978,1966,,1610661,21353225,5410167,,440527,9816282,2187196,,1170134,11536943,3222971,PDN
SM016,,1979,1966,,1290661,21353225,5090167,,298310,9887976,2057736,,992351,11465249,3032431,PDN
SM016,,1980,1966,,1601704,21381319,5406209,,619559,11302624,2630702,,982145,10078695,2775507,PDN
SM016,,1981,1966,,2031264,19908819,5573758,,743097,11394068,2770511,,1288167,8514751,2803247,PDN
SM016,,1982,1966,,2031264,19908819,5573758,,838258,11520471,2888164,,1193006,8388348,2685594,PDN
SM016,,1983,1966,,2031264,19908819,5573758,,888849,11596399,2952265,,1142415,8312420,2621493,PDN
SM016,,1984,1966,,3239323,23532996,7426689,,600266,11668269,2676470,,2639057,11864727,4750219,PDN
SM016,,1985,1966,,3273804,26607864,8008299,,639596,11949144,2765778,,2634208,14658720,5242521,PDN
SM016,,1986,1966,,1305495,17380440,4398100,,661095,12388684,2865487,,644400,4991756,1532613,PDN
SM016,,1987,1966,,1320032,17433687,4422112,,680747,12750994,2949607,,639285,4682693,1472505,PDN
SM016,,1988,1966,,1481187,17816762,4651429,,713064,13064302,3037673,,768123,4752460,1613756,PDN
SM016,,1989,1966,,1420529,15293503,4141793,,734509,13270620,3095829,,686020,2022883,1045964,PDN
SM016,,1990,1966,,1420529,15293503,4141793,,833237,13506783,3236579,,587292,1786720,905214,PDN
SM016,,1991,1966,,1806050,14481170,4382771,,943604,13711526,3383377,,862446,769644,999394,PDN
SM016,,1992,1966,,1806050,14481170,4382771,,1108850,13877418,3578141,,697200,603752,804630,PDN
SM016,,1993,1966,,1806050,14481170,4382771,,1220022,14016737,3714103,,586028,464433,668668,PDN
SM016,,1994,1966,,1809656,14477916,4385798,,1301777,14123356,3814830,,507879,354560,570968,PDN
SM016,,1995,1966,,1575003,14381778,4134038,,1357734,14177420,3880407,,217269,204358,253631,PDN
SM016,,1996,1966,,1648736,14420163,4214601,,1446452,14235661,3979488,,202284,184502,235113,PDN
SM016,,1997,1966,,2181430,14681697,4793832,,1624798,14321978,4173193,,556632,359719,620639,PDN
SM016,,1998,1966,,2181430,14681697,4793832,,1773484,14438652,4342639,,407946,243045,451193,PDN
SM016,,1999,1966,,2434102,15101106,5121131,,1860154,14505800,4441257,,573948,595306,679874,PDN
SM016,,2000,1966,,2681361,21353967,6480999,,1910074,14545216,4498191,,771287,6808751,1982808,PDN
SM016,,2001,1966,,2700117,21407891,6509350,,1980334,14614171,4580720,,719783,6793720,1928630,PDN
SM016,,2002,1966,,2694510,21508106,6521575,,2006831,14667706,4616743,,687679,6840400,1904832,PDN
SM016,,2003,1966,,2715501,22772030,6767463,,2026054,15021943,4698998,,689447,7750087,2068465,PDN
SM016,,2004,1966,,2627540,22863599,6695796,,2068455,15726026,4866680,,559085,7137573,1829116,PDN
SM016,,2005,1966,,2623892,22060248,6549203,,2084152,15872202,4908387,,539740,6188046,1640816,PDN
SM016,,2006,1966,,2700911,29015961,7863894,,2093069,16413519,5013624,,607842,12602442,2850270,PDN
SM016,,2007,1966,,2701412,29016490,7864489,,2116520,17645000,5256200,,584892,11371490,2608289,PDN
SM016,,2008,1966,,2664635,26316020,7347201,,2124067,18277050,5376211,,540568,8038970,1970990,PDN
SM016,,2009,1966,,2153073,20570576,5813319,,2127619,18988771,5506405,,25454,1581805,306914,PDN
SM016,,2010,1966,,2153046,20586867,5816190,,2134455,19374898,5581947,,18591,1211969,234244,PDN
SM016,,2011,1966,,2153046,20586867,5816190,,2142215,19793901,5664262,,10831,792966,151928,PDN
SM016,,2012,1966,,2153046,20586867,5816190,,2143652,19819776,5670303,,9394,767091,145887,PDN
SM016,,2013,1966,,2153046,20586867,5816190,,2143725,19857539,5677096,,9321,729328,139095,PDN
SM016,,2014,1966,,2153046,20586867,5816190,,2143725,19893842,5683555,,9321,693025,132635,PDN
SM016,,2015,1966,,2153046,20586867,5816190,,2143725,19904042,5685370,,9321,682825,130820,PDN
SM016,,2016,1966,,2143725,19905977,5685715,,2143725,19905977,5685715,,0,0,0,PDN
SM016,,2017,1966,,2143725,19905977,5685715,,2143725,19905977,5685715,,0,0,0,PDN
SM016,,2017,1966,,2143725,19905977,5685715,,2143725,19905977,5685715,,0,0,0,PDN
SM017,,1996,1996,,96093,6264165,1210713,,1470,67277,13441,,94623,6196888,1197272,PDN
SM017,,1997,1996,,134420,10161068,1942439,,38551,2506496,484547,,95869,7654572,1457892,PDN
SM017,,1998,1996,,101760,8280517,1575162,,40069,2952561,565436,,61691,5327956,1009726,PDN
SM017,,1999,1996,,40505,11008211,1999261,,40204,4829677,899577,,301,6178534,1099684,PDN
SM017,,2000,1996,,40608,8631469,1576457,,40505,7222856,1325711,,103,1408613,250746,PDN
SM017,,2001,1996,,40819,12032036,2181751,,40589,8515675,1555834,,230,3516361,625917,PDN
SM017,,2002,1996,,40819,12032036,2181751,,40593,9416265,1716085,,226,2615771,465666,PDN
SM017,,2003,1996,,40819,12032036,2181751,,40597,10554203,1918569,,222,1477833,263182,PDN
SM017,,2004,1996,,40961,15199334,2745469,,40669,11454678,2078868,,292,3744656,666601,PDN
SM017,,2005,1996,,40961,15199334,2745469,,40722,12027846,2180908,,239,3171488,564561,PDN
SM017,,2006,1996,,40841,15199334,2745349,,40763,12623247,2286892,,78,2576087,458457,PDN
SM017,,2007,1996,,40841,15199334,2745349,,40776,13179370,2385860,,65,2019964,359489,PDN
SM017,,2008,1996,,40871,16337347,2947872,,40794,13723988,2482785,,77,2613359,465087,PDN
SM017,,2009,1996,,40809,14240626,2574728,,40808,14174300,2562926,,1,66326,11803,PDN
SM017,,2010,1996,,40809,14240626,2574728,,40809,14240626,2574728,,0,0,0,PDN
SM017,,2011,1996,,40809,14240626,2574728,,40809,14240626,2574728,,0,0,0,PDN
SM017,,2012,1996,,40809,14240626,2574728,,40809,14240626,2574728,,0,0,0,PDN
SM017,,2013,1996,,40809,14240626,2574728,,40809,14240626,2574728,,0,0,0,PDN
SM017,,2014,1996,,40809,14240626,2574728,,40809,14240626,2574728,,0,0,0,PDN
SM017,,2015,1996,,40809,14240626,2574728,,40809,14240626,2574728,,0,0,0,PDN
SM017,,2016,1996,,40809,14240626,2574728,,40809,14240626,2574728,,0,0,0,PDN
SM017,,2017,1996,,40809,14240626,2574728,,40809,14240626,2574728,,0,0,0,PDN
SM017,,2017,1996,,40809,14240626,2574728,,40809,14240626,2574728,,0,0,0,PDN
SM018,,1993,1989,,1028130,80832529,15411142,,98508,2137646,478872,,929622,78694883,14932270,PDP
SM018,,1994,1989,,1009671,81126429,15444979,,325465,5784678,1354767,,684206,75341751,14090212,PDP
SM018,,1995,1989,,1047196,83893569,15974877,,495000,6942578,1730334,,552196,76950991,14244543,PDP
SM018,,1996,1989,,1156332,83735705,16055924,,711532,10209315,2528136,,444800,73526390,13527788,PDP
SM018,,1997,1989,,1156332,84018228,16106195,,864072,12579637,3102442,,292260,71438591,13003753,PDP
SM018,,1998,1989,,1104344,92884312,17631802,,946269,13099638,3277165,,158075,79784674,14354637,PDP
SM018,,1999,1989,,1058540,16376810,3972563,,1001518,13419166,3389270,,57022,2957644,583293,PDP
SM018,,2000,1989,,1176257,15371808,3911454,,1049710,13722981,3491522,,126547,1648827,419932,PDP
SM018,,2001,1989,,1131845,14852216,3774588,,1091573,13857305,3557286,,40272,994911,217302,PDP
SM018,,2002,1989,,1151084,15368267,3885651,,1117599,13943250,3598604,,33485,1425017,287047,PDP
SM018,,2003,1989,,1187486,16850828,4185854,,1147259,14459875,3720190,,40227,2390953,465664,PDP
SM018,,2004,1989,,1172278,16732987,4149678,,1155846,14968920,3819355,,16432,1764067,330323,PDP
SM018,,2005,1989,,1303861,16836464,4299673,,1161188,15576631,3932831,,142673,1259833,366842,PDP
SM018,,2006,1989,,1591513,16497681,4527043,,1164311,15924957,3997933,,427202,572724,529110,PDP
SM018,,2007,1989,,1316913,16497357,4252386,,1227016,15993263,4072792,,89897,504094,179594,PDP
SM018,,2008,1989,,1316913,16488115,4250741,,1251484,16001730,4098767,,65429,486385,151974,PDP
SM018,,2009,1989,,1316913,16720521,4292094,,1265927,16292585,4164963,,50986,427936,127131,PDP
SM018,,2010,1989,,1316913,16720521,4292094,,1265927,16299830,4166252,,50986,420691,125842,PDP
SM018,,2011,1989,,1316913,16720521,4292094,,1265927,16299830,4166252,,50986,420691,125842,PDP
SM018,,2012,1989,,1316913,16720521,4292094,,1294346,16608053,4249515,,22567,112468,42579,PDP
SM018,,2013,1989,,1475086,25681650,6044774,,1326257,16840020,4322701,,148829,8841630,1722072,PDP
SM018,,2014,1989,,1475086,25681650,6044774,,1330780,16903535,4338526,,144306,8778115,1706248,PDP
SM018,,2015,1989,,1475086,25681650,6044774,,1331420,17002148,4356712,,143666,8679502,1688062,PDP
SM018,,2016,1989,,1475086,25681650,6044774,,1332325,17124509,4379390,,142761,8557141,1665384,PDP
SM018,,2017,1989,,1475086,25681650,6044774,,1332412,17199176,4392763,,142674,8482474,1652011,PDP
SM018,,2017,1989,,1475086,25681650,6044774,,1332412,17199176,4392763,,142674,8482474,1652011,PDP
SM023,,1975,1960,,30000000,885000000,187473310,,24172934,648482297,139561243,,5827066,236517703,47912067,PDN
SM023,,1976,1960,,30000000,885000000,187473310,,25051419,695113301,148737060,,4948581,189886699,38736250,PDN
SM023,,1977,1960,,39200897,996166171,216454664,,28627970,746578212,161471068,,10572927,249587959,54983596,PDN
SM023,,1978,1960,,40004174,1015104599,220627768,,29277539,780754942,168201906,,10726635,234349657,52425862,PDN
SM023,,1979,1960,,29403757,1040747739,214590187,,23067647,804243624,166171495,,6336110,236504115,48418692,PDN
SM023,,1980,1960,,29403757,1040747739,214590187,,23376420,819892080,169264690,,6027337,220855659,45325497,PDN
SM023,,1981,1960,,27467733,992559019,204079658,,23791373,843502603,173880804,,3676360,149056416,30198854,PDN
SM023,,1982,1960,,28190675,1011205791,208120531,,23945814,853311402,175780583,,4244861,157894389,32339948,PDN
SM023,,1983,1960,,28490329,1024096131,210713840,,24081666,860540853,177202814,,4408663,163555278,33511026,PDN
SM023,,1984,1960,,28559449,1027930123,211465165,,24284656,865845467,178349686,,4274793,162084656,33115479,PDN
SM023,,1985,1960,,28892357,1028243894,211853904,,24415346,868868530,179018287,,4477011,159375364,32835617,PDN
SM023,,1986,1960,,27823081,972336528,200836698,,24521306,871001354,179503753,,3301775,101335174,21332945,PDN
SM023,,1987,1960,,28153992,974688633,201586133,,24651667,874326005,180225689,,3502325,100362628,21360444,PDN
SM023,,1988,1960,,28121963,974603296,201538920,,24737165,876962502,180780315,,3384798,97640794,20758605,PDN
SM023,,1989,1960,,28198741,977174732,202073248,,24822766,879440798,181306894,,3375975,97733934,20766354,PDN
SM023,,1990,1960,,25698098,907211921,187123707,,24885094,881546228,181743853,,813004,25665693,5379854,PDN
SM023,,1991,1960,,26056350,916550678,189143659,,24984155,885181055,182489681,,1072195,31369623,6653978,PDN
SM023,,1992,1960,,26114369,920381572,189883332,,25222139,893289610,184170468,,892230,27091962,5712864,PDN
SM023,,1993,1960,,26795234,946119347,195143872,,25419334,901130487,185762837,,1375900,44988860,9381035,PDN
SM023,,1994,1960,,27432108,974497283,200830201,,25982890,929125588,191307728,,1449218,45371695,9522473,PDN
SM023,,1995,1960,,27955370,1046192346,214110592,,26302469,951355969,195582891,,1652901,94836377,18527701,PDN
SM023,,1996,1960,,28799658,1100827119,224676370,,26732955,976214967,200436686,,2066703,124612152,24239684,PDN
SM023,,1997,1960,,28856734,1092349668,223225002,,27265151,1008309151,206679591,,1591583,84040517,16545411,PDN
SM023,,1998,1960,,28866509,1117369622,227686726,,27583964,1031043460,211043654,,1282545,86326162,16643072,PDN
SM023,,1999,1960,,29166772,1131265754,230459611,,27922998,1055871457,215800481,,1243774,75394297,14659130,PDN
SM023,,2000,1960,,31932750,1203156392,246017517,,28236764,1078053995,220061318,,3695986,125102397,25956199,PDN
SM023,,2001,1960,,34075429,1206678514,248786909,,28592244,1100037982,224328540,,5483185,106640532,24458369,PDN
SM023,,2002,1960,,31576962,1186184900,242641891,,28769935,1108910927,226085047,,2807027,77273973,16556844,PDN
SM023,,2003,1960,,32793703,1227151387,251148043,,29088704,1124093993,229105429,,3704999,103057394,22042614,PDN
SM023,,2004,1960,,30622281,1182339102,241002904,,29410691,1135962560,231539260,,1211590,46376542,9463644,PDN
SM023,,2005,1960,,30625588,1182728502,241075499,,29475443,1140626989,232433982,,1150145,42101513,8641517,PDN
SM023,,2006,1960,,30519627,1178140195,240153114,,29522482,1143770062,233040287,,997145,34370133,7112827,PDN
SM023,,2007,1960,,30747159,1181996543,241066828,,29540316,1145232850,233318403,,1206843,36763693,7748425,PDN
SM023,,2008,1960,,30746987,1181993998,241066204,,29614801,1147194136,233741871,,1132186,34799862,7324333,PDN
SM023,,2009,1960,,30010852,1182016213,240334019,,29650382,1170177988,237867106,,360470,11838225,2466913,PDN
SM023,,2010,1960,,30010852,1182016213,240334019,,29687469,1172386412,238297151,,323383,9629801,2036870,PDN
SM023,,2011,1960,,30010852,1182016213,240334019,,29708393,1173947426,238595835,,302459,8068787,1738186,PDN
SM023,,2012,1960,,29963551,1183139519,240486596,,29741799,1175292495,238868576,,221752,7847024,1618018,PDN
SM023,,2013,1960,,29963551,1183139519,240486596,,29759149,1176074490,239025071,,204402,7065029,1461524,PDN
SM023,,2014,1960,,29763972,1176255446,239062094,,29763972,1176255446,239062094,,0,0,0,PDN
SM023,,2015,1960,,29763972,1176255446,239062094,,29763972,1176255446,239062094,,0,0,0,PDN
SM023,,2016,1960,,29763972,1176255446,239062094,,29763972,1176255446,239062094,,0,0,0,PDN
SM023,,2017,1960,,29763972,1176255446,239062094,,29763972,1176255446,239062094,,0,0,0,PDN
SM023,,2017,1960,,29763972,1176255446,239062094,,29763972,1176255446,239062094,,0,0,0,PDN
SM027,,1975,1965,,5500000,44995500,13506317,,2142949,14809433,4778079,,3357051,30186067,8728238,PDP
SM027,,1976,1965,,2270706,20127159,5852051,,2172136,14720555,4791452,,98570,5406604,1060599,PDP
SM027,,1977,1965,,2270719,20063187,5840681,,2172136,14656566,4780066,,98583,5406621,1060615,PDP
SM027,,1978,1965,,2270719,20063187,5840681,,2192133,14764135,4819203,,78586,5299052,1021478,PDP
SM027,,1979,1965,,2079416,20211848,5675830,,2044960,15000980,4714174,,34456,5210868,961656,PDP
SM027,,1980,1965,,2113248,20325926,5729961,,2054418,15067981,4735553,,58830,5257945,994408,PDP
SM027,,1981,1965,,2181389,23322751,6331345,,2109729,17065497,5146294,,71660,6257254,1185051,PDP
SM027,,1982,1965,,2181389,23322751,6331345,,2125423,17437547,5228189,,55966,5885204,1103156,PDP
SM027,,1983,1965,,2615837,23757199,6843097,,2133003,17524324,5251210,,482834,6232875,1591887,PDP
SM027,,1984,1965,,2724495,18737524,6058574,,2138489,17529021,5257532,,586006,1208503,801042,PDP
SM027,,1985,1965,,2724495,18737524,6058574,,2146723,17535543,5266926,,577772,1201981,791648,PDP
SM027,,1986,1965,,2739690,19509689,6211165,,2154531,17566504,5280243,,585159,1943185,930922,PDP
SM027,,1987,1965,,2715764,18267333,5966179,,2164373,17577380,5292021,,551391,689953,674158,PDP
SM027,,1988,1965,,2715764,18267333,5966179,,2171963,17588673,5301620,,543801,678660,664559,PDP
SM027,,1989,1965,,2372232,17754428,5531383,,2176472,17603393,5308748,,195760,151035,222635,PDP
SM027,,1990,1965,,2276550,19068202,5669469,,2184908,17695126,5333507,,91642,1373076,335962,PDP
SM027,,1991,1965,,2285414,23446968,6457472,,2195601,19129797,5599479,,89813,4317171,857993,PDP
SM027,,1992,1965,,2285223,28781887,7406555,,2200184,25311970,6704093,,85039,3469917,702462,PDP
SM027,,1993,1965,,2258749,37786670,8982356,,2200259,28399662,7253580,,58490,9387008,1728776,PDP
SM027,,1994,1965,,2232618,37763799,8952155,,2200263,29268876,7408248,,32355,8494923,1543907,PDP
SM027,,1995,1965,,2200263,31045121,7724306,,2200263,29646300,7475405,,0,1398821,248901,PDP
SM027,,1996,1965,,2200263,31045121,7724306,,2200263,29852013,7512009,,0,1193108,212297,PDP
SM027,,1997,1965,,2200263,31045121,7724306,,2200263,29960808,7531368,,0,1084313,192938,PDP
SM027,,1998,1965,,2219464,32010798,7915336,,2202118,30096418,7557353,,17346,1914380,357983,PDP
SM027,,1999,1965,,2527050,32225729,8261165,,2243217,30355552,7644561,,283833,1870177,616604,PDP
SM027,,2000,1965,,2568514,31744252,8216957,,2395340,30858049,7886096,,173174,886203,330861,PDP
SM027,,2001,1965,,2568514,31747345,8217508,,2480093,31034537,8002253,,88421,712808,215255,PDP
SM027,,2002,1965,,2590193,33548170,8559618,,2535064,31118444,8072154,,55129,2429726,487464,PDP
SM027,,2003,1965,,4617227,49162498,13365002,,2591498,31875392,8263276,,2025729,17287106,5101726,PDP
SM027,,2004,1965,,4030575,40662454,11265887,,2943679,35060707,9182239,,1086896,5601747,2083648,PDP
SM027,,2005,1965,,4009641,38321625,10828435,,3157713,35789968,9526035,,851928,2531657,1302400,PDP
SM027,,2006,1965,,3591962,36687087,10119913,,3262252,36214740,9706156,,329710,472347,413757,PDP
SM027,,2007,1965,,3576197,36622142,10092592,,2995332,35324415,9280815,,580865,1297727,811777,PDP
SM027,,2008,1965,,3624574,37467116,10291320,,3033328,35378912,9328508,,591246,2088204,962812,PDP
SM027,,2009,1965,,3971637,40277185,11138396,,3481146,37489154,10151815,,490491,2788031,986581,PDP
SM027,,2010,1965,,4013268,44440258,11920787,,3623541,38853333,10536946,,389727,5586925,1383842,PDP
SM027,,2011,1965,,4103622,46408151,12361300,,3721633,40713932,10966105,,381989,5694219,1395195,PDP
SM027,,2012,1965,,4103622,46408151,12361300,,3805122,42381273,11346274,,298500,4026878,1015025,PDP
SM027,,2013,1965,,4103622,46408151,12361300,,3882890,43477028,11619015,,220732,2931123,742284,PDP
SM027,,2014,1965,,4103622,46408151,12361300,,3949412,43934559,11766949,,154210,2473592,594351,PDP
SM027,,2015,1965,,4103622,46408151,12361300,,4010337,44289113,11890962,,93285,2119038,470338,PDP
SM027,,2016,1965,,4300972,45996472,12485398,,4081367,44689610,12033255,,219605,1306862,452142,PDP
SM027,,2017,1965,,4300972,45996472,12485398,,4138859,45029609,12151245,,162113,966863,334152,PDP
SM027,,2017,1965,,4300972,45996472,12485398,,4138859,45029609,12151245,,162113,966863,334152,PDP
SM038,,1975,1963,,700035,20000000,4258754,,259035,10904111,2199268,,441000,9095889,2059486,PDP
SM038,,1976,1963,,700035,20000000,4258754,,298712,12330132,2492686,,401323,7669868,1766068,PDP
SM038,,1977,1963,,389803,32544000,6180550,,291739,12338452,2487193,,98064,20205548,3693357,PDP
SM038,,1978,1963,,455530,32754000,6283644,,323310,13470514,2720199,,132220,19283486,3563445,PDP
SM038,,1979,1963,,455530,32754000,6283644,,352971,14674471,2964087,,102559,18079529,3319557,PDP
SM038,,1980,1963,,447462,33214432,6357503,,382146,16638904,3342805,,65316,16575528,3014698,PDP
SM038,,1981,1963,,483637,35182149,6743806,,383174,16691581,3353206,,100463,18490568,3390600,PDP
SM038,,1982,1963,,483637,35182149,6743806,,383174,16691581,3353206,,100463,18490568,3390600,PDP
SM038,,1983,1963,,2760169,44678573,10710093,,440572,19607505,3929452,,2319597,25071068,6780641,PDP
SM038,,1984,1963,,2848663,52362604,12165852,,554652,27446979,5438456,,2294011,24915625,6727396,PDP
SM038,,1985,1963,,3049149,66863206,14946517,,641195,34412532,6764421,,2407954,32450674,8182096,PDP
SM038,,1986,1963,,1396347,92510474,17857285,,704109,42437185,8255210,,692238,50073289,9602075,PDP
SM038,,1987,1963,,1433789,95090078,18353732,,741037,49149824,9486557,,692752,45940254,8867175,PDP
SM038,,1988,1963,,1447745,95544558,18448556,,759504,54330528,10426858,,688241,41214030,8021698,PDP
SM038,,1989,1963,,2076042,95311922,19035459,,967397,55695211,10877577,,1108645,39616711,8157882,PDP
SM038,,1990,1963,,1542741,97545155,18899530,,991622,63444126,12280612,,551119,34101029,6618918,PDP
SM038,,1991,1963,,1586400,98230057,19065058,,1068026,69872121,13500788,,518374,28357936,5564270,PDP
SM038,,1992,1963,,1603723,97590560,18968591,,1114619,73378687,14171325,,489104,24211873,4797266,PDP
SM038,,1993,1963,,1744866,99030727,19365992,,1218284,76098296,14758906,,526582,22932431,4607086,PDP
SM038,,1994,1963,,2138968,115410559,22674655,,1305523,79091422,15378730,,833445,36319137,7295925,PDP
SM038,,1995,1963,,2487269,110095225,22077167,,1570919,87283588,17101807,,916350,22811637,4975360,PDP
SM038,,1996,1963,,3141962,155770027,30859049,,2247467,115426147,22785927,,894495,40343880,8073122,PDP
SM038,,1997,1963,,3232158,171875164,33814927,,2490663,132304165,26032329,,741495,39570999,7782598,PDP
SM038,,1998,1963,,3232964,171961669,33831126,,2716924,147763570,29009374,,516040,24198099,4821752,PDP
SM038,,1999,1963,,8142693,205165791,44649061,,3747902,158444337,31940845,,4394791,46721454,12708216,PDP
SM038,,2000,1963,,7758986,200377353,43413319,,4456885,165287504,33867473,,3302101,35089849,9545846,PDP
SM038,,2001,1963,,7810210,189235377,41481985,,4729539,167241814,34487869,,3080671,21993563,6994116,PDP
SM038,,2002,1963,,6538179,188810626,40134376,,5226574,169127967,35320518,,1311605,19682659,4813858,PDP
SM038,,2003,1963,,7699489,193340550,42101722,,5525496,171122408,35974323,,2173993,22218142,6127399,PDP
SM038,,2004,1963,,6376850,185046939,39303352,,5838545,172675317,36563690,,538305,12371622,2739662,PDP
SM038,,2005,1963,,6995225,190904164,40963937,,5996143,173475466,36863664,,999082,17428698,4100273,PDP
SM038,,2006,1963,,6764033,188909062,40377745,,6146429,174214409,37145434,,617604,14694653,3232311,PDP
SM038,,2007,1963,,6861645,188278833,40363217,,6248391,175406620,37459533,,613254,12872213,2903684,PDP
SM038,,2008,1963,,7071132,191555717,41155779,,6309231,176053701,37635512,,761901,15502016,3520267,PDP
SM038,,2009,1963,,7024640,192177560,41219934,,6425662,180524066,38547383,,598978,11653494,2672553,PDP
SM038,,2010,1963,,7024640,192177560,41219934,,6524289,181570741,38832249,,500351,10606819,2387684,PDP
SM038,,2011,1963,,7024640,192177560,41219934,,6566891,181987620,38949030,,457749,10189940,2270905,PDP
SM038,,2012,1963,,7039220,191422698,41100197,,6622601,182355177,39070140,,416619,9067521,2030056,PDP
SM038,,2013,1963,,7039220,191422698,41100197,,6659974,182560835,39144108,,379246,8861863,1956089,PDP
SM038,,2014,1963,,6846134,183699253,39532833,,6705298,182757015,39224340,,140836,942238,308494,PDP
SM038,,2015,1963,,7018216,184386811,39827256,,6761580,183045171,39331894,,256636,1341640,495361,PDP
SM038,,2016,1963,,7018216,184386811,39827256,,6802876,183245101,39408765,,215340,1141710,418491,PDP
SM038,,2017,1963,,7018216,184386811,39827256,,6834280,183392381,39466376,,183936,994430,360881,PDP
SM038,,2017,1963,,7018216,184386811,39827256,,6834280,183392381,39466376,,183936,994430,360881,PDP
SM041,,1975,1963,,743482,5360846,1697369,,713549,4640790,1539312,,29933,720056,158057,PDP
SM041,,1976,1963,,743482,5360846,1697369,,716915,4875337,1584413,,26567,485509,112956,PDP
SM041,,1977,1963,,850277,8861115,2426988,,758354,6319636,1882844,,91923,2541479,544144,PDP
SM041,,1978,1963,,1002008,13366125,3380322,,803219,7390039,2118173,,198789,5976086,1262149,PDP
SM041,,1979,1963,,922008,13366125,3300322,,759028,7916074,2167582,,162980,5450051,1132740,PDP
SM041,,1980,1963,,945554,12119818,3102105,,818945,8985232,2417741,,126609,3134586,684364,PDP
SM041,,1981,1963,,945554,12119818,3102105,,824606,9216445,2464543,,120948,2903373,637562,PDP
SM041,,1982,1963,,945554,12119818,3102105,,828668,9397828,2500879,,116886,2721990,601226,PDP
SM041,,1983,1963,,2178865,19262560,5606367,,834505,9561014,2535753,,1344360,9701546,3070614,PDP
SM041,,1984,1963,,2178865,19262560,5606367,,834505,9561014,2535753,,1344360,9701546,3070614,PDP
SM041,,1985,1963,,2178865,19262560,5606367,,820235,9561014,2521483,,1358630,9701546,3084884,PDP
SM041,,1986,1963,,984546,17141495,4034634,,831843,9814195,2578141,,152703,7327300,1456493,PDP
SM041,,1987,1963,,1239674,17141495,4289762,,893573,10593624,2778559,,346101,6547871,1511203,PDP
SM041,,1988,1963,,1239674,17141495,4289762,,943727,11229109,2941789,,295947,5912386,1347973,PDP
SM041,,1989,1963,,1235799,14933205,3892953,,997855,11926164,3119948,,237944,3007041,773005,PDP
SM041,,1990,1963,,1235799,14933205,3892953,,1070749,12813372,3350708,,165050,2119833,542245,PDP
SM041,,1991,1963,,1235799,14933205,3892953,,1144508,13682491,3579115,,91291,1250714,313838,PDP
SM041,,1992,1963,,1235799,14933205,3892953,,1197464,14310673,3743847,,38335,622532,149106,PDP
SM041,,1993,1963,,1283447,15312081,4008017,,1241107,14819130,3877963,,42340,492951,130054,PDP
SM041,,1994,1963,,1568342,32402733,7333953,,1257816,15019799,3930378,,310526,17382934,3403575,PDP
SM041,,1995,1963,,1541467,34994080,7768172,,1423493,22856353,5490460,,117974,12137727,2277712,PDP
SM041,,1996,1963,,2329600,54507161,12028383,,2005624,42295199,9531460,,323976,12211962,2496923,PDP
SM041,,1997,1963,,2461684,58586682,12886361,,2159659,50364729,11121355,,302025,8221953,1765006,PDP
SM041,,1998,1963,,2416717,58100578,12754898,,2266370,56121677,12252434,,150347,1978901,502464,PDP
SM041,,1999,1963,,2491935,65654074,14174155,,2287066,57248100,12473561,,204869,8405974,1700594,PDP
SM041,,2000,1963,,2511559,65742881,14209581,,2326542,60021818,13006581,,185017,5721063,1203000,PDP
SM041,,2001,1963,,2551596,68089502,14667166,,2348525,61808123,13346412,,203071,6281379,1320754,PDP
SM041,,2002,1963,,2551609,68089545,14667186,,2364065,62746727,13528963,,187544,5342818,1138223,PDP
SM041,,2003,1963,,4614099,73181738,17635761,,2386420,62783509,13557863,,2227679,10398229,4077898,PDP
SM041,,2004,1963,,9540998,73627262,22641934,,3765209,64349230,15215250,,5775789,9278032,7426684,PDP
SM041,,2005,1963,,12666548,75783142,26151093,,4869166,65431473,16511777,,7797382,10351669,9639316,PDP
SM041,,2006,1963,,15980339,89818660,31962307,,7338705,67255704,19305912,,8641634,22562956,12656395,PDP
SM041,,2007,1963,,15870471,86321528,31230173,,9563352,69013202,21843281,,6307119,17308326,9386892,PDP
SM041,,2008,1963,,15933460,101429523,33981418,,11026790,72874205,23993730,,4906670,28555318,9987688,PDP
SM041,,2009,1963,,17359374,102088036,35524504,,12545733,82290280,27188131,,4813641,19797756,8336372,PDP
SM041,,2010,1963,,17359374,102088036,35524504,,13384005,86908449,28848143,,3975369,15179587,6676362,PDP
SM041,,2011,1963,,17359374,102088036,35524504,,14043468,89087539,29895343,,3315906,13000497,5629162,PDP
SM041,,2012,1963,,17464375,103166523,35821408,,14627545,90744380,30774232,,2836830,12422143,5047176,PDP
SM041,,2013,1963,,17464375,103166523,35821408,,15214902,92434700,31662358,,2249473,10731823,4159051,PDP
SM041,,2014,1963,,17639587,104806597,36288446,,15689949,93452583,32318522,,1949638,11354014,3969923,PDP
SM041,,2015,1963,,17671631,104582641,36280640,,16026529,93908551,32736233,,1645102,10674090,3544404,PDP
SM041,,2016,1963,,17594110,103604211,36029022,,16300586,94115434,33047102,,1293524,9488777,2981917,PDP
SM041,,2017,1963,,17648349,103644282,36090391,,16600518,94336659,33386399,,1047831,9307623,2703990,PDP
SM041,,2017,1963,,17648349,103644282,36090391,,16600518,94336659,33386399,,1047831,9307623,2703990,PDP
SM048,,1975,1961,,20000000,1275000000,246868327,,14843380,696849595,138837970,,5156620,578150405,108030357,PDP
SM048,,1976,1961,,20000000,1275000000,246868327,,15882960,770772572,153031104,,4117040,504227428,93837223,PDP
SM048,,1977,1961,,22933134,1169690948,231063196,,16623143,832088248,164681550,,6309991,337602700,66381646,PDP
SM048,,1978,1961,,23409211,1184376860,234152425,,17348707,885265855,174869322,,6060504,299111005,59283103,PDP
SM048,,1979,1961,,20536407,1220915265,237781116,,14061730,942675372,181797561,,6474677,278239893,55983555,PDP
SM048,,1980,1961,,22181648,1257550864,245945147,,14668612,987197639,190326555,,7513036,270353225,55618592,PDP
SM048,,1981,1961,,17881437,1252976899,240831063,,15274941,1031934618,198893200,,2606496,221042281,41937863,PDP
SM048,,1982,1961,,18608462,1264538905,243615385,,15929743,1063111393,205095471,,2678719,201427512,38519914,PDP
SM048,,1983,1961,,19631029,1285774443,248416517,,17181180,1088433153,210852560,,2449849,197341290,37563957,PDP
SM048,,1984,1961,,23442461,1540781560,297602881,,17569581,1111163230,215285458,,5872880,429618330,82317423,PDP
SM048,,1985,1961,,23479132,1522508598,294388135,,17301196,1129346552,218252540,,6177936,393162046,76135595,PDP
SM048,,1986,1961,,21775504,1501657564,288974359,,17424091,1148592931,221800057,,4351413,353064633,67174302,PDP
SM048,,1987,1961,,21606891,1498252483,288199860,,17653483,1164719658,224898974,,3953408,333532825,63300886,PDP
SM048,,1988,1961,,21981095,1504257365,289642548,,17901069,1178145052,227535420,,4080026,326112313,62107128,PDP
SM048,,1989,1961,,20599225,1313731737,254359321,,18114630,1190405318,229930523,,2484595,123326419,24428798,PDP
SM048,,1990,1961,,22388625,1318341906,256969035,,18611543,1206869339,233356977,,3777082,111472567,23612058,PDP
SM048,,1991,1961,,22898539,1326345799,258903130,,19320886,1224538236,237210252,,3577653,101807563,21692878,PDP
SM048,,1992,1961,,23780930,1352965924,264522198,,20326806,1252057706,243112875,,3454124,100908218,21409323,PDP
SM048,,1993,1961,,27464396,1471886274,289365868,,21453601,1287085991,250472461,,6010795,184800283,38893407,PDP
SM048,,1994,1961,,28709240,1481753633,292366470,,22720163,1316474127,256968228,,5989077,165279506,35398242,PDP
SM048,,1995,1961,,27580864,1456181748,286687937,,23760080,1347534195,263534848,,3820784,108647553,23153089,PDP
SM048,,1996,1961,,27923528,1527575423,299734101,,24508880,1376109598,269368239,,3414648,151465825,30365862,PDP
SM048,,1997,1961,,28401090,1557669509,305566483,,25299922,1393205606,273201275,,3101168,164463903,32365208,PDP
SM048,,1998,1961,,27868479,1551181045,303879341,,26108054,1421529913,279049320,,1760425,129651132,24830021,PDP
SM048,,1999,1961,,28244342,1582547260,309836381,,26353435,1442843591,283087170,,1890907,139703669,26749211,PDP
SM048,,2000,1961,,28693066,1666214708,325172551,,26590134,1461061421,286565476,,2102932,205153287,38607075,PDP
SM048,,2001,1961,,28978391,1642196521,321184177,,26842909,1475057128,289308590,,2135482,167139393,31875587,PDP
SM048,,2002,1961,,28827972,1641288710,320872226,,27098744,1486855864,291663844,,1729228,154432846,29208382,PDP
SM048,,2003,1961,,29351318,1646604841,322341503,,27366957,1496309546,293614207,,1984361,150295295,28727296,PDP
SM048,,2004,1961,,29285397,1639630127,321034529,,27562675,1503439682,295078633,,1722722,136190445,25955896,PDP
SM048,,2005,1961,,29256075,1642317612,321483409,,27726141,1507540470,295971776,,1529934,134777142,25511633,PDP
SM048,,2006,1961,,29012899,1643437488,321439499,,27819684,1512693867,296982294,,1193215,130743621,24457205,PDP
SM048,,2007,1961,,29010480,1642990406,321357528,,27858278,1518695153,298088732,,1152202,124295253,23268796,PDP
SM048,,2008,1961,,28995703,1641261864,321035180,,27881637,1522280535,298750060,,1114066,118981329,22285120,PDP
SM048,,2009,1961,,28579675,1621248747,317058102,,27882079,1550695432,303806535,,697596,70553315,13251567,PDP
SM048,,2010,1961,,30802657,1623931037,319758360,,27883426,1550979172,303858370,,2919231,72951865,15899990,PDP
SM048,,2011,1961,,30802657,1623931037,319758360,,27883959,1551114575,303882996,,2918698,72816462,15875364,PDP
SM048,,2012,1961,,29520118,1628977973,319373851,,27883959,1551114575,303882996,,1636159,77863398,15490855,PDP
SM048,,2013,1961,,29774802,1629278431,319681998,,28013071,1551271504,304040031,,1761731,78006927,15641966,PDP
SM048,,2014,1961,,30159495,1596851513,314296775,,28426996,1556158418,305323513,,1732499,40693095,8973263,PDP
SM048,,2015,1961,,30390593,1595464738,314281116,,28842270,1557196107,305923430,,1548323,38268631,8357687,PDP
SM048,,2016,1961,,30384215,1566285430,309082692,,29165399,1558354345,306452651,,1218816,7931085,2630041,PDP
SM048,,2017,1961,,30384215,1566285430,309082692,,29334758,1558717772,306686676,,1049457,7567658,2396016,PDP
SM048,,2017,1961,,30384215,1566285430,309082692,,29334758,1558717772,306686676,,1049457,7567658,2396016,PDP
SM066,,1975,1963,,7136081,466534821,90149394,,2137066,147620352,28404033,,4999015,318914469,61745361,PDP
SM066,,1976,1963,,7309200,506224821,97384791,,2416465,202456385,38440733,,4892735,303768436,58944058,PDP
SM066,,1977,1963,,9435109,550493091,107387616,,1685943,247736754,45767216,,7749166,302756337,61620400,PDP
SM066,,1978,1963,,9872154,631640281,122263663,,2899151,307622905,57636323,,6973003,324017376,64627340,PDP
SM066,,1979,1963,,7415516,886644613,165181461,,2401250,430886463,79071439,,5014266,455758150,86110022,PDP
SM066,,1980,1963,,7694037,993365973,184449548,,2716833,542627198,99269715,,4977204,450738775,85179833,PDP
SM066,,1981,1963,,7745769,1012800164,187959321,,2976379,632566580,115532710,,4769390,380233584,72426611,PDP
SM066,,1982,1963,,7911640,1060465665,196606598,,3147453,695409821,126885855,,4764187,365055844,69720743,PDP
SM066,,1983,1963,,5183127,1169106875,213209261,,3238883,739127514,134756234,,1944244,429979361,78453027,PDP
SM066,,1984,1963,,5289859,1180162522,215283190,,3375143,783991190,142875355,,1914716,396171332,72407835,PDP
SM066,,1985,1963,,5415026,1214603402,221536628,,3425176,808160317,147225944,,1989850,406443085,74310684,PDP
SM066,,1986,1963,,4311583,1034600128,188404132,,3533604,840832173,153147870,,777979,193767955,35256262,PDP
SM066,,1987,1963,,4457227,1120744698,203877992,,3626566,887243967,161499158,,830661,233500731,42378834,PDP
SM066,,1988,1963,,4499157,1137168128,206842240,,3699226,914481052,166418274,,799931,222687076,40423966,PDP
SM066,,1989,1963,,4303880,1110936283,201979375,,3760166,931635502,169531608,,543714,179300781,32447767,PDP
SM066,,1990,1963,,4483757,1120113311,203792175,,3880751,959204127,174557642,,603006,160909184,29234533,PDP
SM066,,1991,1963,,4501872,1123071198,204336605,,3970919,983967680,179054136,,530953,139103518,25282469,PDP
SM066,,1992,1963,,4497520,1139319269,207223369,,4037559,1011478817,184015996,,459961,127840452,23207373,PDP
SM066,,1993,1963,,5107378,1211972865,220760913,,4166086,1049359067,190884781,,941292,162613798,29876132,PDP
SM066,,1994,1963,,5217894,1225606492,223297341,,4261012,1076003778,195720759,,956882,149602714,27576582,PDP
SM066,,1995,1963,,5130956,1243933568,226471449,,4344593,1099354535,199959279,,786363,144579033,26512170,PDP
SM066,,1996,1963,,5434324,1281058473,233380672,,4524320,1140417143,207445520,,910004,140641330,25935152,PDP
SM066,,1997,1963,,5319865,1272687488,231776713,,4625797,1168278847,212504595,,694068,104408641,19272118,PDP
SM066,,1998,1963,,5114576,1241929582,226098487,,4690951,1182522186,215104151,,423625,59407396,10994336,PDP
SM066,,1999,1963,,4944852,1251152268,227569811,,4719517,1191993823,216818062,,225335,59158445,10751749,PDP
SM066,,2000,1963,,4936371,1250931021,227521962,,4733592,1199008700,218080336,,202779,51922321,9441626,PDP
SM066,,2001,1963,,4933000,1255106844,228261620,,4742689,1203391276,218869251,,190311,51715568,9392369,PDP
SM066,,2002,1963,,4967615,1256827682,228602434,,4747850,1206339931,219399083,,219765,50487751,9203351,PDP
SM066,,2003,1963,,4967527,1255996460,228454441,,4763307,1210076931,220079487,,204220,45919529,8374954,PDP
SM066,,2004,1963,,4943550,1257667880,228727871,,4773803,1212981788,220606861,,169747,44686092,8121010,PDP
SM066,,2005,1963,,4954544,1260530408,229248211,,4780622,1216237871,221193055,,173922,44292537,8055156,PDP
SM066,,2006,1963,,4961146,1265961969,230221283,,4785467,1217987733,221509263,,175679,47974236,8712020,PDP
SM066,,2007,1963,,4961146,1266063203,230239296,,4798416,1222142401,222261477,,162730,43920802,7977819,PDP
SM066,,2008,1963,,4970230,1279468929,232633741,,4806029,1225867822,222931976,,164201,53601107,9701765,PDP
SM066,,2009,1963,,4933378,1287564803,234037433,,4810944,1252548726,227684380,,122434,35016077,6353053,PDP
SM066,,2010,1963,,4933378,1287564803,234037433,,4816515,1256595733,228410058,,116863,30969070,5627374,PDP
SM066,,2011,1963,,4924174,1285280212,233621718,,4821570,1259471559,228926826,,102604,25808653,4694891,PDP
SM066,,2012,1963,,4885696,1276045141,231939989,,4832597,1262102914,229406067,,53099,13942227,2533923,PDP
SM066,,2013,1963,,4885696,1276045141,231939989,,4838928,1264135229,229774019,,46768,11909912,2165970,PDP
SM066,,2014,1963,,4884386,1276752639,232064567,,4841314,1265504454,230020040,,43072,11248185,2044529,PDP
SM066,,2015,1963,,4886788,1276539935,232029122,,4844696,1266608227,230219823,,42092,9931708,1809300,PDP
SM066,,2016,1963,,4888729,1277467729,232196150,,4846899,1267561518,230391650,,41830,9906211,1804502,PDP
SM066,,2017,1963,,4888729,1277466911,232196005,,4847015,1267636719,230405147,,41714,9830192,1790859,PDP
SM066,,2017,1963,,4888729,1277466911,232196005,,4847015,1267636719,230405147,,41714,9830192,1790859,PDP
SM073,,1975,1963,,70000000,289940000,121590747,,47141178,185174002,80090289,,22858822,104765998,41500458,PDP
SM073,,1976,1963,,62000000,230020000,102928826,,50301580,193720696,84771455,,11698420,36299304,18157371,PDP
SM073,,1977,1963,,62000000,230020000,102928826,,53202925,199965178,88783918,,8797075,30054822,14144908,PDP
SM073,,1978,1963,,62000000,230020000,102928826,,55523781,204573388,91924740,,6476219,25446612,11004086,PDP
SM073,,1979,1963,,63935221,223689364,103737599,,58381753,211559543,96025800,,5553468,12129821,7711799,PDP
SM073,,1980,1963,,64636450,224321064,104551230,,58956998,212086927,96694885,,5679452,12234137,7856345,PDP
SM073,,1981,1963,,64912352,224749572,104903379,,60351808,215079929,98622258,,4560544,9669643,6281121,PDP
SM073,,1982,1963,,66246477,227031537,106643548,,61743880,218854231,100685914,,4502597,8177306,5957634,PDP
SM073,,1983,1963,,74386217,303613287,128409934,,63309475,224404053,103239022,,11076742,79209234,25170912,PDP
SM073,,1984,1963,,83339451,324521289,141083453,,65050794,232017762,106335093,,18288657,92503527,34748360,PDP
SM073,,1985,1963,,87919411,337081150,147898263,,66779205,242647062,109954839,,21140206,94434088,37943424,PDP
SM073,,1986,1963,,79487220,315344608,135598360,,68597461,253608178,113723471,,10889759,61736430,21874889,PDP
SM073,,1987,1963,,81653231,315908716,137864746,,70238766,263790122,117176510,,11414465,52118594,20688236,PDP
SM073,,1988,1963,,80267603,304337538,134420190,,71438145,268192531,119159236,,8829458,36145007,15260954,PDP
SM073,,1989,1963,,80267603,305757508,134672854,,72384431,270948634,120595932,,7883172,34808874,14076922,PDP
SM073,,1990,1963,,81692197,305125840,135985051,,73082785,272520735,121574019,,8609412,32605105,14411032,PDP
SM073,,1991,1963,,81696716,304996494,135966555,,73838962,274198926,122628806,,7857754,30797568,13337749,PDP
SM073,,1992,1963,,79643691,287702972,130836391,,74568223,276026457,123683251,,5075468,11676515,7153140,PDP
SM073,,1993,1963,,79658903,287890204,130884918,,75278090,277529715,124660602,,4380813,10360489,6224316,PDP
SM073,,1994,1963,,81949347,319006958,138712151,,76504320,290431804,128182577,,5445027,28575154,10529574,PDP
SM073,,1995,1963,,87108287,337896391,147232200,,80688251,308115073,135512997,,6420036,29781318,11719203,PDP
SM073,,1996,1963,,93806551,367092204,159125449,,83398846,317239828,139847214,,10407705,49852376,19278235,PDP
SM073,,1997,1963,,94700138,378943642,162127832,,85266437,326092905,143290086,,9433701,52850737,18837746,PDP
SM073,,1998,1963,,92888217,367624809,158301884,,87107998,332284770,146233402,,5780219,35340039,12068482,PDP
SM073,,1999,1963,,96236168,365116418,161203502,,89203713,339077800,149537841,,7032455,26038618,11665661,PDP
SM073,,2000,1963,,103528755,363728521,168249132,,91708301,342620746,152672847,,11820454,21107775,15576285,PDP
SM073,,2001,1963,,107917800,363759884,172643758,,94271457,345154873,155686915,,13646343,18605011,16956843,PDP
SM073,,2002,1963,,107959488,361554631,172293052,,96297647,347319134,158098205,,11661841,14235497,14194847,PDP
SM073,,2003,1963,,108185418,362846820,172748909,,98365216,349680915,160586019,,9820202,13165905,12162890,PDP
SM073,,2004,1963,,111021328,377483723,178189250,,100410747,352438147,163122161,,10610581,25045576,15067089,PDP
SM073,,2005,1963,,114087585,374032836,180641470,,102008205,355415092,165249325,,12079380,18617744,15392145,PDP
SM073,,2006,1963,,112953115,368771146,178570756,,103904197,358105476,167624033,,9048918,10665670,10946723,PDP
SM073,,2007,1963,,112593292,369872437,178406893,,103618319,358725281,167448440,,8974973,11147156,10958453,PDP
SM073,,2008,1963,,116303887,376534183,183302852,,104705722,359766246,168721068,,11598165,16767937,14581784,PDP
SM073,,2009,1963,,119246367,383081928,187410411,,108419860,369506453,174168339,,10826507,13575475,13242072,PDP
SM073,,2010,1963,,119097834,383172698,187278029,,110744031,372507247,177026459,,8353803,10665451,10251570,PDP
SM073,,2011,1963,,118219959,378635415,185592809,,112506850,375422116,179307938,,5713109,3213299,6284871,PDP
SM073,,2012,1963,,118752621,378853242,186164230,,114040351,376292569,180996324,,4712270,2560673,5167906,PDP
SM073,,2013,1963,,118752621,378853242,186164230,,115248148,377001415,182330250,,3504473,1851827,3833980,PDP
SM073,,2014,1963,,119344068,379205056,186818277,,116409006,377658267,183607986,,2935062,1546789,3210291,PDP
SM073,,2015,1963,,119344068,379205056,186818277,,117245507,378189437,184539001,,2098561,1015619,2279276,PDP
SM073,,2016,1963,,120020195,380385950,187704525,,117839894,378597717,185206035,,2180301,1788233,2498492,PDP
SM073,,2017,1963,,120256549,380551398,187970318,,118441378,379003940,185879800,,1815171,1547458,2090519,PDP
SM073,,2017,1963,,120256549,380551398,187970318,,118441378,379003940,185879800,,1815171,1547458,2090519,PDP
SM076,,1975,1964,,1402090,91264074,17641249,,411623,29800242,5714157,,990467,61463832,11927092,PDN
SM076,,1976,1964,,1402090,91264074,17641249,,411623,29800242,5714157,,990467,61463832,11927092,PDN
SM076,,1977,1964,,1405353,91784074,17737039,,413628,30176531,5783118,,991725,61607543,11953921,PDN
SM076,,1978,1964,,1405353,91784074,17737039,,415063,30470566,5836872,,990290,61313508,11900167,PDN
SM076,,1979,1964,,805353,91784074,17137039,,237817,30693112,5699225,,567536,61090962,11437814,PDN
SM076,,1980,1964,,805353,91784074,17137039,,237817,30693112,5699225,,567536,61090962,11437814,PDN
SM076,,1981,1964,,807101,92026368,17181900,,243058,31865527,5913081,,564043,60160841,11268819,PDN
SM076,,1982,1964,,860956,99336168,18536431,,271637,36751152,6810988,,589319,62585016,11725443,PDN
SM076,,1983,1964,,869647,101074303,18854398,,280387,39015472,7222642,,589260,62058831,11631756,PDN
SM076,,1984,1964,,874982,105501282,19647452,,290743,41960275,7756984,,584239,63541007,11890468,PDN
SM076,,1985,1964,,883585,109487030,20365263,,300928,46132125,8509491,,582657,63354905,11855772,PDN
SM076,,1986,1964,,360966,62816838,11538339,,292632,43558201,8043202,,68334,19258637,3495137,PDN
SM076,,1987,1964,,401643,64011043,11791508,,314630,46753849,8633820,,87013,17257194,3157688,PDN
SM076,,1988,1964,,484052,83904755,15413724,,373701,61209790,11265123,,110351,22694965,4148601,PDN
SM076,,1989,1964,,528250,93984805,17251525,,386047,63536741,11691517,,142203,30448064,5560008,PDN
SM076,,1990,1964,,528250,93984805,17251525,,410947,67682904,12454168,,117303,26301901,4797357,PDN
SM076,,1991,1964,,478452,82480485,15154695,,422296,70196493,12912775,,56156,12283992,2241920,PDN
SM076,,1992,1964,,481706,85018665,15609582,,442447,73716860,13559326,,39259,11301805,2050256,PDN
SM076,,1993,1964,,481706,85018665,15609582,,453135,75755444,13932751,,28571,9263221,1676831,PDN
SM076,,1994,1964,,534890,99363943,18215307,,458170,76984839,14156540,,76720,22379104,4058767,PDN
SM076,,1995,1964,,613088,94654641,17455551,,514640,84654155,15577657,,98448,10000486,1877894,PDN
SM076,,1996,1964,,601624,95067314,17517516,,545810,90714056,16687101,,55814,4353258,830415,PDN
SM076,,1997,1964,,584187,103093376,18928204,,555682,94186110,17314776,,28505,8907266,1613428,PDN
SM076,,1998,1964,,584187,103093376,18928204,,559711,96468787,17724976,,24476,6624589,1203228,PDN
SM076,,1999,1964,,619278,109703725,20139513,,564030,98325267,18059629,,55248,11378458,2079884,PDN
SM076,,2000,1964,,715367,139815428,25593557,,579294,104146817,19110756,,136073,35668611,6482801,PDN
SM076,,2001,1964,,696405,139148448,25455915,,592715,109633681,20100487,,103690,29514767,5355428,PDN
SM076,,2002,1964,,782844,140896716,25853434,,638933,116322452,21336878,,143911,24574264,4516556,PDN
SM076,,2003,1964,,764155,141319867,25910038,,662950,123557263,22648228,,101205,17762604,3261810,PDN
SM076,,2004,1964,,748118,142323796,26072637,,671939,128901071,23608073,,76179,13422725,2464564,PDN
SM076,,2005,1964,,748118,142323796,26072637,,675513,130535208,23902418,,72605,11788588,2170219,PDN
SM076,,2006,1964,,750936,140425649,25737706,,675513,130588609,23911920,,75423,9837040,1825786,PDN
SM076,,2007,1964,,761252,155284116,28391878,,611744,112942641,20708299,,149508,42341475,7683579,PDN
SM076,,2008,1964,,761251,155283891,28391837,,689411,132849204,24328059,,71840,22434687,4063778,PDN
SM076,,2009,1964,,755480,149308083,27322754,,695434,137593122,25178195,,60046,11714961,2144558,PDN
SM076,,2010,1964,,744297,144809377,26511090,,695445,137686066,25194745,,48852,7123311,1316345,PDN
SM076,,2011,1964,,744297,144809377,26511090,,711518,140056004,25632515,,32779,4753373,878575,PDN
SM076,,2012,1964,,744297,144809377,26511090,,718352,142286101,26036163,,25945,2523276,474927,PDN
SM076,,2013,1964,,744297,144809377,26511090,,728221,143770623,26310182,,16076,1038754,200908,PDN
SM076,,2014,1964,,762658,146645522,26856167,,730345,144190642,26387043,,32313,2454880,469124,PDN
SM076,,2015,1964,,762658,146645522,26856167,,735295,144832379,26506181,,27363,1813143,349986,PDN
SM076,,2016,1964,,762658,146645522,26856167,,741556,145388353,26611370,,21102,1257169,244797,PDN
SM076,,2017,1964,,748706,146025307,26731856,,741556,145389694,26611608,,7150,635613,120248,PDN
SM076,,2017,1964,,748706,146025307,26731856,,741556,145389694,26611608,,7150,635613,120248,PDN
SM079,,1975,1963,,313281,24067540,4595761,,206285,13232885,2560891,,106996,10834655,2034870,PDP
SM079,,1976,1963,,313281,24067540,4595761,,215862,13950607,2698176,,97419,10116933,1897585,PDP
SM079,,1977,1963,,313281,24067540,4595761,,224109,14521753,2808051,,89172,9545787,1787710,PDP
SM079,,1978,1963,,337671,25589450,4890954,,236166,15140456,2930197,,101505,10448994,1960757,PDP
SM079,,1979,1963,,267671,25589450,4820954,,192733,15392266,2931570,,74938,10197184,1889384,PDP
SM079,,1980,1963,,267671,25589450,4820954,,192733,15392266,2931570,,74938,10197184,1889384,PDP
SM079,,1981,1963,,267691,25579165,4819144,,197460,16062080,3055481,,70231,9517085,1763663,PDP
SM079,,1982,1963,,267691,25579165,4819144,,199952,16465572,3129769,,67739,9113593,1689375,PDP
SM079,,1983,1963,,267691,25579165,4819144,,206531,17412693,3304875,,61160,8166472,1514269,PDP
SM079,,1984,1963,,267691,25579165,4819144,,218446,18382557,3489364,,49245,7196608,1329780,PDP
SM079,,1985,1963,,281244,27266066,5132857,,231051,19421701,3686870,,50193,7844365,1445987,PDP
SM079,,1986,1963,,372348,32746758,6199173,,241756,20338707,3860743,,130592,12408051,2338430,PDP
SM079,,1987,1963,,372348,32746758,6199173,,244949,20649002,3919149,,127399,12097756,2280024,PDP
SM079,,1988,1963,,700283,41055767,8005580,,264858,21469799,4085107,,435425,19585968,3920473,PDP
SM079,,1989,1963,,3390946,204757962,39824747,,468360,31514026,6075838,,2922586,173243936,33748909,PDP
SM079,,1990,1963,,4069442,232175838,45381869,,1080423,79380126,15205001,,2989019,152795712,30176868,PDP
SM079,,1991,1963,,4099596,233758148,45693573,,1436986,116715456,22204861,,2662610,117042692,23488712,PDP
SM079,,1992,1963,,3935588,243053489,47183540,,1735231,164753395,31050782,,2200357,78300094,16132758,PDP
SM079,,1993,1963,,2681769,348458869,64685126,,1942467,203010796,38065384,,739302,145448073,26619742,PDP
SM079,,1994,1963,,2681770,348458869,64685127,,2134441,233704968,43718955,,547329,114753901,20966172,PDP
SM079,,1995,1963,,3015845,363974846,67780052,,2244918,254576360,47543203,,770927,109398486,20236849,PDP
SM079,,1996,1963,,2919565,380011797,70537322,,2344724,275385238,51345656,,574841,104626559,19191666,PDP
SM079,,1997,1963,,2527134,321030819,59650056,,2394435,289296062,53870603,,132699,31734757,5779453,PDP
SM079,,1998,1963,,2563706,329862114,61258032,,2424328,297985648,55446685,,139378,31876466,5811347,PDP
SM079,,1999,1963,,2558193,330135795,61301217,,2447282,306774976,57033577,,110911,23360819,4267640,PDP
SM079,,2000,1963,,2701175,352556709,65433686,,2491219,314655248,58479697,,209956,37901461,6953989,PDP
SM079,,2001,1963,,6285105,342684627,67261017,,2519171,319777601,59419100,,3765934,22907026,7841917,PDP
SM079,,2002,1963,,3839888,352154225,66500782,,2662807,323152620,60163273,,1177081,29001605,6337509,PDP
SM079,,2003,1963,,3827221,350369243,66170502,,2820411,325762552,60785278,,1006810,24606691,5385224,PDP
SM079,,2004,1963,,3156114,342689123,64132826,,2911741,329842236,61602530,,244373,12846887,2530296,PDP
SM079,,2005,1963,,3116024,343090563,64164167,,2946656,331106114,61862335,,169368,11984449,2301832,PDP
SM079,,2006,1963,,3404172,345182359,64824520,,2964128,331847527,62011731,,440044,13334832,2812789,PDP
SM079,,2007,1963,,3382569,345956200,64940612,,3066454,333463261,62401554,,316115,12492939,2539058,PDP
SM079,,2008,1963,,3627391,380801014,71385579,,2932478,320044569,59879910,,694913,60756445,11505669,PDP
SM079,,2009,1963,,3433217,377881501,70671918,,3115375,342030583,63974908,,317842,35850918,6697011,PDP
SM079,,2010,1963,,3469595,384613346,71906133,,3237713,355041856,66412420,,231882,29571490,5493713,PDP
SM079,,2011,1963,,3466900,384416302,71868376,,3333756,364283345,68152856,,133144,20132957,3715522,PDP
SM079,,2012,1963,,3465429,378690496,70848079,,3365224,368282241,68895869,,100205,10408255,1952209,PDP
SM079,,2013,1963,,3470714,379815025,71053458,,3380287,369626785,69150177,,90427,10188240,1903281,PDP
SM079,,2014,1963,,3478356,380671738,71213541,,3395383,371406708,69481984,,82973,9265030,1731555,PDP
SM079,,2015,1963,,3498157,381336781,71351677,,3410223,372662957,69720356,,87934,8673824,1631320,PDP
SM079,,2016,1963,,3498157,381336781,71351677,,3420652,373541677,69887141,,77505,7795104,1464536,PDP
SM079,,2017,1963,,3508338,381604680,71409526,,3427151,373965358,69969028,,81187,7639322,1440496,PDP
SM079,,2017,1963,,3508338,381604680,71409526,,3427151,373965358,69969028,,81187,7639322,1440496,PDP
SM097,,2001,1995,,498,4980598,886725,,0,575530,102407,,498,4405068,784318,PDN
SM097,,2002,1995,,0,2877679,512043,,0,2286715,406889,,0,590964,105154,PDN
SM097,,2003,1995,,0,2775386,493841,,0,2775386,493841,,0,0,0,PDN
SM097,,2004,1995,,0,2775386,493841,,0,2775386,493841,,0,0,0,PDN
SM097,,2005,1995,,0,2775386,493841,,0,2775386,493841,,0,0,0,PDN
SM097,,2006,1995,,0,2775386,493841,,0,2775386,493841,,0,0,0,PDN
SM097,,2007,1995,,0,2775386,493841,,0,2775386,493841,,0,0,0,PDN
SM097,,2008,1995,,0,2775386,493841,,0,2775386,493841,,0,0,0,PDN
SM097,,2009,1995,,0,2775386,493841,,0,2775386,493841,,0,0,0,PDN
SM097,,2010,1995,,0,2775386,493841,,0,2775386,493841,,0,0,0,PDN
SM097,,2011,1995,,0,2775386,493841,,0,2775386,493841,,0,0,0,PDN
SM097,,2012,1995,,0,2775386,493841,,0,2775386,493841,,0,0,0,PDN
SM097,,2013,1995,,0,2775386,493841,,0,2775386,493841,,0,0,0,PDN
SM097,,2014,1995,,0,2775386,493841,,0,2775386,493841,,0,0,0,PDN
SM097,,2015,1995,,0,2775386,493841,,0,2775386,493841,,0,0,0,PDN
SM097,,2016,1995,,0,2775386,493841,,0,2775386,493841,,0,0,0,PDN
SM097,,2017,1995,,0,2775386,493841,,0,2775386,493841,,0,0,0,PDN
SM097,,2017,1995,,0,2775386,493841,,0,2775386,493841,,0,0,0,PDN
SM107,,1978,1964,,2504050,3280306,3087734,,0,0,0,,2504050,3280306,3087734,PDP
SM107,,1979,1964,,5030000,16800000,8019324,,448248,2047998,812660,,4581752,14752002,7206664,PDP
SM107,,1980,1964,,5398400,17024730,8427711,,1008142,4699452,1844343,,4390258,12325278,6583368,PDP
SM107,,1981,1964,,8541228,41702781,15961652,,2276772,11140259,4259024,,6264456,30562522,11702628,PDP
SM107,,1982,1964,,8541228,41702781,15961652,,3548262,18623338,6862023,,4992966,23079443,9099629,PDP
SM107,,1983,1964,,18123386,413966840,91782966,,4827064,305889659,59255829,,13296322,108077181,32527137,PDP
SM107,,1984,1964,,18635049,433292286,95733321,,5854612,335516966,65555140,,12780437,97775320,30178181,PDP
SM107,,1985,1964,,18638622,476998581,103513814,,6903656,367236182,72248172,,11734966,109762399,31265642,PDP
SM107,,1986,1964,,18606247,491472296,106056833,,7691998,390944560,77255087,,10914249,100527736,28801746,PDP
SM107,,1987,1964,,18849337,612937447,127912940,,8331516,417295425,82583371,,10517821,195642022,45329569,PDP
SM107,,1988,1964,,14979641,699942317,139524537,,8959752,448042876,88682684,,6019889,251899441,50841853,PDP
SM107,,1989,1964,,14989863,701908914,139884688,,9466633,473672595,93750013,,5523230,228236319,46134675,PDP
SM107,,1990,1964,,12999788,670817151,132362270,,9761295,494951175,97830899,,3238493,175865976,34531371,PDP
SM107,,1991,1964,,12997135,670817151,132359617,,10250862,513285596,101582819,,2746273,157531555,30776798,PDP
SM107,,1992,1964,,12495576,669674183,131654683,,10647254,526181408,104273839,,1848322,143492775,27380844,PDP
SM107,,1993,1964,,12927300,591461211,118169508,,10980612,537450641,106612399,,1946688,54010570,11557109,PDP
SM107,,1994,1964,,12925485,591494864,118173681,,11296370,548766825,108941713,,1629115,42728039,9231968,PDP
SM107,,1995,1964,,13627190,593987347,119318889,,11574924,556666341,110625874,,2052266,37321006,8693015,PDP
SM107,,1996,1964,,13965076,615080264,123409963,,11795375,561715582,111744767,,2169701,53364682,11665196,PDP
SM107,,1997,1964,,13977708,620790627,124438674,,11965296,564927856,112486267,,2012412,55862771,11952407,PDP
SM107,,1998,1964,,13977708,620790627,124438674,,12116536,567027654,113011136,,1861172,53762973,11427538,PDP
SM107,,1999,1964,,14038675,576840397,116679315,,12069486,559409153,111608481,,1969189,17431244,5070834,PDP
SM107,,2000,1964,,13868673,572405577,115720199,,12246118,560723894,112019053,,1622555,11681683,3701146,PDP
SM107,,2001,1964,,13450562,571132671,115075592,,12383148,561697437,112329311,,1067414,9435234,2746281,PDP
SM107,,2002,1964,,13627494,572184459,115439675,,12416460,562393292,112486441,,1211034,9791167,2953234,PDP
SM107,,2003,1964,,13789992,572335640,115629074,,12548264,563169439,112756349,,1241728,9166201,2872725,PDP
SM107,,2004,1964,,13634127,581594315,117120660,,12709236,564419541,113139759,,924891,17174774,3980901,PDP
SM107,,2005,1964,,13868042,581368410,117314378,,12849910,568265227,113964719,,1018132,13103183,3349659,PDP
SM107,,2006,1964,,13666429,584156038,117608785,,12961894,568920521,114193303,,704535,15235517,3415482,PDP
SM107,,2007,1964,,13576089,582185550,117167824,,13059565,569981175,114479703,,516524,12204375,2688121,PDP
SM107,,2008,1964,,13967040,587099735,118433185,,13114821,571265638,114763511,,852219,15834097,3669674,PDP
SM107,,2009,1964,,13967298,595716880,119966739,,13114820,582426798,116749477,,852478,13290082,3217263,PDP
SM107,,2010,1964,,13967298,595716880,119966739,,13151526,582865244,116864200,,815772,12851636,3102540,PDP
SM107,,2011,1964,,13946258,595635166,119931159,,13236469,584555398,117249880,,709789,11079768,2681277,PDP
SM107,,2012,1964,,13946038,594663264,119758003,,13315307,586128954,117608711,,630731,8534310,2149291,PDP
SM107,,2013,1964,,13946038,594556139,119738941,,13380952,587622396,117940093,,565086,6933743,1798847,PDP
SM107,,2014,1964,,13892428,594505209,119676269,,13464166,588923499,118254820,,428262,5581710,1421449,PDP
SM107,,2015,1964,,14078345,598059717,120494660,,13559330,590072022,118554347,,519015,7987695,1940313,PDP
SM107,,2016,1964,,14078345,598059717,120494660,,13625541,590570516,118709259,,452804,7489201,1785402,PDP
SM107,,2017,1964,,14075744,598037768,120488154,,13694070,590958658,118846851,,381674,7079110,1641303,PDP
SM107,,2017,1964,,14075744,598037768,120488154,,13694070,590958658,118846851,,381674,7079110,1641303,PDP
SM109,,1992,2003,,0,1088925,193759,,0,394004,70107,,0,694921,123652,PDN
SM109,,1993,2003,,0,1088925,193759,,0,456654,81255,,0,632271,112504,PDN
SM109,,1994,2003,,0,1088925,193759,,0,506803,90178,,0,582122,103581,PDN
SM109,,1995,2003,,68,675122,120196,,0,537771,95689,,68,137351,24507,PDN
SM109,,1996,2003,,68,675122,120196,,0,554011,98578,,68,121111,21618,PDN
SM109,,1997,2003,,0,569942,101413,,0,567027,100894,,0,2915,519,PDN
SM109,,1998,2003,,0,569942,101413,,0,569942,101413,,0,0,0,PDN
SM109,,1999,2003,,0,569942,101413,,0,569942,101413,,0,0,0,PDN
SM109,,2000,2003,,0,569942,101413,,0,569942,101413,,0,0,0,PDN
SM109,,2003,2003,,80272,8027261,1508610,,0,0,0,,80272,8027261,1508610,PDN
SM109,,2004,2003,,348904,25713589,4924276,,29094,821289,175231,,319810,24892300,4749045,PDN
SM109,,2005,2003,,277185,19813167,3802660,,151735,7960706,1568231,,125450,11852461,2234429,PDN
SM109,,2006,2003,,247992,17829362,3420476,,182303,11077275,2153348,,65689,6752087,1267128,PDN
SM109,,2007,2003,,247992,17829362,3420476,,192363,12123751,2349614,,55629,5705611,1070862,PDN
SM109,,2008,2003,,247992,17829362,3420476,,196640,12979728,2506200,,51352,4849634,914276,PDN
SM109,,2009,2003,,254967,17220255,3319070,,198892,13485965,2598530,,56075,3734290,720540,PDN
SM109,,2010,2003,,254967,17220255,3319070,,200423,13827422,2660819,,54544,3392833,658252,PDN
SM109,,2011,2003,,254967,17220255,3319070,,201682,14065817,2704496,,53285,3154438,614573,PDN
SM109,,2012,2003,,245144,16708067,3218110,,202086,14158163,2721332,,43058,2549904,496778,PDN
SM109,,2013,2003,,202086,14158163,2721332,,202086,14158163,2721332,,0,0,0,PDN
SM109,,2014,2003,,202086,14158163,2721332,,202086,14158163,2721332,,0,0,0,PDN
SM109,,2015,2003,,202086,14158163,2721332,,202086,14158163,2721332,,0,0,0,PDN
SM109,,2016,2003,,202086,14158163,2721332,,202086,14158163,2721332,,0,0,0,PDN
SM109,,2017,2003,,202086,14157982,2721300,,202086,14157982,2721300,,0,0,0,PDN
SM109,,2017,2003,,202086,14157982,2721300,,202086,14157982,2721300,,0,0,0,PDN
SM113,,1981,1979,,14700,14700000,2630358,,0,40634,7230,,14700,14659366,2623128,PDN
SM113,,1982,1979,,71800,14700000,2687458,,15350,3144881,574937,,56450,11555119,2112521,PDN
SM113,,1983,1979,,83293,16666548,3048871,,21358,5769257,1047916,,61935,10897291,2000955,PDN
SM113,,1984,1979,,94947,16666548,3060525,,31799,7094778,1294215,,63148,9571770,1766310,PDN
SM113,,1985,1979,,32124,7380153,1345318,,31992,7330636,1336376,,132,49517,8942,PDN
SM113,,1986,1979,,35636,8102885,1477430,,32097,7409369,1350490,,3539,693516,126940,PDN
SM113,,1987,1979,,32868,7409369,1351261,,32868,7409369,1351261,,0,0,0,PDN
SM113,,1988,1979,,32868,7409369,1351261,,32868,7409369,1351261,,0,0,0,PDN
SM113,,1989,1979,,32868,7409369,1351261,,32868,7409369,1351261,,0,0,0,PDN
SM113,,1990,1979,,32868,7409369,1351261,,32868,7409369,1351261,,0,0,0,PDN
SM113,,1991,1979,,32868,7409369,1351261,,32868,7409369,1351261,,0,0,0,PDN
SM113,,1992,1979,,32868,7409369,1351261,,32868,7409369,1351261,,0,0,0,PDN
SM113,,1993,1979,,32868,7409369,1351261,,32868,7409369,1351261,,0,0,0,PDN
SM113,,1994,1979,,32868,7409369,1351261,,32868,7409369,1351261,,0,0,0,PDN
SM113,,1995,1979,,32868,7409369,1351261,,32868,7409369,1351261,,0,0,0,PDN
SM113,,1996,1979,,32868,7409369,1351261,,32868,7409369,1351261,,0,0,0,PDN
SM113,,1997,1979,,32868,7409369,1351261,,32868,7409369,1351261,,0,0,0,PDN
SM113,,1998,1979,,32868,7409369,1351261,,32868,7409369,1351261,,0,0,0,PDN
SM113,,1999,1979,,32868,7409369,1351261,,32868,7409369,1351261,,0,0,0,PDN
SM113,,2000,1979,,32868,7409369,1351261,,32868,7409369,1351261,,0,0,0,PDN
SM113,,2001,1979,,32868,7409369,1351261,,32868,7409369,1351261,,0,0,0,PDN
SM113,,2002,1979,,32868,7409369,1351261,,32868,7409369,1351261,,0,0,0,PDN
SM113,,2003,1979,,32868,7409369,1351261,,32868,7409369,1351261,,0,0,0,PDN
SM113,,2004,1979,,32868,7409369,1351261,,32868,7409369,1351261,,0,0,0,PDN
SM113,,2005,1979,,32868,7409369,1351261,,32868,7409369,1351261,,0,0,0,PDN
SM113,,2006,1979,,32868,7409369,1351261,,32868,7409369,1351261,,0,0,0,PDN
SM113,,2007,1979,,32868,7409369,1351261,,32868,7409369,1351261,,0,0,0,PDN
SM113,,2008,1979,,32868,7409369,1351261,,32868,7409369,1351261,,0,0,0,PDN
SM113,,2009,1979,,32868,7557755,1377663,,32868,7557755,1377663,,0,0,0,PDN
SM113,,2010,1979,,32868,7557755,1377663,,32868,7557755,1377663,,0,0,0,PDN
SM113,,2011,1979,,32868,7557755,1377663,,32868,7557755,1377663,,0,0,0,PDN
SM113,,2012,1979,,32868,7557755,1377663,,32868,7557755,1377663,,0,0,0,PDN
SM113,,2013,1979,,32868,7557755,1377663,,32868,7557755,1377663,,0,0,0,PDN
SM113,,2014,1979,,32868,7557755,1377663,,32868,7557755,1377663,,0,0,0,PDN
SM113,,2015,1979,,32868,7557755,1377663,,32868,7557755,1377663,,0,0,0,PDN
SM113,,2016,1979,,32868,7557755,1377663,,32868,7557755,1377663,,0,0,0,PDN
SM113,,2017,1979,,32868,7557755,1377663,,32868,7557755,1377663,,0,0,0,PDN
SM113,,2017,1979,,32868,7557755,1377663,,32868,7557755,1377663,,0,0,0,PDN
SM115,,1975,1971,,30200000,12382000,32403203,,0,0,0,,30200000,12382000,32403203,PDP
SM115,,1976,1971,,5845318,101347082,23878607,,0,0,0,,5845318,101347082,23878607,PDP
SM115,,1977,1971,,2598321,38441834,9438505,,0,0,0,,2598321,38441834,9438505,PDP
SM115,,1978,1971,,763003,47094752,9142852,,12079,510120,102848,,750924,46584632,9040004,PDP
SM115,,1979,1971,,7268579,119583465,28546776,,816513,22276726,4780343,,6452066,97306739,23766433,PDP
SM115,,1980,1971,,4033911,154555819,31534946,,1360770,47185877,9756834,,2673141,107369942,21778112,PDP
SM115,,1981,1971,,3623968,164949305,32974378,,1737080,70500591,14281669,,1886888,94448714,18692709,PDP
SM115,,1982,1971,,23623968,184949305,56533097,,2189898,89018819,18029546,,21434070,95930486,38503551,PDP
SM115,,1983,1971,,27266119,483285220,113259930,,4827233,112679779,24877016,,22438886,370605441,88382914,PDP
SM115,,1984,1971,,24078848,358292313,87831929,,7636989,154247896,35083234,,16441859,204044417,52748695,PDP
SM115,,1985,1971,,24135275,377210258,91254538,,9513473,182757600,42032619,,14621802,194452658,49221919,PDP
SM115,,1986,1971,,20422433,345737716,81941600,,11119815,217431970,49808778,,9302618,128305746,32132822,PDP
SM115,,1987,1971,,20961548,367569801,86365427,,12299507,238314784,54704273,,8662041,129255017,31661154,PDP
SM115,,1988,1971,,21609018,350859025,84039449,,13154032,253773668,58309489,,8454986,97085357,25729960,PDP
SM115,,1989,1971,,21472468,338346308,81676437,,14177584,265279803,61380396,,7294884,73066505,20296041,PDP
SM115,,1990,1971,,20364717,319086496,77141674,,15095251,272421952,63568908,,5269466,46664544,13572766,PDP
SM115,,1991,1971,,20314239,319086496,77091196,,15843818,278299403,65363285,,4470421,40787093,11727911,PDP
SM115,,1992,1971,,20311219,320396192,77321218,,16462331,284822923,67142566,,3848888,35573269,10178652,PDP
SM115,,1993,1971,,20196388,316308790,76479091,,17118619,292209480,69113188,,3077769,24099310,7365903,PDP
SM115,,1994,1971,,21899406,371976919,88087470,,18041454,304732354,72264293,,3857952,67244565,15823177,PDP
SM115,,1995,1971,,22128481,391029880,91706751,,19153550,320954985,76262978,,2974931,70074895,15443773,PDP
SM115,,1996,1971,,31609722,470663816,115357732,,21242219,339176108,81593840,,10367503,131487708,33763892,PDP
SM115,,1997,1971,,31849497,490754895,119172432,,23877296,362295107,88342618,,7972201,128459788,30829814,PDP
SM115,,1998,1971,,31833369,483702245,117901384,,25565569,377706357,92773106,,6267800,105995888,25128278,PDP
SM115,,1999,1971,,33928163,433383513,111042668,,26779548,395395854,97134682,,7148615,37987659,13907986,PDP
SM115,,2000,1971,,37082368,439442976,115275069,,27892276,402484205,99508683,,9190092,36958771,15766386,PDP
SM115,,2001,1971,,37794897,447272544,117380759,,29309607,405818844,101519366,,8485290,41453700,15861393,PDP
SM115,,2002,1971,,40004839,441147274,118500796,,30361345,412176069,103702283,,9643494,28971205,14798513,PDP
SM115,,2003,1971,,40194386,451180297,120475578,,31422292,416243341,105486943,,8772094,34936956,14988635,PDP
SM115,,2004,1971,,43317316,449567367,123311509,,32594300,417941368,106961091,,10723016,31625999,16350418,PDP
SM115,,2005,1971,,44967462,454824957,125897170,,33824663,419629330,108491804,,11142799,35195627,17405366,PDP
SM115,,2006,1971,,45191101,449163547,125113440,,34990843,421937443,110068680,,10200258,27226104,15044760,PDP
SM115,,2007,1971,,45815111,448274504,125579258,,36254195,425801108,112019517,,9560916,22473396,13559741,PDP
SM115,,2008,1971,,45824089,449029263,125722534,,36939896,426690299,112863437,,8884193,22338964,12859097,PDP
SM115,,2009,1971,,42335835,451216642,122623495,,37554920,434964314,114950704,,4780915,16252328,7672789,PDP
SM115,,2010,1971,,42904036,451535517,123248435,,38252033,435638420,115767766,,4652003,15897097,7480668,PDP
SM115,,2011,1971,,43407929,447608572,123053583,,39051657,436711799,116758381,,4356272,10896773,6295199,PDP
SM115,,2012,1971,,44624750,455912482,125747969,,40188921,438461306,118206946,,4435829,17451176,7541021,PDP
SM115,,2013,1971,,44624751,455912482,125747970,,41120892,441100450,119608514,,3503859,14812032,6139453,PDP
SM115,,2014,1971,,47366151,469517878,130910259,,42234084,447234331,121813146,,5132067,22283547,9097111,PDP
SM115,,2015,1971,,47179309,462546186,129482902,,43350908,449963260,123415545,,3828401,12582926,6067357,PDP
SM115,,2016,1971,,47203976,460577442,129157261,,44083348,451752277,124466315,,3120628,8825165,4690943,PDP
SM115,,2017,1971,,47203976,460577442,129157261,,44501088,452844109,125078331,,2702888,7733333,4078926,PDP
SM115,,2017,1971,,47203976,460577442,129157261,,44501088,452844109,125078331,,2702888,7733333,4078926,PDP
SM117,,1987,1985,,260916,19751359,3775393,,0,0,0,,260916,19751359,3775393,PDN
SM117,,1989,1985,,482554,15421870,3226659,,0,0,0,,482554,15421870,3226659,PDN
SM117,,1990,1985,,487979,14588742,3083841,,93224,3299556,680334,,394755,11289186,2403507,PDN
SM117,,1991,1985,,487979,14588742,3083841,,170410,6449867,1318073,,317569,8138875,1765768,PDN
SM117,,1992,1985,,661421,17160663,3714920,,277023,10358218,2120122,,384398,6802445,1594798,PDN
SM117,,1993,1985,,700224,20122575,4280753,,318352,12545104,2550577,,381872,7577471,1730176,PDN
SM117,,1994,1985,,631085,20615077,4299248,,323824,13246957,2680934,,307261,7368120,1618314,PDN
SM117,,1995,1985,,545563,22314409,4516098,,332658,13967628,2818001,,212905,8346781,1698097,PDN
SM117,,1996,1985,,532262,22161569,4475602,,335510,14258878,2872677,,196752,7902691,1602925,PDN
SM117,,1997,1985,,540794,24006939,4812491,,354157,16206548,3237884,,186637,7800391,1574607,PDN
SM117,,1998,1985,,540794,24006939,4812491,,364352,17452708,3469816,,176442,6554231,1342675,PDN
SM117,,1999,1985,,573229,24790541,4984358,,369999,18168524,3602832,,203230,6622017,1381526,PDN
SM117,,2000,1985,,494378,25275330,4991768,,375461,18795632,3719880,,118917,6479698,1271888,PDN
SM117,,2001,1985,,494415,25278183,4992313,,383762,19754977,3898882,,110653,5523206,1093431,PDN
SM117,,2002,1985,,448245,22059720,4373462,,389286,20333617,4007367,,58959,1726103,366095,PDN
SM117,,2003,1985,,448245,22059720,4373462,,389286,20333617,4007367,,58959,1726103,366095,PDN
SM117,,2004,1985,,438329,21636294,4288203,,389286,20333617,4007367,,49043,1302677,280836,PDN
SM117,,2005,1985,,389286,20333617,4007367,,389286,20333617,4007367,,0,0,0,PDN
SM117,,2006,1985,,389286,20333617,4007367,,389286,20333617,4007367,,0,0,0,PDN
SM117,,2007,1985,,389286,20333617,4007367,,389286,20333617,4007367,,0,0,0,PDN
SM117,,2008,1985,,389286,20333617,4007367,,389286,20333617,4007367,,0,0,0,PDN
SM117,,2009,1985,,389286,20675590,4068216,,389286,20675590,4068216,,0,0,0,PDN
SM117,,2010,1985,,389286,20675590,4068216,,389286,20675590,4068216,,0,0,0,PDN
SM117,,2011,1985,,389286,20675590,4068216,,389286,20675590,4068216,,0,0,0,PDN
SM117,,2012,1985,,389286,20675590,4068216,,389286,20675590,4068216,,0,0,0,PDN
SM117,,2013,1985,,389286,20675590,4068216,,389286,20675590,4068216,,0,0,0,PDN
SM117,,2014,1985,,389286,20675590,4068216,,389286,20675590,4068216,,0,0,0,PDN
SM117,,2015,1985,,389286,20675590,4068216,,389286,20675590,4068216,,0,0,0,PDN
SM117,,2016,1985,,389286,20675590,4068216,,389286,20675590,4068216,,0,0,0,PDN
SM117,,2017,1985,,389286,20675590,4068216,,389286,20675590,4068216,,0,0,0,PDN
SM117,,2017,1985,,389286,20675590,4068216,,389286,20675590,4068216,,0,0,0,PDN
SM128,,1976,1974,,28000000,56000000,37964413,,0,0,0,,28000000,56000000,37964413,PDP
SM128,,1977,1974,,28000000,56000000,37964413,,2611814,1717185,2917363,,25388186,54282815,35047050,PDP
SM128,,1978,1974,,96962302,114817640,117392487,,11396146,12586994,13635825,,85566156,102230646,103756662,PDP
SM128,,1979,1974,,96312184,123557205,118297452,,22857703,25851617,27457635,,73454481,97705588,90839817,PDP
SM128,,1980,1974,,105484806,147762831,131777125,,34692259,48596476,43339319,,70792547,99166355,88437806,PDP
SM128,,1981,1974,,96657293,157630682,124705457,,44617111,67973136,56711975,,52040182,89657546,67993482,PDP
SM128,,1982,1974,,96946793,207560931,133879343,,53595300,82928449,68351252,,43351493,124632482,65528091,PDP
SM128,,1983,1974,,102730247,216829891,141312078,,60792236,94590247,77623241,,41938011,122239644,63688837,PDP
SM128,,1984,1974,,111950198,228528750,152613677,,66396370,103518943,84816111,,45553828,125009807,67797566,PDP
SM128,,1985,1974,,120690291,257417479,166494113,,71973278,113817745,92225546,,48717013,143599734,74268567,PDP
SM128,,1986,1974,,122251182,259841104,168486254,,77629668,122170176,99368133,,44621514,137670928,69118121,PDP
SM128,,1987,1974,,125011857,221193926,164370207,,82105359,135246666,106170602,,42906498,85947260,58199605,PDP
SM128,,1988,1974,,128485481,238418156,170908640,,85915472,147764918,112208162,,42570009,90653238,58700478,PDP
SM128,,1989,1974,,120109336,228993096,160855438,,89274368,157296787,117263120,,30834968,71696309,43592318,PDP
SM128,,1990,1974,,121890779,232139511,163196742,,93123484,165545630,122580002,,28767295,66593881,40616740,PDP
SM128,,1991,1974,,121850823,231968858,163126421,,96366178,173733832,127279671,,25484645,58235026,35846750,PDP
SM128,,1992,1974,,121841650,234084062,163493618,,99179370,183386639,131810445,,22662280,50697423,31683173,PDP
SM128,,1993,1974,,115592919,255374650,161033248,,101940926,196659288,136933682,,13651993,58715362,24099566,PDP
SM128,,1994,1974,,117051372,262777500,163808934,,104846562,209580979,142138551,,12204810,53196521,21670383,PDP
SM128,,1995,1974,,117046520,253534882,162159488,,106656683,218548114,145544248,,10389837,34986768,16615240,PDP
SM128,,1996,1974,,125971630,270687292,174136629,,108435274,223712798,148241822,,17536356,46974494,25894807,PDP
SM128,,1997,1974,,120443949,279545534,170185147,,110143621,233599158,151709307,,10300328,45946376,18475840,PDP
SM128,,1998,1974,,120479261,274999972,169411640,,111788075,243239822,155069182,,8691186,31760150,14342458,PDP
SM128,,1999,1974,,121464360,317537360,177965670,,113387901,261613538,159938353,,8076459,55923822,18027317,PDP
SM128,,2000,1974,,132302896,336169993,192119621,,115634270,276715079,164871829,,16668626,59454914,27247792,PDP
SM128,,2001,1974,,134319622,335120317,193949572,,119413686,290389527,171084420,,14905936,44730790,22865152,PDP
SM128,,2002,1974,,138032273,353725685,200972787,,122164767,301494103,175811405,,15867506,52231582,25161382,PDP
SM128,,2003,1974,,137154284,359526161,201126910,,125054038,310701305,180338968,,12100246,48824856,20787942,PDP
SM128,,2004,1974,,137421853,370230160,203299105,,127403590,322286073,184749866,,10018263,47944087,18549239,PDP
SM128,,2005,1974,,137172066,378691635,204554919,,128706179,331686476,187725125,,8465887,47005159,16829794,PDP
SM128,,2006,1974,,141106768,389545375,210420891,,128792256,339170841,189142939,,12314512,50374534,21277952,PDP
SM128,,2007,1974,,141329118,375292211,208107091,,130384324,349820319,192629932,,10944794,25471892,15477159,PDP
SM128,,2008,1974,,142038540,377396765,209190989,,131941561,354657654,195047905,,10096979,22739111,14143084,PDP
SM128,,2009,1974,,142449863,385164518,210984473,,133242104,362801040,197797445,,9207759,22363478,13187027,PDP
SM128,,2010,1974,,142449863,385164518,210984473,,134576116,366758489,199835629,,7873747,18406029,11148839,PDP
SM128,,2011,1974,,142888546,384371055,211281970,,135673257,369196267,201366540,,7215289,15174788,9915427,PDP
SM128,,2012,1974,,142888147,384234294,211257236,,136666217,371247923,202724564,,6221930,12986371,8532671,PDP
SM128,,2013,1974,,142888147,384234294,211257236,,137685515,373678688,204176383,,5202632,10555606,7080851,PDP
SM128,,2014,1974,,143953360,385685219,212580617,,138800912,375130535,205550113,,5152448,10554684,7030505,PDP
SM128,,2015,1974,,145236868,384755560,213698707,,139875258,376251150,206823858,,5361610,8504410,6874850,PDP
SM128,,2016,1974,,147544429,387995996,216582858,,140722121,377301087,207857545,,6822308,10694909,8725316,PDP
SM128,,2017,1974,,147513399,387989491,216550671,,141482467,378197035,208777308,,6030932,9792456,7773363,PDP
SM128,,2017,1974,,147513399,387989491,216550671,,141482467,378197035,208777308,,6030932,9792456,7773363,PDP
SM130,,1975,1973,,45000000,180000000,77028470,,0,0,0,,45000000,180000000,77028470,PDP
SM130,,1976,1973,,121584117,148888575,148076746,,1335652,821506,1481827,,120248465,148067069,146594919,PDP
SM130,,1977,1973,,125590424,143828667,151182714,,6563855,3236405,7139728,,119026569,140592262,144042986,PDP
SM130,,1978,1973,,125608000,143840826,151202453,,14360046,6989565,15603741,,111247954,136851261,135598712,PDP
SM130,,1979,1973,,133147551,153187206,160405061,,24392515,12776209,26665862,,108755036,140410997,133739199,PDP
SM130,,1980,1973,,130246871,148674311,156701375,,37696034,23981086,41963131,,92550837,124693225,114738244,PDP
SM130,,1981,1973,,141846407,166488360,171470670,,52015085,40279198,59182202,,89831322,126209162,112288468,PDP
SM130,,1982,1973,,157991849,175021353,189134439,,65292050,55123903,75100574,,92699799,119897450,114033865,PDP
SM130,,1983,1973,,173810723,205274745,210336478,,78225285,68470789,90408699,,95585438,136803956,119927779,PDP
SM130,,1984,1973,,186577025,290263450,238225326,,89828903,78506076,103797956,,96748122,211757374,134427370,PDP
SM130,,1985,1973,,206212287,309272500,261242981,,100014655,88012056,115675163,,106197632,221260444,145567818,PDP
SM130,,1986,1973,,209632493,309602476,264721902,,110711295,97724918,128100070,,98921198,211877558,136621832,PDP
SM130,,1987,1973,,202185839,215825640,240588978,,121688921,108960072,141076834,,80496918,106865568,99512144,PDP
SM130,,1988,1973,,195728451,191683809,229835890,,130018506,117224745,150877002,,65709945,74459064,78958888,PDP
SM130,,1989,1973,,197708559,200355437,233358993,,136534311,125384503,158844721,,61174248,74970934,74514272,PDP
SM130,,1990,1973,,189706641,223692366,229509553,,141307826,133396060,165043780,,48398815,90296306,64465773,PDP
SM130,,1991,1973,,189859288,226161807,230101602,,146756914,142221104,172063160,,43102374,83940703,58038442,PDP
SM130,,1992,1973,,183760953,219820451,222874912,,151804052,152738990,178981808,,31956901,67081461,43893104,PDP
SM130,,1993,1973,,188505494,232385006,229855139,,156555380,163137359,185583380,,31950114,69247647,44271759,PDP
SM130,,1994,1973,,183482885,258155952,229418108,,160870886,179467705,192804641,,22611999,78688247,36613467,PDP
SM130,,1995,1973,,184933551,260444170,231275930,,164236649,194799179,198898425,,20696902,65644991,32377505,PDP
SM130,,1996,1973,,190286997,277297894,239628259,,167063113,205995748,203717161,,23223884,71302146,35911098,PDP
SM130,,1997,1973,,177477202,244119979,220914921,,169658044,215126380,207936759,,7819158,28993599,12978162,PDP
SM130,,1998,1973,,177644342,244237508,221102973,,171913176,222083924,211429888,,5731166,22153584,9673085,PDP
SM130,,1999,1973,,180367662,246998031,224317490,,173783933,227872081,214330567,,6583729,19125950,9986923,PDP
SM130,,2000,1973,,181889553,248401588,226089124,,175460216,230474095,216469841,,6429337,17927493,9619283,PDP
SM130,,2001,1973,,183288267,254260962,228530431,,176965931,234785112,218742641,,6322336,19475850,9787790,PDP
SM130,,2002,1973,,185092179,246620916,228974904,,178481484,236631021,220586648,,6610695,9989895,8388256,PDP
SM130,,2003,1973,,185689216,254967893,231057169,,179733690,237803553,222047489,,5955526,17164340,9009680,PDP
SM130,,2004,1973,,186060497,260297096,232376707,,180915862,241147842,223824731,,5144635,19149254,8551976,PDP
SM130,,2005,1973,,189468357,256826659,235167051,,181885670,243855123,225276261,,7582687,12971536,9890790,PDP
SM130,,2006,1973,,187457017,251318716,232175650,,182849770,245988799,226620019,,4607247,5329917,5555631,PDP
SM130,,2007,1973,,187226657,251038353,231895403,,183617886,246590896,227495270,,3608771,4447457,4400133,PDP
SM130,,2008,1973,,187932666,256843528,233634361,,184088168,246909576,228022256,,3844498,9933952,5612105,PDP
SM130,,2009,1973,,189168744,261876371,235765961,,184610608,251696731,229396506,,4558136,10179640,6369460,PDP
SM130,,2010,1973,,189171526,262154531,235818238,,185008925,252082567,229863476,,4162601,10071964,5954766,PDP
SM130,,2011,1973,,188971229,256502855,234612303,,185592818,252560988,230532498,,3378411,3941867,4079812,PDP
SM130,,2012,1973,,190195450,256925697,235911761,,186197194,253045369,231223063,,3998256,3880328,4688706,PDP
SM130,,2013,1973,,190306865,257469352,236119913,,186758293,253468516,231859455,,3548572,4000836,4260466,PDP
SM130,,2014,1973,,190710914,257468237,236523766,,187453514,253915354,232634186,,3257400,3552883,3889584,PDP
SM130,,2015,1973,,190772748,257659318,236619600,,188005643,254386789,233270197,,2767105,3272529,3349408,PDP
SM130,,2016,1973,,191456680,257107556,237205354,,188505207,254573344,233802957,,2951473,2534212,3402399,PDP
SM130,,2017,1973,,191455369,257089665,237200860,,188771177,254667483,234085677,,2684192,2422182,3115184,PDP
SM130,,2017,1973,,191455369,257089665,237200860,,188771177,254667483,234085677,,2684192,2422182,3115184,PDP
SM137,,1976,1973,,0,50000000,8896797,,0,0,0,,0,50000000,8896797,PDP
SM137,,1977,1973,,12108052,224546910,52063018,,0,0,0,,12108052,224546910,52063018,PDP
SM137,,1978,1973,,12108052,224546910,52063018,,0,0,0,,12108052,224546910,52063018,PDP
SM137,,1979,1973,,18596225,282037464,68780827,,458862,10482757,2324121,,18137363,271554707,66456706,PDP
SM137,,1980,1973,,19231078,288715543,70603950,,1574861,31958985,7261513,,17656217,256756558,63342437,PDP
SM137,,1981,1973,,19247078,288745543,70625288,,2401760,51000321,11476550,,16845318,237745222,59148738,PDP
SM137,,1982,1973,,23732925,300068979,77125982,,3869244,68863182,16122479,,19863681,231205797,61003503,PDP
SM137,,1983,1973,,25228112,363121730,89840519,,5845917,92556633,22315069,,19382195,270565097,67525450,PDP
SM137,,1984,1973,,29029017,388460967,98150186,,7470909,121375934,29068050,,21558108,267085033,69082136,PDP
SM137,,1985,1973,,34695531,431030847,111391411,,8650711,148562977,35085404,,26044820,282467870,76306007,PDP
SM137,,1986,1973,,17299554,347101035,79061304,,9788757,183565508,42451659,,7510797,163535527,36609645,PDP
SM137,,1987,1973,,17326336,347221142,79109457,,10588993,209335542,47837310,,6737343,137885600,31272147,PDP
SM137,,1988,1973,,17558899,364031021,82333102,,11377869,248518380,55598221,,6181030,115512641,26734881,PDP
SM137,,1989,1973,,18410801,397981336,89225985,,11811434,271403015,60103785,,6599367,126578321,29122200,PDP
SM137,,1990,1973,,16063680,353219618,78914146,,12083381,280729962,62035332,,3980299,72489656,16878814,PDP
SM137,,1991,1973,,16414932,353183350,79258944,,12790735,293919717,65089617,,3624197,59263633,14169327,PDP
SM137,,1992,1973,,16524399,364201991,81329024,,13343518,300351618,66786866,,3180881,63850373,14542158,PDP
SM137,,1993,1973,,16584693,366037486,81715918,,13746041,302669841,67601885,,2838652,63367645,14114033,PDP
SM137,,1994,1973,,17252833,367383898,82623633,,14416970,309477244,69484095,,2835863,57906654,13139538,PDP
SM137,,1995,1973,,18901383,369044062,84567586,,16085882,313529303,71874014,,2815501,55514759,12693572,PDP
SM137,,1996,1973,,22030206,378334567,89349524,,17425340,317316943,73887430,,4604866,61017624,15462094,PDP
SM137,,1997,1973,,20784583,331496145,79769662,,18452003,320450015,75471579,,2332580,11046130,4298083,PDP
SM137,,1998,1973,,20804096,333033279,80062687,,19089625,323445776,76642254,,1714471,9587503,3420433,PDP
SM137,,1999,1973,,21299261,340883851,81954751,,19543040,326476023,77634859,,1756221,14407828,4319892,PDP
SM137,,2000,1973,,21675997,342088652,82545864,,19950494,331045010,78855300,,1725503,11043642,3690564,PDP
SM137,,2001,1973,,30420983,383983087,98745376,,20321287,333657546,79690957,,10099696,50325541,19054419,PDP
SM137,,2002,1973,,31109240,379690091,98669755,,20836604,343104810,81887282,,10272636,36585281,16782473,PDP
SM137,,2003,1973,,31537814,374763776,98221760,,21759104,352279025,84442205,,9778710,22484751,13779555,PDP
SM137,,2004,1973,,31842978,390202691,101274062,,22711892,361052660,86956138,,9131086,29150031,14317924,PDP
SM137,,2005,1973,,34069639,395218373,104393193,,23320004,366637888,88558062,,10749635,28580485,15835131,PDP
SM137,,2006,1973,,32436894,388497299,101564527,,23771120,369515000,89521120,,8665774,18982299,12043407,PDP
SM137,,2007,1973,,32138595,385778406,100782439,,24271765,371815378,90431085,,7866830,13963028,10351354,PDP
SM137,,2008,1973,,32265843,393866804,102348904,,24432993,372694005,90748652,,7832850,21172799,11600252,PDP
SM137,,2009,1973,,32526396,398655601,103461556,,24652841,380080933,92282900,,7873555,18574668,11178656,PDP
SM137,,2010,1973,,32526396,398655601,103461556,,24838459,380678411,92574831,,7687937,17977190,10886725,PDP
SM137,,2011,1973,,32526401,398655883,103461611,,24981117,381124929,92796941,,7545284,17530954,10664670,PDP
SM137,,2012,1973,,32526401,398655883,103461611,,25144939,381823353,93085037,,7381462,16832530,10376574,PDP
SM137,,2013,1973,,33108120,400175243,104313679,,25298026,382730070,93399462,,7810094,17445173,10914217,PDP
SM137,,2014,1973,,33113132,400401519,104358952,,25541927,383694990,93815054,,7571205,16706529,10543898,PDP
SM137,,2015,1973,,33919472,401118771,105292916,,25789506,384549564,94214693,,8129966,16569207,11078223,PDP
SM137,,2016,1973,,33919472,401118771,105292916,,26006329,384832331,94481831,,7913143,16286440,10811086,PDP
SM137,,2017,1973,,33772602,400993379,105123734,,26180094,384955518,94677515,,7592508,16037861,10446220,PDP
SM137,,2017,1973,,33772602,400993379,105123734,,26180094,384955518,94677515,,7592508,16037861,10446220,PDP
SM142,,1975,1966,,14000,14000000,2505103,,0,0,0,,14000,14000000,2505103,PDP
SM142,,1976,1966,,14000,14000000,2505103,,0,0,0,,14000,14000000,2505103,PDP
SM142,,1977,1966,,14000,14000000,2505103,,2280270,14088887,4787189,,-2266270,-88887,-2282086,PDP
SM142,,1978,1966,,10309416,136846474,34659322,,3346235,13806326,5802877,,6963181,123040148,28856445,PDP
SM142,,1979,1966,,10329503,136846474,34679409,,4043756,22431343,8035098,,6285747,114415131,26644311,PDP
SM142,,1980,1966,,10329503,136846474,34679409,,4379879,29553583,9638524,,5949624,107292891,25040885,PDP
SM142,,1981,1966,,11903796,165248795,41307496,,4572839,44802531,12544820,,7330957,120446264,28762676,PDP
SM142,,1982,1966,,11976834,170951172,42395192,,4846973,53976403,14451315,,7129861,116974769,27943877,PDP
SM142,,1983,1966,,11205232,166354734,40805718,,5113508,66000753,16857414,,6091724,100353981,23948304,PDP
SM142,,1984,1966,,11205250,167317614,40977067,,5358596,81557539,19870614,,5846654,85760075,21106453,PDP
SM142,,1985,1966,,11441353,171108258,41887662,,5557098,91897540,21908973,,5884255,79210718,19978689,PDP
SM142,,1986,1966,,11559456,173923119,42506630,,5715379,101257469,23732722,,5844077,72665650,18773908,PDP
SM142,,1987,1966,,11424954,183014832,43989871,,5821900,107293891,24913340,,5603054,75720941,19076531,PDP
SM142,,1988,1966,,11413861,181630398,43732437,,5880074,111275274,25679945,,5533787,70355124,18052492,PDP
SM142,,1989,1966,,6203089,144498330,31914536,,5920365,116849529,26712096,,282724,27648801,5202440,PDP
SM142,,1990,1966,,6213540,149812618,32870589,,5957550,123412181,27917013,,255990,26400437,4953576,PDP
SM142,,1991,1966,,6221383,151942291,33257378,,5999581,132901300,29647499,,221802,19040991,3609879,PDP
SM142,,1992,1966,,6376945,164752584,35692351,,6034317,142006784,31302428,,342628,22745800,4389923,PDP
SM142,,1993,1966,,6465529,181504024,38761619,,6149136,148386709,32552465,,316393,33117315,6209154,PDP
SM142,,1994,1966,,6747614,181918108,39117384,,6413214,154225614,33855494,,334400,27692494,5261890,PDP
SM142,,1995,1966,,6697378,179579892,38651095,,6435661,157751070,34505246,,261717,21828822,4145849,PDP
SM142,,1996,1966,,6730672,181055400,38946935,,6500861,159869322,34947360,,229811,21186078,3999575,PDP
SM142,,1997,1966,,6859118,177885105,38511272,,6579451,160569731,35150578,,279667,17315374,3360694,PDP
SM142,,1998,1966,,7498746,168853909,37543926,,6712230,162112888,35557940,,786516,6741021,1985986,PDP
SM142,,1999,1966,,8040536,177986304,39710697,,7239365,166679901,36897710,,801171,11306403,2812987,PDP
SM142,,2000,1966,,9315156,190761578,43258498,,7718146,168638964,37725079,,1597010,22122614,5533419,PDP
SM142,,2001,1966,,10718709,207009332,47553109,,8116239,177678513,39731633,,2602470,29330819,7821476,PDP
SM142,,2002,1966,,11541033,225167446,51606414,,8491740,186363473,41652500,,3049293,38803973,9953914,PDP
SM142,,2003,1966,,11522143,222638475,51137530,,9048605,195108936,43765498,,2473538,27529539,7372032,PDP
SM142,,2004,1966,,11776622,244157216,55220966,,9532670,204544755,45928534,,2243952,39612461,9292432,PDP
SM142,,2005,1966,,11794488,244182766,55243378,,9784307,210960042,47321681,,2010181,33222724,7921697,PDP
SM142,,2006,1966,,11779798,275218278,60751021,,10125194,219466242,49176127,,1654604,55752036,11574894,PDP
SM142,,2007,1966,,11574458,259168940,57689927,,10602509,235582437,52521092,,971949,23586503,5168835,PDP
SM142,,2008,1966,,11960438,264845862,59086036,,10794622,241699179,53801593,,1165816,23146683,5284443,PDP
SM142,,2009,1966,,11772463,268323996,59516946,,10899381,247479934,54934955,,873082,20844062,4581989,PDP
SM142,,2010,1966,,11772657,268331073,59518399,,11103994,251165307,55795330,,668663,17165766,3723069,PDP
SM142,,2011,1966,,11772657,268331073,59518399,,11246525,253536696,56359816,,526132,14794377,3158584,PDP
SM142,,2012,1966,,11773769,261313954,58270914,,11350410,255022228,56728031,,423359,6291726,1542885,PDP
SM142,,2013,1966,,11773769,261313954,58270914,,11425159,256013390,56979143,,348610,5300564,1291771,PDP
SM142,,2014,1966,,11845590,262095144,58481735,,11486861,256719883,57166555,,358729,5375261,1315180,PDP
SM142,,2015,1966,,11872020,262962225,58662450,,11552024,257460575,57363515,,319996,5501650,1298937,PDP
SM142,,2016,1966,,11990987,263090362,58804218,,11611532,258023898,57523257,,379455,5066464,1280960,PDP
SM142,,2017,1966,,11990987,263090362,58804218,,11664579,258397152,57642720,,326408,4693210,1161500,PDP
SM142,,2017,1966,,11990987,263090362,58804218,,11664579,258397152,57642720,,326408,4693210,1161500,PDP
SM146,,1976,1974,,0,31000000,5516014,,0,0,0,,0,31000000,5516014,PDP
SM146,,1977,1974,,34222,34222660,6123663,,0,0,0,,34222,34222660,6123663,PDP
SM146,,1978,1974,,34222,34222660,6123663,,0,0,0,,34222,34222660,6123663,PDP
SM146,,1979,1974,,34222,34222660,6123663,,3562,1914854,344283,,30660,32307806,5779380,PDP
SM146,,1980,1974,,91934,35381710,6387612,,21316,9146109,1648738,,70618,26235601,4738874,PDP
SM146,,1981,1974,,91934,35381710,6387612,,38833,14876656,2685925,,53101,20505054,3701687,PDP
SM146,,1982,1974,,133400,49787782,8992436,,51097,19372954,3498242,,82303,30414828,5494194,PDP
SM146,,1983,1974,,231602,59224405,10769752,,55044,21101602,3809777,,176558,38122803,6959975,PDP
SM146,,1984,1974,,231602,59224405,10769752,,57805,22414555,4046160,,173797,36809850,6723592,PDP
SM146,,1985,1974,,231602,59224405,10769752,,59036,22873403,4129037,,172566,36351002,6640715,PDP
SM146,,1986,1974,,59036,22873403,4129037,,59036,22873403,4129037,,0,0,0,PDP
SM146,,1987,1974,,59036,22873403,4129037,,59036,22873403,4129037,,0,0,0,PDP
SM146,,1988,1974,,59036,22873403,4129037,,59036,22873403,4129037,,0,0,0,PDP
SM146,,1989,1974,,59036,22873403,4129037,,59036,22873403,4129037,,0,0,0,PDP
SM146,,1990,1974,,59036,22873403,4129037,,59036,22873403,4129037,,0,0,0,PDP
SM146,,1991,1974,,971587,48053230,9521984,,487887,35757770,6850480,,483700,12295460,2671504,PDP
SM146,,1992,1974,,6709372,193324567,41108761,,1539174,66472368,13366997,,5170198,126852199,27741764,PDP
SM146,,1993,1974,,7674901,219423984,46718315,,2795624,102537485,21040728,,4879277,116886499,25677587,PDP
SM146,,1994,1974,,7932941,227541448,48420743,,4222254,150822733,31059039,,3710687,76718715,17361704,PDP
SM146,,1995,1974,,8183895,234423261,49896219,,5016333,169213844,35125558,,3167562,65209417,14770661,PDP
SM146,,1996,1974,,7686174,228496886,48343983,,5409077,180452094,37517991,,2277097,48044792,10825992,PDP
SM146,,1997,1974,,7447347,221618073,46881168,,5677893,187973560,39125146,,1769454,33644513,7756022,PDP
SM146,,1998,1974,,6921406,216194521,45390182,,5793849,190185173,39634627,,1127557,26009348,5755555,PDP
SM146,,1999,1974,,6899924,205064006,43388181,,5830368,191264009,39863110,,1069556,13799997,3525071,PDP
SM146,,2000,1974,,6247964,204858509,42699656,,5840661,191882590,39983471,,407303,12975919,2716185,PDP
SM146,,2001,1974,,6495771,207716240,43455956,,5913770,193557166,40354547,,582001,14159074,3101409,PDP
SM146,,2002,1974,,6285036,203125630,42428386,,5945967,194332100,40524632,,339069,8793530,1903754,PDP
SM146,,2003,1974,,6285036,203125630,42428386,,5968473,194756431,40622642,,316563,8369199,1805744,PDP
SM146,,2004,1974,,6261470,199762308,41806365,,5985734,195039383,40690251,,275736,4722925,1116114,PDP
SM146,,2005,1974,,6260075,200093240,41863855,,5999531,195280532,40746957,,260544,4812708,1116898,PDP
SM146,,2006,1974,,8012973,209906571,45362897,,6249339,196417587,41199088,,1763634,13488984,4163809,PDP
SM146,,2007,1974,,7809091,206114106,44484199,,6562560,198444813,41873025,,1246531,7669293,2611174,PDP
SM146,,2008,1974,,7808937,218482135,46684762,,6782334,200185655,42402557,,1026603,18296480,4282205,PDP
SM146,,2009,1974,,7650097,209823271,44985197,,6968173,206025752,43627559,,681924,3797519,1357639,PDP
SM146,,2010,1974,,7650097,209823271,44985197,,7146697,207612881,44088492,,503400,2210390,896709,PDP
SM146,,2011,1974,,7640634,208173560,44682193,,7230084,207715747,44190182,,410550,457813,492011,PDP
SM146,,2012,1974,,7675703,208286879,44737426,,7374596,207859468,44360267,,301107,427411,377159,PDP
SM146,,2013,1974,,7675703,208286879,44737426,,7480446,207958829,44483797,,195257,328050,253629,PDP
SM146,,2014,1974,,7672040,208155980,44710471,,7493676,207966894,44498462,,178364,189086,212009,PDP
SM146,,2015,1974,,7672040,208155980,44710471,,7566972,208021063,44581397,,105068,134917,129075,PDP
SM146,,2016,1974,,7821289,208245329,44875619,,7671829,208102303,44700709,,149460,143026,174910,PDP
SM146,,2017,1974,,7889845,208302693,44954382,,7735963,208147247,44772839,,153882,155446,181541,PDP
SM146,,2017,1974,,7889845,208302693,44954382,,7735963,208147247,44772839,,153882,155446,181541,PDP
SM155,,1981,1979,,632800,9200000,2269811,,0,0,0,,632800,9200000,2269811,PDN
SM155,,1982,1979,,632800,9200000,2269811,,0,0,0,,632800,9200000,2269811,PDN
SM155,,1983,1979,,2766174,28055173,7758198,,648368,4483282,1446105,,2117806,23571891,6312093,PDN
SM155,,1984,1979,,2998465,31860603,8667611,,1176654,7426183,2498039,,1821811,24434420,6169572,PDN
SM155,,1985,1979,,18163763,99026231,35784089,,1915363,13795878,4370146,,16248400,85230353,31413943,PDN
SM155,,1986,1979,,14506851,108982931,33898832,,2641245,24633356,7024404,,11865606,84349575,26874428,PDN
SM155,,1987,1979,,14507240,108982931,33899221,,3259773,35614563,9596884,,11247467,73368368,24302337,PDN
SM155,,1988,1979,,10451698,139153214,35212056,,3913280,49886506,12789882,,6538418,89266708,22422174,PDN
SM155,,1989,1979,,10451698,139153214,35212056,,4200555,53515039,13722804,,6251143,85638175,21489252,PDN
SM155,,1990,1979,,10459741,138750224,35148393,,4355710,58587942,14780611,,6104031,80162282,20367782,PDN
SM155,,1991,1979,,10288728,138750224,34977380,,4470843,61487121,15411612,,5817885,77263103,19565768,PDN
SM155,,1992,1979,,5793694,91426136,22061690,,4733330,66706190,16602759,,1060364,24719946,5458931,PDN
SM155,,1993,1979,,5793694,91426136,22061690,,5021523,71869935,17809768,,772171,19556201,4251922,PDN
SM155,,1994,1979,,5793693,91426133,22061688,,5183336,74681540,18471866,,610357,16744593,3589822,PDN
SM155,,1995,1979,,5906655,92737708,22408027,,5296673,76567401,18920766,,609982,16170307,3487261,PDN
SM155,,1996,1979,,9122396,104681931,27749074,,5482949,82862645,20227192,,3639447,21819286,7521882,PDN
SM155,,1997,1979,,6125870,90269077,22187983,,5604421,86539079,21002834,,521449,3729998,1185149,PDN
SM155,,1998,1979,,6125870,90269077,22187983,,5641576,87475102,21206541,,484294,2793975,981442,PDN
SM155,,1999,1979,,6226713,112132035,26179033,,5643727,87521168,21216889,,582986,24610867,4962144,PDN
SM155,,2000,1979,,5674241,107510557,24804234,,5644813,87553608,21223747,,29428,19956949,3580487,PDN
SM155,,2001,1979,,5674241,107510557,24804234,,5644813,87553608,21223747,,29428,19956949,3580487,PDN
SM155,,2002,1979,,5674241,107510557,24804234,,5644813,87553608,21223747,,29428,19956949,3580487,PDN
SM155,,2003,1979,,5674241,107510557,24804234,,5644813,87553608,21223747,,29428,19956949,3580487,PDN
SM155,,2004,1979,,5665131,101511762,23727722,,5644813,87553608,21223747,,20318,13958154,2503975,PDN
SM155,,2005,1979,,5665131,101511762,23727722,,5644813,87553608,21223747,,20318,13958154,2503975,PDN
SM155,,2006,1979,,5665131,101511762,23727722,,5644813,87553608,21223747,,20318,13958154,2503975,PDN
SM155,,2007,1979,,5665131,101511762,23727722,,5644813,87553608,21223747,,20318,13958154,2503975,PDN
SM155,,2008,1979,,5665131,101511762,23727722,,5644813,87553608,21223747,,20318,13958154,2503975,PDN
SM155,,2009,1979,,5644813,89302778,21534987,,5644813,89302778,21534987,,0,0,0,PDN
SM155,,2010,1979,,5644813,89302778,21534987,,5644813,89302778,21534987,,0,0,0,PDN
SM155,,2011,1979,,5644813,89302778,21534987,,5644813,89302778,21534987,,0,0,0,PDN
SM155,,2012,1979,,5644813,89302778,21534987,,5644813,89302778,21534987,,0,0,0,PDN
SM155,,2013,1979,,5644813,89302778,21534987,,5644813,89302778,21534987,,0,0,0,PDN
SM155,,2014,1979,,5644813,89302778,21534987,,5644813,89302778,21534987,,0,0,0,PDN
SM155,,2015,1979,,5644813,89302778,21534987,,5644813,89302778,21534987,,0,0,0,PDN
SM155,,2016,1979,,5644813,89302778,21534987,,5644813,89302778,21534987,,0,0,0,PDN
SM155,,2017,1979,,5644813,89302778,21534987,,5644813,89302778,21534987,,0,0,0,PDN
SM155,,2017,1979,,5644813,89302778,21534987,,5644813,89302778,21534987,,0,0,0,PDN
SM160,,1983,1984,,1504770,30095300,6859806,,0,0,0,,1504770,30095300,6859806,PDP
SM160,,1984,1984,,1504770,30095300,6859806,,909885,1330340,1146600,,594885,28764960,5713206,PDP
SM160,,1985,1984,,6524409,24035937,10801266,,2100285,3703458,2759263,,4424124,20332479,8042003,PDP
SM160,,1986,1984,,6524409,24035937,10801266,,2994827,5697480,4008613,,3529582,18338457,6792653,PDP
SM160,,1987,1984,,6524409,24035937,10801266,,3957812,8391540,5450969,,2566597,15644397,5350297,PDP
SM160,,1988,1984,,6524409,24035937,10801266,,4631448,10508463,6501281,,1892961,13527474,4299985,PDP
SM160,,1989,1984,,7798021,27839683,12751701,,5186193,11979940,7317855,,2611828,15859743,5433846,PDP
SM160,,1990,1984,,7798021,27839683,12751701,,5645156,12772484,7917840,,2152865,15067199,4833861,PDP
SM160,,1991,1984,,7798021,27839683,12751701,,6124725,13707503,8563782,,1673296,14132180,4187919,PDP
SM160,,1992,1984,,7798021,27839683,12751701,,6769132,15231228,9479315,,1028889,12608455,3272386,PDP
SM160,,1993,1984,,7844601,32497636,13627099,,7332633,16559603,10279182,,511968,15938033,3347917,PDP
SM160,,1994,1984,,11909027,32692739,17726240,,7855581,17972436,11053523,,4053446,14720303,6672717,PDP
SM160,,1995,1984,,11909027,32692739,17726240,,8711341,19501940,12181437,,3197686,13190799,5544803,PDP
SM160,,1996,1984,,11377058,26462095,16085616,,9296827,20268720,12903361,,2080231,6193375,3182255,PDP
SM160,,1997,1984,,11680981,26735625,16438210,,9730014,20811029,13433044,,1950967,5924596,3005166,PDP
SM160,,1998,1984,,11680981,26735625,16438210,,10053918,21138059,13815138,,1627063,5597566,2623072,PDP
SM160,,1999,1984,,11680981,26735625,16438210,,10313969,21676729,14171038,,1367012,5058896,2267172,PDP
SM160,,2000,1984,,12073234,25288964,16573050,,10751445,22660699,14783598,,1321789,2628265,1789452,PDP
SM160,,2001,1984,,13052688,26630559,17791222,,11003017,23029537,15100799,,2049671,3601022,2690423,PDP
SM160,,2002,1984,,13052688,26630559,17791222,,11369252,23910667,15623819,,1683436,2719892,2167403,PDP
SM160,,2003,1984,,13052688,26630559,17791222,,11889138,24876858,16315625,,1163550,1753701,1475597,PDP
SM160,,2004,1984,,13021460,27614392,17935053,,12214642,25677408,16783576,,806818,1936984,1151477,PDP
SM160,,2005,1984,,13912439,29192732,19106875,,12381060,25929679,16994882,,1531379,3263053,2111993,PDP
SM160,,2006,1984,,13909395,29460040,19151395,,12568782,26169430,17225264,,1340613,3290610,1926131,PDP
SM160,,2007,1984,,13909395,29460040,19151395,,12803706,26614645,17539408,,1105689,2845395,1611987,PDP
SM160,,2008,1984,,13909395,29460040,19151395,,12908107,26825900,17681399,,1001288,2634140,1469996,PDP
SM160,,2009,1984,,13423774,28176166,18437327,,12991017,27342184,17856174,,432757,833982,581153,PDP
SM160,,2010,1984,,13423774,28176166,18437327,,13101665,27575998,18008427,,322109,600168,428901,PDP
SM160,,2011,1984,,13423774,28176166,18437327,,13185756,27717146,18117633,,238018,459020,319694,PDP
SM160,,2012,1984,,13423774,28176166,18437327,,13254673,27815983,18204136,,169101,360183,233190,PDP
SM160,,2013,1984,,13423774,28176166,18437327,,13314352,27893718,18277648,,109422,282448,159679,PDP
SM160,,2014,1984,,13979398,30481921,19403228,,13442611,28283737,18475305,,536787,2198184,927922,PDP
SM160,,2015,1984,,13979398,30481921,19403228,,13648964,28584048,18735094,,330434,1897873,668134,PDP
SM160,,2016,1984,,13979398,30481921,19403228,,13734162,28685963,18838427,,245236,1795958,564802,PDP
SM160,,2017,1984,,13976898,30404542,19386960,,13849599,28800782,18974294,,127299,1603760,412665,PDP
SM160,,2017,1984,,13976898,30404542,19386960,,13849599,28800782,18974294,,127299,1603760,412665,PDP
SM166,,1976,1973,,0,6000000,1067616,,0,0,0,,0,6000000,1067616,PDP
SM166,,1991,1973,,3556,8890247,1585450,,1310,2685559,479167,,2246,6204688,1106283,PDP
SM166,,1992,1973,,3556,8890247,1585450,,2738,5205150,928921,,818,3685097,656529,PDP
SM166,,1993,1973,,5773,8890247,1587667,,3645,6297887,1124265,,2128,2592360,463402,PDP
SM166,,1994,1973,,5773,8890247,1587667,,3661,6334009,1130709,,2112,2556238,456958,PDP
SM166,,1995,1973,,3661,6334009,1130709,,3661,6334009,1130709,,0,0,0,PDP
SM166,,1996,1973,,3661,6334009,1130709,,3661,6334009,1130709,,0,0,0,PDP
SM166,,1997,1973,,3661,6334009,1130709,,3661,6334009,1130709,,0,0,0,PDP
SM166,,1998,1973,,3661,6334009,1130709,,3661,6334009,1130709,,0,0,0,PDP
SM166,,1999,1973,,3661,6334009,1130709,,3661,6334009,1130709,,0,0,0,PDP
SM166,,2000,1973,,1326186,25528491,5868622,,3661,6334009,1130709,,1322525,19194482,4737913,PDP
SM166,,2001,1973,,1863540,37756859,8581842,,468252,13425358,2857106,,1395288,24331501,5724736,PDP
SM166,,2002,1973,,2152171,14165301,4672687,,950323,13563735,3363799,,1201848,601566,1308888,PDP
SM166,,2003,1973,,2156813,14248844,4692194,,1255764,13636844,3682249,,901049,612000,1009945,PDP
SM166,,2004,1973,,2418457,14512453,5000744,,1473326,13749229,3919808,,945131,763224,1080936,PDP
SM166,,2005,1973,,3247193,21586579,7088221,,1659166,13875688,4128150,,1588027,7710891,2960071,PDP
SM166,,2006,1973,,3237101,21310880,7029073,,1877121,15749952,4679604,,1359980,5560928,2349469,PDP
SM166,,2007,1973,,3239118,21310880,7031090,,2106589,16479785,5038935,,1132529,4831095,1992155,PDP
SM166,,2008,1973,,3239118,21310880,7031090,,2278570,16498740,5214289,,960548,4812140,1816801,PDP
SM166,,2009,1973,,5854516,17593181,8984975,,2459184,16716005,5433562,,3395332,877176,3551413,PDP
SM166,,2010,1973,,5854516,17593181,8984975,,3042846,16853680,6041721,,2811670,739501,2943254,PDP
SM166,,2011,1973,,5824016,17554410,8947576,,3623685,16977353,6644566,,2200331,577057,2303010,PDP
SM166,,2012,1973,,6220362,17885359,9402810,,4124309,17105417,7167978,,2096053,779942,2234832,PDP
SM166,,2013,1973,,6220362,17885359,9402811,,4710153,17267338,7782633,,1510209,618021,1620178,PDP
SM166,,2014,1973,,6229764,23243710,10365656,,5173754,19436677,8632239,,1056010,3807033,1733419,PDP
SM166,,2015,1973,,6229764,23243710,10365656,,5604012,20234115,9204388,,625752,3009595,1161268,PDP
SM166,,2016,1973,,7026711,21859466,10916296,,5986841,20415487,9619490,,1039870,1443979,1296806,PDP
SM166,,2017,1973,,7046989,24627840,11429167,,6328528,20892272,10046015,,718461,3735568,1383152,PDP
SM166,,2017,1973,,7046989,24627840,11429167,,6328528,20892272,10046015,,718461,3735568,1383152,PDP
SM172,,1994,1986,,30214,5497845,1008478,,0,1219797,217046,,30214,4278048,791432,PDN
SM172,,1995,1986,,8030,12078275,2157189,,0,4443578,790672,,8030,7634697,1366517,PDN
SM172,,1996,1986,,6274459,11740488,8363514,,162,7044284,1253593,,6274297,4696204,7109921,PDN
SM172,,1997,1986,,8629,12459045,2225541,,471,8925765,1588685,,8158,3533280,636856,PDN
SM172,,1998,1986,,8629,12459045,2225541,,471,9550267,1699807,,8158,2908778,525734,PDN
SM172,,1999,1986,,471,10127389,1802498,,471,10124739,1802026,,0,2650,472,PDN
SM172,,2000,1986,,471,10127389,1802498,,471,10127389,1802498,,0,0,0,PDN
SM172,,2001,1986,,471,10127390,1802498,,471,10127390,1802498,,0,0,0,PDN
SM172,,2002,1986,,471,10127390,1802498,,471,10127390,1802498,,0,0,0,PDN
SM172,,2003,1986,,471,10127390,1802498,,471,10127390,1802498,,0,0,0,PDN
SM172,,2004,1986,,471,10127390,1802498,,471,10127390,1802498,,0,0,0,PDN
SM172,,2005,1986,,471,10127390,1802498,,471,10127390,1802498,,0,0,0,PDN
SM172,,2006,1986,,471,10127390,1802498,,471,10127390,1802498,,0,0,0,PDN
SM172,,2007,1986,,471,10127390,1802498,,471,10127390,1802498,,0,0,0,PDN
SM172,,2008,1986,,471,10127390,1802498,,471,10127390,1802498,,0,0,0,PDN
SM172,,2009,1986,,471,10315046,1835887,,471,10315046,1835887,,0,0,0,PDN
SM172,,2010,1986,,471,10315046,1835887,,471,10315046,1835887,,0,0,0,PDN
SM172,,2011,1986,,471,10315046,1835887,,471,10315046,1835887,,0,0,0,PDN
SM172,,2012,1986,,471,10315046,1835887,,471,10315046,1835887,,0,0,0,PDN
SM172,,2013,1986,,471,10315046,1835887,,471,10315046,1835887,,0,0,0,PDN
SM172,,2014,1986,,471,10315046,1835887,,471,10315046,1835887,,0,0,0,PDN
SM172,,2015,1986,,471,10315046,1835887,,471,10315046,1835887,,0,0,0,PDN
SM172,,2016,1986,,471,10315046,1835887,,471,10315046,1835887,,0,0,0,PDN
SM172,,2017,1986,,471,10315046,1835887,,471,10315046,1835887,,0,0,0,PDN
SM172,,2017,1986,,471,10315046,1835887,,471,10315046,1835887,,0,0,0,PDN
SM175,,1975,1973,,0,16000000,2846975,,0,0,0,,0,16000000,2846975,PDN
SM175,,1976,1973,,0,16000000,2846975,,0,0,0,,0,16000000,2846975,PDN
SM175,,1977,1973,,1213159,2913376,1731553,,0,0,0,,1213159,2913376,1731553,PDN
SM175,,1981,1973,,24990,24990000,4471609,,0,0,0,,24990,24990000,4471609,PDN
SM175,,1982,1973,,2330906,29473909,7575374,,0,0,0,,2330906,29473909,7575374,PDN
SM175,,1983,1973,,24844204,52681086,34218063,,1011319,721660,1139728,,23832885,51959426,33078335,PDN
SM175,,1984,1973,,25846776,54686232,35577422,,3383144,3758977,4052001,,22463632,50927255,31525421,PDN
SM175,,1985,1973,,16621865,30036473,21966433,,4661461,6639399,5842849,,11960404,23397074,16123584,PDN
SM175,,1986,1973,,13564976,63104481,24793531,,6627330,14867609,9272812,,6937646,48236872,15520719,PDN
SM175,,1987,1973,,13562874,63100834,24790780,,7771455,19538629,11248079,,5791419,43562205,13542701,PDN
SM175,,1988,1973,,13605371,63099790,24833092,,8682687,23378619,12842584,,4922684,39721171,11990508,PDN
SM175,,1989,1973,,13914899,65838468,25629929,,9226431,28075707,14222108,,4688468,37762761,11407821,PDN
SM175,,1990,1973,,13074944,52912356,22489954,,9829554,32613795,15632720,,3245390,20298561,6857234,PDN
SM175,,1991,1973,,13074944,54213512,22721476,,10147959,36666857,16672311,,2926985,17546655,6049165,PDN
SM175,,1992,1973,,13074944,54213512,22721476,,10369306,39367147,17374136,,2705638,14846365,5347340,PDN
SM175,,1993,1973,,13074944,54213512,22721476,,10667576,41047276,17971362,,2407368,13166236,4750114,PDN
SM175,,1994,1973,,13073434,54210105,22719360,,11087111,44362306,18980760,,1986323,9847799,3738600,PDN
SM175,,1995,1973,,12835456,60672719,23631313,,11546082,46972559,19904189,,1289374,13700160,3727124,PDN
SM175,,1996,1973,,13008747,59757027,23641670,,11829762,48690430,20493540,,1178985,11066597,3148130,PDN
SM175,,1997,1973,,13809958,53275060,23289506,,12296568,49880589,21172118,,1513390,3394471,2117388,PDN
SM175,,1998,1973,,13809958,53275060,23289506,,12890499,51329949,22023942,,919459,1945111,1265564,PDN
SM175,,1999,1973,,14232094,56386638,24265303,,13377725,52757374,22765158,,854369,3629264,1500145,PDN
SM175,,2000,1973,,14830819,56313499,24851014,,13733756,53807868,23308110,,1097063,2505631,1542904,PDN
SM175,,2001,1973,,14824148,63957869,26204552,,13937178,54322768,23603151,,886970,9635101,2601401,PDN
SM175,,2002,1973,,14413268,68655682,26629581,,14030365,57105899,24191557,,382903,11549783,2438024,PDN
SM175,,2003,1973,,14545479,71490140,27266144,,14084521,60621855,24871328,,460958,10868285,2394816,PDN
SM175,,2004,1973,,14656290,79828462,28860643,,14124344,61392884,25048345,,531946,18435578,3812298,PDN
SM175,,2005,1973,,14745105,82369133,29401535,,14183205,61679353,25158179,,561900,20689780,4243356,PDN
SM175,,2006,1973,,14855538,80771373,29227669,,14213791,61922604,25232048,,641747,18848769,3995621,PDN
SM175,,2007,1973,,14827908,80324031,29120440,,14307791,62398221,25410677,,520117,17925810,3709763,PDN
SM175,,2008,1973,,14757508,71524075,27484212,,14361730,62564774,25494252,,395778,8959301,1989960,PDN
SM175,,2009,1973,,14436305,64376570,25891211,,14436305,64376570,25891211,,0,0,0,PDN
SM175,,2010,1973,,14442908,64410747,25903893,,14442908,64410747,25903893,,0,0,0,PDN
SM175,,2011,1973,,14442908,64410747,25903893,,14442908,64410747,25903893,,0,0,0,PDN
SM175,,2012,1973,,14442908,64410747,25903893,,14442908,64410747,25903893,,0,0,0,PDN
SM175,,2013,1973,,14442908,64410747,25903893,,14442908,64410747,25903893,,0,0,0,PDN
SM175,,2014,1973,,14442908,64410747,25903893,,14442908,64410747,25903893,,0,0,0,PDN
SM175,,2015,1973,,14442908,64410747,25903893,,14442908,64410747,25903893,,0,0,0,PDN
SM175,,2016,1973,,14442908,64410747,25903893,,14442908,64410747,25903893,,0,0,0,PDN
SM175,,2017,1973,,14442908,64410747,25903893,,14442908,64410747,25903893,,0,0,0,PDN
SM175,,2017,1973,,14442908,64410747,25903893,,14442908,64410747,25903893,,0,0,0,PDN
SM184,,1976,1974,,0,10000000,1779359,,0,0,0,,0,10000000,1779359,PDN
SM184,,2000,1974,,26602,7980704,1446656,,0,0,0,,26602,7980704,1446656,PDN
SM184,,2001,1974,,26602,7980704,1446656,,0,0,0,,26602,7980704,1446656,PDN
SM184,,2002,1974,,0,1674458,297946,,0,612589,109002,,0,1061869,188944,PDN
SM184,,2003,1974,,0,1674458,297946,,0,1674458,297946,,0,0,0,PDN
SM184,,2004,1974,,0,1674458,297946,,0,1674458,297946,,0,0,0,PDN
SM184,,2005,1974,,0,1674458,297946,,0,1674458,297946,,0,0,0,PDN
SM184,,2006,1974,,0,1674458,297946,,0,1674458,297946,,0,0,0,PDN
SM184,,2007,1974,,0,1674458,297946,,0,1674458,297946,,0,0,0,PDN
SM184,,2008,1974,,0,1674458,297946,,0,1674458,297946,,0,0,0,PDN
SM184,,2009,1974,,0,1674458,297947,,0,1674458,297947,,0,0,0,PDN
SM184,,2010,1974,,0,1674458,297947,,0,1674458,297947,,0,0,0,PDN
SM184,,2011,1974,,0,1674458,297947,,0,1674458,297947,,0,0,0,PDN
SM184,,2012,1974,,0,1674458,297947,,0,1674458,297947,,0,0,0,PDN
SM184,,2013,1974,,0,1674458,297947,,0,1674458,297947,,0,0,0,PDN
SM184,,2014,1974,,0,1674458,297947,,0,1674458,297947,,0,0,0,PDN
SM184,,2015,1974,,0,1674458,297947,,0,1674458,297947,,0,0,0,PDN
SM184,,2016,1974,,0,1674458,297947,,0,1674458,297947,,0,0,0,PDN
SM184,,2017,1974,,0,1674458,297947,,0,1674458,297947,,0,0,0,PDN
SM184,,2017,1974,,0,1674458,297947,,0,1674458,297947,,0,0,0,PDN
SM192,,1993,1991,,268775,26877504,5051249,,0,0,0,,268775,26877504,5051249,PDP
SM192,,1994,1991,,268775,26877504,5051249,,0,0,0,,268775,26877504,5051249,PDP
SM192,,1995,1991,,268775,26877504,5051249,,0,0,0,,268775,26877504,5051249,PDP
SM192,,1996,1991,,178902,17890198,3362211,,20711,797173,162557,,158191,17093025,3199654,PDP
SM192,,1997,1991,,720806,27931947,5690903,,254085,9842399,2005402,,466721,18089548,3685501,PDP
SM192,,1998,1991,,720806,27931947,5690903,,449497,16769826,3433452,,271309,11162121,2257451,PDP
SM192,,1999,1991,,720806,27931947,5690903,,528670,19955788,4079522,,192136,7976159,1611381,PDP
SM192,,2000,1991,,720806,27931947,5690903,,561828,21199719,4334020,,158978,6732228,1356883,PDP
SM192,,2001,1991,,720806,27931947,5690903,,573089,21618372,4419774,,147717,6313575,1271129,PDP
SM192,,2002,1991,,607802,22701400,4647197,,575302,21689593,4434660,,32500,1011807,212537,PDP
SM192,,2003,1991,,575302,21689593,4434660,,575302,21689593,4434660,,0,0,0,PDP
SM192,,2004,1991,,738878,29632700,6011600,,594189,22689203,4631414,,144689,6943497,1380186,PDP
SM192,,2005,1991,,4551733,47020474,12918365,,630127,24413878,4974233,,3921606,22606596,7944132,PDP
SM192,,2006,1991,,3619356,35123828,9869147,,1381975,26890611,6166781,,2237381,8233217,3702366,PDP
SM192,,2007,1991,,4214349,38872900,11131235,,1975876,29760612,7271359,,2238473,9112288,3859876,PDP
SM192,,2008,1991,,4214349,38872900,11131235,,2320854,30709166,7785118,,1893495,8163734,3346117,PDP
SM192,,2009,1991,,4750966,38332516,11571698,,2871035,32893973,8724056,,1879931,5438543,2847643,PDP
SM192,,2010,1991,,4750966,38332516,11571698,,3638230,34700405,9812679,,1112736,3632111,1759020,PDP
SM192,,2011,1991,,4750966,38332516,11571698,,4043004,35858391,10423500,,707962,2474125,1148198,PDP
SM192,,2012,1991,,4774617,38177398,11567749,,4326214,36731035,10861986,,448403,1446363,705763,PDP
SM192,,2013,1991,,4774617,38177398,11567749,,4530404,37403349,11185805,,244213,774049,381944,PDP
SM192,,2014,1991,,4774617,38177398,11567749,,4630074,37682249,11335101,,144543,495149,232648,PDP
SM192,,2015,1991,,5181209,39362127,12185146,,4746461,38055033,11517819,,434748,1307094,667327,PDP
SM192,,2016,1991,,5181209,39362127,12185146,,4823839,38319287,11642218,,357370,1042840,542929,PDP
SM192,,2017,1991,,4992952,39053174,11941916,,4943008,38583968,11808484,,49944,469206,133432,PDP
SM192,,2017,1991,,4992952,39053174,11941916,,4943008,38583968,11808484,,49944,469206,133432,PDP
SM195,,1993,1981,,161171,16117095,3028981,,0,0,0,,161171,16117095,3028981,PDN
SM195,,1994,1981,,161171,16117095,3028981,,0,0,0,,161171,16117095,3028981,PDN
SM195,,2003,1981,,696541,26604967,5430521,,178,150901,27029,,696363,26454066,5403492,PDN
SM195,,2004,1981,,663936,23344726,4817802,,3846,1300012,235165,,660090,22044714,4582637,PDN
SM195,,2005,1981,,638142,26042149,5271977,,4666,1690871,305533,,633476,24351278,4966444,PDN
SM195,,2006,1981,,637342,27432066,5518493,,4926,3130938,562032,,632416,24301128,4956461,PDN
SM195,,2007,1981,,637342,27432066,5518493,,4826,4110820,736289,,632516,23321246,4782204,PDN
SM195,,2008,1981,,637463,29543155,5894253,,4826,5875017,1050203,,632637,23668138,4844050,PDN
SM195,,2009,1981,,5526,11165782,1992320,,4826,7971798,1423296,,700,3193984,569025,PDN
SM195,,2010,1981,,5526,11165782,1992320,,4826,9916845,1769389,,700,1248937,222931,PDN
SM195,,2011,1981,,5526,11165782,1992320,,4836,10852674,1935917,,690,313108,56403,PDN
SM195,,2012,1981,,6175,12438173,2219373,,4837,11634418,2075018,,1338,803755,144355,PDN
SM195,,2013,1981,,6175,12438173,2219373,,5270,11908145,2124157,,905,530028,95216,PDN
SM195,,2014,1981,,6175,12438173,2219373,,5316,12123640,2162547,,859,314533,56826,PDN
SM195,,2015,1981,,5316,12189092,2174194,,5316,12189092,2174194,,0,0,0,PDN
SM195,,2016,1981,,5316,12189092,2174194,,5316,12189092,2174194,,0,0,0,PDN
SM195,,2017,1981,,5316,12189092,2174194,,5316,12189092,2174194,,0,0,0,PDN
SM195,,2017,1981,,5316,12189092,2174194,,5316,12189092,2174194,,0,0,0,PDN
SM205,,1987,1985,,381323,28866160,5517650,,0,0,0,,381323,28866160,5517650,PDN
SM205,,1989,1985,,726915,70438016,13260370,,0,0,0,,726915,70438016,13260370,PDN
SM205,,1990,1985,,726915,70438016,13260370,,0,23597261,4198801,,726915,46840755,9061569,PDN
SM205,,1991,1985,,0,105693269,18806631,,0,52420657,9327519,,0,53272612,9479112,PDN
SM205,,1992,1985,,0,105693269,18806631,,0,70098464,12473036,,0,35594805,6333595,PDN
SM205,,1993,1985,,0,105693269,18806631,,0,75048349,13353799,,0,30644920,5452832,PDN
SM205,,1994,1985,,104684727,107402996,123795580,,0,78818897,14024715,,104684727,28584099,109770865,PDN
SM205,,1995,1985,,0,100909434,17955415,,0,80507166,14325119,,0,20402268,3630296,PDN
SM205,,1996,1985,,0,100909434,17955415,,0,81520735,14505469,,0,19388699,3449946,PDN
SM205,,1997,1985,,0,100909434,17955415,,0,81520735,14505469,,0,19388699,3449946,PDN
SM205,,1998,1985,,0,100909434,17955415,,0,81520735,14505469,,0,19388699,3449946,PDN
SM205,,1999,1985,,0,82720910,14719023,,0,81520735,14505469,,0,1200175,213554,PDN
SM205,,2000,1985,,0,82720910,14719023,,0,81520735,14505469,,0,1200175,213554,PDN
SM205,,2001,1985,,0,82720910,14719023,,0,81520735,14505469,,0,1200175,213554,PDN
SM205,,2002,1985,,0,82720910,14719023,,0,81520735,14505469,,0,1200175,213554,PDN
SM205,,2003,1985,,0,82720910,14719023,,0,81520735,14505469,,0,1200175,213554,PDN
SM205,,2004,1985,,0,81520735,14505469,,0,81520735,14505469,,0,0,0,PDN
SM205,,2005,1985,,0,81520735,14505469,,0,81520735,14505469,,0,0,0,PDN
SM205,,2006,1985,,0,81520735,14505469,,0,81520735,14505469,,0,0,0,PDN
SM205,,2007,1985,,0,81520735,14505469,,0,81520735,14505469,,0,0,0,PDN
SM205,,2008,1985,,0,81520735,14505469,,0,81520735,14505469,,0,0,0,PDN
SM205,,2009,1985,,0,83153359,14795971,,0,83153359,14795971,,0,0,0,PDN
SM205,,2010,1985,,0,83153359,14795971,,0,83153359,14795971,,0,0,0,PDN
SM205,,2011,1985,,0,83153359,14795971,,0,83153359,14795971,,0,0,0,PDN
SM205,,2012,1985,,0,83153359,14795971,,0,83153359,14795971,,0,0,0,PDN
SM205,,2013,1985,,0,83153359,14795971,,0,83153359,14795971,,0,0,0,PDN
SM205,,2014,1985,,0,83153359,14795971,,0,83153359,14795971,,0,0,0,PDN
SM205,,2015,1985,,0,83153359,14795971,,0,83153359,14795971,,0,0,0,PDN
SM205,,2016,1985,,0,83153359,14795971,,0,83153359,14795971,,0,0,0,PDN
SM205,,2017,1985,,0,83153359,14795971,,0,83153359,14795971,,0,0,0,PDN
SM205,,2017,1985,,0,83153359,14795971,,0,83153359,14795971,,0,0,0,PDN
SM223,,2002,2002,,3977000,63748073,15320073,,0,0,0,,3977000,63748073,15320073,PDP
SM223,,2003,2002,,14512733,216086119,52962220,,362009,4208742,1110895,,14150724,211877377,51851325,PDP
SM223,,2004,2002,,7251960,109644779,26761707,,1201523,16670732,4167845,,6050437,92974047,22593862,PDP
SM223,,2005,2002,,7437509,112428476,27442576,,1853147,25770332,6438615,,5584362,86658144,21003961,PDP
SM223,,2006,2002,,6283163,96857618,23517615,,2258157,31516588,7866091,,4025006,65341030,15651524,PDP
SM223,,2007,2002,,6283163,96868243,23519505,,2723844,37841080,9457132,,3559319,59027163,14062373,PDP
SM223,,2008,2002,,6234001,96152442,23342976,,2995788,41991161,10467525,,3238213,54161281,12875451,PDP
SM223,,2009,2002,,6284450,96862859,23519835,,3244832,45526865,11345698,,3039618,51335994,12174136,PDP
SM223,,2010,2002,,6284450,96862859,23519835,,3421003,48372362,12028186,,2863447,48490497,11491650,PDP
SM223,,2011,2002,,6284450,96862859,23519835,,3566480,50905105,12624328,,2717970,45957754,10895506,PDP
SM223,,2012,2002,,6284450,96862859,23519835,,3723307,53214447,13192070,,2561143,43648412,10327764,PDP
SM223,,2013,2002,,6284450,96862859,23519835,,3833272,55180095,13651794,,2451178,41682764,9868040,PDP
SM223,,2014,2002,,6284450,96862859,23519835,,3920195,56713999,14011654,,2364255,40148860,9508181,PDP
SM223,,2015,2002,,6284450,96862859,23519835,,3991409,57881014,14290523,,2293041,38981845,9229312,PDP
SM223,,2016,2002,,6284450,96862859,23519835,,4054049,58829188,14521876,,2230401,38033671,8997958,PDP
SM223,,2017,2002,,6609749,102220159,24798390,,4128157,59852816,14778125,,2481592,42367343,10020266,PDP
SM223,,2017,2002,,6609749,102220159,24798390,,4128157,59852816,14778125,,2481592,42367343,10020266,PDP
SM231,,1986,1980,,26653,20223584,3625155,,1624,1326567,237668,,25029,18897017,3387487,PDN
SM231,,1987,1980,,26653,20223584,3625155,,6263,4229737,758885,,20390,15993847,2866270,PDN
SM231,,1988,1980,,26653,20223584,3625155,,11403,7211949,1294668,,15250,13011635,2330487,PDN
SM231,,1989,1980,,67220,28568416,5150568,,18731,10118139,1819112,,48489,18450277,3331456,PDN
SM231,,1990,1980,,67220,28568416,5150568,,23549,12535390,2254045,,43671,16033026,2896523,PDN
SM231,,1991,1980,,67220,28568416,5150568,,24880,13287011,2389117,,42340,15281405,2761451,PDN
SM231,,1992,1980,,67220,28568416,5150568,,24896,13442330,2416770,,42324,15126086,2733798,PDN
SM231,,1993,1980,,63677,17324311,3146295,,24866,13511476,2429043,,38811,3812835,717252,PDN
SM231,,1994,1980,,95848,35302719,6377471,,37133,17245651,3105754,,58715,18057068,3271717,PDN
SM231,,1995,1980,,81868,30176573,5451365,,47316,20555536,3704885,,34552,9621037,1746480,PDN
SM231,,1996,1980,,98537,26235510,4766777,,49482,21597146,3892391,,49055,4638364,874386,PDN
SM231,,1997,1980,,55255,25941048,4671100,,54718,22964362,4140903,,537,2976686,530197,PDN
SM231,,1998,1980,,55255,25941048,4671100,,54817,24064135,4336692,,438,1876913,334408,PDN
SM231,,1999,1980,,55255,25941048,4671100,,54817,24530613,4419695,,438,1410435,251405,PDN
SM231,,2000,1980,,55255,25941048,4671100,,54817,24755731,4459751,,438,1185317,211349,PDN
SM231,,2001,1980,,55255,25939481,4670821,,54817,24933506,4491384,,438,1005975,179437,PDN
SM231,,2002,1980,,55255,25939481,4670821,,54817,24973950,4498580,,438,965531,172241,PDN
SM231,,2003,1980,,55255,25939481,4670821,,54817,24973950,4498580,,438,965531,172241,PDN
SM231,,2004,1980,,54998,26788363,4821610,,54817,24973950,4498580,,181,1814413,323030,PDN
SM231,,2005,1980,,54998,26788363,4821610,,54817,24973950,4498580,,181,1814413,323030,PDN
SM231,,2006,1980,,54998,26788363,4821610,,54817,24973950,4498580,,181,1814413,323030,PDN
SM231,,2007,1980,,54998,26788363,4821610,,54817,24973950,4498580,,181,1814413,323030,PDN
SM231,,2008,1980,,54998,26788363,4821610,,54817,24973950,4498580,,181,1814413,323030,PDN
SM231,,2009,1980,,54817,25449461,4583191,,54817,25449461,4583191,,0,0,0,PDN
SM231,,2010,1980,,54817,25449461,4583191,,54817,25449461,4583191,,0,0,0,PDN
SM231,,2011,1980,,54817,25449461,4583191,,54817,25449461,4583191,,0,0,0,PDN
SM231,,2012,1980,,54817,25449461,4583191,,54817,25449461,4583191,,0,0,0,PDN
SM231,,2013,1980,,54817,25449461,4583191,,54817,25449461,4583191,,0,0,0,PDN
SM231,,2014,1980,,54817,25449461,4583191,,54817,25449461,4583191,,0,0,0,PDN
SM231,,2015,1980,,54817,25449461,4583191,,54817,25449461,4583191,,0,0,0,PDN
SM231,,2016,1980,,54817,25449461,4583191,,54817,25449461,4583191,,0,0,0,PDN
SM231,,2017,1980,,54817,25449461,4583191,,54817,25449461,4583191,,0,0,0,PDN
SM231,,2017,1980,,54817,25449461,4583191,,54817,25449461,4583191,,0,0,0,PDN
SM236,,1983,1982,,14900197,66733470,26774480,,966805,2536556,1418149,,13933392,64196914,25356331,PDP
SM236,,1984,1982,,61797612,262400724,108488132,,3150318,11410830,5180715,,58647294,250989894,103307417,PDP
SM236,,1985,1982,,59655262,252671462,104614597,,8455877,24307551,12781064,,51199385,228363911,91833533,PDP
SM236,,1986,1982,,59655262,252671462,104614597,,14505779,48458874,23128354,,45149483,204212588,81486243,PDP
SM236,,1987,1982,,38232084,212519694,76046976,,18909000,72109312,31739838,,19323084,140410382,44307138,PDP
SM236,,1988,1982,,46235579,246120672,90029293,,22630962,92474156,39085438,,23604617,153646516,50943855,PDP
SM236,,1989,1982,,42488280,228325178,83115536,,25477032,107939668,44683379,,17011248,120385510,38432157,PDP
SM236,,1990,1982,,38625713,197626523,73790575,,27709967,119151925,48911377,,10915746,78474598,24879198,PDP
SM236,,1991,1982,,38625713,197626524,73790575,,29412170,129758825,52500929,,9213543,67867699,21289646,PDP
SM236,,1992,1982,,38625713,197626524,73790575,,30670641,139713608,55530714,,7955072,57912916,18259861,PDP
SM236,,1993,1982,,38625713,197626524,73790575,,31699533,146451316,57758486,,6926180,51175208,16032089,PDP
SM236,,1994,1982,,39313492,240163285,82047173,,32795278,159180332,61119180,,6518214,80982953,20927993,PDP
SM236,,1995,1982,,39313588,240169688,82048408,,33781214,175051638,64929192,,5532374,65118050,17119216,PDP
SM236,,1996,1982,,38706755,238743490,81187803,,34683603,192591971,68952637,,4023152,46151519,12235166,PDP
SM236,,1997,1982,,38682648,253127225,83723079,,35637388,204179189,71968205,,3045260,48948036,11754874,PDP
SM236,,1998,1982,,38418448,227350362,78872249,,36484501,211606246,74136858,,1933947,15744116,4735391,PDP
SM236,,1999,1982,,38654069,233673465,80232977,,37184773,218482936,76060740,,1469296,15190529,4172237,PDP
SM236,,2000,1982,,39729522,248326097,83915660,,37759901,226060991,77984277,,1969621,22265106,5931383,PDP
SM236,,2001,1982,,41846486,244040205,85270010,,38519255,232051304,79809523,,3327231,11988901,5460487,PDP
SM236,,2002,1982,,41847268,243199062,85121123,,39044635,234182829,80714178,,2802633,9016233,4406945,PDP
SM236,,2003,1982,,42052877,241867682,85089831,,39444273,235494785,81347260,,2608604,6372897,3742571,PDP
SM236,,2004,1982,,41554084,252297682,86446910,,39804251,236306142,81851607,,1749833,15991540,4595303,PDP
SM236,,2005,1982,,42001785,253459262,87101297,,40031336,236832968,82172434,,1970449,16626294,4928863,PDP
SM236,,2006,1982,,42283522,246957789,86226189,,40313110,238738554,82793280,,1970412,8219235,3432909,PDP
SM236,,2007,1982,,42283522,246957789,86226189,,40514739,239712841,83168269,,1768783,7244948,3057920,PDP
SM236,,2008,1982,,42283522,246957789,86226189,,40728233,240506471,83522979,,1555289,6451318,2703210,PDP
SM236,,2009,1982,,43651071,252763047,88626704,,41013199,245567388,84708466,,2637872,7195659,3918239,PDP
SM236,,2010,1982,,43851431,253040930,88876509,,41301536,246283728,85124267,,2549895,6757202,3752245,PDP
SM236,,2011,1982,,43820085,251176523,88513417,,41707570,246932546,85645747,,2112515,4243977,2867671,PDP
SM236,,2012,1982,,43820085,251176523,88513417,,42115712,247452865,86146473,,1704373,3723658,2366945,PDP
SM236,,2013,1982,,43727894,251493721,88477667,,42520073,248170989,86678614,,1207821,3322732,1799054,PDP
SM236,,2014,1982,,43727894,251493721,88477667,,42845325,248784082,87112958,,882569,2709639,1364711,PDP
SM236,,2015,1982,,43960259,251822154,88768471,,43139818,249268154,87493583,,820441,2554000,1274889,PDP
SM236,,2016,1982,,44351729,252427915,89267729,,43390335,249667183,87815103,,961394,2760732,1452627,PDP
SM236,,2017,1982,,44351729,252427915,89267729,,43620992,250035081,88111222,,730737,2392834,1156508,PDP
SM236,,2017,1982,,44351729,252427915,89267729,,43620992,250035081,88111222,,730737,2392834,1156508,PDP
SM239,,1985,1985,,6178619,18562439,9481544,,64684,49148,73429,,6113935,18513291,9408115,PDP
SM239,,1986,1985,,21352827,81573690,35867718,,2054214,3238616,2630480,,19298613,78335074,33237238,PDP
SM239,,1987,1985,,21352827,81573690,35867718,,4555527,7362467,5865575,,16797300,74211223,30002143,PDP
SM239,,1988,1985,,21352827,81573690,35867718,,7469345,12119912,9625913,,13883482,69453778,26241805,PDP
SM239,,1989,1985,,37823091,122952496,59700759,,11118956,17824393,14290556,,26704135,105128103,45410203,PDP
SM239,,1990,1985,,38282005,131116890,61612412,,14633890,24110758,18924060,,23648115,107006132,42688352,PDP
SM239,,1991,1985,,36782285,114014950,57069643,,17705414,31047101,23229809,,19076871,82967849,33839834,PDP
SM239,,1992,1985,,37353733,116498834,58083063,,20128561,38072406,26903010,,17225172,78426428,31180053,PDP
SM239,,1993,1985,,37353733,116498834,58083063,,22353469,46941897,30706120,,15000264,69556937,27376943,PDP
SM239,,1994,1985,,34211583,112834430,54288884,,24401847,56303943,34420342,,9809736,56530487,19868542,PDP
SM239,,1995,1985,,34211583,112834430,54288884,,26225695,68710487,38451760,,7985888,44123943,15837124,PDP
SM239,,1996,1985,,31639695,133813969,55450010,,27625890,89663945,43580329,,4013805,44150024,11869681,PDP
SM239,,1997,1985,,31977118,188950170,65598145,,28985605,122962603,50865072,,2991513,65987567,14733073,PDP
SM239,,1998,1985,,30294864,192539094,64554489,,29447048,149701943,56084404,,847816,42837151,8470085,PDP
SM239,,1999,1985,,31038193,189493132,64755832,,29903969,166828525,59588760,,1134224,22664607,5167072,PDP
SM239,,2000,1985,,32326654,202555208,68368506,,30560292,174030851,61526636,,1766362,28524357,6841870,PDP
SM239,,2001,1985,,34806931,220213579,73990842,,30983146,180207112,63048468,,3823785,40006467,10942374,PDP
SM239,,2002,1985,,32039846,212856691,69914702,,31259470,187095651,64550511,,780376,25761040,5364191,PDP
SM239,,2003,1985,,32148852,210287649,69566583,,31429586,192324541,65651035,,719266,17963108,3915548,PDP
SM239,,2004,1985,,32313612,213707676,70339889,,31638471,196076635,66527552,,675141,17631041,3812337,PDP
SM239,,2005,1985,,32656264,216651076,71206277,,31788532,199004464,67198579,,867732,17646612,4007698,PDP
SM239,,2006,1985,,32668117,213491093,70655856,,31848651,200644681,67550552,,819466,12846412,3105304,PDP
SM239,,2007,1985,,32430501,216509426,70955310,,32011863,204169905,68341028,,418638,12339521,2614282,PDP
SM239,,2008,1985,,32667391,221503745,72080869,,32111727,206755145,68900899,,555664,14748600,3179970,PDP
SM239,,2009,1985,,32855180,220343079,72062134,,32198275,210956050,69734939,,656905,9387029,2327197,PDP
SM239,,2010,1985,,32855180,220343079,72062134,,32308303,212063673,70042052,,546877,8279406,2020080,PDP
SM239,,2011,1985,,32852194,220252710,72043068,,32416879,213700522,70441882,,435315,6552188,1601184,PDP
SM239,,2012,1985,,33410517,221781854,72873480,,32519706,215052086,70785201,,890811,6729768,2088278,PDP
SM239,,2013,1985,,33410517,221781854,72873480,,32665790,216249249,71144303,,744727,5532605,1729177,PDP
SM239,,2014,1985,,33410517,221781854,72873480,,32812890,216891773,71405730,,597627,4890081,1467749,PDP
SM239,,2015,1985,,33410517,221781854,72873480,,32961130,217392389,71643049,,449387,4389465,1230430,PDP
SM239,,2016,1985,,33410517,221781854,72873480,,33096054,217939023,71875238,,314463,3842831,998240,PDP
SM239,,2017,1985,,33410517,221781854,72873480,,33200350,218760382,72125683,,210167,3021472,747795,PDP
SM239,,2017,1985,,33410517,221781854,72873480,,33200350,218760382,72125683,,210167,3021472,747795,PDP
SM241,,1991,1982,,2102108,71001238,14735780,,80615,6820340,1294199,,2021493,64180898,13441581,PDP
SM241,,1992,1982,,2226524,73399770,15286981,,199412,15573155,2970436,,2027112,57826615,12316545,PDP
SM241,,1993,1982,,2242933,73212305,15270034,,331042,28410669,5386321,,1911891,44801636,9883713,PDP
SM241,,1994,1982,,2512271,112012736,22443363,,603176,45307447,8664999,,1909095,66705289,13778364,PDP
SM241,,1995,1982,,2350600,103033752,20684008,,757235,58387512,11146472,,1593365,44646240,9537536,PDP
SM241,,1996,1982,,2387274,109571746,21884026,,938160,69047911,13224265,,1449114,40523835,8659761,PDP
SM241,,1997,1982,,2271562,133880135,26093650,,1212808,89345902,17110655,,1058754,44534233,8982995,PDP
SM241,,1998,1982,,3680807,154646870,31198044,,2353047,110016862,21929001,,1327760,44630008,9269043,PDP
SM241,,1999,1982,,5756721,166699855,35418617,,3162362,121546613,24789873,,2594359,45153242,10628744,PDP
SM241,,2000,1982,,6457309,167275401,36221615,,4291399,132957439,27949306,,2165910,34317962,8272309,PDP
SM241,,2001,1982,,6597629,164504753,35868937,,4918791,139576120,29754400,,1678838,24928633,6114537,PDP
SM241,,2002,1982,,6599846,165746616,36092126,,5247249,143305450,30746439,,1352597,22441166,5345687,PDP
SM241,,2003,1982,,6151910,162279892,35027336,,5519753,145582418,31424098,,632157,16697474,3603238,PDP
SM241,,2004,1982,,6181251,153227224,33445882,,5684467,146792526,31804134,,496784,6434698,1641748,PDP
SM241,,2005,1982,,6057685,157825307,34140480,,5755377,147325369,31969855,,302308,10499938,2170625,PDP
SM241,,2006,1982,,6375066,152659841,33538739,,5788309,148120848,32144332,,586757,4538993,1394407,PDP
SM241,,2007,1982,,6375066,152659841,33538739,,5885756,148693814,32343730,,489310,3966027,1195009,PDP
SM241,,2008,1982,,6375066,152659841,33538739,,5926802,149315624,32495418,,448264,3344217,1043321,PDP
SM241,,2009,1982,,6637447,154342540,34100532,,6011993,151575244,32982677,,625454,2767296,1117856,PDP
SM241,,2010,1982,,6637447,154342540,34100532,,6098282,151704867,33092030,,539165,2637673,1008502,PDP
SM241,,2011,1982,,6627476,153241421,33894632,,6191809,151920467,33223921,,435667,1320954,670712,PDP
SM241,,2012,1982,,6627476,153241421,33894632,,6320603,152154790,33394409,,306873,1086631,500223,PDP
SM241,,2013,1982,,6794592,153531333,34113334,,6431399,152347043,33539414,,363193,1184290,573921,PDP
SM241,,2014,1982,,6794592,153531333,34113334,,6543640,152469891,33673514,,250952,1061442,439820,PDP
SM241,,2015,1982,,6794592,153531333,34113334,,6643761,152612522,33799014,,150831,918811,314321,PDP
SM241,,2016,1982,,7155815,153509654,34470700,,6736016,152677486,33902829,,419799,832168,567872,PDP
SM241,,2017,1982,,7155815,153509654,34470700,,6817444,152726948,33993057,,338371,782706,477642,PDP
SM241,,2017,1982,,7155815,153509654,34470700,,6817444,152726948,33993057,,338371,782706,477642,PDP
SM243,,1975,1974,,0,120956376,21522487,,0,0,0,,0,120956376,21522487,PDN
SM243,,1976,1974,,0,120956376,21522487,,0,0,0,,0,120956376,21522487,PDN
SM243,,1977,1974,,1090220,274079592,49858831,,48052,3988944,757829,,1042168,270090648,49101002,PDN
SM243,,1978,1974,,1341646,152410872,28461018,,194939,18122579,3419597,,1146707,134288293,25041421,PDN
SM243,,1979,1974,,1489240,161323692,30194523,,435322,43701802,8211443,,1053918,117621890,21983080,PDN
SM243,,1980,1974,,2116898,202036587,38066469,,772900,79108679,14849177,,1343998,122927908,23217292,PDN
SM243,,1981,1974,,2116898,202036587,38066469,,1118517,116887788,21917056,,998381,85148799,16149413,PDN
SM243,,1982,1974,,2610602,245654722,46321407,,1386604,143266544,26878872,,1223998,102388178,19442535,PDN
SM243,,1983,1974,,5231691,305438251,59580134,,1549105,162005976,30375791,,3682586,143432275,29204343,PDN
SM243,,1984,1974,,3691944,316219699,59958794,,1845418,193865897,36341129,,1846526,122353802,23617665,PDN
SM243,,1985,1974,,3708453,346339653,65334726,,1961486,221219555,41324396,,1746967,125120098,24010330,PDN
SM243,,1986,1974,,2858289,343072947,63903297,,2032610,231772950,43273348,,825679,111299997,20629949,PDN
SM243,,1987,1974,,3016490,342611358,63979365,,2251558,255251726,47670015,,764932,87359632,16309350,PDN
SM243,,1988,1974,,3228589,376029257,70137709,,2400052,272891365,50957234,,828537,103137892,19180475,PDN
SM243,,1989,1974,,3579491,451168242,83858538,,2539380,294925139,55017163,,1040111,156243103,28841375,PDN
SM243,,1990,1974,,3579491,451168022,83858498,,2660377,315896092,58869646,,919114,135271930,24988852,PDN
SM243,,1991,1974,,3538153,451169012,83817337,,2704183,325689992,60656139,,833970,125479020,23161198,PDN
SM243,,1992,1974,,3538153,451169184,83817367,,2728740,331988158,61801366,,809413,119181026,22016001,PDN
SM243,,1993,1974,,3163610,384543249,71587676,,2762215,338670667,63023900,,401395,45872582,8563776,PDN
SM243,,1994,1974,,3088815,377939069,70337760,,2794154,343777820,63964585,,294661,34161249,6373175,PDN
SM243,,1995,1974,,3099640,374730928,69777741,,2839677,348397787,64832166,,259963,26333141,4945575,PDN
SM243,,1996,1974,,3337553,385215418,71881222,,2917628,352444006,65630085,,419925,32771412,6251137,PDN
SM243,,1997,1974,,3254438,404082165,75155179,,2961431,358177997,66694171,,293007,45904168,8461008,PDN
SM243,,1998,1974,,3229588,400547848,74501447,,3043867,373775670,69551993,,185721,26772178,4949454,PDN
SM243,,1999,1974,,3182557,407080720,75616849,,3073522,381806453,71010613,,109035,25274267,4606236,PDN
SM243,,2000,1974,,3281099,414395477,77016949,,3105952,389106964,72342067,,175147,25288513,4674882,PDN
SM243,,2001,1974,,3273074,418532011,77744962,,3143998,396339645,73667067,,129076,22192366,4077895,PDN
SM243,,2002,1974,,3328455,413720882,76944270,,3158347,398196352,74011790,,170108,15524530,2932480,PDN
SM243,,2003,1974,,3226252,406543818,75565010,,3187229,400032760,74367435,,39023,6511058,1197575,PDN
SM243,,2004,1974,,3214293,404244443,75143909,,3198459,401531444,74645335,,15834,2712999,498574,PDN
SM243,,2005,1974,,3209426,404642968,75209954,,3200858,402051630,74740294,,8568,2591338,469660,PDN
SM243,,2006,1974,,3207530,404238696,75136124,,3202692,402568956,74834179,,4838,1669740,301945,PDN
SM243,,2007,1974,,3209413,404086225,75110877,,3204151,403067996,74924435,,5262,1018229,186442,PDN
SM243,,2008,1974,,3209441,404125244,75117847,,3204742,403191893,74947072,,4699,933351,170775,PDN
SM243,,2009,1974,,3206236,410874648,76315604,,3206001,410824465,76306438,,235,50183,9165,PDN
SM243,,2010,1974,,3206236,410874648,76315604,,3206236,410874648,76315604,,0,0,0,PDN
SM243,,2011,1974,,3206236,410874648,76315604,,3206236,410874648,76315604,,0,0,0,PDN
SM243,,2012,1974,,3206236,410874648,76315604,,3206236,410874648,76315604,,0,0,0,PDN
SM243,,2013,1974,,3362129,1969805919,353861402,,3206236,410874648,76315604,,155893,1558931271,277545798,PDN
SM243,,2014,1974,,3206236,410874648,76315604,,3206236,410874648,76315604,,0,0,0,PDN
SM243,,2015,1974,,3206236,410874648,76315604,,3206236,410874648,76315604,,0,0,0,PDN
SM243,,2016,1974,,3206236,410874648,76315604,,3206236,410874648,76315604,,0,0,0,PDN
SM243,,2017,1974,,3206236,410874648,76315604,,3206236,410874648,76315604,,0,0,0,PDN
SM243,,2017,1974,,3206236,410874648,76315604,,3206236,410874648,76315604,,0,0,0,PDN
SM249,,1975,1973,,500000,178654000,32288968,,0,2918,519,,500000,178651082,32288449,PDP
SM249,,1976,1973,,500000,178654000,32288968,,0,2918,519,,500000,178651082,32288449,PDP
SM249,,1977,1973,,734952,225454000,40851322,,6590,7384205,1320505,,728362,218069795,39530817,PDP
SM249,,1978,1973,,734952,376114000,67659151,,17749,21478145,3839483,,717203,354635855,63819668,PDP
SM249,,1979,1973,,234952,376114000,67159151,,32791,37669550,6735558,,202161,338444450,60423593,PDP
SM249,,1980,1973,,239626,381107000,68052259,,51817,58716337,10499564,,187809,322390663,57552695,PDP
SM249,,1981,1973,,245246,383562465,68494795,,65851,77093435,13783544,,179395,306469030,54711251,PDP
SM249,,1982,1973,,258165,383562465,68507714,,73152,92788683,16583594,,185013,290773782,51924120,PDP
SM249,,1983,1973,,258165,383562465,68507714,,75996,101961448,18218602,,182169,281601017,50289112,PDP
SM249,,1984,1973,,258892,385474465,68848654,,77014,114164807,20391037,,181878,271309658,48457617,PDP
SM249,,1985,1973,,261158,387555000,69221122,,79934,119080626,21268657,,181224,268474374,47952465,PDP
SM249,,1986,1973,,104878,162309911,28985645,,80751,122165921,21818459,,24127,40143990,7167186,PDP
SM249,,1987,1973,,106610,163659911,29227591,,82579,131515250,23483869,,24031,32144661,5743722,PDP
SM249,,1988,1973,,107593,179337175,32018122,,83334,136889602,24440914,,24259,42447573,7577208,PDP
SM249,,1989,1973,,84937,152143637,27156759,,83441,140140317,25019440,,1496,12003320,2137319,PDP
SM249,,1990,1973,,85630,152143637,27157452,,83816,142943418,25518588,,1814,9200219,1638864,PDP
SM249,,1991,1973,,85630,152143637,27157452,,84073,145247998,25928913,,1557,6895639,1228539,PDP
SM249,,1992,1973,,85630,152143637,27157452,,84197,146875945,26218707,,1433,5267692,938745,PDP
SM249,,1993,1973,,129999,165834430,29637905,,96552,151939072,27131974,,33447,13895358,2505931,PDP
SM249,,1994,1973,,129822,165734588,29619962,,104907,156657040,27979825,,24915,9077548,1640137,PDP
SM249,,1995,1973,,309602,191904660,34456339,,108594,159363042,28465007,,201008,32541618,5991332,PDP
SM249,,1996,1973,,151788,171268164,30626550,,120401,165133392,29503567,,31387,6134772,1122983,PDP
SM249,,1997,1973,,133543,180500974,32251154,,124302,169624501,30306598,,9241,10876473,1944556,PDP
SM249,,1998,1973,,144074,192473017,34391942,,130843,177028623,31630598,,13231,15444394,2761344,PDP
SM249,,1999,1973,,137051,183351905,32761945,,133273,180214227,32199861,,3778,3137678,562084,PDP
SM249,,2000,1973,,138971,186931053,33400724,,134166,181513844,32432003,,4805,5417209,968721,PDP
SM249,,2001,1973,,146858,190662616,34072590,,134517,182292720,32570944,,12341,8369896,1501646,PDP
SM249,,2002,1973,,147246,191476097,34217726,,135328,183246190,32741412,,11918,8229907,1476314,PDP
SM249,,2003,1973,,147246,191476097,34217726,,136290,184192197,32910702,,10956,7283900,1307024,PDP
SM249,,2004,1973,,218696,203600154,36446482,,137069,186289080,33284592,,81627,17311074,3161890,PDP
SM249,,2005,1973,,225031,218169664,39045256,,137457,188183409,33622049,,87574,29986255,5423207,PDP
SM249,,2006,1973,,216801,210388740,37652520,,137931,189904184,33928711,,78870,20484556,3723809,PDP
SM249,,2007,1973,,1141572,214203467,39256068,,140067,191649368,34241378,,1001505,22554099,5014690,PDP
SM249,,2008,1973,,1141646,214203467,39256142,,454559,193520509,34888813,,687087,20682958,4367329,PDP
SM249,,2009,1973,,1686692,202093258,37646346,,719991,198237702,35993602,,966701,3855556,1652744,PDP
SM249,,2010,1973,,1686692,202093258,37646346,,885527,198873180,36272213,,801165,3220078,1374133,PDP
SM249,,2011,1973,,1686692,202093258,37646346,,1101483,199411513,36583958,,585209,2681745,1062388,PDP
SM249,,2012,1973,,1686692,202093258,37646346,,1329437,199958252,36909196,,357255,2135006,737149,PDP
SM249,,2013,1973,,1686692,202093258,37646346,,1555039,200508718,37232746,,131653,1584540,413600,PDP
SM249,,2014,1973,,2924152,205206572,39437776,,1764291,201024539,37533781,,1159861,4182033,1903995,PDP
SM249,,2015,1973,,2924152,205206572,39437776,,1993836,201575364,37861337,,930316,3631208,1576439,PDP
SM249,,2016,1973,,2924152,205206572,39437776,,2279518,202272562,38271076,,644634,2934010,1166700,PDP
SM249,,2017,1973,,2924152,205206572,39437776,,2529807,202870613,38627780,,394345,2335959,809996,PDP
SM249,,2017,1973,,2924152,205206572,39437776,,2529807,202870613,38627780,,394345,2335959,809996,PDP
SM252,,1979,1978,,21490,21490000,3845333,,0,0,0,,21490,21490000,3845333,PDN
SM252,,1980,1978,,21490,21490000,3845333,,437,104151,18969,,21053,21385849,3826364,PDN
SM252,,1981,1978,,21490,21490000,3845333,,437,181583,32747,,21053,21308417,3812586,PDN
SM252,,1982,1978,,21490,21490000,3845333,,437,251575,45201,,21053,21238425,3800132,PDN
SM252,,1983,1978,,36607,23304488,4183313,,600,333371,59919,,36007,22971117,4123394,PDN
SM252,,1984,1978,,38046,24829925,4456182,,1464,926577,166335,,36582,23903348,4289847,PDN
SM252,,1985,1978,,37180,12766389,2308779,,2578,1338003,240657,,34602,11428386,2068122,PDN
SM252,,1986,1978,,54819,22017316,3972491,,3725,1671807,301200,,51094,20345509,3671291,PDN
SM252,,1987,1978,,54819,22017316,3972491,,11238,4674925,843075,,43581,17342391,3129416,PDN
SM252,,1988,1978,,151626,31698108,5791859,,18407,7646696,1379029,,133219,24051412,4412830,PDN
SM252,,1989,1978,,131317,60980795,10981992,,34637,15874111,2859212,,96680,45106684,8122780,PDN
SM252,,1990,1978,,131317,60980795,10981992,,42032,20409679,3673647,,89285,40571116,7308345,PDN
SM252,,1991,1978,,113072,60980795,10963747,,45803,22476539,4045187,,67269,38504256,6918560,PDN
SM252,,1992,1978,,113494,61135747,10991741,,52139,25656571,4617365,,61355,35479176,6374376,PDN
SM252,,1993,1978,,177990,67585292,12203843,,58344,28377075,5107646,,119646,39208217,7096197,PDN
SM252,,1994,1978,,177990,67585292,12203843,,60544,30016702,5401594,,117446,37568590,6802249,PDN
SM252,,1995,1978,,100123,42263305,7620284,,62309,31667260,5697053,,37814,10596045,1923231,PDN
SM252,,1996,1978,,100030,42305147,7627636,,64438,33628810,6048212,,35592,8676337,1579424,PDN
SM252,,1997,1978,,100030,42305147,7627636,,65663,35244881,6336994,,34367,7060266,1290642,PDN
SM252,,1998,1978,,99624,43905931,7912067,,66746,36776655,6610635,,32878,7129276,1301432,PDN
SM252,,1999,1978,,68193,40340457,7246210,,67236,37775320,6788823,,957,2565137,457387,PDN
SM252,,2000,1978,,70620,41303313,7419964,,67350,38189504,6862635,,3270,3113809,557329,PDN
SM252,,2001,1978,,403480,59100453,10919575,,93215,39864979,7186628,,310265,19235474,3732947,PDN
SM252,,2002,1978,,212476,59100453,10728571,,150751,45945972,8326191,,61725,13154481,2402380,PDN
SM252,,2003,1978,,191342,54926858,9964804,,166091,49232365,8926298,,25251,5694493,1038506,PDN
SM252,,2004,1978,,189533,54655602,9914729,,173349,50438112,9148102,,16184,4217490,766627,PDN
SM252,,2005,1978,,189533,54655602,9914729,,177774,51018587,9255814,,11759,3637015,658915,PDN
SM252,,2006,1978,,180771,51854071,9407474,,179426,51619637,9364415,,1345,234434,43059,PDN
SM252,,2007,1978,,180798,51854129,9407511,,180798,51854129,9407511,,0,0,0,PDN
SM252,,2008,1978,,180798,51854139,9407513,,180798,51854139,9407513,,0,0,0,PDN
SM252,,2009,1978,,180798,52578839,9536460,,180798,52578839,9536460,,0,0,0,PDN
SM252,,2010,1978,,180798,52578839,9536460,,180798,52578839,9536460,,0,0,0,PDN
SM252,,2011,1978,,180798,52578839,9536460,,180798,52578839,9536460,,0,0,0,PDN
SM252,,2012,1978,,180798,52578839,9536460,,180798,52578839,9536460,,0,0,0,PDN
SM252,,2013,1978,,180798,52578839,9536460,,180798,52578839,9536460,,0,0,0,PDN
SM252,,2014,1978,,180798,52578839,9536460,,180798,52578839,9536460,,0,0,0,PDN
SM252,,2015,1978,,180798,52578839,9536460,,180798,52578839,9536460,,0,0,0,PDN
SM252,,2016,1978,,180798,52578839,9536460,,180798,52578839,9536460,,0,0,0,PDN
SM252,,2017,1978,,180798,52578839,9536460,,180798,52578839,9536460,,0,0,0,PDN
SM252,,2017,1978,,180798,52578839,9536460,,180798,52578839,9536460,,0,0,0,PDN
SM255,,1993,1984,,1717841,166529168,31349366,,0,0,0,,1717841,166529168,31349366,PDN
SM255,,1994,1984,,1717841,166529168,31349366,,9191,1429812,263606,,1708650,165099356,31085760,PDN
SM255,,1995,1984,,1394241,135453186,25496231,,38967,6260217,1152885,,1355274,129192969,24343346,PDN
SM255,,1996,1984,,1392601,135294161,25466295,,53687,8659833,1594583,,1338914,126634328,23871712,PDN
SM255,,1997,1984,,1392601,135294161,25466295,,62923,9749545,1797717,,1329678,125544616,23668578,PDN
SM255,,1998,1984,,1392601,135294161,25466295,,67390,10336026,1906541,,1325211,124958135,23559754,PDN
SM255,,1999,1984,,81887,18788807,3425091,,68277,10420843,1922520,,13610,8367964,1502571,PDN
SM255,,2000,1984,,89196,25778254,4676074,,71270,12612271,2315446,,17926,13165983,2360628,PDN
SM255,,2001,1984,,89189,25773941,4675299,,75063,15943658,2912013,,14126,9830283,1763286,PDN
SM255,,2002,1984,,89189,25773941,4675299,,78231,19325311,3516898,,10958,6448630,1158401,PDN
SM255,,2003,1984,,86242,32967226,5952296,,79640,21802646,3959114,,6602,11164580,1993182,PDN
SM255,,2004,1984,,86242,30012641,5426570,,79640,24041006,4357399,,6602,5971635,1069171,PDN
SM255,,2005,1984,,86242,30012641,5426570,,79640,24780656,4489009,,6602,5231985,937561,PDN
SM255,,2006,1984,,84132,30012641,5424460,,79640,25393897,4598127,,4492,4618744,826333,PDN
SM255,,2007,1984,,84132,30012641,5424460,,79752,26127871,4728839,,4380,3884770,695621,PDN
SM255,,2008,1984,,85208,30601283,5530276,,80532,26500367,4795900,,4676,4100916,734376,PDN
SM255,,2009,1984,,81624,26970308,4880611,,81547,26931224,4873579,,77,39084,7031,PDN
SM255,,2010,1984,,81624,26970308,4880611,,81624,26970308,4880611,,0,0,0,PDN
SM255,,2011,1984,,81624,26970308,4880611,,81624,26970308,4880611,,0,0,0,PDN
SM255,,2012,1984,,81624,26970308,4880611,,81624,26970308,4880611,,0,0,0,PDN
SM255,,2013,1984,,81624,26970308,4880611,,81624,26970308,4880611,,0,0,0,PDN
SM255,,2014,1984,,81624,26970308,4880611,,81624,26970308,4880611,,0,0,0,PDN
SM255,,2015,1984,,81624,26970308,4880611,,81624,26970308,4880611,,0,0,0,PDN
SM255,,2016,1984,,81624,26970308,4880611,,81624,26970308,4880611,,0,0,0,PDN
SM255,,2017,1984,,81624,26970308,4880611,,81624,26970308,4880611,,0,0,0,PDN
SM255,,2017,1984,,81624,26970308,4880611,,81624,26970308,4880611,,0,0,0,PDN
SM257,,1978,1977,,5939,5939010,1062702,,0,137412,24451,,5939,5801598,1038251,PDN
SM257,,1979,1977,,5939,5939010,1062702,,0,1967058,350010,,5939,3971952,712692,PDN
SM257,,1980,1977,,8082,8507000,1521783,,0,3601988,640923,,8082,4905012,880860,PDN
SM257,,1981,1977,,8082,8507000,1521783,,0,5139355,914476,,8082,3367645,607307,PDN
SM257,,1982,1977,,8082,8507000,1521783,,0,6294980,1120103,,8082,2212020,401680,PDN
SM257,,1983,1977,,0,19185220,3413740,,0,7502973,1335049,,0,11682247,2078691,PDN
SM257,,1984,1977,,0,19185220,3413740,,0,8572920,1525431,,0,10612300,1888309,PDN
SM257,,1985,1977,,0,19185220,3413740,,0,9398011,1672244,,0,9787209,1741496,PDN
SM257,,1986,1977,,0,9398011,1672244,,0,9398011,1672244,,0,0,0,PDN
SM257,,1987,1977,,0,9398011,1672244,,0,9398011,1672244,,0,0,0,PDN
SM257,,1988,1977,,0,9398011,1672244,,0,9398011,1672244,,0,0,0,PDN
SM257,,1989,1977,,0,9398011,1672244,,0,9398011,1672244,,0,0,0,PDN
SM257,,1990,1977,,0,9398011,1672244,,0,9398011,1672244,,0,0,0,PDN
SM257,,1991,1977,,0,9398011,1672244,,0,9398011,1672244,,0,0,0,PDN
SM257,,1992,1977,,0,9398011,1672244,,0,9398011,1672244,,0,0,0,PDN
SM257,,1993,1977,,0,9398011,1672244,,0,9398011,1672244,,0,0,0,PDN
SM257,,1994,1977,,0,9398011,1672244,,0,9398011,1672244,,0,0,0,PDN
SM257,,1995,1977,,0,9398011,1672244,,0,9398011,1672244,,0,0,0,PDN
SM257,,1996,1977,,0,9398011,1672244,,0,9398011,1672244,,0,0,0,PDN
SM257,,1997,1977,,0,9398011,1672244,,0,9398011,1672244,,0,0,0,PDN
SM257,,1998,1977,,0,9398011,1672244,,0,9398011,1672244,,0,0,0,PDN
SM257,,1999,1977,,0,9398011,1672244,,0,9398011,1672244,,0,0,0,PDN
SM257,,2000,1977,,0,9398011,1672244,,0,9398011,1672244,,0,0,0,PDN
SM257,,2001,1977,,0,9398011,1672244,,0,9398011,1672244,,0,0,0,PDN
SM257,,2002,1977,,0,9398011,1672244,,0,9398011,1672244,,0,0,0,PDN
SM257,,2003,1977,,0,9398011,1672244,,0,9398011,1672244,,0,0,0,PDN
SM257,,2004,1977,,0,9398011,1672244,,0,9398011,1672244,,0,0,0,PDN
SM257,,2005,1977,,0,9398011,1672244,,0,9398011,1672244,,0,0,0,PDN
SM257,,2006,1977,,0,9398011,1672244,,0,9398011,1672244,,0,0,0,PDN
SM257,,2007,1977,,0,9398011,1672244,,0,9398011,1672244,,0,0,0,PDN
SM257,,2008,1977,,0,9398011,1672244,,0,9398011,1672244,,0,0,0,PDN
SM257,,2009,1977,,0,9586225,1705734,,0,9586225,1705734,,0,0,0,PDN
SM257,,2010,1977,,0,9586225,1705734,,0,9586225,1705734,,0,0,0,PDN
SM257,,2011,1977,,0,9586225,1705734,,0,9586225,1705734,,0,0,0,PDN
SM257,,2012,1977,,0,9586225,1705734,,0,9586225,1705734,,0,0,0,PDN
SM257,,2013,1977,,0,9586225,1705734,,0,9586225,1705734,,0,0,0,PDN
SM257,,2014,1977,,0,9586225,1705734,,0,9586225,1705734,,0,0,0,PDN
SM257,,2015,1977,,0,9586225,1705734,,0,9586225,1705734,,0,0,0,PDN
SM257,,2016,1977,,0,9586225,1705734,,0,9586225,1705734,,0,0,0,PDN
SM257,,2017,1977,,0,9586225,1705734,,0,9586225,1705734,,0,0,0,PDN
SM257,,2017,1977,,0,9586225,1705734,,0,9586225,1705734,,0,0,0,PDN
SM261,,1975,1973,,10567737,81791120,25121317,,763165,1107858,960293,,9804572,80683262,24161024,PDN
SM261,,1976,1973,,10567737,81791120,25121317,,1100182,2044706,1464009,,9467555,79746414,23657308,PDN
SM261,,1977,1973,,10567737,81791120,25121317,,1268657,2748981,1757800,,9299080,79042139,23363517,PDN
SM261,,1978,1973,,10577737,91791120,26910677,,1402676,3144646,1962222,,9175061,88646474,24948455,PDN
SM261,,1979,1973,,10577737,92624816,27059021,,1444833,3489116,2065672,,9132904,89135700,24993349,PDN
SM261,,1980,1973,,10959737,113391816,31136217,,1516150,9348728,3179625,,9443587,104043088,27956592,PDN
SM261,,1981,1973,,11827582,176743886,43276672,,1814191,32452831,7588716,,10013391,144291055,35687956,PDN
SM261,,1982,1973,,11827582,176743886,43276672,,1729153,27141966,6558684,,10098429,149601920,36717988,PDN
SM261,,1983,1973,,11487143,151081459,38369965,,1819687,37519286,8495717,,9667456,113562173,29874248,PDN
SM261,,1984,1973,,10414748,90448860,26508851,,1926574,48641551,10581654,,8488174,41807309,15927197,PDN
SM261,,1985,1973,,10680143,127002403,33278435,,2010372,58544415,12427528,,8669771,68457988,20850907,PDN
SM261,,1986,1973,,2428749,108841198,21795510,,2052018,64023181,13444043,,376731,44818017,8351467,PDN
SM261,,1987,1973,,2433789,110624220,22117814,,2102201,71896369,14895149,,331588,38727851,7222665,PDN
SM261,,1988,1973,,2487741,116019421,23131766,,2136894,79066139,16205602,,350847,36953282,6926164,PDN
SM261,,1989,1973,,2415269,136269331,26662481,,2159462,85000514,17284109,,255807,51268817,9378372,PDN
SM261,,1990,1973,,2424735,138418459,27054354,,2201010,94073595,18940084,,223725,44344864,8114270,PDN
SM261,,1991,1973,,2630163,139075829,27376752,,2251146,101762197,20358298,,379017,37313632,7018454,PDN
SM261,,1992,1973,,2630163,139075829,27376752,,2366375,106159075,21255890,,263788,32916754,6120862,PDN
SM261,,1993,1973,,2779587,142948489,28215261,,2446055,110121255,22040584,,333532,32827234,6174677,PDN
SM261,,1994,1973,,2695328,127871320,25448232,,2480108,114507033,22855025,,215220,13364287,2593207,PDN
SM261,,1995,1973,,2574637,129485219,25614712,,2487671,117171169,23336633,,86966,12314050,2278079,PDN
SM261,,1996,1973,,2542810,131370637,25918368,,2494018,119226838,23708758,,48792,12143799,2209610,PDN
SM261,,1997,1973,,2634458,137250196,27056201,,2495905,120561826,23948187,,138553,16688370,3108014,PDN
SM261,,1998,1973,,2634458,137250196,27056201,,2496268,120664227,23966771,,138190,16585969,3089430,PDN
SM261,,1999,1973,,2517799,128842591,25443527,,2497120,121127294,24050019,,20679,7715297,1393508,PDN
SM261,,2000,1973,,3989103,131567925,27399766,,2504692,124267014,24616260,,1484411,7300911,2783506,PDN
SM261,,2001,1973,,3445493,125524333,25780783,,2570353,124681116,24755605,,875140,843217,1025178,PDN
SM261,,2002,1973,,3444167,125960498,25857067,,2669194,124978346,24907334,,774973,982152,949733,PDN
SM261,,2003,1973,,3444167,125960498,25857067,,2755652,125131869,25021109,,688515,828629,835958,PDN
SM261,,2004,1973,,3279533,125364232,25586336,,2822457,125217762,25103198,,457076,146470,483138,PDN
SM261,,2005,1973,,3278122,125339487,25580522,,2875045,125253100,25162073,,403077,86387,418449,PDN
SM261,,2006,1973,,3096690,125332887,25397915,,2892630,125253100,25179658,,204060,79787,218257,PDN
SM261,,2007,1973,,3096690,125332887,25397915,,2892630,125253100,25179658,,204060,79787,218257,PDN
SM261,,2008,1973,,2892630,125253100,25179658,,2892630,125253100,25179658,,0,0,0,PDN
SM261,,2009,1973,,2892630,127669456,25609616,,2892630,127669456,25609616,,0,0,0,PDN
SM261,,2010,1973,,2892630,127669456,25609616,,2892630,127669456,25609616,,0,0,0,PDN
SM261,,2011,1973,,2892630,127669456,25609616,,2892630,127669456,25609616,,0,0,0,PDN
SM261,,2012,1973,,2892630,127669456,25609616,,2892630,127669456,25609616,,0,0,0,PDN
SM261,,2013,1973,,2892630,127669456,25609616,,2892630,127669456,25609616,,0,0,0,PDN
SM261,,2014,1973,,2892630,127669456,25609616,,2892630,127669456,25609616,,0,0,0,PDN
SM261,,2015,1973,,2892630,127669456,25609616,,2892630,127669456,25609616,,0,0,0,PDN
SM261,,2016,1973,,2892630,127669456,25609616,,2892630,127669456,25609616,,0,0,0,PDN
SM261,,2017,1973,,2892630,127669456,25609616,,2892630,127669456,25609616,,0,0,0,PDN
SM261,,2017,1973,,2892630,127669456,25609616,,2892630,127669456,25609616,,0,0,0,PDN
SM265,,1979,1977,,55380,17500000,3169259,,0,0,0,,55380,17500000,3169259,PDN
SM265,,1980,1977,,55380,17500000,3169259,,0,0,0,,55380,17500000,3169259,PDN
SM265,,1981,1977,,55381,17500000,3169260,,8301,2969609,536701,,47080,14530391,2632559,PDN
SM265,,1982,1977,,46690,18676000,3369822,,18928,7434669,1341823,,27762,11241331,2027999,PDN
SM265,,1983,1977,,46690,18676000,3369822,,27478,10906582,1968151,,19212,7769418,1401671,PDN
SM265,,1984,1977,,46690,18676000,3369822,,36249,14622199,2638064,,10441,4053801,731758,PDN
SM265,,1985,1977,,72336,29802220,5375222,,41961,17560327,3166574,,30375,12241893,2208648,PDN
SM265,,1986,1977,,72336,29802220,5375222,,46374,19694836,3550793,,25962,10107384,1824429,PDN
SM265,,1987,1977,,72336,31680929,5709512,,49041,21696896,3909699,,23295,9984033,1799813,PDN
SM265,,1988,1977,,72336,31680929,5709512,,53077,24384734,4391998,,19259,7296195,1317514,PDN
SM265,,1989,1977,,98299,52551507,9449101,,57837,27189287,4895788,,40462,25362220,4553313,PDN
SM265,,1990,1977,,98299,52551507,9449101,,63465,31449891,5659531,,34834,21101616,3789570,PDN
SM265,,1991,1977,,98299,52551507,9449101,,70097,35844094,6448050,,28202,16707413,3001051,PDN
SM265,,1992,1977,,98299,52551507,9449101,,74587,39256038,7059647,,23712,13295469,2389454,PDN
SM265,,1993,1977,,98299,52551507,9449101,,78074,42452806,7631954,,20225,10098701,1817147,PDN
SM265,,1994,1977,,100027,60317751,10832723,,81084,44949034,8079133,,18943,15368717,2753590,PDN
SM265,,1995,1977,,100027,60317751,10832723,,83395,47256548,8492033,,16632,13061203,2340690,PDN
SM265,,1996,1977,,100506,60314011,10832536,,90067,50347809,9048752,,10439,9966202,1783784,PDN
SM265,,1997,1977,,102684,59558270,10700241,,96018,53335885,9586389,,6666,6222385,1113852,PDN
SM265,,1998,1977,,102684,59558270,10700241,,100908,55498458,9976078,,1776,4059812,724163,PDN
SM265,,1999,1977,,112813,59937340,10777820,,103796,56894183,10227316,,9017,3043157,550504,PDN
SM265,,2000,1977,,107503,59937340,10772510,,104675,57975334,10420571,,2828,1962006,351939,PDN
SM265,,2001,1977,,105350,58588321,10530318,,105268,58552486,10523860,,82,35835,6458,PDN
SM265,,2002,1977,,105350,58588321,10530318,,105350,58588321,10530318,,0,0,0,PDN
SM265,,2003,1977,,105350,58588321,10530318,,105350,58588321,10530318,,0,0,0,PDN
SM265,,2004,1977,,105350,58588321,10530318,,105350,58588321,10530318,,0,0,0,PDN
SM265,,2005,1977,,105350,58588321,10530318,,105350,58588321,10530318,,0,0,0,PDN
SM265,,2006,1977,,105350,58588321,10530318,,105350,58588321,10530318,,0,0,0,PDN
SM265,,2007,1977,,281297,63131445,11514650,,206439,61065875,11072253,,74858,2065570,442397,PDN
SM265,,2008,1977,,290071,62976547,11495862,,258542,62519031,11382925,,31529,457516,112937,PDN
SM265,,2009,1977,,290614,64080699,11692874,,262781,63828382,11620144,,27833,252317,72729,PDN
SM265,,2010,1977,,290614,64080699,11692874,,267061,63872773,11632323,,23553,207926,60551,PDN
SM265,,2011,1977,,290614,64080699,11692874,,268360,63886910,11636138,,22254,193789,56736,PDN
SM265,,2012,1977,,290614,64080699,11692874,,272107,63928218,11647235,,18507,152481,45639,PDN
SM265,,2013,1977,,290614,64080699,11692874,,274158,63954670,11653993,,16456,126029,38881,PDN
SM265,,2014,1977,,274158,63954670,11653993,,274158,63954670,11653993,,0,0,0,PDN
SM265,,2015,1977,,274158,63954670,11653993,,274158,63954670,11653993,,0,0,0,PDN
SM265,,2016,1977,,274158,63954670,11653993,,274158,63954670,11653993,,0,0,0,PDN
SM265,,2017,1977,,274158,63954670,11653993,,274158,63954670,11653993,,0,0,0,PDN
SM265,,2017,1977,,274158,63954670,11653993,,274158,63954670,11653993,,0,0,0,PDN
SM269,,1975,1973,,17607021,257882770,63493635,,330086,693879,453552,,17276935,257188891,63040083,PDP
SM269,,1976,1973,,25907021,262032770,72532069,,2872308,5995751,3939168,,23034713,256037019,68592901,PDP
SM269,,1977,1973,,25907021,262032770,72532069,,3473211,6764151,4676797,,22433810,255268619,67855272,PDP
SM269,,1978,1973,,29506657,331533632,88498406,,6726758,13336861,9099865,,22779899,318196771,79398541,PDP
SM269,,1979,1973,,38648246,397197905,109324030,,9834529,36372137,16306439,,28813717,360825768,93017591,PDP
SM269,,1980,1973,,42927891,461300559,125009841,,13910464,81000886,28323433,,29017427,380299673,96686408,PDP
SM269,,1981,1973,,49688228,513218769,141008294,,18627908,136409046,42899980,,31060320,376809723,98108314,PDP
SM269,,1982,1973,,55312188,605077306,162977189,,22348368,183099173,54928292,,32963820,421978133,108048897,PDP
SM269,,1983,1973,,64753673,720463004,192949937,,25497717,211351883,63104814,,39255956,509111121,129845123,PDP
SM269,,1984,1973,,66448446,721461440,194822368,,27966867,233824798,69572703,,38481579,487636642,125249665,PDP
SM269,,1985,1973,,67722337,741607561,199680978,,30147857,252026867,74992495,,37574480,489580694,124688483,PDP
SM269,,1986,1973,,67477582,753312945,201519031,,32297409,267073887,79819453,,35180173,486239058,121699578,PDP
SM269,,1987,1973,,54582501,636600168,167856552,,34172785,282773962,84488437,,20409716,353826206,83368115,PDP
SM269,,1988,1973,,57148032,676020950,177436457,,35872828,310009938,91034739,,21275204,366011012,86401718,PDP
SM269,,1989,1973,,54146359,607934352,162319731,,37365815,340956653,98034259,,16780544,266977699,64285472,PDP
SM269,,1990,1973,,54878348,616638903,164600573,,38805742,370054423,104651725,,16072606,246584480,59948848,PDP
SM269,,1991,1973,,48976759,584789616,153031851,,39654917,397091480,110311764,,9321842,187698136,42720087,PDP
SM269,,1992,1973,,48112804,578155075,150987373,,40715681,423974753,116156029,,7397123,154180322,34831344,PDP
SM269,,1993,1973,,48625251,586382228,152963726,,41906296,451689797,122278146,,6718955,134692431,30685580,PDP
SM269,,1994,1973,,50240755,592410598,155651893,,42528594,472356035,126577711,,7712161,120054563,29074182,PDP
SM269,,1995,1973,,49727128,632634680,162295576,,43791822,500630490,132871980,,5935306,132004190,29423596,PDP
SM269,,1996,1973,,52531901,649046643,168020628,,45463827,521879969,138325031,,7068074,127166674,29695597,PDP
SM269,,1997,1973,,50100233,609049020,158471945,,46389425,537935478,142107482,,3710808,71113542,16364463,PDP
SM269,,1998,1973,,51035083,628353039,162841674,,47622891,560790548,147407686,,3412192,67562491,15433988,PDP
SM269,,1999,1973,,53611703,636325300,166836845,,48651077,575349472,151026428,,4960626,60975828,15810417,PDP
SM269,,2000,1973,,55490110,688169104,177940128,,49465050,584575200,153481990,,6025060,103593904,24458138,PDP
SM269,,2001,1973,,59035096,721135812,187351077,,50915155,596915130,157127812,,8119941,124220682,30223265,PDP
SM269,,2002,1973,,65336913,719095722,193289889,,52794142,626416059,164256074,,12542771,92679663,29033815,PDP
SM269,,2003,1973,,62650770,734091811,193272088,,55620380,643572299,170135024,,7030390,90519512,23137064,PDP
SM269,,2004,1973,,64693021,737167258,195861572,,57108917,658372185,174256993,,7584104,78795073,21604579,PDP
SM269,,2005,1973,,65015147,741476853,196950530,,58071844,667758040,176890001,,6943303,73718813,20060529,PDP
SM269,,2006,1973,,65714547,732793989,196104937,,58595259,673847733,178496991,,7119288,58946256,17607946,PDP
SM269,,2007,1973,,65302328,733733498,195859890,,59511585,680017681,180511172,,5790743,53715817,15348718,PDP
SM269,,2008,1973,,65962334,739771228,197594225,,60363994,683818919,182039958,,5598340,55952309,15554267,PDP
SM269,,2009,1973,,64570708,744843225,197105081,,61077749,698631724,185389439,,3492959,46211501,11715643,PDP
SM269,,2010,1973,,64994813,751283190,198675087,,61640181,702880973,186707963,,3354632,48402217,11967124,PDP
SM269,,2011,1973,,64534491,750730804,198116476,,62138190,707312007,187994414,,2396301,43418797,10122065,PDP
SM269,,2012,1973,,64534491,750730804,198116476,,62587189,711132076,189123139,,1947302,39598728,8993338,PDP
SM269,,2013,1973,,65671388,749375219,199012166,,63068825,714227040,190155484,,2602563,35148179,8856685,PDP
SM269,,2014,1973,,65983926,751522986,199706869,,63628197,716909909,191192234,,2355729,34613077,8514635,PDP
SM269,,2015,1973,,66164961,755961306,200677641,,64050370,719348617,192048341,,2114591,36612689,8629302,PDP
SM269,,2016,1973,,66328714,763689289,202216480,,64355040,722755083,192959144,,1973674,40934206,9257339,PDP
SM269,,2017,1973,,66153089,758324064,201086190,,64577030,724806915,193546229,,1576059,33517149,7539962,PDP
SM269,,2017,1973,,66153089,758324064,201086190,,64577030,724806915,193546229,,1576059,33517149,7539962,PDP
SM273,,1982,1980,,4600,4600000,823105,,0,0,0,,4600,4600000,823105,PDN
SM273,,1990,1980,,0,19089936,3396786,,0,0,0,,0,19089936,3396786,PDN
SM273,,1991,1980,,0,19089936,3396786,,0,419856,74707,,0,18670080,3322079,PDN
SM273,,1992,1980,,500,19089936,3397286,,48,1097587,195348,,452,17992349,3201938,PDN
SM273,,1993,1980,,500,11352891,2020587,,62,1192944,212330,,438,10159947,1808257,PDN
SM273,,1994,1980,,62,1192944,212330,,62,1192944,212330,,0,0,0,PDN
SM273,,1995,1980,,62,1192944,212330,,62,1192944,212330,,0,0,0,PDN
SM273,,1996,1980,,62,1192944,212330,,62,1192944,212330,,0,0,0,PDN
SM273,,1997,1980,,62,1192944,212330,,62,1192944,212330,,0,0,0,PDN
SM273,,1998,1980,,62,1192944,212330,,62,1192944,212330,,0,0,0,PDN
SM273,,1999,1980,,62,1192944,212330,,62,1192944,212330,,0,0,0,PDN
SM273,,2000,1980,,62,1192944,212330,,62,1192944,212330,,0,0,0,PDN
SM273,,2001,1980,,62,1192944,212330,,62,1192944,212330,,0,0,0,PDN
SM273,,2002,1980,,62,1192944,212330,,62,1192944,212330,,0,0,0,PDN
SM273,,2003,1980,,62,1192944,212330,,62,1192944,212330,,0,0,0,PDN
SM273,,2004,1980,,62,1192944,212330,,62,1192944,212330,,0,0,0,PDN
SM273,,2005,1980,,62,1192944,212330,,62,1192944,212330,,0,0,0,PDN
SM273,,2006,1980,,62,1192944,212330,,62,1192944,212330,,0,0,0,PDN
SM273,,2007,1980,,62,1192944,212330,,62,1192944,212330,,0,0,0,PDN
SM273,,2008,1980,,62,1192944,212330,,62,1192944,212330,,0,0,0,PDN
SM273,,2009,1980,,62,1216835,216581,,62,1216835,216581,,0,0,0,PDN
SM273,,2010,1980,,62,1216835,216581,,62,1216835,216581,,0,0,0,PDN
SM273,,2011,1980,,62,1216835,216581,,62,1216835,216581,,0,0,0,PDN
SM273,,2012,1980,,62,1216835,216581,,62,1216835,216581,,0,0,0,PDN
SM273,,2013,1980,,62,1216835,216581,,62,1216835,216581,,0,0,0,PDN
SM273,,2014,1980,,62,1216835,216581,,62,1216835,216581,,0,0,0,PDN
SM273,,2015,1980,,62,1216835,216581,,62,1216835,216581,,0,0,0,PDN
SM273,,2016,1980,,62,1216835,216581,,62,1216835,216581,,0,0,0,PDN
SM273,,2017,1980,,62,1216835,216581,,62,1216835,216581,,0,0,0,PDN
SM273,,2017,1980,,62,1216835,216581,,62,1216835,216581,,0,0,0,PDN
SM274,,1991,1982,,315,9404786,1673764,,315,9404786,1673764,,0,0,0,PDN
SM274,,1992,1982,,315,9404786,1673764,,315,9404786,1673764,,0,0,0,PDN
SM274,,1993,1982,,315,9404786,1673764,,315,9404786,1673764,,0,0,0,PDN
SM274,,1994,1982,,315,9404786,1673764,,315,9404786,1673764,,0,0,0,PDN
SM274,,1995,1982,,315,9404786,1673764,,315,9404786,1673764,,0,0,0,PDN
SM274,,1996,1982,,315,9404786,1673764,,315,9404786,1673764,,0,0,0,PDN
SM274,,1997,1982,,315,9404786,1673764,,315,9404786,1673764,,0,0,0,PDN
SM274,,1998,1982,,315,9404786,1673764,,315,9404786,1673764,,0,0,0,PDN
SM274,,1999,1982,,315,9404786,1673764,,315,9404786,1673764,,0,0,0,PDN
SM274,,2000,1982,,315,9404786,1673764,,315,9404786,1673764,,0,0,0,PDN
SM274,,2001,1982,,315,9404786,1673764,,315,9404786,1673764,,0,0,0,PDN
SM274,,2002,1982,,315,9404786,1673764,,315,9404786,1673764,,0,0,0,PDN
SM274,,2003,1982,,315,9404786,1673764,,315,9404786,1673764,,0,0,0,PDN
SM274,,2004,1982,,315,9404786,1673764,,315,9404786,1673764,,0,0,0,PDN
SM274,,2005,1982,,315,9404786,1673764,,315,9404786,1673764,,0,0,0,PDN
SM274,,2006,1982,,315,9404786,1673764,,315,9404786,1673764,,0,0,0,PDN
SM274,,2007,1982,,315,9404786,1673764,,315,9404786,1673764,,0,0,0,PDN
SM274,,2008,1982,,315,9404786,1673764,,315,9404786,1673764,,0,0,0,PDN
SM274,,2009,1982,,315,9593133,1707277,,315,9593133,1707277,,0,0,0,PDN
SM274,,2010,1982,,315,9593133,1707277,,315,9593133,1707277,,0,0,0,PDN
SM274,,2011,1982,,315,9593133,1707277,,315,9593133,1707277,,0,0,0,PDN
SM274,,2012,1982,,315,9593133,1707277,,315,9593133,1707277,,0,0,0,PDN
SM274,,2013,1982,,315,9593133,1707277,,315,9593133,1707277,,0,0,0,PDN
SM274,,2014,1982,,315,9593133,1707277,,315,9593133,1707277,,0,0,0,PDN
SM274,,2015,1982,,315,9593133,1707277,,315,9593133,1707277,,0,0,0,PDN
SM274,,2016,1982,,315,9593133,1707277,,315,9593133,1707277,,0,0,0,PDN
SM274,,2017,1982,,315,9593133,1707277,,315,9593133,1707277,,0,0,0,PDN
SM274,,2017,1982,,315,9593133,1707277,,315,9593133,1707277,,0,0,0,PDN
SP027,,1975,1954,,214800000,628934400,326710036,,191955282,583966407,295863895,,22844718,44967993,30846141,PDP
SP027,,1976,1954,,224800000,738019200,356120142,,195849438,610023264,304394503,,28950562,127995936,51725639,PDP
SP027,,1977,1954,,224800000,738019200,356120142,,201787479,638645772,315425517,,23012521,99373428,40694625,PDP
SP027,,1978,1954,,224800000,738019200,356120142,,205870665,662006721,323665455,,18929335,76012479,32454687,PDP
SP027,,1979,1954,,244200000,738019200,375520142,,237407302,720820198,365667124,,6792698,17199002,9853018,PDP
SP027,,1980,1954,,131171579,604120069,238666253,,118330747,527381973,212170956,,12840832,76738096,26495297,PDP
SP027,,1981,1954,,132065187,725196110,261103641,,121359811,541561881,217723135,,10705376,183634229,43380506,PDP
SP027,,1982,1954,,134157576,759682054,269332319,,121352007,556736495,220415440,,12805569,202945559,48916879,PDP
SP027,,1983,1954,,173178378,954030679,342934727,,123788761,556675427,222841328,,49389617,397355252,120093399,PDP
SP027,,1984,1954,,177935853,963153030,349315396,,126518212,568401219,227657219,,51417641,394751811,121658177,PDP
SP027,,1985,1954,,168124576,860951499,321318793,,127401296,576075799,229905887,,40723280,284875700,91412906,PDP
SP027,,1986,1954,,147349694,690769339,270262388,,129546398,619914351,239851443,,17803296,70854988,30410945,PDP
SP027,,1987,1954,,152083363,700743686,276770852,,131684520,626097010,243089682,,20398843,74646676,33681170,PDP
SP027,,1988,1954,,145907259,692903860,269199761,,133366072,629302961,245341688,,12541187,63600899,23858073,PDP
SP027,,1989,1954,,148311875,711750728,274957912,,135026543,633499401,247748856,,13285332,78251327,27209056,PDP
SP027,,1990,1954,,150334620,716322077,277794064,,136460076,638894967,250142454,,13874544,77427110,27651610,PDP
SP027,,1991,1954,,151016035,730034409,280915396,,137438387,643013020,251853515,,13577648,87021389,29061881,PDP
SP027,,1992,1954,,148618807,687731660,270990988,,138671697,648798335,254116241,,9947110,38933325,16874747,PDP
SP027,,1993,1954,,148355722,711957333,275038521,,139794832,657365180,256763725,,8560890,54592153,18274796,PDP
SP027,,1994,1954,,154835657,776736524,293045003,,141302166,670525582,260612768,,13533491,106210942,32432235,PDP
SP027,,1995,1954,,155951375,787622106,296097657,,142551544,683682994,264203322,,13399831,103939112,31894335,PDP
SP027,,1996,1954,,152274055,761516446,287775202,,143663076,695876593,267484534,,8610979,65639853,20290668,PDP
SP027,,1997,1954,,152260842,763171425,288056469,,144475627,706935311,270264828,,7785215,56236114,17791641,PDP
SP027,,1998,1954,,174646938,788101654,314878549,,145063460,714147168,272135910,,29583478,73954486,42742639,PDP
SP027,,1999,1954,,151543213,772651609,289025706,,145695696,718715981,273581102,,5847517,53935628,15444604,PDP
SP027,,2000,1954,,152547000,766467905,288929190,,146254432,722179170,274756064,,6292568,44288735,14173126,PDP
SP027,,2001,1954,,150659381,822410365,296995745,,147001691,730278560,276944495,,3657690,92131805,20051250,PDP
SP027,,2002,1954,,149255943,791580932,290106643,,147433986,741461326,279366606,,1821957,50119606,10740037,PDP
SP027,,2003,1954,,150667472,795709894,292252862,,148128526,751958049,281928891,,2538946,43751845,10323971,PDP
SP027,,2004,1954,,151238943,791371704,292052413,,149206555,758658401,284199153,,2032388,32713303,7853260,PDP
SP027,,2005,1954,,151256222,792174604,292212557,,149633282,760802018,285007307,,1622940,31372586,7205250,PDP
SP027,,2006,1954,,151874663,793705227,293103351,,150010277,762320903,285654566,,1864386,31384324,7448785,PDP
SP027,,2007,1954,,151688750,794326322,293027953,,150333619,763548489,286196339,,1355131,30777833,6831614,PDP
SP027,,2008,1954,,151966533,795135583,293449733,,150627351,764569586,286671761,,1339182,30565997,6777972,PDP
SP027,,2009,1954,,152281616,809120710,296253271,,150806964,779935355,289585497,,1474652,29185355,6667775,PDP
SP027,,2010,1954,,153008922,810760055,297272275,,151063801,781901305,290192146,,1945121,28858750,7080132,PDP
SP027,,2011,1954,,152775660,810937803,297070641,,151281245,782627394,290538788,,1494415,28310409,6531854,PDP
SP027,,2012,1954,,152791301,810948167,297088127,,151473178,782919544,290782705,,1318123,28028623,6305422,PDP
SP027,,2013,1954,,152681850,810890975,296968501,,151650713,783170912,291004969,,1031137,27720063,5963532,PDP
SP027,,2014,1954,,152835356,791732353,293712996,,151801350,783389320,291194469,,1034006,8343033,2518533,PDP
SP027,,2015,1954,,152964773,791300358,293765546,,151941585,783520069,291357968,,1023188,7780289,2407577,PDP
SP027,,2016,1954,,152871106,791160746,293647036,,152069959,783674011,291513731,,801147,7486735,2133304,PDP
SP027,,2017,1954,,153072450,791597803,293926150,,152183741,783930911,291673225,,888709,7666892,2252923,PDP
SP027,,2017,1954,,153072450,791597803,293926150,,152183741,783930911,291673225,,888709,7666892,2252923,PDP
SP043,,1989,1988,,5726977,10899730,7666431,,6953,429631,83400,,5720024,10470099,7583031,PDN
SP043,,1990,1988,,6330288,13916285,8806495,,13414,1205864,227981,,6316874,12710421,8578514,PDN
SP043,,1991,1988,,6330288,13916285,8806495,,447524,3527592,1075209,,5882764,10388693,7731286,PDN
SP043,,1992,1988,,6330288,13916285,8806495,,533009,5784546,1562288,,5797279,8131739,7244207,PDN
SP043,,1993,1988,,4813831,22854053,8880388,,620802,9109520,2241713,,4193029,13744533,6638675,PDN
SP043,,1994,1988,,4813733,22854169,8880311,,705703,10884482,2642444,,4108030,11969687,6237867,PDN
SP043,,1995,1988,,770340,12333786,2964964,,770340,12333786,2964964,,0,0,0,PDN
SP043,,1996,1988,,770340,12333786,2964964,,770340,12333786,2964964,,0,0,0,PDN
SP043,,1997,1988,,770340,12333786,2964964,,770340,12333786,2964964,,0,0,0,PDN
SP043,,1998,1988,,770340,12333786,2964964,,770340,12333786,2964964,,0,0,0,PDN
SP043,,1999,1988,,770340,12333786,2964964,,770340,12333786,2964964,,0,0,0,PDN
SP043,,2000,1988,,770340,12333786,2964964,,770340,12333786,2964964,,0,0,0,PDN
SP043,,2001,1988,,770340,12333786,2964964,,770340,12333786,2964964,,0,0,0,PDN
SP043,,2002,1988,,770340,12333786,2964964,,770340,12333786,2964964,,0,0,0,PDN
SP043,,2003,1988,,770340,12333786,2964964,,770340,12333786,2964964,,0,0,0,PDN
SP043,,2004,1988,,770340,12333786,2964964,,770340,12333786,2964964,,0,0,0,PDN
SP043,,2005,1988,,770340,12333786,2964964,,770340,12333786,2964964,,0,0,0,PDN
SP043,,2006,1988,,770340,12333786,2964964,,770340,12333786,2964964,,0,0,0,PDN
SP043,,2007,1988,,1010279,17599296,4141826,,860463,13967245,3345738,,149816,3632051,796088,PDN
SP043,,2008,1988,,1156187,17868664,4335665,,899313,15659921,3685776,,256874,2208743,649889,PDN
SP043,,2009,1988,,1157195,18196425,4394993,,960410,17430517,4061925,,196785,765908,333068,PDN
SP043,,2010,1988,,1060207,17823299,4231613,,1013459,17561485,4138278,,46748,261814,93334,PDN
SP043,,2011,1988,,1060722,17833669,4233973,,1042409,17770028,4204336,,18313,63641,29637,PDN
SP043,,2012,1988,,1060722,17881987,4242571,,1060716,17866155,4239748,,6,15832,2823,PDN
SP043,,2013,1988,,1062053,18003011,4265437,,1062053,18003011,4265437,,0,0,0,PDN
SP043,,2014,1988,,1062053,18003011,4265437,,1062053,18003011,4265437,,0,0,0,PDN
SP043,,2015,1988,,1062053,18003011,4265437,,1062053,18003011,4265437,,0,0,0,PDN
SP043,,2016,1988,,1062053,18003011,4265437,,1062053,18003011,4265437,,0,0,0,PDN
SP043,,2017,1988,,1062054,18001157,4265107,,1062054,18001157,4265107,,0,0,0,PDN
SP043,,2017,1988,,1062054,18001157,4265107,,1062054,18001157,4265107,,0,0,0,PDN
SP045,,1983,1969,,920000,92000000,17290107,,0,0,0,,920000,92000000,17290107,PDN
SP045,,1984,1969,,920000,92000000,17290107,,0,0,0,,920000,92000000,17290107,PDN
SP045,,1985,1969,,1305262,41929966,8766110,,0,0,0,,1305262,41929966,8766110,PDN
SP045,,1986,1969,,1305262,41929966,8766110,,0,0,0,,1305262,41929966,8766110,PDN
SP045,,1987,1969,,1516240,74098452,14701018,,0,0,0,,1516240,74098452,14701018,PDN
SP045,,1988,1969,,1516240,74098452,14701018,,0,0,0,,1516240,74098452,14701018,PDN
SP045,,1989,1969,,1516240,74098452,14701018,,0,0,0,,1516240,74098452,14701018,PDN
SP045,,1990,1969,,1574185,77272498,15323740,,89218,11349231,2108654,,1484967,65923267,13215086,PDN
SP045,,1991,1969,,920837,98652053,18474583,,176256,27307278,5035202,,744581,71344775,13439381,PDN
SP045,,1992,1969,,921010,98652053,18474756,,254016,37279361,6887354,,666994,61372692,11587402,PDN
SP045,,1993,1969,,1221697,125996394,23640984,,324131,45541332,8427571,,897566,80455062,15213413,PDN
SP045,,1994,1969,,1222323,131566675,24632763,,395750,50080823,9306928,,826573,81485852,15325835,PDN
SP045,,1995,1969,,739265,69651249,13132726,,473852,58077780,10807977,,265413,11573469,2324749,PDN
SP045,,1996,1969,,655019,77028572,14361171,,543147,61415442,11471162,,111872,15613130,2890009,PDN
SP045,,1997,1969,,706533,77187012,14440877,,605447,63341020,11876091,,101086,13845992,2564786,PDN
SP045,,1998,1969,,706533,77187012,14440877,,653144,64726809,12170370,,53389,12460203,2270507,PDN
SP045,,1999,1969,,763838,68694296,12987022,,708157,65905955,12435195,,55681,2788341,551827,PDN
SP045,,2000,1969,,1933143,133271697,25646968,,762470,66825963,12653211,,1170673,66445734,12993757,PDN
SP045,,2001,1969,,1935835,135760691,26092541,,812476,68236910,12954275,,1123359,67523781,13138266,PDN
SP045,,2002,1969,,1969749,135907108,26152508,,860923,70095844,13333493,,1108826,65811264,12819015,PDN
SP045,,2003,1969,,2058557,136229525,26298686,,899604,70862332,13508560,,1158953,65367193,12790126,PDN
SP045,,2004,1969,,1996098,135717316,26145086,,924842,71325648,13616238,,1071256,64391668,12528848,PDN
SP045,,2005,1969,,1995835,135236965,26059352,,935887,71444513,13648434,,1059948,63792452,12410918,PDN
SP045,,2006,1969,,62998,69835413,12489228,,62998,69835413,12489228,,0,0,0,PDN
SP045,,2007,1969,,62998,69835413,12489228,,62998,69835413,12489228,,0,0,0,PDN
SP045,,2008,1969,,62998,69835413,12489228,,62998,69835413,12489228,,0,0,0,PDN
SP045,,2009,1969,,935887,72733046,13877710,,935887,72733046,13877710,,0,0,0,PDN
SP045,,2010,1969,,935887,72733046,13877712,,935887,72733046,13877712,,0,0,0,PDN
SP045,,2011,1969,,935887,72733046,13877712,,935887,72733046,13877712,,0,0,0,PDN
SP045,,2012,1969,,935887,72733046,13877712,,935887,72733046,13877712,,0,0,0,PDN
SP045,,2013,1969,,935887,72733046,13877712,,935887,72733046,13877712,,0,0,0,PDN
SP045,,2014,1969,,935887,72733046,13877712,,935887,72733046,13877712,,0,0,0,PDN
SP045,,2015,1969,,935887,72733046,13877712,,935887,72733046,13877712,,0,0,0,PDN
SP045,,2016,1969,,935887,72733046,13877712,,935887,72733046,13877712,,0,0,0,PDN
SP045,,2017,1969,,935887,72733046,13877712,,935887,72733046,13877712,,0,0,0,PDN
SP045,,2017,1969,,935887,72733046,13877712,,935887,72733046,13877712,,0,0,0,PDN
SP049,,1977,1974,,27000000,25007000,31449644,,0,0,0,,27000000,25007000,31449644,PDP
SP049,,1978,1974,,19450150,11670090,21526678,,0,0,0,,19450150,11670090,21526678,PDP
SP049,,1979,1974,,19450150,11670090,21526678,,0,0,0,,19450150,11670090,21526678,PDP
SP049,,1980,1974,,19623150,11973013,21753579,,112018,95294,128974,,19511132,11877719,21624605,PDP
SP049,,1981,1974,,23302750,13169013,25645991,,2428894,1904731,2767814,,20873856,11264282,22878177,PDP
SP049,,1982,1974,,23302750,14885345,25951388,,9422769,9186130,11057312,,13879981,5699215,14894076,PDP
SP049,,1983,1974,,30886153,30958487,36394781,,18926676,19140609,22332478,,11959477,11817878,14062303,PDP
SP049,,1984,1974,,41909960,45648152,50032407,,28688603,30269005,34074547,,13221357,15379147,15957860,PDP
SP049,,1985,1974,,57497445,94554922,74322164,,37169519,42602454,44750027,,20327926,51952468,29572137,PDP
SP049,,1986,1974,,57497445,94554922,74322164,,44029127,51317015,53160268,,13468318,43237907,21161896,PDP
SP049,,1987,1974,,75892231,200213716,111517447,,49115422,58971901,59608643,,26776809,141241815,51908804,PDP
SP049,,1988,1974,,75918093,200400305,111576510,,53025443,65838625,64740501,,22892650,134561680,46836009,PDP
SP049,,1989,1974,,73898464,170591006,104252736,,55667745,71540432,68397359,,18230719,99050574,35855377,PDP
SP049,,1990,1974,,73898464,170591006,104252736,,58054367,76588561,71682225,,15844097,94002445,32570511,PDP
SP049,,1991,1974,,73898464,170591006,104252736,,61193965,83602038,76069772,,12704499,86988968,28182964,PDP
SP049,,1992,1974,,78436119,148952903,104940194,,63371661,88480082,79115448,,15064458,60472821,25824746,PDP
SP049,,1993,1974,,78596330,151660831,105582243,,65716589,94422834,82517805,,12879741,57237997,23064438,PDP
SP049,,1994,1974,,79766165,152607775,106920573,,67376984,98646691,84929776,,12389181,53961084,21990797,PDP
SP049,,1995,1974,,77062480,157639449,105112204,,68798635,102490457,87035371,,8263845,55148992,18076833,PDP
SP049,,1996,1974,,77649763,174524063,108703867,,70186171,114455113,90551849,,7463592,60068950,18152018,PDP
SP049,,1997,1974,,78484013,177980655,110153169,,71289572,131486835,94685806,,7194441,46493820,15467363,PDP
SP049,,1998,1974,,92599325,208305291,129664323,,73061012,139676275,97914442,,19538313,68629016,31749881,PDP
SP049,,1999,1974,,80626685,201485728,116478238,,74466410,149952160,101148289,,6160275,51533568,15329949,PDP
SP049,,2000,1974,,78255088,208317025,115322174,,75365552,161322604,104070642,,2889536,46994421,11251532,PDP
SP049,,2001,1974,,86437085,222773177,126076440,,76263474,177256031,107803693,,10173611,45517146,18272747,PDP
SP049,,2002,1974,,87887395,204682307,124307734,,77015349,183098816,109595209,,10872046,21583491,14712525,PDP
SP049,,2003,1974,,88282519,206839573,125086713,,77726993,187542078,111097470,,10555526,19297495,13989243,PDP
SP049,,2004,1974,,86327205,202205959,122306913,,78262678,190528408,112164530,,8064527,11677551,10142383,PDP
SP049,,2005,1974,,86327205,202205959,122306913,,78262678,190528408,112164530,,8064527,11677551,10142383,PDP
SP049,,2006,1974,,88376179,204899936,124835242,,78314181,190610712,112230678,,10061998,14289224,12604564,PDP
SP049,,2007,1974,,89460600,208125455,126493599,,78965330,192132197,113152554,,10495270,15993258,13341045,PDP
SP049,,2008,1974,,89460600,208224547,126511231,,79575012,193474332,114001050,,9885588,14750215,12510181,PDP
SP049,,2009,1974,,89425693,209218544,126653192,,79575013,196233717,114492043,,9850680,12984827,12161147,PDP
SP049,,2010,1974,,92752092,218291432,131593984,,80381636,197863345,115588637,,12370456,20428087,16005348,PDP
SP049,,2011,1974,,92464077,217627287,131187794,,81192007,199681246,116722476,,11272070,17946041,14465317,PDP
SP049,,2012,1974,,93065430,227873603,133612335,,81842124,201933551,117773361,,11223306,25940052,15838974,PDP
SP049,,2013,1974,,93109626,235468504,135007937,,82542686,210680599,120030336,,10566940,24787905,14977600,PDP
SP049,,2014,1974,,92993817,237599397,135271288,,83147373,217382145,121827470,,9846444,20217252,13443820,PDP
SP049,,2015,1974,,86134590,237675960,128425685,,83829790,223184480,123542329,,2304800,14491480,4883356,PDP
SP049,,2016,1974,,86331675,236095811,128341605,,84396758,226188603,124643840,,1934917,9907208,3697768,PDP
SP049,,2017,1974,,86406428,236104404,128417887,,84878003,227527706,125363359,,1528425,8576698,3054527,PDP
SP049,,2017,1974,,86406428,236104404,128417887,,84878003,227527706,125363359,,1528425,8576698,3054527,PDP
SP052,,1976,1974,,0,25000000,4448399,,0,0,0,,0,25000000,4448399,PDN
SP052,,1984,1974,,48841,2783931,544202,,0,0,0,,48841,2783931,544202,PDN
SP052,,1985,1974,,48841,2783931,544202,,0,0,0,,48841,2783931,544202,PDN
SP052,,1986,1974,,207899,11891373,2323802,,0,0,0,,207899,11891373,2323802,PDN
SP052,,1987,1974,,207899,11891373,2323802,,0,0,0,,207899,11891373,2323802,PDN
SP052,,1991,1974,,4761,47609979,8476288,,0,0,0,,4761,47609979,8476288,PDN
SP052,,1992,1974,,266786,70508439,12812772,,32061,13885944,2502870,,234725,56622495,10309902,PDN
SP052,,1993,1974,,7712824,95694076,24740240,,71357,27517163,4967649,,7641467,68176913,19772591,PDN
SP052,,1994,1974,,7337351,94485261,24149675,,252152,39335858,7251415,,7085199,55149403,16898260,PDN
SP052,,1995,1974,,4403865,93023390,20956070,,422012,50014438,9321378,,3981853,43008952,11634692,PDN
SP052,,1996,1974,,846669,67927075,12933337,,534001,58053946,10863885,,312668,9873129,2069452,PDN
SP052,,1997,1974,,1336759,70252180,13837147,,648492,62148777,11706993,,688267,8103403,2130154,PDN
SP052,,1998,1974,,1338238,71420110,14046443,,796312,65287829,12413363,,541926,6132281,1633080,PDN
SP052,,1999,1974,,1370881,89090385,17223263,,1060036,72351286,13933930,,310845,16739099,3289333,PDN
SP052,,2000,1974,,1343820,94958451,18240342,,1282386,78032309,15167138,,61434,16926142,3073204,PDN
SP052,,2001,1974,,1700657,92216097,18109215,,1521703,79993871,15755488,,178954,12222226,2353727,PDN
SP052,,2002,1974,,1752076,91531109,18038750,,1672455,81061668,16096239,,79621,10469441,1942511,PDN
SP052,,2003,1974,,1789838,89947766,17794779,,1741428,81476999,16239115,,48410,8470767,1555664,PDN
SP052,,2004,1974,,1923656,88333905,17641433,,1805477,81799005,16360460,,118179,6534900,1280973,PDN
SP052,,2005,1974,,1923656,88333905,17641433,,1805477,81799005,16360460,,118179,6534900,1280973,PDN
SP052,,2006,1974,,1806126,88283350,17514907,,1805477,81799005,16360460,,649,6484345,1154447,PDN
SP052,,2007,1974,,1805477,81799005,16360460,,1805477,81799005,16360460,,0,0,0,PDN
SP052,,2008,1974,,1805477,81799005,16360460,,1805477,81799005,16360460,,0,0,0,PDN
SP052,,2009,1974,,1805477,83087779,16589780,,1805477,83087779,16589780,,0,0,0,PDN
SP052,,2010,1974,,1805477,83087779,16589780,,1805477,83087779,16589780,,0,0,0,PDN
SP052,,2011,1974,,1805477,83087779,16589780,,1805477,83087779,16589780,,0,0,0,PDN
SP052,,2012,1974,,1805477,83087779,16589780,,1805477,83087779,16589780,,0,0,0,PDN
SP052,,2013,1974,,1805477,83087779,16589780,,1805477,83087779,16589780,,0,0,0,PDN
SP052,,2014,1974,,1805477,83087779,16589780,,1805477,83087779,16589780,,0,0,0,PDN
SP052,,2015,1974,,1805477,83087779,16589780,,1805477,83087779,16589780,,0,0,0,PDN
SP052,,2016,1974,,1805477,83087779,16589780,,1805477,83087779,16589780,,0,0,0,PDN
SP052,,2017,1974,,1805477,83087779,16589780,,1805477,83087779,16589780,,0,0,0,PDN
SP052,,2017,1974,,1805477,83087779,16589780,,1805477,83087779,16589780,,0,0,0,PDN
SP054,,1975,1968,,10000000,75000000,23345196,,3644115,27076552,8462007,,6355885,47923448,14883189,PDN
SP054,,1976,1968,,10000000,75000000,23345196,,4149879,33122139,10043498,,5850121,41877861,13301698,PDN
SP054,,1977,1968,,6307815,83476067,21161208,,3705954,40419774,10898085,,2601861,43056293,10263123,PDN
SP054,,1978,1968,,6911627,85765748,22172436,,3982908,45750709,12123604,,2928719,40015039,10048832,PDN
SP054,,1979,1968,,6905433,85765748,22166242,,4146390,50895766,13202576,,2759043,34869982,8963666,PDN
SP054,,1980,1968,,5702694,82308503,20348335,,4950165,53752700,14514702,,752529,28555803,5833633,PDN
SP054,,1981,1968,,5883371,82415103,20547980,,5064896,58462244,15467431,,818475,23952859,5080549,PDN
SP054,,1982,1968,,6032748,82429369,20699896,,5160069,60918843,15999721,,872679,21510526,4700175,PDN
SP054,,1983,1968,,7636865,87535690,23212611,,5260296,67297826,17234998,,2376569,20237864,5977613,PDN
SP054,,1984,1968,,6745526,136537219,31040405,,5324709,77987393,19201469,,1420817,58549826,11838936,PDN
SP054,,1985,1968,,6745526,136537219,31040405,,5368334,81158876,19809415,,1377192,55378343,11230990,PDN
SP054,,1986,1968,,6745780,138830947,31448795,,5436014,84730967,20512699,,1309766,54099980,10936096,PDN
SP054,,1987,1968,,6745654,138830947,31448669,,5447811,86974935,20923778,,1297843,51856012,10524891,PDN
SP054,,1988,1968,,6745654,142011088,32014531,,5447811,93171408,22026353,,1297843,48839680,9988178,PDN
SP054,,1989,1968,,6745654,142011088,32014531,,5447811,103021761,23779085,,1297843,38989327,8235446,PDN
SP054,,1990,1968,,6751333,144209971,32411470,,5451405,111747933,25335379,,1299928,32462038,7076091,PDN
SP054,,1991,1968,,5464643,146356066,31506648,,5454239,120180093,26838597,,10404,26175973,4668051,PDN
SP054,,1992,1968,,5469062,146356066,31511067,,5456675,127584704,28158580,,12387,18771362,3352487,PDN
SP054,,1993,1968,,5471646,147647847,31743505,,5460376,134429882,29380284,,11270,13217965,2363221,PDN
SP054,,1994,1968,,5559278,157087500,33510790,,5489648,146086130,31483621,,69630,11001370,2027169,PDN
SP054,,1995,1968,,6217719,172598992,36929283,,5508188,153273488,32781051,,709531,19325504,4148232,PDN
SP054,,1996,1968,,5647897,161026975,34300384,,5563255,155114155,33163638,,84642,5912820,1136746,PDN
SP054,,1997,1968,,5647894,160631542,34230019,,5579109,155754244,33293387,,68785,4877298,936632,PDN
SP054,,1998,1968,,5647894,160631542,34230019,,5585633,156226167,33383883,,62261,4405375,846136,PDN
SP054,,1999,1968,,5585938,157662812,33639819,,5585633,156226167,33383883,,305,1436645,255936,PDN
SP054,,2000,1968,,5585633,156226167,33383883,,5585633,156226167,33383883,,0,0,0,PDN
SP054,,2001,1968,,5668933,157880733,33761590,,5585633,156226167,33383883,,83300,1654566,377707,PDN
SP054,,2002,1968,,5585633,156226167,33383883,,5585633,156226167,33383883,,0,0,0,PDN
SP054,,2003,1968,,5585633,156226167,33383883,,5585633,156226167,33383883,,0,0,0,PDN
SP054,,2004,1968,,5585633,156226167,33383883,,5585633,156226167,33383883,,0,0,0,PDN
SP054,,2005,1968,,5585633,156226167,33383883,,5585633,156226167,33383883,,0,0,0,PDN
SP054,,2006,1968,,5585633,156226167,33383883,,5585633,156226167,33383883,,0,0,0,PDN
SP054,,2007,1968,,5585633,156226167,33383883,,5585633,156226167,33383883,,0,0,0,PDN
SP054,,2008,1968,,5585633,156226167,33383883,,5585633,156226167,33383883,,0,0,0,PDN
SP054,,2009,1968,,5585633,159354915,33940599,,5585633,159354915,33940599,,0,0,0,PDN
SP054,,2010,1968,,5585633,159354915,33940599,,5585633,159354915,33940599,,0,0,0,PDN
SP054,,2011,1968,,5585633,159354915,33940599,,5585633,159354915,33940599,,0,0,0,PDN
SP054,,2012,1968,,5585633,159354915,33940599,,5585633,159354915,33940599,,0,0,0,PDN
SP054,,2013,1968,,5585633,159354915,33940599,,5585633,159354915,33940599,,0,0,0,PDN
SP054,,2014,1968,,5585633,159354915,33940599,,5585633,159354915,33940599,,0,0,0,PDN
SP054,,2015,1968,,5585633,159354915,33940599,,5585633,159354915,33940599,,0,0,0,PDN
SP054,,2016,1968,,5585633,159354915,33940599,,5585633,159354915,33940599,,0,0,0,PDN
SP054,,2017,1968,,5585633,159354915,33940599,,5585633,159354915,33940599,,0,0,0,PDN
SP054,,2017,1968,,5585633,159354915,33940599,,5585633,159354915,33940599,,0,0,0,PDN
SP061,,1975,1967,,110000000,99990000,127791815,,20826764,25546870,25372470,,89173236,74443130,102419345,PDP
SP061,,1976,1967,,110000000,99990000,127791815,,29811002,37543371,36491317,,80188998,62446629,91300498,PDP
SP061,,1977,1967,,110000000,99990000,127791815,,43101414,52798028,52496081,,66898586,47191972,75295734,PDP
SP061,,1978,1967,,297933427,312600943,353556371,,54097956,68174633,66228674,,243835471,244426310,287327697,PDP
SP061,,1979,1967,,174718805,190807855,208670381,,63884378,80276475,78168448,,110834427,110531380,130501933,PDP
SP061,,1980,1967,,182399867,202260456,218389272,,76128147,94071972,92866932,,106271720,108188484,125522340,PDP
SP061,,1981,1967,,183431805,203156455,219580640,,89057771,104954192,107732894,,94374034,98202263,111847746,PDP
SP061,,1982,1967,,184535830,206958276,221361146,,102090775,118079816,123101418,,82445055,88878460,98259728,PDP
SP061,,1983,1967,,225793913,286833544,276831910,,112583152,130077476,135728610,,113210761,156756068,141103300,PDP
SP061,,1984,1967,,244130846,311485641,299555337,,125154072,145167873,150984654,,118976774,166317768,148570683,PDP
SP061,,1985,1967,,258326589,345386797,319783314,,137134530,162124885,165982374,,121192059,183261912,153800940,PDP
SP061,,1986,1967,,275123154,366359259,340311634,,148121067,182889137,180663618,,127002087,183470122,159648016,PDP
SP061,,1987,1967,,219658868,282829249,269984357,,157011393,200296070,192651263,,62647475,82533179,77333094,PDP
SP061,,1988,1967,,231212564,304584503,285409095,,164970155,215892909,203385263,,66242409,88691594,82023832,PDP
SP061,,1989,1967,,232214127,305423529,286559951,,169934759,224537682,209888083,,62279368,80885847,76671868,PDP
SP061,,1990,1967,,210330110,279796103,260115893,,174805662,231450323,215988993,,35524448,48345780,44126900,PDP
SP061,,1991,1967,,215858864,293334049,268053535,,182302625,248691387,226553761,,33556239,44642662,41499774,PDP
SP061,,1992,1967,,239858203,387933739,308885559,,185297062,254565063,230593337,,54561141,133368676,78292222,PDP
SP061,,1993,1967,,234590561,350715299,296995418,,186599290,254984215,231970147,,47991271,95731084,65025271,PDP
SP061,,1994,1967,,246287669,426592070,322193731,,204482586,348755995,266538813,,41805083,77836075,55654918,PDP
SP061,,1995,1967,,273963038,480506062,359462337,,211163679,379303253,278655361,,62799359,101202809,80806976,PDP
SP061,,1996,1967,,245719487,483908619,331824223,,219013196,398353030,289894518,,26706291,85555589,41929705,PDP
SP061,,1997,1967,,250447581,473200099,334646887,,226884306,420887596,301775337,,23563275,52312503,32871550,PDP
SP061,,1998,1967,,254331405,482010756,340098443,,233755150,438798147,311833112,,20576255,43212609,28265331,PDP
SP061,,1999,1967,,254572829,486800222,341192086,,239538026,456295152,320729334,,15034803,30505070,20462752,PDP
SP061,,2000,1967,,259509259,507833983,349871178,,244846438,472944328,329000233,,14662821,34889655,20870945,PDP
SP061,,2001,1967,,264826789,514392972,356355788,,248721338,483443452,334743305,,16105451,30949520,21612483,PDP
SP061,,2002,1967,,263123454,507100709,353354897,,251582456,489641686,338707311,,11540998,17459023,14647586,PDP
SP061,,2003,1967,,263862995,517816994,356001250,,254501134,495738754,342710877,,9361861,22078240,13290373,PDP
SP061,,2004,1967,,263248965,508182682,353672930,,257231914,501451545,346458168,,6017051,6731137,7214762,PDP
SP061,,2005,1967,,264151599,509411229,354794167,,258143315,502495007,347555238,,6008284,6916222,7238929,PDP
SP061,,2006,1967,,267261423,515356342,358961840,,259520640,505113530,349398492,,7740783,10242812,9563348,PDP
SP061,,2007,1967,,269626002,517928363,361784074,,261553276,507862556,351920279,,8072726,10065807,9863795,PDP
SP061,,2008,1967,,284054799,525412761,377544614,,263176149,510156491,353951325,,20878650,15256270,23593289,PDP
SP061,,2009,1967,,285223613,534363704,380306118,,264600287,520778065,357265426,,20623326,13585639,23040700,PDP
SP061,,2010,1967,,273772885,531867382,368411210,,265846881,522459620,358811228,,7926004,9407762,9599987,PDP
SP061,,2011,1967,,274666401,532541547,369424682,,267083250,523992928,360320431,,7583151,8548619,9104260,PDP
SP061,,2012,1967,,274537472,532527212,369293203,,268238398,525484010,361740892,,6299074,7043202,7552318,PDP
SP061,,2013,1967,,273913613,531108983,368416989,,269238800,526798147,362975124,,4674813,4310836,5441870,PDP
SP061,,2014,1967,,274544471,531417061,369102667,,270082631,527654979,363971417,,4461840,3762082,5131252,PDP
SP061,,2015,1967,,281061813,549376431,378815628,,270980680,528930026,365096347,,10081133,20446405,13719287,PDP
SP061,,2016,1967,,275675444,532494586,370425372,,271733255,529058763,365871825,,3942189,3435823,4553548,PDP
SP061,,2017,1967,,276081539,532979500,370917752,,272240975,529332430,366428240,,3840564,3647070,4489511,PDP
SP061,,2017,1967,,276081539,532979500,370917752,,272240975,529332430,366428240,,3840564,3647070,4489511,PDP
SP062,,1975,1965,,125000000,150000000,151690391,,53593373,71132186,66250346,,71406627,78867814,85440045,PDP
SP062,,1976,1965,,125000000,150000000,151690391,,57550562,77371331,71317703,,67449438,72628669,80372688,PDP
SP062,,1977,1965,,90000000,119990000,111350534,,65589206,84111321,80555633,,24410794,35878679,30794901,PDP
SP062,,1978,1965,,90000000,119990000,111350534,,72388092,93455001,89017096,,17611908,26534999,22333438,PDP
SP062,,1979,1965,,98157093,128727986,121062429,,80258206,106088148,99135101,,17898887,22639838,21927328,PDP
SP062,,1980,1965,,98422641,130187562,121587688,,82228833,108409938,101518858,,16193808,21777624,20068830,PDP
SP062,,1981,1965,,97940638,130393130,121142263,,86286141,112895375,106374286,,11654497,17497755,14767977,PDP
SP062,,1982,1965,,105769920,175583446,137012526,,90365777,117923204,111348554,,15404143,57660242,25663972,PDP
SP062,,1983,1965,,115348218,196143858,150249260,,94047468,121395408,115648074,,21300750,74748450,34601186,PDP
SP062,,1984,1965,,121953848,204922393,158416907,,97622944,125340473,119925519,,24330904,79581920,38491388,PDP
SP062,,1985,1965,,129983377,214728237,168191248,,99992918,129080886,122961047,,29990459,85647351,45230201,PDP
SP062,,1986,1965,,137934662,187846535,171359312,,102355646,132822006,125989455,,35579016,55024529,45369857,PDP
SP062,,1987,1965,,146010851,207714857,182970790,,105567622,137426649,130020762,,40443229,70288208,52950028,PDP
SP062,,1988,1965,,143409816,206953574,180234295,,108743701,142273734,134059312,,34666115,64679840,46174983,PDP
SP062,,1989,1965,,133802812,191854841,167940684,,112669438,148468212,139087269,,21133374,43386629,28853415,PDP
SP062,,1990,1965,,129665633,172074664,160283901,,116623787,153892978,144006879,,13041846,18181686,16277022,PDP
SP062,,1991,1965,,132375768,181218066,164620975,,119986084,160092395,148472275,,12389684,21125671,16148700,PDP
SP062,,1992,1965,,135914595,187478732,169273800,,123285812,165829480,152792837,,12628783,21649252,16480963,PDP
SP062,,1993,1965,,143952385,218519834,182834918,,126899210,174000341,157860125,,17053175,44519493,24974793,PDP
SP062,,1994,1965,,148109989,223504573,187879486,,130062203,180740742,162222477,,18047786,42763831,25657009,PDP
SP062,,1995,1965,,156513579,233203461,198008857,,134161223,188343639,167674326,,22352356,44859822,30334531,PDP
SP062,,1996,1965,,150179694,223966171,190031326,,137459940,195411838,172230730,,12719754,28554333,17800596,PDP
SP062,,1997,1965,,150383878,219858682,189504640,,140181609,201081913,175961309,,10202269,18776769,13543331,PDP
SP062,,1998,1965,,151454463,224775219,191450054,,143021320,206908507,179837780,,8433143,17866712,11612274,PDP
SP062,,1999,1965,,152795374,227828433,193334241,,145561777,214078216,183653986,,7233597,13750217,9680255,PDP
SP062,,2000,1965,,156094766,239053154,198630914,,148179183,219788927,187287533,,7915583,19264227,11343381,PDP
SP062,,2001,1965,,159121866,245015497,202718929,,150756280,224417481,190688216,,8365586,20598016,12030713,PDP
SP062,,2002,1965,,160331959,242203877,203428734,,152916309,229026993,193668443,,7415650,13176884,9760291,PDP
SP062,,2003,1965,,161400210,243477484,204723606,,154766809,232206947,196084771,,6633401,11270537,8638835,PDP
SP062,,2004,1965,,160791681,242940659,204019556,,155859546,234926484,197661411,,4932135,8014175,6358145,PDP
SP062,,2005,1965,,160054749,242675708,203235480,,156301518,236155356,198322044,,3753231,6520352,4913436,PDP
SP062,,2006,1965,,160122527,242811210,203327369,,156527057,236711904,198646613,,3595470,6099306,4680756,PDP
SP062,,2007,1965,,161433576,244250148,204894456,,157359174,238226857,199748294,,4074402,6023291,5146162,PDP
SP062,,2008,1965,,169050850,247618740,213111124,,158350085,239194644,200911410,,10700765,8424096,12199714,PDP
SP062,,2009,1965,,164623338,251047413,209293696,,159695248,244546988,203208950,,4928090,6500425,6084750,PDP
SP062,,2010,1965,,165424403,252442513,210343000,,160533355,245635942,204240819,,4891048,6806571,6102180,PDP
SP062,,2011,1965,,166239424,253315520,211313360,,161582060,246768562,205491057,,4657364,6546958,5822306,PDP
SP062,,2012,1965,,166263561,253348156,211343303,,162443252,247666846,206512092,,3820309,5681310,4831220,PDP
SP062,,2013,1965,,165929376,253050849,210956216,,163242620,248614770,207480123,,2686756,4436079,3476093,PDP
SP062,,2014,1965,,167034209,254326314,212288002,,164034432,249684610,208462300,,2999777,4641704,3825705,PDP
SP062,,2015,1965,,167965550,256065037,213528726,,164980515,250998056,209642093,,2985035,5066981,3886632,PDP
SP062,,2016,1965,,168009863,256278255,213610976,,165805473,252322775,210702766,,2204390,3955480,2908212,PDP
SP062,,2017,1965,,169146853,257354805,214939524,,166359634,252988141,211375316,,2787219,4366664,3564208,PDP
SP062,,2017,1965,,169146853,257354805,214939524,,166359634,252988141,211375316,,2787219,4366664,3564208,PDP
SP065,,1975,1967,,75948022,84926824,91059557,,58995666,44584777,66928900,,16952356,40342047,24130657,PDP
SP065,,1976,1967,,93583244,97546344,110940245,,60922761,48759131,69598763,,32660483,48787213,41341482,PDP
SP065,,1977,1967,,97972141,108964805,117360896,,67124207,55059252,76921227,,30847934,53905553,40439669,PDP
SP065,,1978,1967,,99073541,109741487,118600496,,71532698,59810269,82175095,,27540843,49931218,36425401,PDP
SP065,,1979,1967,,96363599,109514653,115850192,,72579291,63391134,83858852,,23784308,46123519,31991340,PDP
SP065,,1980,1967,,98263249,111136110,118038358,,76003380,67554060,88023675,,22259869,43582050,30014683,PDP
SP065,,1981,1967,,99788745,113326747,119953647,,79493639,73522727,92575975,,20295106,39804020,27377672,PDP
SP065,,1982,1967,,101663326,114953159,122117625,,82273877,77429254,96051324,,19389449,37523905,26066301,PDP
SP065,,1983,1967,,103054448,117286920,123924007,,84733041,81551930,99244061,,18321407,35734990,24679946,PDP
SP065,,1984,1967,,103665327,117494904,124571894,,87025501,84833577,102120444,,16639826,32661327,22451450,PDP
SP065,,1985,1967,,107664382,120869064,129171333,,88773828,86317553,104132823,,18890554,34551511,25038510,PDP
SP065,,1986,1967,,123607202,123867055,145647603,,92154235,88787683,107952755,,31452967,35079372,37694848,PDP
SP065,,1987,1967,,118122609,123012746,140010998,,96182937,92206791,112589839,,21939672,30805955,27421159,PDP
SP065,,1988,1967,,125543872,129893911,148656668,,100354914,95798140,117400846,,25188958,34095771,31255822,PDP
SP065,,1989,1967,,120798552,117037909,141623803,,103357655,98051644,120804567,,17440897,18986265,20819236,PDP
SP065,,1990,1967,,120798552,117037909,141623803,,105402240,99562728,123118028,,15396312,17475181,18505775,PDP
SP065,,1991,1967,,121179436,117350562,142060319,,108406323,101519152,126470229,,12773113,15831410,15590090,PDP
SP065,,1992,1967,,121865873,119774853,143178124,,110571844,103378873,128966661,,11294029,16395980,14211463,PDP
SP065,,1993,1967,,124257030,118184953,145286381,,113266263,105360743,132013726,,10990767,12824210,13272655,PDP
SP065,,1994,1967,,125926919,119488690,147188252,,115286390,107253997,134370731,,10640529,12234693,12817521,PDP
SP065,,1995,1967,,131134644,152576364,158283463,,117107771,109455094,136583766,,14026873,43121270,21699697,PDP
SP065,,1996,1967,,124040526,122948272,145917443,,118453428,112142407,138407593,,5587098,10805865,7509850,PDP
SP065,,1997,1967,,124092105,123541579,146074592,,119900568,115784438,140502781,,4191537,7757141,5571811,PDP
SP065,,1998,1967,,124351887,124449163,146495866,,121185175,119113049,142379668,,3166712,5336114,4116198,PDP
SP065,,1999,1967,,124637048,126223411,147096730,,122368533,121929116,144064105,,2268515,4294295,3032625,PDP
SP065,,2000,1967,,129471712,141996876,154738060,,123697334,124708980,145887544,,5774378,17287896,8850516,PDP
SP065,,2001,1967,,129042981,136505224,153332167,,124968560,126971510,147561355,,4074421,9533714,5770812,PDP
SP065,,2002,1967,,129601027,136680053,153921321,,125993704,128584740,148873551,,3607323,8095313,5047770,PDP
SP065,,2003,1967,,129685128,137024035,154066629,,126844479,129746250,149931000,,2840649,7277785,4135629,PDP
SP065,,2004,1967,,128671262,132213814,152196852,,127299091,130293704,150483024,,1372171,1920110,1713828,PDP
SP065,,2005,1967,,128771832,132294565,152311790,,127311011,130298280,150495758,,1460821,1996285,1816032,PDP
SP065,,2006,1967,,128808265,132307996,152350613,,127387258,130298280,150572005,,1421007,2009716,1778608,PDP
SP065,,2007,1967,,129098550,132072033,152598912,,128074507,131018183,151387351,,1024043,1053850,1211561,PDP
SP065,,2008,1967,,130998345,134560491,154941493,,128512025,131445049,151900824,,2486320,3115442,3040669,PDP
SP065,,2009,1967,,130646889,135318326,154724883,,129054127,134288047,152948797,,1592762,1030279,1776085,PDP
SP065,,2010,1967,,133057374,138404094,157684437,,129525272,134586876,153473114,,3532102,3817218,4211322,PDP
SP065,,2011,1967,,133226111,138454292,157862105,,130205965,135127703,154250040,,3020146,3326589,3612065,PDP
SP065,,2012,1967,,133252932,138482461,157893939,,130780228,135615209,154911047,,2472704,2867252,2982893,PDP
SP065,,2013,1967,,131875528,136361460,156139132,,131263688,135951118,155454276,,611840,410342,684857,PDP
SP065,,2014,1967,,132375313,136677911,156695225,,131620630,136172248,155850567,,754683,505663,844660,PDP
SP065,,2015,1967,,133072957,140782451,158123216,,132110741,138953380,156835539,,962216,1829071,1287675,PDP
SP065,,2016,1967,,132961159,141333125,158109403,,132590522,140582042,157605121,,370637,751083,504281,PDP
SP065,,2017,1967,,133598321,142219037,158904201,,133039303,141224140,158168154,,559018,994897,736047,PDP
SP065,,2017,1967,,133598321,142219037,158904201,,133039303,141224140,158168154,,559018,994897,736047,PDP
SP072,,1994,1976,,1302,13018056,2317682,,0,0,0,,1302,13018056,2317682,PDN
SP072,,1995,1976,,1302,13018056,2317682,,0,0,0,,1302,13018056,2317682,PDN
SP072,,1996,1976,,4642,17077449,3043334,,477,3358291,598038,,4165,13719158,2445296,PDN
SP072,,1997,1976,,6090,20945095,3732975,,2477,11471590,2043685,,3613,9473505,1689290,PDN
SP072,,1998,1976,,5889,23238330,4140823,,2831,16861979,3003183,,3058,6376351,1137640,PDN
SP072,,1999,1976,,5889,23238330,4140823,,2892,17942868,3195573,,2997,5295462,945250,PDN
SP072,,2000,1976,,5500,21341324,3802889,,2892,18291675,3257638,,2608,3049649,545251,PDN
SP072,,2001,1976,,784564,23775550,5015089,,2892,18556752,3304805,,781672,5218798,1710284,PDN
SP072,,2002,1976,,784373,23330128,4935641,,2892,19071778,3396447,,781481,4258350,1539194,PDN
SP072,,2003,1976,,784346,22717688,4826639,,2892,19722222,3512184,,781454,2995466,1314455,PDN
SP072,,2004,1976,,784346,22688306,4821411,,2892,19797382,3525558,,781454,2890924,1295853,PDN
SP072,,2005,1976,,2892,19797382,3525558,,2892,19797382,3525558,,0,0,0,PDN
SP072,,2006,1976,,2892,19797382,3525558,,2892,19797382,3525558,,0,0,0,PDN
SP072,,2007,1976,,2892,19797382,3525558,,2892,19797382,3525558,,0,0,0,PDN
SP072,,2008,1976,,2892,19797382,3525558,,2892,19797382,3525558,,0,0,0,PDN
SP072,,2009,1976,,2892,20106130,3580495,,2892,20106130,3580495,,0,0,0,PDN
SP072,,2010,1976,,2892,20106130,3580495,,2892,20106130,3580495,,0,0,0,PDN
SP072,,2011,1976,,2892,20106130,3580495,,2892,20106130,3580495,,0,0,0,PDN
SP072,,2012,1976,,2892,20106130,3580495,,2892,20106130,3580495,,0,0,0,PDN
SP072,,2013,1976,,2892,20106130,3580495,,2892,20106130,3580495,,0,0,0,PDN
SP072,,2014,1976,,2892,20106130,3580495,,2892,20106130,3580495,,0,0,0,PDN
SP072,,2015,1976,,2892,20106130,3580495,,2892,20106130,3580495,,0,0,0,PDN
SP072,,2016,1976,,2892,20106130,3580495,,2892,20106130,3580495,,0,0,0,PDN
SP072,,2017,1976,,2892,20106130,3580495,,2892,20106130,3580495,,0,0,0,PDN
SP072,,2017,1976,,2892,20106130,3580495,,2892,20106130,3580495,,0,0,0,PDN
SP078,,1975,1972,,44300000,407560000,116819573,,0,0,0,,44300000,407560000,116819573,PDP
SP078,,1976,1972,,44300000,407560000,116819573,,0,0,0,,44300000,407560000,116819573,PDP
SP078,,1977,1972,,28000000,336000000,87786477,,0,0,0,,28000000,336000000,87786477,PDP
SP078,,1978,1972,,28000000,336000000,87786477,,17669,81954,32252,,27982331,335918046,87754225,PDP
SP078,,1979,1972,,28004328,336066006,87802550,,50768,189215,84436,,27953560,335876791,87718114,PDP
SP078,,1980,1972,,28024109,336151551,87837552,,123681,331647,182693,,27900428,335819904,87654859,PDP
SP078,,1981,1972,,28000000,336000000,87786477,,576317,25847917,5175590,,27423683,310152083,82610887,PDP
SP078,,1982,1972,,28000000,336000000,87786477,,1454862,119681472,22750498,,26545138,216318528,65035979,PDP
SP078,,1983,1972,,28000000,336000000,87786477,,3446955,221894844,42930023,,24553045,114105156,44856454,PDP
SP078,,1984,1972,,8500000,400000000,79674377,,7226560,326002599,65234140,,1273440,73997401,14440237,PDP
SP078,,1985,1972,,16374850,454458527,97239357,,11925777,394161248,82061230,,4449073,60297279,15178127,PDP
SP078,,1986,1972,,28479249,587001346,132927887,,14921249,437392383,92749075,,13558000,149608963,40178812,PDP
SP078,,1987,1972,,28999539,587001346,133448177,,17297251,470560691,101026911,,11702288,116440655,32421266,PDP
SP078,,1988,1972,,28999539,587001346,133448177,,19802630,503610974,109413124,,9196909,83390372,24035053,PDP
SP078,,1989,1972,,29673305,587001346,134121943,,23512460,539958322,119590453,,6160845,47043024,14531490,PDP
SP078,,1990,1972,,45293070,751183634,178955638,,27454438,579902816,130639992,,17838632,171280818,48315646,PDP
SP078,,1991,1972,,41775280,713492058,168731162,,31299564,609034980,139668778,,10475716,104457078,29062384,PDP
SP078,,1992,1972,,45661257,728055479,175208495,,34029665,625386105,145308331,,11631592,102669374,29900164,PDP
SP078,,1993,1972,,52324669,746821578,185211071,,38056509,642166596,152321028,,14268160,104654982,32890043,PDP
SP078,,1994,1972,,58409885,782790898,197696522,,42018453,659209455,159315509,,16391432,123581443,38381013,PDP
SP078,,1995,1972,,61016751,800254869,203410856,,45408501,670212027,164663310,,15608250,130042842,38747546,PDP
SP078,,1996,1972,,63333865,792084495,204274167,,49005374,694894437,172652071,,14328491,97190058,31622096,PDP
SP078,,1997,1972,,63191916,816569632,208489004,,52727347,723912332,181537370,,10464569,92657300,26951634,PDP
SP078,,1998,1972,,71110191,856954544,223593206,,56327021,750509350,189869610,,14783170,106445194,33723596,PDP
SP078,,1999,1972,,73880660,877154321,229957941,,60190769,778818036,198770491,,13689891,98336285,31187450,PDP
SP078,,2000,1972,,69588996,865389363,223572868,,63031983,805816223,206415653,,6557013,59573140,17157215,PDP
SP078,,2001,1972,,72105909,903116822,232802853,,65221725,829002860,212731131,,6884184,74113962,20071722,PDP
SP078,,2002,1972,,73714597,896713943,233272238,,67072753,848200143,217998045,,6641844,48513800,15274193,PDP
SP078,,2003,1972,,74909083,903860625,235738375,,68937204,862461847,222400166,,5971879,41398778,13338209,PDP
SP078,,2004,1972,,75078195,898917622,235027950,,70620360,871770871,225739732,,4457835,27146751,9288218,PDP
SP078,,2005,1972,,76281612,895622414,235645031,,71659185,876217196,227569718,,4622427,19405218,8075313,PDP
SP078,,2006,1972,,77725162,899987514,237865289,,72934168,881321477,229752936,,4790994,18666037,8112353,PDP
SP078,,2007,1972,,78276987,901569484,238698603,,74393961,887171573,232253671,,3883026,14397911,6444932,PDP
SP078,,2008,1972,,79726520,903889156,240560889,,75374805,890352502,233800517,,4351715,13536654,6760372,PDP
SP078,,2009,1972,,80996736,920431414,244774567,,76629041,908751349,238328568,,4367695,11680065,6445998,PDP
SP078,,2010,1972,,81684176,921319701,245620069,,77527318,910724068,239577865,,4156858,10595633,6042202,PDP
SP078,,2011,1972,,82270493,921743413,246281779,,78312573,912243215,240633432,,3957920,9500198,5648345,PDP
SP078,,2012,1972,,82299994,925661721,247008488,,79031684,913428792,241563502,,3268310,12232929,5444987,PDP
SP078,,2013,1972,,81976007,925175340,246597959,,79823379,915865166,242788716,,2152628,9310174,3809240,PDP
SP078,,2014,1972,,82859038,929406759,248233912,,80475907,919260777,244045446,,2383131,10145982,4188465,PDP
SP078,,2015,1972,,84142416,928990034,249443135,,81482670,923832081,245865606,,2659746,5157953,3577531,PDP
SP078,,2016,1972,,84506883,935950677,251046154,,82303697,928588876,247533036,,2203186,7361801,3513112,PDP
SP078,,2017,1972,,84967827,937863052,251847377,,82985402,931825690,248790687,,1982425,6037362,3056687,PDP
SP078,,2017,1972,,84967827,937863052,251847377,,82985402,931825690,248790687,,1982425,6037362,3056687,PDP
SP083,,1986,1983,,8087485,81946013,22668626,,0,0,0,,8087485,81946013,22668626,PDP
SP083,,1987,1983,,9491456,159341497,37844036,,0,0,0,,9491456,159341497,37844036,PDP
SP083,,1988,1983,,10321945,164737573,39634680,,1904305,27325496,6766493,,8417640,137412077,32868187,PDP
SP083,,1989,1983,,10618880,181349282,42887436,,4016618,76696522,17663686,,6602262,104652760,25223750,PDP
SP083,,1990,1983,,11874489,321156800,69019827,,5521143,112222190,25489504,,6353346,208934610,43530323,PDP
SP083,,1991,1983,,12051874,331100626,70966576,,6456471,141476266,31630184,,5595403,189624360,39336392,PDP
SP083,,1992,1983,,12193867,358009127,75896559,,6970741,182649348,39470625,,5223126,175359779,36425934,PDP
SP083,,1993,1983,,8373215,429377697,84774940,,7537211,223903746,47377735,,836004,205473951,37397205,PDP
SP083,,1994,1983,,8479940,455593670,89546429,,7760209,247456337,51791586,,719731,208137333,37754843,PDP
SP083,,1995,1983,,16120032,504241303,105842684,,8040090,265182782,55225638,,8079942,239058521,50617046,PDP
SP083,,1996,1983,,8660173,370448254,74576232,,8438681,287425410,59581992,,221492,83022844,14994240,PDP
SP083,,1997,1983,,8953716,378281444,76263581,,8565823,298011230,61592732,,387893,80270214,14670849,PDP
SP083,,1998,1983,,8983208,386514255,77757986,,8721527,305667939,63110840,,261681,80846316,14647146,PDP
SP083,,1999,1983,,9270165,390691851,78788288,,8853551,315151453,64930322,,416614,75540398,13857966,PDP
SP083,,2000,1983,,9272857,395583722,79661420,,9002730,326800997,67152374,,270127,68782725,12509046,PDP
SP083,,2001,1983,,9508165,398841456,80476396,,9125651,335835359,68882832,,382514,63006097,11593564,PDP
SP083,,2002,1983,,9454164,377089750,76551984,,9216646,340294022,69767184,,237518,36795728,6784800,PDP
SP083,,2003,1983,,9459227,377774505,76678890,,9298316,343886706,70488121,,160911,33887799,6190769,PDP
SP083,,2004,1983,,9543355,377098500,76642732,,9363355,344959772,70744097,,180000,32138728,5898635,PDP
SP083,,2005,1983,,9439869,376055071,76353583,,9405665,345454225,70874388,,34204,30600846,5479195,PDP
SP083,,2006,1983,,9770129,376053402,76683546,,9405665,345454225,70874388,,364464,30599177,5809158,PDP
SP083,,2007,1983,,9948011,393772066,80014215,,9443909,348468021,71448895,,504102,45304045,8565320,PDP
SP083,,2008,1983,,10024735,414611942,83799102,,9502800,358706219,73329529,,521935,55905723,10469573,PDP
SP083,,2009,1983,,9794629,419587854,84454390,,9540473,381546107,77431241,,254156,38041747,7023149,PDP
SP083,,2010,1983,,10063223,447636060,89713768,,9674718,396233011,80178813,,388505,51403049,9534954,PDP
SP083,,2011,1983,,13405644,450638577,93590445,,9802779,407662467,82340587,,3602865,42976110,11249859,PDP
SP083,,2012,1983,,13411301,450694023,93605969,,9864907,411715601,83123912,,3546394,38978422,10482056,PDP
SP083,,2013,1983,,10022870,455302453,91037545,,9910171,415683493,83875207,,112699,39618960,7162336,PDP
SP083,,2014,1983,,10018064,459352124,91753320,,9941570,422500736,85119639,,76494,36851388,6633680,PDP
SP083,,2015,1983,,10011052,462001961,92217806,,9944171,426524437,85838200,,66881,35477524,6379607,PDP
SP083,,2016,1983,,10007246,466887653,93083342,,9947646,429889481,86440435,,59600,36998172,6642904,PDP
SP083,,2017,1983,,9972220,461814930,92145695,,9948211,431662207,86756434,,24009,30152723,5389262,PDP
SP083,,2017,1983,,9972220,461814930,92145695,,9948211,431662207,86756434,,24009,30152723,5389262,PDP
SP089,,1975,1969,,32000000,44800000,39971530,,0,0,0,,32000000,44800000,39971530,PDP
SP089,,1976,1969,,32000000,44800000,39971530,,0,0,0,,32000000,44800000,39971530,PDP
SP089,,1977,1969,,32000000,44800000,39971530,,0,0,0,,32000000,44800000,39971530,PDP
SP089,,1978,1969,,19080337,17487960,22192074,,117234,76504,130847,,18963103,17411456,22061227,PDP
SP089,,1979,1969,,19080337,17487960,22192074,,775513,582971,879244,,18304824,16904989,21312830,PDP
SP089,,1980,1969,,47067985,53565689,56599246,,2292912,1851955,2622441,,44775073,51713734,53976805,PDP
SP089,,1981,1969,,47067985,53565689,56599246,,3995256,3567023,4629958,,43072729,49998666,51969288,PDP
SP089,,1982,1969,,47067985,53565689,56599246,,7030684,6067552,8110320,,40037301,47498137,48488926,PDP
SP089,,1983,1969,,74986346,127384825,97652685,,12182567,12814625,14462749,,62803779,114570200,83189936,PDP
SP089,,1984,1969,,78455175,131731700,101894979,,22264093,25481413,26798152,,56191082,106250287,75096827,PDP
SP089,,1985,1969,,104162048,163065265,133177220,,35818716,45158600,43854054,,68343332,117906665,89323166,PDP
SP089,,1986,1969,,142670991,221245773,182038566,,49589333,64412429,61050619,,93081658,156833344,120987947,PDP
SP089,,1987,1969,,158148429,233408393,199680172,,63619663,81634977,78145460,,94528766,151773416,121534712,PDP
SP089,,1988,1969,,168304515,251428391,213042663,,78215573,111000926,97966627,,90088942,140427465,115076036,PDP
SP089,,1989,1969,,171194094,325106785,229042276,,89461561,148695852,115919898,,81732533,176410933,113122378,PDP
SP089,,1990,1969,,168227400,337716328,228319273,,98866840,179185271,130750340,,69360560,158531057,97568933,PDP
SP089,,1991,1969,,161460523,329922971,220165678,,107032043,205807672,143652625,,54428480,124115299,76513053,PDP
SP089,,1992,1969,,170305823,359940881,234352243,,115577729,234734208,157345382,,54728094,125206673,77006861,PDP
SP089,,1993,1969,,161727303,415006518,235571879,,118102074,266331509,165492022,,43625229,148675009,70079857,PDP
SP089,,1994,1969,,164145636,466674264,247183761,,131304239,322406985,188672030,,32841397,144267279,58511731,PDP
SP089,,1995,1969,,178590985,586576698,282964063,,140697103,374675259,207365299,,37893882,211901439,75598764,PDP
SP089,,1996,1969,,182878065,835050167,331463504,,148806118,432056743,225684542,,34071947,402993424,105778962,PDP
SP089,,1997,1969,,180944085,830316072,328687158,,156736427,486791819,243354188,,24207658,343524253,85332970,PDP
SP089,,1998,1969,,185195722,844632691,335486236,,163440777,533024402,258284977,,21754945,311608289,77201259,PDP
SP089,,1999,1969,,189238677,927547672,354282747,,169588345,582234577,273188804,,19650332,345313095,81093943,PDP
SP089,,2000,1969,,187882348,960261763,358747430,,175121646,639063368,288833989,,12760702,321198395,69913441,PDP
SP089,,2001,1969,,193466781,876881343,349495490,,179239980,695824174,303052111,,14226801,181057169,46443379,PDP
SP089,,2002,1969,,193027131,852227955,344669116,,182569773,744230760,314995175,,10457358,107997195,29673941,PDP
SP089,,2003,1969,,191198688,849744260,342398734,,185081980,779729664,323823913,,6116708,70014596,18574821,PDP
SP089,,2004,1969,,191100678,839891691,340547598,,186818922,799066968,329001657,,4281756,40824723,11545941,PDP
SP089,,2005,1969,,190757121,841478408,340486375,,187817893,814513689,332749154,,2939228,26964719,7737221,PDP
SP089,,2006,1969,,191083464,849963813,342322577,,188287574,826404029,335334554,,2795890,23559784,6988023,PDP
SP089,,2007,1969,,192028278,852078264,343643628,,189374871,836543755,338226073,,2653407,15534509,5417555,PDP
SP089,,2008,1969,,193516972,851784308,345080016,,190047358,841202584,339727533,,3469614,10581724,5352483,PDP
SP089,,2009,1969,,194435281,864993215,348348667,,190802750,855245107,342981598,,3632531,9748108,5367070,PDP
SP089,,2010,1969,,196023996,872183567,351216804,,191583558,858113663,344272827,,4440438,14069904,6943981,PDP
SP089,,2011,1969,,197249495,874487215,352852204,,192462985,863407299,346094180,,4786510,11079916,6758027,PDP
SP089,,2012,1969,,197140553,874265731,352703850,,193443745,866564657,347636748,,3696808,7701074,5067105,PDP
SP089,,2013,1969,,196495155,871067044,351489293,,194199504,868192296,348682121,,2295651,2874748,2807172,PDP
SP089,,2014,1969,,197175992,873923863,352678462,,194838589,869772970,349602466,,2337403,4150893,3075998,PDP
SP089,,2015,1969,,197310712,874943956,352994694,,195449548,871375776,350498618,,1861164,3568180,2496071,PDP
SP089,,2016,1969,,197434932,874995787,353128137,,195993425,872699990,351278121,,1441507,2295797,1850014,PDP
SP089,,2017,1969,,198260601,877306065,354364883,,196456515,873691487,351917635,,1804086,3614578,2447249,PDP
SP089,,2017,1969,,198260601,877306065,354364883,,196456515,873691487,351917635,,1804086,3614578,2447249,PDP
SS015,,1981,1962,,22180000,36672105,28705286,,9993,332642,69182,,22170007,36339463,28636104,PDP
SS015,,1982,1962,,2045052,40525337,9255966,,143378,6039915,1218096,,1901674,34485422,8037870,PDP
SS015,,1983,1962,,2045052,40525337,9255966,,252577,13301247,2619347,,1792475,27224090,6636619,PDP
SS015,,1984,1962,,3008997,50065787,11917500,,907254,37871854,7646018,,2101743,12193933,4271482,PDP
SS015,,1985,1962,,2832767,50525276,11823030,,926492,40518207,8136137,,1906275,10007069,3686893,PDP
SS015,,1986,1962,,2957287,58776907,13415811,,1015539,42047774,8497349,,1941748,16729133,4918462,PDP
SS015,,1987,1962,,3686004,58776907,14144528,,1258725,43691717,9033052,,2427279,15085190,5111476,PDP
SS015,,1988,1962,,3686004,58776907,14144528,,1427768,44296408,9309691,,2258236,14480499,4834837,PDP
SS015,,1989,1962,,3907583,62490798,15026942,,1544388,45341936,9612348,,2363195,17148862,5414594,PDP
SS015,,1990,1962,,1739527,46210586,9962051,,1635170,45964989,9813994,,104357,245597,148057,PDP
SS015,,1991,1962,,1844187,46841408,10178957,,1683705,46105648,9887557,,160482,735760,291400,PDP
SS015,,1992,1962,,1888727,51295453,11016032,,1686916,46115912,9892594,,201811,5179541,1123438,PDP
SS015,,1993,1962,,2691546,52087655,11959812,,1779050,46139414,9988910,,912496,5948241,1970902,PDP
SS015,,1994,1962,,2650968,51810964,11870001,,2121838,46282571,10357171,,529130,5528393,1512830,PDP
SS015,,1995,1962,,2756628,46664435,11059908,,2285353,46373270,10536825,,471275,291165,523083,PDP
SS015,,1996,1962,,2952657,46761960,11273290,,2449402,46456248,10715638,,503255,305712,557652,PDP
SS015,,1997,1962,,2800895,48837625,11490864,,2552113,46520573,10829795,,248782,2317052,661069,PDP
SS015,,1998,1962,,2783737,48897994,11484448,,2622716,47000611,10985814,,161021,1897383,498634,PDP
SS015,,1999,1962,,3118573,54858077,12879797,,2672568,47305267,11089875,,446005,7552810,1789922,PDP
SS015,,2000,1962,,3153454,54840182,12911494,,2715601,47496489,11166934,,437853,7343693,1744560,PDP
SS015,,2001,1962,,3136703,54840300,12894764,,2725546,47647769,11203797,,411157,7192531,1690967,PDP
SS015,,2002,1962,,3136703,54840300,12894764,,2726614,47685233,11211531,,410089,7155067,1683233,PDP
SS015,,2003,1962,,3136703,54840300,12894764,,2729016,47725441,11221087,,407687,7114859,1673677,PDP
SS015,,2004,1962,,3081602,54213423,12728119,,2730210,47928992,11258500,,351392,6284431,1469619,PDP
SS015,,2005,1962,,3070345,54209365,12716139,,2731651,48015516,11275337,,338694,6193849,1440802,PDP
SS015,,2006,1962,,3070345,54209365,12716139,,2732895,48086126,11289145,,337450,6123239,1426994,PDP
SS015,,2007,1962,,3077142,54567801,12786715,,2736652,48198322,11312866,,340490,6369479,1473849,PDP
SS015,,2008,1962,,3077142,54567801,12786715,,2739214,48253784,11325297,,337928,6314017,1461418,PDP
SS015,,2009,1962,,3084291,55659662,12988146,,2740950,49266314,11507198,,343341,6393348,1480948,PDP
SS015,,2010,1962,,3155690,55544678,13039086,,2741864,49289018,11512153,,413826,6255660,1526933,PDP
SS015,,2011,1962,,3155690,55544678,13039086,,2798463,49456155,11598491,,357227,6088523,1440595,PDP
SS015,,2012,1962,,3155690,55544678,13039086,,2814153,49465325,11615813,,341537,6079353,1423273,PDP
SS015,,2013,1962,,3155690,55544678,13039086,,2814153,49465325,11615813,,341537,6079353,1423273,PDP
SS015,,2014,1962,,3179307,55555711,13064666,,2822350,49468418,11624560,,356957,6087293,1440106,PDP
SS015,,2015,1962,,3179307,55555711,13064666,,2831843,49475203,11635261,,347464,6080508,1429406,PDP
SS015,,2016,1962,,3179307,55555711,13064666,,2832855,49476269,11636462,,346452,6079442,1428204,PDP
SS015,,2017,1962,,3174488,55555794,13059862,,2832951,49476441,11636589,,341537,6079353,1423273,PDP
SS015,,2017,1962,,3174488,55555794,13059862,,2832951,49476441,11636589,,341537,6079353,1423273,PDP
SS028,,1975,1949,,22000385,800000000,164349139,,18744047,668933063,137771282,,3256338,131066937,26577857,PDP
SS028,,1976,1949,,22000192,687000000,144242185,,18815715,674128137,138767341,,3184477,12871863,5474844,PDP
SS028,,1977,1949,,22000192,687000000,144242185,,19741130,680078833,140751599,,2259062,6921167,3490586,PDP
SS028,,1978,1949,,32805711,1127190441,233373405,,23481321,692309816,146668121,,9324390,434880625,86705284,PDP
SS028,,1979,1949,,24978819,1136360086,227178123,,18741633,701088639,143490501,,6237186,435271447,83687622,PDP
SS028,,1980,1949,,25023653,1141914926,228211362,,18885912,708233054,144906028,,6137741,433681872,83305334,PDP
SS028,,1981,1949,,25099695,1145720147,228964490,,19107396,718077278,146879154,,5992299,427642869,82085336,PDP
SS028,,1982,1949,,25103266,1145854554,228991977,,19495053,729021286,149214143,,5608213,416833268,79777834,PDP
SS028,,1983,1949,,25183070,1154024109,230525438,,19671145,737527488,150903794,,5511925,416496621,79621644,PDP
SS028,,1984,1949,,24160974,851569871,175685862,,19090120,719770688,147163196,,5070854,131799183,28522666,PDP
SS028,,1985,1949,,24249724,854268841,176254856,,19134352,721789535,147566654,,5115372,132479306,28688202,PDP
SS028,,1986,1949,,22299536,789633767,162803765,,19171079,723685304,147940706,,3128457,65948463,14863059,PDP
SS028,,1987,1949,,20349733,776806593,158571547,,19189163,726083470,148385510,,1160570,50723123,10186037,PDP
SS028,,1988,1949,,20380876,776806593,158602690,,19217434,727930060,148742356,,1163442,48876533,9860334,PDP
SS028,,1989,1949,,19357085,734954295,150131871,,19239564,728970069,148949541,,117521,5984226,1182330,PDP
SS028,,1990,1949,,19384990,737000279,150523830,,19251861,729621427,149077738,,133129,7378852,1446092,PDP
SS028,,1991,1949,,19294703,732154367,149571281,,19269825,730545596,149260145,,24878,1608771,311136,PDP
SS028,,1992,1949,,19328118,735495896,150199274,,19286526,731119856,149379027,,41592,4376040,820247,PDP
SS028,,1993,1949,,19504868,734203761,150146107,,19327697,731631382,149511217,,177171,2572379,634890,PDP
SS028,,1994,1949,,22158097,824207321,168814204,,19387022,734889609,150150298,,2771075,89317712,18663906,PDP
SS028,,1995,1949,,22149524,826665784,169243080,,19523112,740405314,151267830,,2626412,86260470,17975250,PDP
SS028,,1996,1949,,22094466,828075926,169438937,,19643929,744991665,152204723,,2450537,83084261,17234214,PDP
SS028,,1997,1949,,22094466,828075926,169438937,,19725364,747951739,152812862,,2369102,80124187,16626075,PDP
SS028,,1998,1949,,22596416,847255468,173353617,,19782020,750194185,153268530,,2814396,97061283,20085087,PDP
SS028,,1999,1949,,21874307,830672834,169680861,,20861922,788912593,161237828,,1012385,41760241,8443033,PDP
SS028,,2000,1949,,21876439,861276890,175128555,,20972989,793053330,162085681,,903450,68223560,13042874,PDP
SS028,,2001,1949,,21949138,861809023,175295939,,21015445,794534420,162391676,,933693,67274603,12904263,PDP
SS028,,2002,1949,,21949138,861809023,175295939,,21036338,795620362,162605797,,912800,66188661,12690142,PDP
SS028,,2003,1949,,21669170,830031263,169361566,,21074108,799103355,163263317,,595062,30927908,6098249,PDP
SS028,,2004,1949,,21505446,824164659,168153962,,21103526,800843386,163602349,,401920,23321273,4551613,PDP
SS028,,2005,1949,,21346974,819744673,167209016,,21118281,801678194,163765646,,228693,18066479,3443370,PDP
SS028,,2006,1949,,21346870,819741017,167208261,,21127355,802645994,163946927,,219515,17095023,3261334,PDP
SS028,,2007,1949,,21346998,819745560,167209197,,21134880,803584456,164121438,,212118,16161104,3087759,PDP
SS028,,2008,1949,,21875262,838613853,171094809,,21142371,804201225,164238674,,732891,34412628,6856135,PDP
SS028,,2009,1949,,21898260,855096141,174050594,,21151457,820283310,167109337,,746803,34812831,6941256,PDP
SS028,,2010,1949,,21898260,855096141,174050594,,21174087,820948700,167250362,,724173,34147441,6800227,PDP
SS028,,2011,1949,,21563199,843429294,171639581,,21216153,822124533,167501652,,347046,21304761,4137928,PDP
SS028,,2012,1949,,21563199,843429294,171639581,,21271227,823504687,167802305,,291972,19924607,3837274,PDP
SS028,,2013,1949,,21385942,834709377,169910736,,21316029,824674383,168055238,,69913,10034994,1855499,PDP
SS028,,2014,1949,,21385942,834709377,169910736,,21354400,825641992,168265781,,31542,9067385,1644955,PDP
SS028,,2015,1949,,21403762,834709377,169928556,,21373518,826193285,168382994,,30244,8516092,1545562,PDP
SS028,,2016,1949,,21407203,834709377,169931997,,21393033,826684289,168489877,,14170,8025088,1442121,PDP
SS028,,2017,1949,,21443989,827997346,168774472,,21404306,826951141,168548631,,39683,1046205,225841,PDP
SS028,,2017,1949,,21443989,827997346,168774472,,21404306,826951141,168548631,,39683,1046205,225841,PDP
SS032,,1975,1947,,8000000,180000000,40028470,,4811839,112147519,24766914,,3188161,67852481,15261556,PDP
SS032,,1976,1947,,8000000,180000000,40028470,,5761763,122437843,27547856,,2238237,57562157,12480614,PDP
SS032,,1977,1947,,8000000,180000000,40028470,,7511075,132415812,31072607,,488925,47584188,8955863,PDP
SS032,,1978,1947,,12905630,220647395,52166732,,7220511,102992072,25546502,,5685119,117655323,26620230,PDP
SS032,,1979,1947,,13786520,248088223,57930332,,7631611,150163858,34351159,,6154909,97924365,23579173,PDP
SS032,,1980,1947,,13218095,242683989,56400299,,7683337,145155355,33511692,,5534758,97528634,22888607,PDP
SS032,,1981,1947,,13218095,242683989,56400299,,8048904,145655835,33966312,,5169191,97028154,22433987,PDP
SS032,,1982,1947,,13607164,249156743,57941104,,8413265,145911052,34376086,,5193899,103245691,23565018,PDP
SS032,,1983,1947,,14325248,251251468,59031915,,8937515,146818504,35061804,,5387733,104432964,23970111,PDP
SS032,,1984,1947,,14637735,251273868,59348388,,9356292,147487784,35599670,,5281443,103786084,23748718,PDP
SS032,,1985,1947,,19134293,250638116,63731823,,10326701,147928675,36648529,,8807592,102709441,27083294,PDP
SS032,,1986,1947,,19190821,251361267,63917025,,10660897,148434402,37072712,,8529924,102926865,26844313,PDP
SS032,,1987,1947,,19752647,250852736,64388365,,11022503,149053002,37544389,,8730144,101799734,26843976,PDP
SS032,,1988,1947,,18708073,246423558,62555681,,11317946,150753249,38142368,,7390127,95670309,24413313,PDP
SS032,,1989,1947,,18708073,246423558,62555681,,11591577,153088820,38831581,,7116496,93334738,23724100,PDP
SS032,,1990,1947,,18538683,246810399,62455124,,11809043,154307592,39265910,,6729640,92502807,23189214,PDP
SS032,,1991,1947,,13182158,162003956,42008485,,11991100,154905494,39554355,,1191058,7098462,2454130,PDP
SS032,,1992,1947,,13263852,170173356,43543809,,12224989,155648953,39920532,,1038863,14524403,3623277,PDP
SS032,,1993,1947,,13263852,170173356,43543809,,12523532,159026799,40820115,,740320,11146557,2723694,PDP
SS032,,1994,1947,,13754767,181963105,46132544,,12785791,164629023,42079211,,968976,17334082,4053333,PDP
SS032,,1995,1947,,13869560,184428084,46685945,,13039009,172230361,43684981,,830551,12197723,3000964,PDP
SS032,,1996,1947,,14420004,188553080,47970374,,13255661,176639762,44686224,,1164343,11913318,3284150,PDP
SS032,,1997,1947,,14131326,195313244,48884572,,13477987,180103829,45524932,,653339,15209415,3359640,PDP
SS032,,1998,1947,,14131326,195313244,48884572,,13655747,183292080,46269996,,475579,12021164,2614576,PDP
SS032,,1999,1947,,13306063,164482294,42573375,,12783133,150067527,39485540,,522930,14414767,3087835,PDP
SS032,,2000,1947,,16620735,201731207,52515968,,12959735,152194497,40040606,,3661000,49536710,12475362,PDP
SS032,,2001,1947,,16561209,200957779,52318821,,13676803,156048508,41443441,,2884406,44909271,10875380,PDP
SS032,,2002,1947,,16570045,200963045,52328594,,14168816,158913739,42445282,,2401229,42049306,9883312,PDP
SS032,,2003,1947,,16610877,201589576,52480908,,14349117,160902059,42979377,,2261760,40687517,9501531,PDP
SS032,,2004,1947,,16609867,201430559,52451603,,14491653,162276488,43366473,,2118214,39154071,9085130,PDP
SS032,,2005,1947,,16504721,200727883,52221426,,14618560,163210870,43659640,,1886161,37517013,8561786,PDP
SS032,,2006,1947,,16500832,201923675,52430311,,14680459,163846456,43834633,,1820373,38077219,8595678,PDP
SS032,,2007,1947,,16587290,202119313,52551580,,14745542,164506048,44017081,,1841748,37613265,8534499,PDP
SS032,,2008,1947,,16741291,202139127,52709107,,14823364,164913692,44167437,,1917927,37225435,8541670,PDP
SS032,,2009,1947,,16837207,206093765,53508693,,14896683,168071078,44802567,,1940524,38022687,8706125,PDP
SS032,,2010,1947,,16759294,201757509,52659203,,14954018,168842908,44997239,,1805276,32914601,7661965,PDP
SS032,,2011,1947,,16764860,202190183,52741757,,15009179,169625105,45191580,,1755681,32565078,7550177,PDP
SS032,,2012,1947,,16766245,202351415,52771831,,15048332,169890281,45277917,,1717913,32461134,7493915,PDP
SS032,,2013,1947,,16766245,202351415,52771831,,15075116,169970107,45318905,,1691129,32381308,7452927,PDP
SS032,,2014,1947,,16768288,202461703,52793498,,15113038,170030133,45367509,,1655250,32431570,7425991,PDP
SS032,,2015,1947,,16857456,202518770,52892820,,15140206,170050064,45398222,,1717250,32468706,7494599,PDP
SS032,,2016,1947,,16887781,204677406,53307243,,15165715,170144701,45440571,,1722066,34532705,7866675,PDP
SS032,,2017,1947,,16404549,196201061,51315766,,15187763,170311873,45492364,,1216786,25889188,5823403,PDP
SS032,,2017,1947,,16404549,196201061,51315766,,15187763,170311873,45492364,,1216786,25889188,5823403,PDP
SS037,,1987,1985,,20261,2562397,476204,,50,1173350,208831,,20211,1389047,267373,PDN
SS037,,1988,1985,,20261,2562397,476204,,50,1464195,260583,,20211,1098202,215621,PDN
SS037,,1989,1985,,38820,4756860,885236,,50,1576729,280607,,38770,3180131,604629,PDN
SS037,,1990,1985,,358339,12353180,2556414,,42893,4824312,901312,,315446,7528868,1655102,PDN
SS037,,1991,1985,,429770,21528516,4260467,,126048,7836517,1520446,,303722,13691999,2740021,PDN
SS037,,1992,1985,,596635,16354681,3506721,,200299,8036501,1630281,,396336,8318180,1876440,PDN
SS037,,1993,1985,,629509,20980049,4362614,,285912,9633256,2000014,,343597,11346793,2362600,PDN
SS037,,1994,1985,,631579,21225732,4408400,,351569,10876336,2286860,,280010,10349396,2121540,PDN
SS037,,1995,1985,,370850,10906158,2311448,,370850,10906158,2311448,,0,0,0,PDN
SS037,,1996,1985,,370850,10906158,2311448,,370850,10906158,2311448,,0,0,0,PDN
SS037,,1997,1985,,370850,10906158,2311448,,370850,10906158,2311448,,0,0,0,PDN
SS037,,1998,1985,,370850,10906158,2311448,,370850,10906158,2311448,,0,0,0,PDN
SS037,,1999,1985,,370850,10906158,2311448,,370850,10906158,2311448,,0,0,0,PDN
SS037,,2000,1985,,370850,10906158,2311448,,370850,10906158,2311448,,0,0,0,PDN
SS037,,2001,1985,,370850,10906158,2311448,,370850,10906158,2311448,,0,0,0,PDN
SS037,,2002,1985,,370850,10906158,2311448,,370850,10906158,2311448,,0,0,0,PDN
SS037,,2003,1985,,370850,10906158,2311448,,370850,10906158,2311448,,0,0,0,PDN
SS037,,2004,1985,,370850,10906158,2311448,,370850,10906158,2311448,,0,0,0,PDN
SS037,,2005,1985,,370850,10906158,2311448,,370850,10906158,2311448,,0,0,0,PDN
SS037,,2006,1985,,370850,10906158,2311448,,370850,10906158,2311448,,0,0,0,PDN
SS037,,2007,1985,,370850,10906158,2311448,,370850,10906158,2311448,,0,0,0,PDN
SS037,,2008,1985,,370850,10906158,2311448,,370850,10906158,2311448,,0,0,0,PDN
SS037,,2009,1985,,370850,11124572,2350311,,370850,11124572,2350311,,0,0,0,PDN
SS037,,2010,1985,,370850,11124572,2350311,,370850,11124572,2350311,,0,0,0,PDN
SS037,,2011,1985,,370850,11124572,2350311,,370850,11124572,2350311,,0,0,0,PDN
SS037,,2012,1985,,370850,11124572,2350311,,370850,11124572,2350311,,0,0,0,PDN
SS037,,2013,1985,,370850,11124572,2350311,,370850,11124572,2350311,,0,0,0,PDN
SS037,,2014,1985,,370850,11124572,2350311,,370850,11124572,2350311,,0,0,0,PDN
SS037,,2015,1985,,370850,11124572,2350311,,370850,11124572,2350311,,0,0,0,PDN
SS037,,2016,1985,,370850,11124572,2350311,,370850,11124572,2350311,,0,0,0,PDN
SS037,,2017,1985,,370850,11124572,2350311,,370850,11124572,2350311,,0,0,0,PDN
SS037,,2017,1985,,370850,11124572,2350311,,370850,11124572,2350311,,0,0,0,PDN
SS052,,1988,1987,,570080,11655059,2643934,,0,0,0,,570080,11655059,2643934,PDN
SS052,,1997,1987,,713663,1717354,1019242,,0,0,0,,713663,1717354,1019242,PDN
SS052,,1998,1987,,713663,1717354,1019242,,0,0,0,,713663,1717354,1019242,PDN
SS052,,1999,1987,,713663,1717354,1019242,,0,0,0,,713663,1717354,1019242,PDN
SS052,,2000,1987,,3055088,5141039,3969864,,0,0,0,,3055088,5141039,3969864,PDN
SS052,,2001,1987,,3055088,5141039,3969864,,0,0,0,,3055088,5141039,3969864,PDN
SS052,,2002,1987,,3055088,5141039,3969864,,0,0,0,,3055088,5141039,3969864,PDN
SS052,,2003,1987,,3421368,6129995,4512115,,0,0,0,,3421368,6129995,4512115,PDN
SS052,,2004,1987,,3465321,6248668,4577184,,130467,320048,187415,,3334854,5928620,4389769,PDN
SS052,,2005,1987,,3465321,6248668,4577184,,223809,716689,351334,,3241512,5531979,4225850,PDN
SS052,,2006,1987,,3465321,6248668,4577184,,300133,991757,476602,,3165188,5256911,4100582,PDN
SS052,,2007,1987,,3465321,6248668,4577184,,300240,994071,477121,,3165081,5254597,4100063,PDN
SS052,,2008,1987,,3355328,6146070,4448935,,300240,1005031,479071,,3055088,5141039,3969864,PDN
SS052,,2009,1987,,1267318,3084238,1816115,,300240,1005031,479071,,967078,2079207,1337044,PDN
SS052,,2010,1987,,1267318,3084238,1816115,,300240,1005031,479071,,967078,2079207,1337044,PDN
SS052,,2011,1987,,1267318,3084238,1816115,,300240,1005031,479071,,967078,2079207,1337044,PDN
SS052,,2012,1987,,1267318,3084238,1816115,,300240,1005031,479071,,967078,2079207,1337044,PDN
SS052,,2013,1987,,1267318,3084238,1816115,,300240,1005031,479071,,967078,2079207,1337044,PDN
SS052,,2014,1987,,1267318,3084238,1816115,,300240,1005031,479071,,967078,2079207,1337044,PDN
SS052,,2015,1987,,1267318,3084238,1816115,,300240,1005031,479071,,967078,2079207,1337044,PDN
SS052,,2016,1987,,300240,1005031,479071,,300240,1005031,479071,,0,0,0,PDN
SS052,,2017,1987,,300240,1005031,479071,,300240,1005031,479071,,0,0,0,PDN
SS052,,2017,1987,,300240,1005031,479071,,300240,1005031,479071,,0,0,0,PDN
SS053,,2006,2006,,538151,7550795,1881709,,0,0,0,,538151,7550795,1881709,PDN
SS053,,2007,2006,,538151,7550795,1881709,,141832,2038921,504629,,396319,5511874,1377080,PDN
SS053,,2008,2006,,538151,7550795,1881709,,274375,4029350,991341,,263776,3521445,890368,PDN
SS053,,2009,2006,,548958,7702426,1919496,,305835,4492872,1105278,,243123,3209554,814218,PDN
SS053,,2010,2006,,305835,4492872,1105278,,305835,4492872,1105278,,0,0,0,PDN
SS053,,2011,2006,,305835,4492872,1105278,,305835,4492872,1105278,,0,0,0,PDN
SS053,,2012,2006,,305835,4492872,1105278,,305835,4492872,1105278,,0,0,0,PDN
SS053,,2013,2006,,305835,4492872,1105278,,305835,4492872,1105278,,0,0,0,PDN
SS053,,2014,2006,,305835,4492872,1105278,,305835,4492872,1105278,,0,0,0,PDN
SS053,,2015,2006,,305835,4492872,1105278,,305835,4492872,1105278,,0,0,0,PDN
SS053,,2016,2006,,305835,4492872,1105278,,305835,4492872,1105278,,0,0,0,PDN
SS053,,2017,2006,,305835,4492872,1105278,,305835,4492872,1105278,,0,0,0,PDN
SS053,,2017,2006,,305835,4492872,1105278,,305835,4492872,1105278,,0,0,0,PDN
SS056,,2005,2005,,184,1836671,326994,,0,0,0,,184,1836671,326994,PDN
SS056,,2006,2005,,184,1836671,326994,,0,23157,4120,,184,1813514,322874,PDN
SS056,,2007,2005,,184,1836671,326994,,0,1159644,206342,,184,677027,120652,PDN
SS056,,2008,2005,,0,2244821,399434,,0,1897749,337678,,0,347072,61756,PDN
SS056,,2009,2005,,0,2289751,407429,,0,2094178,372630,,0,195573,34799,PDN
SS056,,2010,2005,,0,2289751,407429,,0,2173132,386678,,0,116619,20751,PDN
SS056,,2011,2005,,0,2289751,407429,,0,2207907,392866,,0,81844,14563,PDN
SS056,,2012,2005,,0,2289751,407429,,0,2217491,394571,,0,72260,12858,PDN
SS056,,2013,2005,,0,2217491,394571,,0,2217491,394571,,0,0,0,PDN
SS056,,2014,2005,,0,2217491,394571,,0,2217491,394571,,0,0,0,PDN
SS056,,2015,2005,,0,2217491,394571,,0,2217491,394571,,0,0,0,PDN
SS056,,2016,2005,,0,2217491,394571,,0,2217491,394571,,0,0,0,PDN
SS056,,2017,2005,,0,2217491,394571,,0,2217491,394571,,0,0,0,PDN
SS056,,2017,2005,,0,2217491,394571,,0,2217491,394571,,0,0,0,PDN
SS058,,1989,1966,,247783,29298392,5461020,,0,0,0,,247783,29298392,5461020,PDP
SS058,,1990,1966,,338555,40031563,7461609,,0,0,0,,338555,40031563,7461609,PDP
SS058,,1991,1966,,797106,40031563,7920160,,63296,813705,208083,,733810,39217858,7712077,PDP
SS058,,1992,1966,,1689785,42921887,9327131,,122223,1662003,417953,,1567562,41259884,8909178,PDP
SS058,,1993,1966,,1689785,42921887,9327131,,302932,2771894,796152,,1386853,40149993,8530979,PDP
SS058,,1994,1966,,1932989,43037121,9590840,,483948,3473353,1101982,,1449041,39563768,8488858,PDP
SS058,,1995,1966,,1733601,11974216,3864244,,727317,4715184,1566318,,1006284,7259032,2297926,PDP
SS058,,1996,1966,,1676942,11429882,3710729,,917593,5696498,1931205,,759349,5733384,1779524,PDP
SS058,,1997,1966,,1889888,12498645,4113846,,1077867,6132533,2169065,,812021,6366112,1944781,PDP
SS058,,1998,1966,,2057292,17283170,5132589,,1158324,6429416,2302348,,898968,10853754,2830241,PDP
SS058,,1999,1966,,2210831,36771353,8753776,,1331322,10420713,3185541,,879509,26350640,5568235,PDP
SS058,,2000,1966,,2270470,36774712,8814013,,1450805,12726784,3715357,,819665,24047928,5098656,PDP
SS058,,2001,1966,,3463876,33239177,9378320,,1785600,14676196,4397023,,1678276,18562981,4981297,PDP
SS058,,2002,1966,,3463876,33239177,9378320,,2273211,16815439,5265282,,1190665,16423738,4113038,PDP
SS058,,2003,1966,,3751602,37083411,10350074,,2633298,19500059,6103059,,1118304,17583352,4247015,PDP
SS058,,2004,1966,,3251634,30872720,8745001,,2823359,22584122,6841886,,428275,8288598,1903115,PDP
SS058,,2005,1966,,3251470,29994645,8588595,,2931444,24258616,7247924,,320026,5736029,1340671,PDP
SS058,,2006,1966,,3342590,30866650,8834876,,3048036,25757339,7631192,,294554,5109311,1203684,PDP
SS058,,2007,1966,,3624360,32493741,9406164,,3219579,27214882,8062085,,404781,5278859,1344079,PDP
SS058,,2008,1966,,3671384,32571313,9466991,,3378819,28034777,8367213,,292565,4536536,1099778,PDP
SS058,,2009,1966,,3694422,33008503,9567822,,3441251,28301768,8477154,,253171,4706735,1090668,PDP
SS058,,2010,1966,,4004107,33657258,9992944,,3551721,28560419,8633646,,452386,5096839,1359297,PDP
SS058,,2011,1966,,4037807,33637713,10023166,,3694867,28874817,8832735,,342940,4762896,1190431,PDP
SS058,,2012,1966,,4031314,33642557,10017535,,3787124,29056672,8957350,,244190,4585885,1060184,PDP
SS058,,2013,1966,,3879367,32599860,9680054,,3823632,29133148,9007466,,55735,3466712,672588,PDP
SS058,,2014,1966,,3991467,32739765,9817049,,3874965,29245878,9078858,,116502,3493887,738191,PDP
SS058,,2015,1966,,3991467,32739765,9817049,,3932100,29404669,9164247,,59367,3335096,652802,PDP
SS058,,2016,1966,,4027589,32847401,9872323,,3999786,29559809,9259539,,27803,3287592,612784,PDP
SS058,,2017,1966,,4153167,33047900,10033577,,4052749,29682723,9334372,,100418,3365177,699205,PDP
SS058,,2017,1966,,4153167,33047900,10033577,,4052749,29682723,9334372,,100418,3365177,699205,PDP
SS062,,1991,1990,,46255,5469240,1019429,,2817,524821,96202,,43438,4944419,923227,PDN
SS062,,1992,1990,,35154,6008118,1104214,,6418,1797409,326242,,28736,4210709,777972,PDN
SS062,,1993,1990,,6822,2573640,464765,,6822,2573640,464765,,0,0,0,PDN
SS062,,1994,1990,,6822,2573640,464765,,6822,2573640,464765,,0,0,0,PDN
SS062,,1995,1990,,6822,2573640,464765,,6822,2573640,464765,,0,0,0,PDN
SS062,,1996,1990,,6822,2573640,464765,,6822,2573640,464765,,0,0,0,PDN
SS062,,1997,1990,,6822,2573640,464765,,6822,2573640,464765,,0,0,0,PDN
SS062,,1998,1990,,6822,2573640,464765,,6822,2573640,464765,,0,0,0,PDN
SS062,,1999,1990,,6822,2573640,464765,,6822,2573640,464765,,0,0,0,PDN
SS062,,2000,1990,,6822,2573640,464765,,6822,2573640,464765,,0,0,0,PDN
SS062,,2001,1990,,6822,2573640,464765,,6822,2573640,464765,,0,0,0,PDN
SS062,,2002,1990,,6822,2573640,464765,,6822,2573640,464765,,0,0,0,PDN
SS062,,2003,1990,,6822,2573640,464765,,6822,2573640,464765,,0,0,0,PDN
SS062,,2004,1990,,6822,2573640,464765,,6822,2573640,464765,,0,0,0,PDN
SS062,,2005,1990,,50707,6485777,1204760,,6958,2583455,466648,,43749,3902322,738112,PDN
SS062,,2006,1990,,50707,6485777,1204760,,40893,5062795,941746,,9814,1422982,263014,PDN
SS062,,2007,1990,,50707,6485777,1204760,,50305,6312681,1173558,,402,173096,31202,PDN
SS062,,2008,1990,,54415,7172068,1330584,,54415,7172068,1330584,,0,0,0,PDN
SS062,,2009,1990,,54415,7223609,1339755,,54415,7223609,1339755,,0,0,0,PDN
SS062,,2010,1990,,54415,7223609,1339755,,54415,7223609,1339755,,0,0,0,PDN
SS062,,2011,1990,,54415,7223609,1339755,,54415,7223609,1339755,,0,0,0,PDN
SS062,,2012,1990,,54415,7223609,1339755,,54415,7223609,1339755,,0,0,0,PDN
SS062,,2013,1990,,54415,7223609,1339755,,54415,7223609,1339755,,0,0,0,PDN
SS062,,2014,1990,,54415,7223609,1339755,,54415,7223609,1339755,,0,0,0,PDN
SS062,,2015,1990,,54415,7223609,1339755,,54415,7223609,1339755,,0,0,0,PDN
SS062,,2016,1990,,54415,7223609,1339755,,54415,7223609,1339755,,0,0,0,PDN
SS062,,2017,1990,,54415,7223609,1339755,,54415,7223609,1339755,,0,0,0,PDN
SS062,,2017,1990,,54415,7223609,1339755,,54415,7223609,1339755,,0,0,0,PDN
SS067,,1995,1995,,745843,7095791,2008439,,11486,137208,35900,,734357,6958583,1972539,PDP
SS067,,1996,1995,,1835927,9089159,3453215,,470155,4099983,1199689,,1365772,4989176,2253526,PDP
SS067,,1997,1995,,1865912,15261765,4581529,,1243172,8532174,2761352,,622740,6729591,1820177,PDP
SS067,,1998,1995,,2103700,13511531,4507887,,1647298,11220950,3643908,,456402,2290581,863979,PDP
SS067,,1999,1995,,2552915,13956156,5036217,,1948148,12168515,4113364,,604767,1787641,922853,PDP
SS067,,2000,1995,,2644308,13967032,5129545,,2184272,12613593,4428684,,460036,1353439,700861,PDP
SS067,,2001,1995,,4380733,16512225,7318851,,3366134,13866588,5833498,,1014599,2645637,1485353,PDP
SS067,,2002,1995,,4403586,17325799,7486468,,3801106,15129827,6493246,,602480,2195972,993222,PDP
SS067,,2003,1995,,4403586,17325799,7486468,,3915952,15870937,6739962,,487634,1454862,746506,PDP
SS067,,2004,1995,,4127150,18612186,7438927,,3965156,16624847,6923314,,161994,1987339,515613,PDP
SS067,,2005,1995,,4127150,18612186,7438927,,4004497,17226010,7069623,,122653,1386176,369304,PDP
SS067,,2006,1995,,4231465,19223396,7651998,,4037604,17871457,7217579,,193861,1351939,434419,PDP
SS067,,2007,1995,,4231465,19223396,7651998,,4077670,18328272,7338928,,153795,895124,313070,PDP
SS067,,2008,1995,,4231465,19223396,7651998,,4144844,18799317,7489918,,86621,424079,162080,PDP
SS067,,2009,1995,,4285041,19411449,7739035,,4212724,19282798,7643827,,72317,128651,95208,PDP
SS067,,2010,1995,,4285041,19411449,7739035,,4280913,19387223,7730597,,4128,24226,8438,PDP
SS067,,2011,1995,,4285041,19411449,7739035,,4281171,19387553,7730914,,3870,23896,8122,PDP
SS067,,2012,1995,,4285050,19411486,7739051,,4282165,19390053,7732353,,2885,21433,6699,PDP
SS067,,2013,1995,,4331878,19427301,7788694,,4309826,19410702,7763688,,22052,16599,25006,PDP
SS067,,2014,1995,,4349924,19455762,7811804,,4328928,19410720,7782793,,20996,45042,29011,PDP
SS067,,2015,1995,,4350272,19456492,7812282,,4337674,19410720,7791539,,12598,45772,20743,PDP
SS067,,2016,1995,,4360272,19459412,7822801,,4345297,19410720,7799162,,14975,48692,23639,PDP
SS067,,2017,1995,,4360272,19459412,7822801,,4346576,19410720,7800441,,13696,48692,22360,PDP
SS067,,2017,1995,,4360272,19459412,7822801,,4346576,19410720,7800441,,13696,48692,22360,PDP
SS069,,1982,1979,,562500,2950000,1087411,,0,0,0,,562500,2950000,1087411,PDN
SS069,,1983,1979,,562500,2950000,1087411,,0,0,0,,562500,2950000,1087411,PDN
SS069,,1984,1979,,2380057,11079007,4351411,,77422,70400,89949,,2302635,11008607,4261462,PDN
SS069,,1985,1979,,4150000,6050000,5226512,,2132550,3442306,2745060,,2017450,2607694,2481452,PDN
SS069,,1986,1979,,54363493,206355768,91081601,,3783826,5703722,4798723,,50579667,200652046,86282878,PDN
SS069,,1987,1979,,54363493,220987249,93685068,,5294602,7798143,6682172,,49068891,213189106,87002896,PDN
SS069,,1988,1979,,52951675,183872582,85669216,,6798708,10977759,8752046,,46152967,172894823,76917170,PDN
SS069,,1989,1979,,52975784,184905409,85877102,,7959098,14074229,10463409,,45016686,170831180,75413693,PDN
SS069,,1990,1979,,25227385,94414959,42027200,,9019194,18426522,12297935,,16208191,75988437,29729265,PDN
SS069,,1991,1979,,25988159,95875587,43047872,,10369433,24045269,14647951,,15618726,71830318,28399921,PDN
SS069,,1992,1979,,28886743,99965650,46674225,,11813561,25832444,16410081,,17073182,74133206,30264144,PDN
SS069,,1993,1979,,28337613,90118406,44372917,,13402747,27878786,18363385,,14934866,62239620,26009532,PDN
SS069,,1994,1979,,20709330,65553323,32373622,,14487263,30656248,19942111,,6222067,34897075,12431511,PDN
SS069,,1995,1979,,27334296,68120686,39455415,,15091050,31726317,20736302,,12243246,36394369,18719113,PDN
SS069,,1996,1979,,28054410,72268588,40913589,,15601980,34629384,21763792,,12452430,37639204,19149797,PDN
SS069,,1997,1979,,23825405,71720817,36587116,,15986550,37205335,22606716,,7838855,34515482,13980400,PDN
SS069,,1998,1979,,23183953,75189824,36562925,,16430945,39976743,23544244,,6753008,35213081,13018681,PDN
SS069,,1999,1979,,23183518,72585096,36099016,,16878870,41943955,24342207,,6304648,30641141,11756809,PDN
SS069,,2000,1979,,24756843,87520180,40329829,,17369176,43804580,25163585,,7387667,43715600,15166244,PDN
SS069,,2001,1979,,23759970,81260546,38219142,,17797650,44617987,25736794,,5962320,36642559,12482348,PDN
SS069,,2002,1979,,23793598,81366943,38271702,,18159565,45252979,26211696,,5634033,36113964,12060006,PDN
SS069,,2003,1979,,23790748,81747179,38336509,,18457986,46173195,26673857,,5332762,35573984,11662652,PDN
SS069,,2004,1979,,23507450,82979134,38272420,,18725551,47766708,27224965,,4781899,35212426,11047455,PDN
SS069,,2005,1979,,23490267,82966821,38253046,,18929922,48440607,27549247,,4560345,34526214,10703799,PDN
SS069,,2006,1979,,23488030,82967107,38250860,,19047940,48807497,27732548,,4440090,34159610,10518312,PDN
SS069,,2007,1979,,23795391,83462439,38646359,,19217622,49236320,27978533,,4577769,34226119,10667826,PDN
SS069,,2008,1979,,23795391,83462439,38646359,,19318456,49489300,28124381,,4476935,33973139,10521978,PDN
SS069,,2009,1979,,23805890,78704454,37810241,,19420372,50321808,28374430,,4385518,28382646,9435811,PDN
SS069,,2010,1979,,23942392,79114390,38019687,,19553148,50424677,28525508,,4389244,28689713,9494176,PDN
SS069,,2011,1979,,24026141,79017666,38086225,,19661050,50452520,28638364,,4365091,28565146,9447859,PDN
SS069,,2012,1979,,24026141,79017666,38086225,,19703868,50475477,28685269,,4322273,28542189,9400954,PDN
SS069,,2013,1979,,24111350,79032152,38174011,,19777138,50492582,28761581,,4334212,28539570,9412428,PDN
SS069,,2014,1979,,24172508,80050965,38416452,,19856953,50666819,28872401,,4315555,29384146,9544051,PDN
SS069,,2015,1979,,24342641,80308142,38632345,,19915188,50714766,28939166,,4427453,29593376,9693179,PDN
SS069,,2016,1979,,19938908,50910106,28997645,,19938908,50910106,28997645,,0,0,0,PDN
SS069,,2017,1979,,19938908,50909280,28997499,,19938908,50909280,28997499,,0,0,0,PDN
SS069,,2017,1979,,19938908,50909280,28997499,,19938908,50909280,28997499,,0,0,0,PDN
SS072,,1975,1948,,6800000,44002800,14629680,,6008182,40315135,13181694,,791818,3687665,1447986,PDP
SS072,,1976,1948,,6800000,44002800,14629680,,6112732,41535258,13503347,,687268,2467542,1126333,PDP
SS072,,1977,1948,,6800000,44002800,14629680,,6291563,42600398,13871705,,508437,1402402,757975,PDP
SS072,,1978,1948,,8675707,134555299,32617931,,6400108,58408509,16793081,,2275599,76146790,15824850,PDP
SS072,,1979,1948,,9497186,138360459,34116485,,7030340,81256314,21488759,,2466846,57104145,12627726,PDP
SS072,,1980,1948,,11987730,153870489,39366821,,7684046,94467621,24493231,,4303684,59402868,14873590,PDP
SS072,,1981,1948,,12086058,158306471,40254469,,8230714,99065230,25857979,,3855344,59241241,14396490,PDP
SS072,,1982,1948,,13999336,158424965,42188832,,9201009,102869931,27505267,,4798327,55555034,14683565,PDP
SS072,,1983,1948,,18839360,179054007,50699504,,10031401,106719524,29020640,,8807959,72334483,21678864,PDP
SS072,,1984,1948,,20126718,183869137,52843646,,10948127,111460709,30780993,,9178591,72408428,22062653,PDP
SS072,,1985,1948,,20387203,191656572,54489796,,11725237,114181945,32042309,,8661966,77474627,22447487,PDP
SS072,,1986,1948,,21492112,213720327,59520640,,12585695,118514300,33673649,,8906417,95206027,25846991,PDP
SS072,,1987,1948,,21288931,211337501,58893469,,13526350,126526539,36039969,,7762581,84810962,22853500,PDP
SS072,,1988,1948,,23027385,223675177,62827239,,14326097,134289219,38220976,,8701288,89385958,24606263,PDP
SS072,,1989,1948,,19574277,183585023,52240651,,14912727,141016656,40004659,,4661550,42568367,12235992,PDP
SS072,,1990,1948,,20836766,196041660,55719624,,15383081,148189586,41751335,,5453685,47852074,13968289,PDP
SS072,,1991,1948,,20197625,193033882,54545291,,15788085,155393712,43438212,,4409540,37640170,11107079,PDP
SS072,,1992,1948,,18554050,191443121,52618662,,16058243,160292465,44580034,,2495807,31150656,8038628,PDP
SS072,,1993,1948,,19750701,196866666,54780357,,17120997,167270803,46884485,,2629704,29595863,7895872,PDP
SS072,,1994,1948,,20298531,199329296,55766377,,17815501,174762753,48912076,,2483030,24566543,6854301,PDP
SS072,,1995,1948,,20707220,226392237,60990536,,18134494,180684846,50284822,,2572726,45707391,10705714,PDP
SS072,,1996,1948,,19057430,204828111,55503713,,18359638,188852601,51963304,,697792,15975510,3540409,PDP
SS072,,1997,1948,,18852791,203590405,55078842,,18470709,193537211,52907935,,382082,10053194,2170907,PDP
SS072,,1998,1948,,19111233,211824703,56802461,,18550544,196349340,53488149,,560689,15475363,3314312,PDP
SS072,,1999,1948,,19095293,211833257,56788043,,18651152,198568185,53983569,,444141,13265072,2804474,PDP
SS072,,2000,1948,,19653788,216572663,58189849,,18683186,198725942,54043674,,970602,17846721,4146175,PDP
SS072,,2001,1948,,21093270,225269132,61176746,,19075137,202750751,55151783,,2018133,22518381,6024963,PDP
SS072,,2002,1948,,21615595,235922755,63594733,,19751207,207120934,56605466,,1864388,28801821,6989267,PDP
SS072,,2003,1948,,21947434,240542397,64748572,,20195272,210834475,57710303,,1752162,29707922,7038269,PDP
SS072,,2004,1948,,22149017,230769252,63211162,,20747215,216279226,59231063,,1401802,14490026,3980099,PDP
SS072,,2005,1948,,22274489,231443632,63456630,,21184455,221217043,60546918,,1090034,10226589,2909712,PDP
SS072,,2006,1948,,24766816,247160916,68745627,,21613491,226332669,61886208,,3153325,20828247,6859419,PDP
SS072,,2007,1948,,24655527,249589753,69066515,,22745020,235257421,64605771,,1910507,14332332,4460744,PDP
SS072,,2008,1948,,25028254,250894535,69671410,,23239827,238022580,65592599,,1788427,12871955,4078811,PDP
SS072,,2009,1948,,25528914,258538860,71532270,,23672598,244854700,67241048,,1856316,13684160,4291223,PDP
SS072,,2010,1948,,25321632,256626343,70984681,,24032875,246002097,67805489,,1288757,10624246,3179193,PDP
SS072,,2011,1948,,25449908,249777981,69894385,,24364819,246439016,68215176,,1085089,3338965,1679209,PDP
SS072,,2012,1948,,25605598,251155936,70295263,,24773404,247119169,68744785,,832194,4036767,1550480,PDP
SS072,,2013,1948,,25605598,251155936,70295263,,25064570,247683774,69136413,,541028,3472162,1158851,PDP
SS072,,2014,1948,,25714972,251436486,70454558,,25291195,248649021,69534791,,423777,2787465,919766,PDP
SS072,,2015,1948,,25762621,251673773,70544429,,25383770,249021910,69693715,,378851,2651863,850711,PDP
SS072,,2016,1948,,26043675,252008085,70884969,,25552554,249341015,69919279,,491121,2667070,965688,PDP
SS072,,2017,1948,,26169912,254418399,71440088,,25735416,250733933,70349994,,434496,3684466,1090093,PDP
SS072,,2017,1948,,26169912,254418399,71440088,,25735416,250733933,70349994,,434496,3684466,1090093,PDP
SS078,,1985,1982,,226185,2408844,654805,,0,0,0,,226185,2408844,654805,PDP
SS078,,1988,1982,,0,6677407,1188151,,0,1201019,213704,,0,5476388,974447,PDP
SS078,,1989,1982,,10480,7916612,1419130,,0,3895816,693206,,10480,4020796,725924,PDP
SS078,,1990,1982,,0,24204773,4306899,,0,6549775,1165440,,0,17654998,3141459,PDP
SS078,,1991,1982,,0,30306805,5392670,,0,8186350,1456646,,0,22120455,3936024,PDP
SS078,,1992,1982,,0,30306805,5392670,,0,10905253,1940436,,0,19401552,3452234,PDP
SS078,,1993,1982,,0,30306805,5392670,,0,13627301,2424787,,0,16679504,2967883,PDP
SS078,,1994,1982,,0,30306805,5392670,,0,16915728,3009916,,0,13391077,2382754,PDP
SS078,,1995,1982,,0,25650685,4564179,,0,20263649,3605631,,0,5387036,958548,PDP
SS078,,1996,1982,,0,26990690,4802614,,0,21523640,3829829,,0,5467050,972785,PDP
SS078,,1997,1982,,0,26990690,4802614,,0,22173723,3945502,,0,4816967,857112,PDP
SS078,,1998,1982,,0,26990690,4802614,,0,22576169,4017112,,0,4414521,785502,PDP
SS078,,1999,1982,,0,22805537,4057925,,0,22695387,4038325,,0,110150,19600,PDP
SS078,,2000,1982,,0,22805537,4057925,,0,22712063,4041292,,0,93474,16633,PDP
SS078,,2001,1982,,0,22805537,4057925,,0,22712063,4041292,,0,93474,16633,PDP
SS078,,2002,1982,,519323,23688769,4734406,,68644,22858603,4136011,,450679,830166,598395,PDP
SS078,,2003,1982,,519323,23688769,4734406,,309622,23258200,4448092,,209701,430569,286314,PDP
SS078,,2004,1982,,519323,23688769,4734406,,460797,23480080,4638747,,58526,208689,95659,PDP
SS078,,2005,1982,,784230,24127285,5077341,,545136,23602301,4744834,,239094,524984,332507,PDP
SS078,,2006,1982,,784230,24127285,5077341,,665362,23842882,4907868,,118868,284403,169473,PDP
SS078,,2007,1982,,788826,24246519,5103153,,750797,24120223,5042652,,38029,126296,60501,PDP
SS078,,2008,1982,,1193962,25143934,5667972,,811170,24262262,5128298,,382792,881672,539674,PDP
SS078,,2009,1982,,1193962,25500775,5731466,,866583,24829381,5284622,,327379,671394,446844,PDP
SS078,,2010,1982,,1196567,25655197,5761548,,973150,25020896,5425267,,223417,634301,336282,PDP
SS078,,2011,1982,,1196567,25655197,5761548,,1066207,25239048,5557141,,130360,416149,204408,PDP
SS078,,2012,1982,,1196567,25655197,5761548,,1145988,25408694,5667108,,50579,246503,94440,PDP
SS078,,2013,1982,,1339680,26184914,5998918,,1217932,25706200,5791988,,121748,478714,206928,PDP
SS078,,2014,1982,,1347710,26755079,6108401,,1268862,25918945,5880774,,78848,836134,227627,PDP
SS078,,2015,1982,,1379710,27478055,6269044,,1312799,26096203,5956251,,66911,1381852,312792,PDP
SS078,,2016,1982,,1489056,27621735,6403955,,1382977,26613192,6118420,,106079,1008543,285535,PDP
SS078,,2017,1982,,1500536,28057991,6493061,,1421106,26834170,6195869,,79430,1223821,297191,PDP
SS078,,2017,1982,,1500536,28057991,6493061,,1421106,26834170,6195869,,79430,1223821,297191,PDP
SS084,,1978,1976,,5000,5000000,894680,,0,0,0,,5000,5000000,894680,PDN
SS084,,1979,1976,,5000,5000000,894680,,119,3449,733,,4881,4996551,893947,PDN
SS084,,1980,1976,,850000,38891000,7770107,,85079,3892251,777650,,764921,34998749,6992457,PDN
SS084,,1981,1976,,1555182,78766000,15570484,,843970,44951118,8842390,,711212,33814882,6728094,PDN
SS084,,1982,1976,,2444330,129389408,25467356,,709096,40584277,7930498,,1735234,88805131,17536858,PDN
SS084,,1983,1976,,1594330,90498408,17697250,,867457,51242663,9985369,,726873,39255745,7711881,PDN
SS084,,1984,1976,,1594330,90498408,17697250,,972974,58569075,11394518,,621356,31929333,6302732,PDN
SS084,,1985,1976,,1594330,90498408,17697250,,1049070,64082756,12451696,,545260,26415652,5245554,PDN
SS084,,1986,1976,,1594330,90498408,17697250,,1104846,68295189,13257015,,489484,22203219,4440235,PDN
SS084,,1987,1976,,1594330,90498408,17697250,,1157916,72334884,14028892,,436414,18163524,3668358,PDN
SS084,,1988,1976,,1580773,90320326,17652005,,1260247,80436629,15572814,,320526,9883697,2079191,PDN
SS084,,1989,1976,,1580788,101339871,19612794,,1322641,86021601,16628976,,258147,15318270,2983818,PDN
SS084,,1990,1976,,1544672,104251406,20094744,,1371700,90040304,17393106,,172972,14211102,2701638,PDN
SS084,,1991,1976,,1544672,104251406,20094744,,1415888,93577438,18066678,,128784,10673968,2028066,PDN
SS084,,1992,1976,,1593650,107570496,20734308,,1457896,96905245,18700822,,135754,10665251,2033486,PDN
SS084,,1993,1976,,1593650,107570496,20734308,,1497803,100131602,19314814,,95847,7438894,1419494,PDN
SS084,,1994,1976,,1593650,107570496,20734308,,1520425,102055836,19679826,,73225,5514660,1054482,PDN
SS084,,1995,1976,,1762423,117016547,22583873,,1576620,106701972,20562736,,185803,10314575,2021137,PDN
SS084,,1996,1976,,1834286,126489788,24341366,,1649561,113261363,21802828,,184725,13228425,2538538,PDN
SS084,,1997,1976,,1834286,126489788,24341366,,1660798,114213450,21983476,,173488,12276338,2357890,PDN
SS084,,1998,1976,,1995108,131496956,25393143,,1669392,114923535,22118420,,325716,16573421,3274723,PDN
SS084,,1999,1976,,1884432,124033033,23954367,,1755987,118038557,22759289,,128445,5994476,1195078,PDN
SS084,,2000,1976,,1884432,124033033,23954367,,1801258,119410612,23048698,,83174,4622421,905669,PDN
SS084,,2001,1976,,1852747,121386199,23451715,,1821933,119644447,23110981,,30814,1741752,340734,PDN
SS084,,2002,1976,,1852747,121386199,23451715,,1824522,119670324,23118174,,28225,1715875,333541,PDN
SS084,,2003,1976,,1824522,119670324,23118174,,1824522,119670324,23118174,,0,0,0,PDN
SS084,,2004,1976,,1824522,119670324,23118174,,1824522,119670324,23118174,,0,0,0,PDN
SS084,,2005,1976,,1824522,119670324,23118174,,1824522,119670324,23118174,,0,0,0,PDN
SS084,,2006,1976,,1824522,119670324,23118174,,1824522,119670324,23118174,,0,0,0,PDN
SS084,,2007,1976,,1824522,119670324,23118174,,1824522,119670324,23118174,,0,0,0,PDN
SS084,,2008,1976,,1824522,119670324,23118174,,1824522,119670324,23118174,,0,0,0,PDN
SS084,,2009,1976,,1824522,121967980,23527010,,1824522,121967980,23527010,,0,0,0,PDN
SS084,,2010,1976,,1824522,121967980,23527010,,1824522,121967980,23527010,,0,0,0,PDN
SS084,,2011,1976,,1824522,121967980,23527010,,1824522,121967980,23527010,,0,0,0,PDN
SS084,,2012,1976,,1824522,121967980,23527010,,1824522,121967980,23527010,,0,0,0,PDN
SS084,,2013,1976,,1824522,121967980,23527010,,1824522,121967980,23527010,,0,0,0,PDN
SS084,,2014,1976,,1824522,121967980,23527010,,1824522,121967980,23527010,,0,0,0,PDN
SS084,,2015,1976,,1824522,121967980,23527010,,1824522,121967980,23527010,,0,0,0,PDN
SS084,,2016,1976,,1824522,121967980,23527010,,1824522,121967980,23527010,,0,0,0,PDN
SS084,,2017,1976,,1824522,121967980,23527010,,1824522,121967980,23527010,,0,0,0,PDN
SS084,,2017,1976,,1824522,121967980,23527010,,1824522,121967980,23527010,,0,0,0,PDN
SS091,,1981,1979,,14700,14700000,2630358,,0,0,0,,14700,14700000,2630358,PDP
SS091,,1982,1979,,14700,14700000,2630358,,0,0,0,,14700,14700000,2630358,PDP
SS091,,1983,1979,,8000893,6378423,9135844,,2345237,1978000,2697194,,5655656,4400423,6438650,PDP
SS091,,1984,1979,,10181955,8842965,11755436,,5573703,6444027,6720327,,4608252,2398938,5035109,PDP
SS091,,1985,1979,,15043547,22253429,19003232,,7809764,12515322,10036690,,7233783,9738107,8966542,PDP
SS091,,1986,1979,,15043547,31850248,20710851,,8961811,16998460,11986448,,6081736,14851788,8724403,PDP
SS091,,1987,1979,,15043547,32601380,20844504,,9674762,20027072,13238298,,5368785,12574308,7606206,PDP
SS091,,1988,1979,,15043547,32601380,20844504,,10377058,22168178,14321574,,4666489,10433202,6522930,PDP
SS091,,1989,1979,,15043547,32601380,20844504,,11013835,23531337,15200906,,4029712,9070043,5643598,PDP
SS091,,1990,1979,,15359632,30943061,20865515,,11756345,24916811,16189941,,3603287,6026250,4675574,PDP
SS091,,1991,1979,,15359632,30943061,20865515,,12357611,26226910,17024321,,3002021,4716151,3841194,PDP
SS091,,1992,1979,,15359632,30943061,20865515,,12860080,27254227,17709587,,2499552,3688834,3155928,PDP
SS091,,1993,1979,,15359632,31112259,20895621,,13333916,27794195,18279502,,2025716,3318064,2616119,PDP
SS091,,1994,1979,,16035100,30723056,21501836,,13844805,28316360,18883303,,2190295,2406696,2618533,PDP
SS091,,1995,1979,,16035100,30723056,21501836,,14220786,28746151,19335759,,1814314,1976905,2166077,PDP
SS091,,1996,1979,,15388043,30984354,20901273,,14538637,29247622,19742840,,849406,1736732,1158433,PDP
SS091,,1997,1979,,15388043,31092652,20920543,,14768196,29468499,20011701,,619847,1624153,908842,PDP
SS091,,1998,1979,,15709527,31728666,21355197,,15051123,29811113,20355592,,658404,1917553,999605,PDP
SS091,,1999,1979,,15709527,31728666,21355197,,15306069,30222061,20683660,,403458,1506605,671537,PDP
SS091,,2000,1979,,18073348,34249383,24167544,,15677843,30894573,21175098,,2395505,3354810,2992446,PDP
SS091,,2001,1979,,17750497,34047586,23808786,,15948358,31445860,21543707,,1802139,2601726,2265079,PDP
SS091,,2002,1979,,17750497,34047586,23808786,,16143982,31845589,21810457,,1606515,2201997,1998329,PDP
SS091,,2003,1979,,17750497,34047586,23808786,,16295850,32139088,22014549,,1454647,1908498,1794237,PDP
SS091,,2004,1979,,17750497,34160277,23828838,,16365382,32345815,22120865,,1385115,1814462,1707973,PDP
SS091,,2005,1979,,17750497,34160277,23828838,,16445219,32496137,22227450,,1305278,1664140,1601388,PDP
SS091,,2006,1979,,18122435,34723560,24301004,,16560883,32693605,22378250,,1561552,2029955,1922754,PDP
SS091,,2007,1979,,18122435,34723560,24301004,,16646873,32834136,22489246,,1475562,1889424,1811758,PDP
SS091,,2008,1979,,18187523,34735887,24368286,,16742922,32965309,22608635,,1444601,1770578,1759651,PDP
SS091,,2009,1979,,18415124,35454334,24723724,,16830745,33662254,22820470,,1584379,1792080,1903254,PDP
SS091,,2010,1979,,18436508,35512337,24755429,,16924132,33736626,22927090,,1512376,1775711,1828338,PDP
SS091,,2011,1979,,18436508,35512337,24755429,,16926156,33738372,22929424,,1510352,1773965,1826004,PDP
SS091,,2012,1979,,18436508,35512337,24755429,,16994674,33807750,23010288,,1441834,1704587,1745141,PDP
SS091,,2013,1979,,18481568,35579578,24812454,,17103100,33961729,23146112,,1378468,1617849,1666341,PDP
SS091,,2014,1979,,18555598,35835017,24931935,,17192220,34102143,23260218,,1363378,1732874,1671719,PDP
SS091,,2015,1979,,18555598,35835017,24931935,,17241657,34214582,23329660,,1313941,1620435,1602274,PDP
SS091,,2016,1979,,18569598,38292216,25383159,,17278978,34733671,23459346,,1290620,3558545,1923813,PDP
SS091,,2017,1979,,18718161,37033650,25307778,,17363724,34886182,23571230,,1354437,2147468,1736548,PDP
SS091,,2017,1979,,18718161,37033650,25307778,,17363724,34886182,23571230,,1354437,2147468,1736548,PDP
SS092,,1989,1988,,3508869,12203846,5680372,,0,0,0,,3508869,12203846,5680372,PDN
SS092,,1990,1988,,3508869,12203846,5680372,,95188,198572,130521,,3413681,12005274,5549851,PDN
SS092,,1991,1988,,1523843,15531934,4287532,,460215,1077497,651940,,1063628,14454437,3635592,PDN
SS092,,1992,1988,,1660479,15531934,4424168,,777697,2189472,1167283,,882782,13342462,3256885,PDN
SS092,,1993,1988,,1660479,15808707,4473416,,1029437,2562268,1485357,,631042,13246439,2988059,PDN
SS092,,1994,1988,,1660684,15808977,4473669,,1207182,2809124,1707026,,453502,12999853,2766643,PDN
SS092,,1995,1988,,1670522,15921925,4503605,,1288467,2972962,1817464,,382055,12948963,2686141,PDN
SS092,,1996,1988,,1698587,14942807,4357449,,1323386,3120272,1878595,,375201,11822535,2478854,PDN
SS092,,1997,1988,,1698587,14942807,4357449,,1384428,3811633,2062655,,314159,11131174,2294794,PDN
SS092,,1998,1988,,1698587,14942807,4357449,,1539097,4968617,2423193,,159490,9974190,1934256,PDN
SS092,,1999,1988,,1907259,15498665,4665029,,1685520,5674029,2695134,,221739,9824636,1969895,PDN
SS092,,2000,1988,,1994132,15908708,4824863,,1750754,5883480,2797637,,243378,10025228,2027226,PDN
SS092,,2001,1988,,1939698,14730893,4560853,,1755029,6104273,2841199,,184669,8626620,1719654,PDN
SS092,,2002,1988,,1939698,14730893,4560853,,1755062,6146200,2848692,,184636,8584693,1712161,PDN
SS092,,2003,1988,,1939698,14730893,4560853,,1755353,6174057,2853940,,184345,8556836,1706913,PDN
SS092,,2004,1988,,1890781,8893380,3473233,,1755353,6178553,2854740,,135428,2714827,618493,PDN
SS092,,2005,1988,,2184662,9181991,3818468,,1784847,6205717,2889067,,399815,2976274,929401,PDN
SS092,,2006,1988,,2175449,9170922,3807286,,1968146,6587220,3140249,,207303,2583702,667037,PDN
SS092,,2007,1988,,2177657,9192663,3813362,,2034572,6693647,3225612,,143085,2499016,587750,PDN
SS092,,2008,1988,,2177657,9192663,3813362,,2040101,6694164,3231233,,137556,2498499,582129,PDN
SS092,,2009,1988,,2040101,6785771,3247534,,2040101,6785771,3247534,,0,0,0,PDN
SS092,,2010,1988,,2040101,6785771,3247534,,2040101,6785771,3247534,,0,0,0,PDN
SS092,,2011,1988,,2040101,6785771,3247534,,2040101,6785771,3247534,,0,0,0,PDN
SS092,,2012,1988,,2040101,6785771,3247534,,2040101,6785771,3247534,,0,0,0,PDN
SS092,,2013,1988,,2040101,6785771,3247534,,2040101,6785771,3247534,,0,0,0,PDN
SS092,,2014,1988,,2040101,6785771,3247534,,2040101,6785771,3247534,,0,0,0,PDN
SS092,,2015,1988,,2040101,6785771,3247534,,2040101,6785771,3247534,,0,0,0,PDN
SS092,,2016,1988,,2040101,6785771,3247535,,2040101,6785771,3247535,,0,0,0,PDN
SS092,,2017,1988,,2040087,6773717,3245376,,2040087,6773717,3245376,,0,0,0,PDN
SS092,,2017,1988,,2040087,6773717,3245376,,2040087,6773717,3245376,,0,0,0,PDN
SS097,,1985,1984,,430285,19225132,3851127,,43151,1927996,386211,,387134,17297136,3464916,PDN
SS097,,1986,1984,,605305,28661207,5705164,,248112,12919037,2546873,,357193,15742170,3158291,PDN
SS097,,1987,1984,,550893,31040711,6074151,,370366,22214024,4323039,,180527,8826687,1751112,PDN
SS097,,1988,1984,,698118,51846807,9923528,,447433,32039402,6148394,,250685,19807405,3775134,PDN
SS097,,1989,1984,,698118,51846807,9923528,,460957,34174513,6541831,,237161,17672294,3381697,PDN
SS097,,1990,1984,,462180,34234349,6553701,,462180,34234349,6553701,,0,0,0,PDN
SS097,,1991,1984,,462180,34237301,6554226,,462180,34237301,6554226,,0,0,0,PDN
SS097,,1992,1984,,462180,34237301,6554226,,462180,34237301,6554226,,0,0,0,PDN
SS097,,1993,1984,,462180,34237301,6554226,,462180,34237301,6554226,,0,0,0,PDN
SS097,,1994,1984,,462180,34237301,6554226,,462180,34237301,6554226,,0,0,0,PDN
SS097,,1995,1984,,462180,34237301,6554226,,462180,34237301,6554226,,0,0,0,PDN
SS097,,1996,1984,,462180,34237301,6554226,,462180,34237301,6554226,,0,0,0,PDN
SS097,,1997,1984,,462180,34237301,6554226,,462180,34237301,6554226,,0,0,0,PDN
SS097,,1998,1984,,462180,34237301,6554226,,462180,34237301,6554226,,0,0,0,PDN
SS097,,1999,1984,,462180,34237301,6554226,,462180,34237301,6554226,,0,0,0,PDN
SS097,,2000,1984,,462180,34237301,6554226,,462180,34237301,6554226,,0,0,0,PDN
SS097,,2001,1984,,462180,34237301,6554226,,462180,34237301,6554226,,0,0,0,PDN
SS097,,2002,1984,,462180,34237301,6554226,,462180,34237301,6554226,,0,0,0,PDN
SS097,,2003,1984,,462180,34237301,6554226,,462180,34237301,6554226,,0,0,0,PDN
SS097,,2004,1984,,462180,34237301,6554226,,462180,34237301,6554226,,0,0,0,PDN
SS097,,2005,1984,,495502,35381241,6791096,,463612,34327078,6571633,,31890,1054163,219463,PDN
SS097,,2006,1984,,495502,35381241,6791096,,487575,35275006,6764266,,7927,106235,26830,PDN
SS097,,2007,1984,,549800,39345107,7550709,,509973,37530040,7187916,,39827,1815067,362793,PDN
SS097,,2008,1984,,611506,41978663,8081019,,555071,39711818,7621231,,56435,2266845,459788,PDN
SS097,,2009,1984,,614871,43528836,8360215,,577869,41657758,7990281,,37002,1871078,369934,PDN
SS097,,2010,1984,,614871,43528836,8360215,,613312,41919467,8072292,,1559,1609369,287923,PDN
SS097,,2011,1984,,614871,43528836,8360215,,614053,42995096,8264426,,818,533740,95790,PDN
SS097,,2012,1984,,614871,43528836,8360215,,614307,43079881,8279766,,564,448955,80449,PDN
SS097,,2013,1984,,614871,43528836,8360215,,614347,43121942,8287290,,524,406894,72925,PDN
SS097,,2014,1984,,614871,43528836,8360215,,614360,43127594,8288309,,511,401242,71906,PDN
SS097,,2015,1984,,614360,43127594,8288309,,614360,43127594,8288309,,0,0,0,PDN
SS097,,2016,1984,,614360,43127594,8288309,,614360,43127594,8288309,,0,0,0,PDN
SS097,,2017,1984,,614360,43127594,8288309,,614360,43127594,8288309,,0,0,0,PDN
SS097,,2017,1984,,614360,43127594,8288309,,614360,43127594,8288309,,0,0,0,PDN
SS100,,1987,1987,,2196017,20089113,5770592,,3152,42700,10750,,2192865,20046413,5759842,PDP
SS100,,1988,1987,,2196017,20089113,5770592,,45428,805638,188780,,2150589,19283475,5581812,PDP
SS100,,1989,1987,,2196017,20089113,5770592,,130179,2877073,642114,,2065838,17212040,5128478,PDP
SS100,,1990,1987,,4106145,50873145,13158306,,531076,10319257,2367243,,3575069,40553888,10791063,PDP
SS100,,1991,1987,,3965558,43217612,11655525,,1021846,20907005,4741954,,2943712,22310607,6913571,PDP
SS100,,1992,1987,,3203809,58025856,13528694,,1369195,27556378,6272465,,1834614,30469478,7256229,PDP
SS100,,1993,1987,,4180519,110014812,23756108,,1945678,35775408,8311409,,2234841,74239404,15444699,PDP
SS100,,1994,1987,,4090182,109261851,23531792,,2785656,43389967,10506291,,1304526,65871884,13025501,PDP
SS100,,1995,1987,,5264227,115445769,25806179,,3239646,49773882,12096209,,2024581,65671887,13709970,PDP
SS100,,1996,1987,,4936111,68025306,17040258,,3655415,58009796,13977443,,1280696,10015510,3062815,PDP
SS100,,1997,1987,,5005908,73065883,18006955,,3969299,65040176,15542284,,1036609,8025707,2464671,PDP
SS100,,1998,1987,,5199379,82638032,19903655,,4128272,68394219,16298062,,1071107,14243813,3605593,PDP
SS100,,1999,1987,,6347411,83544201,21212927,,4345497,74897054,17672375,,2001914,8647147,3540552,PDP
SS100,,2000,1987,,6549724,89455235,22467026,,4757234,79121786,18835844,,1792490,10333449,3631182,PDP
SS100,,2001,1987,,6296423,91041099,22495907,,4922786,81031205,19341150,,1373637,10009894,3154757,PDP
SS100,,2002,1987,,6308208,91077123,22514102,,5099939,81590708,19617859,,1208269,9486415,2896243,PDP
SS100,,2003,1987,,6381418,88070064,22052248,,5172861,81794030,19726959,,1208557,6276034,2325289,PDP
SS100,,2004,1987,,5641553,91046741,21842041,,5284289,82702873,20000103,,357264,8343868,1841938,PDP
SS100,,2005,1987,,5886975,87467323,21450556,,5381577,82552891,20070704,,505398,4914432,1379852,PDP
SS100,,2006,1987,,5957942,89504089,21883936,,5537533,83725263,20435267,,420409,5778826,1448669,PDP
SS100,,2007,1987,,5957942,89504089,21883936,,5654245,85224442,20818736,,303697,4279647,1065200,PDP
SS100,,2008,1987,,5961050,90141568,22000475,,5732947,86097541,21052794,,228103,4044027,947681,PDP
SS100,,2009,1987,,6392906,91721879,22713523,,5823359,87829614,21451403,,569547,3892265,1262120,PDP
SS100,,2010,1987,,6152033,88850929,21961806,,5920224,88702336,21703557,,231809,148593,258249,PDP
SS100,,2011,1987,,6152033,88850929,21961806,,5996254,88776304,21792748,,155779,74625,169057,PDP
SS100,,2012,1987,,6152033,88850929,21961806,,6052644,88803660,21854006,,99389,47269,107800,PDP
SS100,,2013,1987,,6152033,88850929,21961806,,6094085,88848747,21903470,,57948,2182,58336,PDP
SS100,,2014,1987,,6293627,89074647,22143207,,6144519,88892058,21961610,,149108,182589,181597,PDP
SS100,,2015,1987,,6302028,89004836,22139187,,6186821,88919961,22008877,,115207,84875,130309,PDP
SS100,,2016,1987,,6364320,89077128,22214342,,6252464,88967173,22082921,,111856,109955,131421,PDP
SS100,,2017,1987,,6518347,89087293,22370178,,6324940,89007032,22162489,,193407,80261,207688,PDP
SS100,,2017,1987,,6518347,89087293,22370178,,6324940,89007032,22162489,,193407,80261,207688,PDP
SS101,,2005,2004,,60933,4996470,949985,,40164,2305418,450381,,20769,2691052,499604,PDN
SS101,,2006,2004,,60933,4996470,949985,,47388,3463378,663647,,13545,1533092,286338,PDN
SS101,,2007,2004,,60933,4996470,949985,,49310,3732215,713405,,11623,1264255,236580,PDN
SS101,,2008,2004,,60933,4996470,949985,,50600,3769290,721292,,10333,1227180,228693,PDN
SS101,,2009,2004,,53444,3979733,761581,,52076,3873714,741349,,1368,106019,20233,PDN
SS101,,2010,2004,,53444,3979733,761581,,53206,3920756,750849,,238,58977,10732,PDN
SS101,,2011,2004,,53444,3979733,761581,,53218,3950189,756098,,226,29544,5483,PDN
SS101,,2012,2004,,53444,3979733,761581,,53218,3952433,756498,,226,27300,5084,PDN
SS101,,2013,2004,,53218,3952433,756498,,53218,3952433,756498,,0,0,0,PDN
SS101,,2014,2004,,53218,3952433,756498,,53218,3952433,756498,,0,0,0,PDN
SS101,,2015,2004,,53218,3952433,756498,,53218,3952433,756498,,0,0,0,PDN
SS101,,2016,2004,,53218,3952433,756498,,53218,3952433,756498,,0,0,0,PDN
SS101,,2017,2004,,53218,3952433,756498,,53218,3952433,756498,,0,0,0,PDN
SS101,,2017,2004,,53218,3952433,756498,,53218,3952433,756498,,0,0,0,PDN
SS103,,1999,1999,,154377,11578262,2214566,,60381,1364712,303212,,93996,10213550,1911354,PDN
SS103,,2000,1999,,515575,11578262,2575764,,245767,5519267,1227843,,269808,6058995,1347921,PDN
SS103,,2001,1999,,359916,8082624,1798105,,308613,6740860,1508054,,51303,1341764,290051,PDN
SS103,,2002,1999,,359916,8082624,1798105,,317730,7038923,1570207,,42186,1043701,227898,PDN
SS103,,2003,1999,,359916,8082624,1798105,,327679,7306842,1627829,,32237,775782,170276,PDN
SS103,,2004,1999,,359916,8082624,1798105,,334245,7534357,1674878,,25671,548267,123227,PDN
SS103,,2005,1999,,359916,8082624,1798105,,336643,7632240,1694693,,23273,450384,103412,PDN
SS103,,2006,1999,,359916,8082624,1798105,,336643,7632240,1694693,,23273,450384,103412,PDN
SS103,,2007,1999,,336643,7632240,1694693,,336643,7632240,1694693,,0,0,0,PDN
SS103,,2008,1999,,336643,7632240,1694693,,336643,7632240,1694693,,0,0,0,PDN
SS103,,2009,1999,,336643,7632240,1694693,,336643,7632240,1694693,,0,0,0,PDN
SS103,,2010,1999,,336643,7632240,1694693,,336643,7632240,1694693,,0,0,0,PDN
SS103,,2011,1999,,336643,7632240,1694693,,336643,7632240,1694693,,0,0,0,PDN
SS103,,2012,1999,,336643,7632240,1694693,,336643,7632240,1694693,,0,0,0,PDN
SS103,,2013,1999,,336643,7632240,1694693,,336643,7632240,1694693,,0,0,0,PDN
SS103,,2014,1999,,336643,7632240,1694693,,336643,7632240,1694693,,0,0,0,PDN
SS103,,2015,1999,,336643,7632240,1694693,,336643,7632240,1694693,,0,0,0,PDN
SS103,,2016,1999,,336643,7632240,1694693,,336643,7632240,1694693,,0,0,0,PDN
SS103,,2017,1999,,336643,7632240,1694693,,336643,7632240,1694693,,0,0,0,PDN
SS103,,2017,1999,,336643,7632240,1694693,,336643,7632240,1694693,,0,0,0,PDN
SS105,,1991,1968,,980418,10889080,2917977,,0,0,0,,980418,10889080,2917977,PDP
SS105,,1992,1968,,980418,10889080,2917977,,0,0,0,,980418,10889080,2917977,PDP
SS105,,1993,1968,,980418,10889080,2917977,,9300,76314,22879,,971118,10812766,2895098,PDP
SS105,,1994,1968,,1161198,10889274,3098791,,82924,1262173,307510,,1078274,9627101,2791281,PDP
SS105,,1995,1968,,1094056,8805578,2660885,,100607,1467919,361803,,993449,7337659,2299082,PDP
SS105,,1996,1968,,1029282,8647136,2567918,,122821,1641044,414822,,906461,7006092,2153096,PDP
SS105,,1997,1968,,3347218,41114577,10662979,,308043,4082960,1034548,,3039175,37031617,9628431,PDP
SS105,,1998,1968,,3347218,41114577,10662979,,876448,12758770,3146692,,2470770,28355807,7516287,PDP
SS105,,1999,1968,,3583216,53616169,13123460,,1334446,21642179,5185368,,2248770,31973990,7938092,PDP
SS105,,2000,1968,,4815833,62825182,15994691,,1935805,33634751,7920636,,2880028,29190431,8074055,PDP
SS105,,2001,1968,,5305301,68836744,17553832,,2527527,41377700,9890107,,2777774,27459044,7663725,PDP
SS105,,2002,1968,,5938502,74539717,19201797,,2983341,48119300,11545494,,2955161,26420417,7656303,PDP
SS105,,2003,1968,,6023702,78434289,19979981,,3790315,59589042,14393347,,2233387,18845247,5586634,PDP
SS105,,2004,1968,,5388612,70066755,17856006,,4136691,63697946,15470845,,1251921,6368809,2385161,PDP
SS105,,2005,1968,,5426784,71428937,18136559,,4310669,66091338,16070694,,1116115,5337599,2065865,PDP
SS105,,2006,1968,,5368910,70490614,17911724,,4442367,67392873,16433981,,926543,3097741,1477743,PDP
SS105,,2007,1968,,5522991,71520281,18249020,,4577672,68537395,16772938,,945319,2982886,1476082,PDP
SS105,,2008,1968,,5522991,71520596,18249076,,4638507,69068163,16928216,,884484,2452433,1320860,PDP
SS105,,2009,1968,,5813202,75044864,19166382,,4825958,71734038,17590023,,987244,3310826,1576359,PDP
SS105,,2010,1968,,5813202,75044864,19166382,,4974602,72999067,17963761,,838600,2045797,1202622,PDP
SS105,,2011,1968,,5813202,75044864,19166382,,5016721,73518383,18098284,,796481,1526481,1068098,PDP
SS105,,2012,1968,,6167619,78440542,20125010,,5094375,74149951,18288316,,1073244,4290591,1836694,PDP
SS105,,2013,1968,,6167619,78440542,20125010,,5179316,74965924,18518448,,988303,3474618,1606563,PDP
SS105,,2014,1968,,6167619,78440542,20125010,,5252455,75866723,18751871,,915164,2573819,1373139,PDP
SS105,,2015,1968,,6167619,78440542,20125010,,5272311,76044493,18803360,,895308,2396049,1321652,PDP
SS105,,2016,1968,,6167619,78440542,20125010,,5284276,76073803,18820540,,883343,2366739,1304472,PDP
SS105,,2017,1968,,6473906,78389505,20422216,,5447234,76354808,19033499,,1026672,2034697,1388718,PDP
SS105,,2017,1968,,6473906,78389505,20422216,,5447234,76354808,19033499,,1026672,2034697,1388718,PDP
SS106,,2006,2006,,224110,7308226,1524506,,891,26118,5538,,223219,7282108,1518968,PDN
SS106,,2007,2006,,224110,7308226,1524506,,44452,1463144,304798,,179658,5845082,1219708,PDN
SS106,,2008,2006,,224110,7308226,1524506,,60632,1974622,411988,,163478,5333604,1112518,PDN
SS106,,2009,2006,,109336,2275208,514177,,68734,2226486,464906,,40602,48722,49271,PDN
SS106,,2010,2006,,109336,2275208,514177,,97050,2260211,499223,,12286,14997,14955,PDN
SS106,,2011,2006,,105796,2273617,510354,,105796,2273617,510354,,0,0,0,PDN
SS106,,2012,2006,,105796,2273617,510354,,105796,2273617,510354,,0,0,0,PDN
SS106,,2013,2006,,105796,2273617,510354,,105796,2273617,510354,,0,0,0,PDN
SS106,,2014,2006,,105796,2273617,510354,,105796,2273617,510354,,0,0,0,PDN
SS106,,2015,2006,,105796,2273617,510354,,105796,2273617,510354,,0,0,0,PDN
SS106,,2016,2006,,105796,2273617,510354,,105796,2273617,510354,,0,0,0,PDN
SS106,,2017,2006,,105796,2273617,510354,,105796,2273617,510354,,0,0,0,PDN
SS106,,2017,2006,,105796,2273617,510354,,105796,2273617,510354,,0,0,0,PDN
SS107,,1975,1957,,55198259,62809399,66374309,,45392181,48162798,53962074,,9806078,14646601,12412235,PDP
SS107,,1976,1957,,55198259,62809399,66374309,,47358397,50234937,56296998,,7839862,12574462,10077311,PDP
SS107,,1977,1957,,56712607,67910539,68796333,,49018266,54456865,58708100,,7694341,13453674,10088233,PDP
SS107,,1978,1957,,58610761,71294223,71296566,,50207098,56923748,60335879,,8403663,14370475,10960687,PDP
SS107,,1979,1957,,58963411,75339975,72369101,,51214050,58959927,61705140,,7749361,16380048,10663961,PDP
SS107,,1980,1957,,58968211,75478091,72398476,,51974376,60955438,62820539,,6993835,14522653,9577937,PDP
SS107,,1981,1957,,61141782,77679842,74963818,,54884111,64270803,66320197,,6257671,13409039,8643621,PDP
SS107,,1982,1957,,61160593,77752020,74995472,,55564887,65774523,67268539,,5595706,11977497,7726933,PDP
SS107,,1983,1957,,62573808,80544561,76905580,,56110032,66691612,67976867,,6463776,13852949,8928713,PDP
SS107,,1984,1957,,64107419,83246943,78920042,,56509888,67532509,68526349,,7597531,15714434,10393693,PDP
SS107,,1985,1957,,65202889,84128229,80172325,,55985614,68359651,68149253,,9217275,15768578,12023072,PDP
SS107,,1986,1957,,65292981,84464261,80322209,,56228208,68976498,68501606,,9064773,15487763,11820603,PDP
SS107,,1987,1957,,65898103,85885967,81180304,,56452141,69515432,68821435,,9445962,16370535,12358869,PDP
SS107,,1988,1957,,65487362,83663295,80374069,,56781045,70967105,69408644,,8706317,12696190,10965425,PDP
SS107,,1989,1957,,67538119,89708856,83500549,,57148887,73643209,70252661,,10389232,16065647,13247888,PDP
SS107,,1990,1957,,60878211,88429764,76613044,,57713903,77100273,71432813,,3164308,11329491,5180231,PDP
SS107,,1991,1957,,61691033,91838427,78032390,,58164449,79986567,72396934,,3526584,11851860,5635456,PDP
SS107,,1992,1957,,61691033,91838427,78032390,,58447000,81555482,72958652,,3244033,10282945,5073738,PDP
SS107,,1993,1957,,61781292,92659588,78268763,,58686940,83137856,73480153,,3094352,9521732,4788610,PDP
SS107,,1994,1957,,61781281,92659572,78268749,,59113960,84584767,74164630,,2667321,8074805,4104119,PDP
SS107,,1995,1957,,63761501,89439765,79676050,,59615982,85256962,74786260,,4145519,4182803,4889790,PDP
SS107,,1996,1957,,64272580,101040753,82251362,,60127431,88523089,75878870,,4145149,12517664,6372492,PDP
SS107,,1997,1957,,64126549,101516372,82189960,,60470756,90051168,76494096,,3655793,11465204,5695864,PDP
SS107,,1998,1957,,64126549,101516372,82189960,,60686717,90710729,76827416,,3439832,10805643,5362544,PDP
SS107,,1999,1957,,64060751,99002860,81676918,,60866430,91336742,77118519,,3194321,7666118,4558399,PDP
SS107,,2000,1957,,61335317,96979927,78591532,,60970514,93226457,77558852,,364803,3753470,1032680,PDP
SS107,,2001,1957,,61621206,97538437,78976800,,61047938,93680325,77717035,,573268,3858112,1259765,PDP
SS107,,2002,1957,,61621206,97538437,78976800,,61091205,94709215,77943378,,530001,2829222,1033422,PDP
SS107,,2003,1957,,61438091,98778090,79014264,,61240062,96177041,78353414,,198029,2601049,660850,PDP
SS107,,2004,1957,,61608730,100348133,79464270,,61337796,97238505,78640021,,270934,3109628,824249,PDP
SS107,,2005,1957,,61758964,106459852,80701998,,61446244,99451912,79142314,,312720,7007940,1559684,PDP
SS107,,2006,1957,,61766060,106878533,80783593,,61561633,102462635,79793419,,204427,4415898,990174,PDP
SS107,,2007,1957,,61933354,105336570,80676516,,61627518,103266257,80002297,,305836,2070313,674219,PDP
SS107,,2008,1957,,61915513,106165605,80806190,,61675482,104498044,80269440,,240031,1667561,536750,PDP
SS107,,2009,1957,,61868112,107770400,81044341,,61715326,106800096,80718903,,152786,970304,325438,PDP
SS107,,2010,1957,,61974622,107861940,81167139,,61766962,107312389,80861695,,207660,549551,305445,PDP
SS107,,2011,1957,,61974622,107861940,81167139,,61854919,107572076,80995859,,119703,289864,171280,PDP
SS107,,2012,1957,,61974622,107861940,81167139,,61931808,107702394,81095937,,42814,159546,71203,PDP
SS107,,2013,1957,,62162452,108018218,81382777,,61993275,107789173,81172844,,169177,229045,209932,PDP
SS107,,2014,1957,,62162452,108018218,81382777,,62066983,107888628,81264249,,95469,129590,118528,PDP
SS107,,2015,1957,,62303809,108190076,81554714,,62136900,107974876,81349513,,166909,215200,205200,PDP
SS107,,2016,1957,,62303809,108190076,81554714,,62196257,108055854,81423279,,107552,134222,131435,PDP
SS107,,2017,1957,,62367946,108328893,81643551,,62247532,108141027,81489709,,120414,187866,153842,PDP
SS107,,2017,1957,,62367946,108328893,81643551,,62247532,108141027,81489709,,120414,187866,153842,PDP
SS110,,2004,2003,,14214,9326847,1673795,,1965,675686,122194,,12249,8651161,1551601,PDP
SS110,,2005,2003,,14214,9310642,1670912,,4470,2364129,425134,,9744,6946513,1245778,PDP
SS110,,2006,2003,,13990,9872431,1770650,,6464,4001265,718433,,7526,5871166,1052217,PDP
SS110,,2007,2003,,14496,10802146,1936586,,7023,5418028,971085,,7473,5384118,965501,PDP
SS110,,2008,2003,,14506,10806950,1937451,,7199,6537796,1170508,,7307,4269154,766943,PDP
SS110,,2009,2003,,14646,11794056,2113234,,7252,7281632,1302917,,7394,4512424,810316,PDP
SS110,,2010,2003,,131032,13032231,2449936,,7275,7778603,1391369,,123757,5253628,1058567,PDP
SS110,,2011,2003,,131032,13032231,2449936,,14478,8423650,1513349,,116554,4608581,936586,PDP
SS110,,2012,2003,,131032,13032231,2449936,,69783,8531048,1587763,,61249,4501183,862171,PDP
SS110,,2013,2003,,366830,11125831,2346516,,126756,8557854,1649506,,240074,2567977,697009,PDP
SS110,,2014,2003,,366830,11125831,2346516,,214262,8585858,1741995,,152568,2539973,604520,PDP
SS110,,2015,2003,,366830,11125831,2346516,,279288,8602318,1809950,,87542,2523513,536566,PDP
SS110,,2016,2003,,375851,11892575,2491968,,284698,8960637,1879117,,91153,2931938,612850,PDP
SS110,,2017,2003,,385796,12737942,2652334,,290410,9451980,1972257,,95386,3285962,680077,PDP
SS110,,2017,2003,,385796,12737942,2652334,,290410,9451980,1972257,,95386,3285962,680077,PDP
SS111,,1987,1985,,358109,21892228,4253523,,0,0,0,,358109,21892228,4253523,PDP
SS111,,1990,1985,,224595,26556562,4949962,,4136,144816,29904,,220459,26411746,4920058,PDP
SS111,,1991,1985,,302079,26556562,5027446,,46226,2017175,405154,,255853,24539387,4622292,PDP
SS111,,1992,1985,,302079,26556562,5027446,,78593,3352255,675080,,223486,23204307,4352366,PDP
SS111,,1993,1985,,387251,30315895,5781538,,136998,5882310,1183672,,250253,24433585,4597866,PDP
SS111,,1994,1985,,838997,48584267,9483884,,270636,13015194,2586507,,568361,35569073,6897377,PDP
SS111,,1995,1985,,838997,48584267,9483884,,322741,15954569,3161632,,516256,32629698,6322252,PDP
SS111,,1996,1985,,541011,33700291,6537504,,338587,17069065,3375787,,202424,16631226,3161717,PDP
SS111,,1997,1985,,440115,28849233,5573430,,344362,17527263,3463092,,95753,11321970,2110338,PDP
SS111,,1998,1985,,706843,42473443,8264395,,352093,17949939,3546032,,354750,24523504,4718363,PDP
SS111,,1999,1985,,706843,42473443,8264395,,392720,20373331,4017868,,314123,22100112,4246527,PDP
SS111,,2000,1985,,706843,42473443,8264395,,408524,22297265,4376009,,298319,20176178,3888386,PDP
SS111,,2001,1985,,416513,23856270,4661401,,415560,23582700,4611770,,953,273570,49631,PDP
SS111,,2002,1985,,416513,23856270,4661401,,416513,23856270,4661401,,0,0,0,PDP
SS111,,2003,1985,,416513,23856270,4661401,,416513,23856270,4661401,,0,0,0,PDP
SS111,,2004,1985,,416513,23856270,4661401,,416513,23856270,4661401,,0,0,0,PDP
SS111,,2005,1985,,540034,34075741,6603333,,424497,24507633,4785286,,115537,9568108,1818047,PDP
SS111,,2006,1985,,886899,44409761,8788992,,552748,33119327,6445867,,334151,11290434,2343125,PDP
SS111,,2007,1985,,925284,46966207,9282260,,658411,41007810,7955174,,266873,5958397,1327086,PDP
SS111,,2008,1985,,966447,52297271,10272011,,696482,44646405,8640682,,269965,7650866,1631329,PDP
SS111,,2009,1985,,1035267,58317735,11412090,,734940,47695819,9221741,,300327,10621916,2190347,PDP
SS111,,2010,1985,,1125404,75360088,14534674,,781352,51462460,9938374,,344052,23897628,4596298,PDP
SS111,,2011,1985,,1124978,75329832,14528864,,855502,56437184,10897707,,269476,18892648,3631157,PDP
SS111,,2012,1985,,1124978,75329832,14528864,,920598,61207359,11811589,,204380,14122473,2717274,PDP
SS111,,2013,1985,,1124978,75329832,14528864,,954332,65146867,12546303,,170646,10182965,1982561,PDP
SS111,,2014,1985,,1114574,76556289,14736691,,985088,68643275,13199194,,129486,7913014,1537496,PDP
SS111,,2015,1985,,1114574,76556289,14736691,,1015911,70975317,13644971,,98663,5580972,1091719,PDP
SS111,,2016,1985,,1164935,76711115,14814601,,1077534,73299233,14120102,,87401,3411882,694499,PDP
SS111,,2017,1985,,1115146,79339698,15232531,,1086587,74806739,14397395,,28559,4532959,835135,PDP
SS111,,2017,1985,,1115146,79339698,15232531,,1086587,74806739,14397395,,28559,4532959,835135,PDP
SS113,,1975,1955,,65000000,134940000,89010676,,35618444,74507574,48876019,,29381556,60432426,40134657,PDP
SS113,,1976,1955,,65000000,134940000,89010676,,41301350,89188204,57171137,,23698650,45751796,31839539,PDP
SS113,,1977,1955,,65000000,134940000,89010676,,45237703,96082842,62334294,,19762297,38857158,26676382,PDP
SS113,,1978,1955,,65000000,134940000,89010676,,48386586,103324689,66771762,,16613414,31615311,22238914,PDP
SS113,,1979,1955,,65000000,134940000,89010676,,51113969,114250952,71443320,,13886031,20689048,17567356,PDP
SS113,,1980,1955,,67475200,277591688,116868739,,54554515,151764280,81558835,,12920685,125827408,35309904,PDP
SS113,,1981,1955,,69954308,280291707,119828277,,56972176,180522352,89093591,,12982132,99769355,30734686,PDP
SS113,,1982,1955,,71975022,283857257,122483431,,59766969,209312112,97011117,,12208053,74545145,25472314,PDP
SS113,,1983,1955,,96068483,354732239,159188098,,62759292,230898358,103844409,,33309191,123833881,55343689,PDP
SS113,,1984,1955,,101482769,366353903,166670296,,64582451,247761282,108668088,,36900318,118592621,58002208,PDP
SS113,,1985,1955,,115442784,408522572,188133633,,68220129,261302683,114715268,,47222655,147219889,73418365,PDP
SS113,,1986,1955,,134816783,494914067,222879784,,72401162,274228597,121196286,,62415621,220685470,101683498,PDP
SS113,,1987,1955,,115791251,479664022,201140721,,76468611,289345693,127953610,,39322640,190318329,73187111,PDP
SS113,,1988,1955,,122992212,521747150,215829783,,80030658,301957546,133759759,,42961554,219789604,82070024,PDP
SS113,,1989,1955,,107973071,404268447,179906958,,83112970,312345446,138690451,,24860101,91923001,41216507,PDP
SS113,,1990,1955,,110615553,422795165,185846009,,86050614,325187226,143913110,,24564939,97607939,41932899,PDP
SS113,,1991,1955,,111987348,436137391,189591866,,88919935,338092343,149078715,,23067413,98045048,40513151,PDP
SS113,,1992,1955,,110652314,429667116,187105537,,91911629,348630549,153945535,,18740685,81036567,33160002,PDP
SS113,,1993,1955,,112790989,430427621,189379534,,95399883,361974285,159808119,,17391106,68453336,29571415,PDP
SS113,,1994,1955,,114898277,434896378,192281974,,99102546,377013835,166186858,,15795731,57882543,26095116,PDP
SS113,,1995,1955,,114451641,448304138,194221061,,102432634,393312262,172417022,,12019007,54991876,21804039,PDP
SS113,,1996,1955,,115160317,457864358,196630843,,104999666,408451959,177677951,,10160651,49412399,18952892,PDP
SS113,,1997,1955,,114871399,459704332,196669323,,107090375,420753116,181957477,,7781024,38951216,14711846,PDP
SS113,,1998,1955,,115258959,464129422,197844265,,108548839,428038366,184712249,,6710120,36091056,13132016,PDP
SS113,,1999,1955,,113947297,462934093,196319911,,109918847,435012848,187323268,,4028450,27921245,8996643,PDP
SS113,,2000,1955,,115854982,461742122,198015502,,110996113,438650210,189047752,,4858869,23091912,8967750,PDP
SS113,,2001,1955,,116590745,463314603,199031066,,111874684,441421466,190419429,,4716061,21893137,8611637,PDP
SS113,,2002,1955,,116868428,464763076,199566485,,112866297,445955213,192217758,,4002131,18807863,7348727,PDP
SS113,,2003,1955,,117713704,473459644,201959193,,113872646,452086377,194315062,,3841058,21373267,7644131,PDP
SS113,,2004,1955,,117828059,468016397,201104998,,114897939,458198640,196427946,,2930120,9817757,4677052,PDP
SS113,,2005,1955,,117784473,469995169,201413507,,115389456,460735873,197370928,,2395017,9259296,4042579,PDP
SS113,,2006,1955,,118261743,469529822,201807975,,115818082,462883016,198181608,,2443661,6646806,3626367,PDP
SS113,,2007,1955,,119876561,473620735,204150714,,116522140,464900792,199244701,,3354421,8719943,4906013,PDP
SS113,,2008,1955,,120259117,475325158,204836548,,117332044,466629044,200362123,,2927073,8696114,4474425,PDP
SS113,,2009,1955,,119863822,483297326,205859789,,117946733,476838127,202793376,,1917089,6459199,3066414,PDP
SS113,,2010,1955,,124356483,490483737,211631171,,118608924,480012470,204020397,,5747559,10471267,7610773,PDP
SS113,,2011,1955,,125170226,500061553,214149151,,120395425,486585504,206976477,,4774801,13476049,7172673,PDP
SS113,,2012,1955,,128445760,504318308,218182115,,122382190,491475149,209833284,,6063570,12843159,8348831,PDP
SS113,,2013,1955,,128445753,504299164,218178702,,124160604,494742051,212192998,,4285149,9557113,5985703,PDP
SS113,,2014,1955,,129575831,506258323,219657385,,125728997,497201870,214199084,,3846834,9056453,5458303,PDP
SS113,,2015,1955,,129855722,506170452,219921639,,126758852,499241067,215591780,,3096870,6929385,4329855,PDP
SS113,,2016,1955,,129778728,504595503,219564405,,127553066,500233281,216562547,,2225662,4362222,3001859,PDP
SS113,,2017,1955,,130151734,506172714,220218056,,128171770,500897556,217299450,,1979964,5275158,2918605,PDP
SS113,,2017,1955,,130151734,506172714,220218056,,128171770,500897556,217299450,,1979964,5275158,2918605,PDP
SS113A,,1981,1972,,2800,2800000,501021,,0,469178,83484,,2800,2330822,417537,PDP
SS113A,,1982,1972,,3445,18181478,3238583,,343,3208544,571258,,3102,14972934,2667325,PDP
SS113A,,1983,1972,,356936,62088513,11404714,,2749,6728989,1200078,,354187,55359524,10204636,PDP
SS113A,,1984,1972,,417566,109896791,19972155,,45976,30634984,5497041,,371590,79261807,14475114,PDP
SS113A,,1985,1972,,833021,221767587,40293446,,114527,66574053,11960444,,718494,155193534,28333002,PDP
SS113A,,1986,1972,,904120,236239126,42939552,,176149,115607280,20746839,,727971,120631846,22192713,PDP
SS113A,,1987,1972,,668254,288696371,52037715,,222157,160544471,28788789,,446097,128151900,23248926,PDP
SS113A,,1988,1972,,574212,336768632,60497456,,213944,191944465,34367763,,360268,144824167,26129693,PDP
SS113A,,1989,1972,,545820,422464938,75717517,,232190,227302282,40677436,,313630,195162656,35040081,PDP
SS113A,,1990,1972,,376757,408017366,72977712,,244222,246990279,44192670,,132535,161027087,28785042,PDP
SS113A,,1991,1972,,378256,415395160,74291986,,252344,259470573,46421485,,125912,155924587,27870501,PDP
SS113A,,1992,1972,,344266,379986958,67957604,,262847,278232124,49770342,,81419,101754834,18187262,PDP
SS113A,,1993,1972,,327678,389983505,69719761,,273867,300051721,53663853,,53811,89931784,16055908,PDP
SS113A,,1994,1972,,325686,389742266,69674844,,281264,319219236,57081840,,44422,70523030,12593004,PDP
SS113A,,1995,1972,,323677,393731824,70382720,,286880,335758916,60030459,,36797,57972908,10352261,PDP
SS113A,,1996,1972,,317209,368288662,65848999,,289876,341739026,61097532,,27333,26549636,4751467,PDP
SS113A,,1997,1972,,313426,359401380,64263849,,291947,345196527,61714817,,21479,14204853,2549032,PDP
SS113A,,1998,1972,,314073,359401380,64264496,,293670,346594578,61965303,,20403,12806802,2299193,PDP
SS113A,,1999,1972,,302416,356233997,63689248,,297202,354865770,63440577,,5214,1368227,248671,PDP
SS113A,,2000,1972,,302416,356233997,63689248,,298420,355066880,63477580,,3996,1167117,211668,PDP
SS113A,,2001,1972,,345775,369162751,66033097,,342277,368059641,65833316,,3498,1103110,199781,PDP
SS113A,,2002,1972,,373076,371396459,66457855,,342277,368059641,65833316,,30799,3336818,624539,PDP
SS113A,,2003,1972,,409212,375101044,67153170,,405714,373997934,66953389,,3498,1103110,199781,PDP
SS113A,,2004,1972,,409212,375101044,67153170,,405714,373997934,66953389,,3498,1103110,199781,PDP
SS113A,,2005,1972,,543271,380340270,68219476,,406220,374099911,66972040,,137051,6240359,1247436,PDP
SS113A,,2006,1972,,540948,379507913,68069046,,408784,374452062,67037265,,132164,5055851,1031781,PDP
SS113A,,2007,1972,,540971,379655964,68095413,,421795,375942346,67315451,,119176,3713618,779962,PDP
SS113A,,2008,1972,,540971,379695117,68102380,,421862,376246586,67369653,,119109,3448531,732727,PDP
SS113A,,2009,1972,,422667,386367524,69171337,,421875,384013691,68751713,,792,2353833,419624,PDP
SS113A,,2010,1972,,422667,386367524,69171337,,422094,384659052,68866765,,573,1708472,304572,PDP
SS113A,,2011,1972,,422667,386367524,69171337,,422154,385026626,68932230,,513,1340898,239107,PDP
SS113A,,2012,1972,,422667,386367524,69171337,,422298,385681420,69048885,,369,686104,122452,PDP
SS113A,,2013,1972,,422865,385814194,69073077,,422618,385798385,69070017,,247,15809,3060,PDP
SS113A,,2014,1972,,422961,386158701,69134473,,422915,385944067,69096236,,46,214634,38237,PDP
SS113A,,2015,1972,,423741,386464554,69189675,,423072,386139794,69131220,,669,324760,58455,PDP
SS113A,,2016,1972,,423091,386921565,69270344,,423072,386307738,69161103,,19,613827,109241,PDP
SS113A,,2017,1972,,423091,386921565,69270344,,423072,386746108,69239105,,19,175457,31239,PDP
SS113A,,2017,1972,,423091,386921565,69270344,,423072,386746108,69239105,,19,175457,31239,PDP
SS115,,1976,1974,,0,10000000,1779359,,0,0,0,,0,10000000,1779359,PDN
SS115,,1977,1974,,0,8700000,1548043,,0,1543117,274576,,0,7156883,1273467,PDN
SS115,,1978,1974,,0,8700000,1548043,,0,2735918,486818,,0,5964082,1061225,PDN
SS115,,1979,1974,,0,8700000,1548043,,0,4396500,782295,,0,4303500,765748,PDN
SS115,,1980,1974,,47200,47200000,8445777,,0,6607439,1175701,,47200,40592561,7270076,PDN
SS115,,1981,1974,,47200,47200000,8445777,,0,8473256,1507697,,47200,38726744,6938080,PDN
SS115,,1982,1974,,47200,47200000,8445777,,0,9712642,1728228,,47200,37487358,6717549,PDN
SS115,,1983,1974,,47200,47200000,8445777,,0,10581234,1882782,,47200,36618766,6562995,PDN
SS115,,1984,1974,,47200,47200000,8445777,,0,11709912,2083614,,47200,35490088,6362163,PDN
SS115,,1985,1974,,47200,47200000,8445777,,0,12780423,2274097,,47200,34419577,6171680,PDN
SS115,,1986,1974,,47200,47200000,8445777,,0,13489265,2400225,,47200,33710735,6045552,PDN
SS115,,1987,1974,,0,23645400,4207367,,0,14205623,2527691,,0,9439777,1679676,PDN
SS115,,1988,1974,,0,23645400,4207367,,0,15102635,2687302,,0,8542765,1520065,PDN
SS115,,1989,1974,,0,23645400,4207367,,0,15677339,2789562,,0,7968061,1417805,PDN
SS115,,1990,1974,,0,23645400,4207367,,0,16527615,2940857,,0,7117785,1266510,PDN
SS115,,1991,1974,,0,23645400,4207367,,0,17509670,3115600,,0,6135730,1091767,PDN
SS115,,1992,1974,,0,23645376,4207362,,0,18406831,3275237,,0,5238545,932125,PDN
SS115,,1993,1974,,0,23645376,4207362,,0,19201260,3416594,,0,4444116,790768,PDN
SS115,,1994,1974,,0,23645376,4207362,,0,20156985,3586652,,0,3488391,620710,PDN
SS115,,1995,1974,,0,23645370,4207361,,0,21045551,3744760,,0,2599819,462601,PDN
SS115,,1996,1974,,0,23396084,4163004,,0,21713098,3863541,,0,1682986,299463,PDN
SS115,,1997,1974,,0,23396084,4163004,,0,22194252,3949155,,0,1201832,213849,PDN
SS115,,1998,1974,,0,23396084,4163004,,0,22491053,4001967,,0,905031,161037,PDN
SS115,,1999,1974,,0,23396084,4163004,,0,22658962,4031844,,0,737122,131160,PDN
SS115,,2000,1974,,0,23396084,4163004,,0,22759343,4049705,,0,636741,113299,PDN
SS115,,2001,1974,,0,22794222,4055911,,0,22794222,4055911,,0,0,0,PDN
SS115,,2002,1974,,0,22794222,4055911,,0,22794222,4055911,,0,0,0,PDN
SS115,,2003,1974,,0,22794222,4055911,,0,22794222,4055911,,0,0,0,PDN
SS115,,2004,1974,,0,22794222,4055911,,0,22794222,4055911,,0,0,0,PDN
SS115,,2005,1974,,0,22794222,4055911,,0,22794222,4055911,,0,0,0,PDN
SS115,,2006,1974,,0,22794222,4055911,,0,22794222,4055911,,0,0,0,PDN
SS115,,2007,1974,,0,22794222,4055911,,0,22794222,4055911,,0,0,0,PDN
SS115,,2008,1974,,0,22794222,4055911,,0,22794222,4055911,,0,0,0,PDN
SS115,,2009,1974,,0,23243095,4135782,,0,23243095,4135782,,0,0,0,PDN
SS115,,2010,1974,,0,23243095,4135782,,0,23243095,4135782,,0,0,0,PDN
SS115,,2011,1974,,0,23243095,4135782,,0,23243095,4135782,,0,0,0,PDN
SS115,,2012,1974,,0,23243095,4135782,,0,23243095,4135782,,0,0,0,PDN
SS115,,2013,1974,,0,23243095,4135782,,0,23243095,4135782,,0,0,0,PDN
SS115,,2014,1974,,0,23243095,4135782,,0,23243095,4135782,,0,0,0,PDN
SS115,,2015,1974,,0,23243095,4135782,,0,23243095,4135782,,0,0,0,PDN
SS115,,2016,1974,,0,23243095,4135782,,0,23243095,4135782,,0,0,0,PDN
SS115,,2017,1974,,0,23243095,4135782,,0,23243095,4135782,,0,0,0,PDN
SS115,,2017,1974,,0,23243095,4135782,,0,23243095,4135782,,0,0,0,PDN
SS128,,1992,1990,,4234999,5081999,5139269,,0,0,0,,4234999,5081999,5139269,PDP
SS128,,1993,1990,,4320519,7898274,5725906,,154409,2166795,539960,,4166110,5731479,5185946,PDP
SS128,,1994,1990,,4319506,7897058,5724676,,203215,2451137,639360,,4116291,5445921,5085316,PDP
SS128,,1995,1990,,4205908,8079388,5643522,,627390,3423359,1236529,,3578518,4656029,4406993,PDP
SS128,,1996,1990,,2916866,11095512,4891156,,967133,3317271,1557395,,1949733,7778241,3333761,PDP
SS128,,1997,1990,,5816358,31288953,11383787,,2467275,9009486,4070386,,3349083,22279467,7313401,PDP
SS128,,1998,1990,,5332703,28302077,10368660,,2692374,10936201,4638317,,2640329,17365876,5730343,PDP
SS128,,1999,1990,,5095010,25485992,9629884,,2841918,12034965,4983371,,2253092,13451027,4646513,PDP
SS128,,2000,1990,,4127783,22178155,8074074,,2977430,12693807,5236115,,1150353,9484348,2837959,PDP
SS128,,2001,1990,,4246307,22831972,8308935,,3164637,14554554,5754415,,1081670,8277418,2554520,PDP
SS128,,2002,1990,,4246248,22891174,8319411,,3316551,16432097,6240412,,929697,6459077,2078999,PDP
SS128,,2003,1990,,4299077,23215876,8430016,,3456650,17130032,6504698,,842427,6085844,1925318,PDP
SS128,,2004,1990,,4299077,23215876,8430016,,3524434,17513981,6640801,,774643,5701895,1789215,PDP
SS128,,2005,1990,,4397059,23320262,8546572,,3588722,17743720,6745968,,808337,5576542,1800604,PDP
SS128,,2006,1990,,4575824,23676402,8788707,,3632342,17892706,6816098,,943482,5783696,1972609,PDP
SS128,,2007,1990,,4575824,23676402,8788707,,3668317,17993630,6870031,,907507,5682772,1918676,PDP
SS128,,2008,1990,,4575824,23676402,8788707,,3725115,18123765,6949984,,850709,5552637,1838723,PDP
SS128,,2009,1990,,4588822,23966721,8853363,,3726083,18342295,6989836,,862739,5624426,1863528,PDP
SS128,,2010,1990,,4588822,23966721,8853363,,3732603,18389391,7004736,,856219,5577330,1848628,PDP
SS128,,2011,1990,,4588822,23966721,8853363,,3736055,18409272,7011726,,852767,5557449,1841638,PDP
SS128,,2012,1990,,4588822,23966721,8853363,,3736055,18409272,7011726,,852767,5557449,1841638,PDP
SS128,,2013,1990,,4558404,23811439,8795315,,3786850,18457031,7071019,,771554,5354408,1724296,PDP
SS128,,2014,1990,,4558404,23811439,8795315,,3810233,18491202,7100482,,748171,5320237,1694833,PDP
SS128,,2015,1990,,4558404,23811439,8795315,,3835061,18498097,7126537,,723343,5313342,1668778,PDP
SS128,,2016,1990,,4604950,23804131,8840560,,3863428,18508663,7156784,,741522,5295468,1683776,PDP
SS128,,2017,1990,,4615271,19646209,8111038,,3886991,18524463,7183159,,728280,1121746,927880,PDP
SS128,,2017,1990,,4615271,19646209,8111038,,3886991,18524463,7183159,,728280,1121746,927880,PDP
SS138,,2006,2006,,3885,44175,11745,,0,0,0,,3885,44175,11745,PDN
SS138,,2007,2006,,118510,2328172,532775,,41722,750775,175312,,76788,1577397,357463,PDN
SS138,,2008,2006,,115476,2290926,523114,,88086,1906463,427314,,27390,384463,95800,PDN
SS138,,2009,2006,,111295,3241171,688016,,105801,2687596,584021,,5494,553575,103995,PDN
SS138,,2010,2006,,111295,3241171,688016,,108871,3033718,648678,,2424,207453,39337,PDN
SS138,,2011,2006,,247870,5290353,1189214,,120830,3355263,717852,,127040,1935090,471362,PDN
SS138,,2012,2006,,247870,5290353,1189214,,234864,4754858,1080924,,13006,535495,108290,PDN
SS138,,2013,2006,,249061,5302258,1192523,,248156,5273351,1186474,,905,28907,6049,PDN
SS138,,2014,2006,,249061,5302258,1192523,,249061,5302258,1192523,,0,0,0,PDN
SS138,,2015,2006,,249061,5302258,1192523,,249061,5302258,1192523,,0,0,0,PDN
SS138,,2016,2006,,249061,5302258,1192523,,249061,5302258,1192523,,0,0,0,PDN
SS138,,2017,2006,,249061,5303488,1192742,,249061,5303488,1192742,,0,0,0,PDN
SS138,,2017,2006,,249061,5303488,1192742,,249061,5303488,1192742,,0,0,0,PDN
SS139,,1975,1957,,3000000,30000000,8338078,,2520000,26697244,7270399,,480000,3302756,1067679,PDP
SS139,,1976,1957,,2109620,26697244,6860019,,2109538,26697244,6859937,,82,0,82,PDP
SS139,,1977,1957,,2109620,26697244,6860019,,2109538,26697244,6859937,,82,0,82,PDP
SS139,,1978,1957,,2109620,26697244,6860019,,2109620,26697244,6860019,,0,0,0,PDP
SS139,,1979,1957,,2109620,26697244,6860019,,2109620,26697244,6860019,,0,0,0,PDP
SS139,,1980,1957,,2270927,25604962,6826970,,2270927,25604962,6826970,,0,0,0,PDP
SS139,,1981,1957,,2270927,25604962,6826970,,2270927,25604962,6826970,,0,0,0,PDP
SS139,,1982,1957,,2270900,25604837,6826921,,2270900,25604837,6826921,,0,0,0,PDP
SS139,,1983,1957,,2270900,25604837,6826921,,2270900,25604837,6826921,,0,0,0,PDP
SS139,,1984,1957,,2270900,25604837,6826921,,2270900,25604837,6826921,,0,0,0,PDP
SS139,,1985,1957,,2270900,25637345,6832705,,2270900,25637345,6832705,,0,0,0,PDP
SS139,,1986,1957,,2270900,25659449,6836638,,2270900,25659449,6836638,,0,0,0,PDP
SS139,,1987,1957,,2270900,25898423,6879160,,2270900,25898423,6879160,,0,0,0,PDP
SS139,,1988,1957,,2732353,65574630,14400437,,2270900,25898423,6879160,,461453,39676207,7521277,PDP
SS139,,1989,1957,,4564534,65574630,16232618,,2522052,28582591,7607922,,2042482,36992039,8624696,PDP
SS139,,1990,1957,,4564534,65574630,16232618,,2628123,29864022,7942006,,1936411,35710608,8290612,PDP
SS139,,1991,1957,,4564534,65574630,16232618,,2631449,29980871,7966124,,1933085,35593759,8266494,PDP
SS139,,1992,1957,,2631449,30016506,7972464,,2631449,30016506,7972464,,0,0,0,PDP
SS139,,1993,1957,,2631449,30016506,7972464,,2631449,30016506,7972464,,0,0,0,PDP
SS139,,1994,1957,,2631449,30016506,7972464,,2631449,30016506,7972464,,0,0,0,PDP
SS139,,1995,1957,,2631449,30016506,7972464,,2631449,30016506,7972464,,0,0,0,PDP
SS139,,1996,1957,,2631449,30016506,7972464,,2631449,30016506,7972464,,0,0,0,PDP
SS139,,1997,1957,,2631449,30016506,7972464,,2631449,30016506,7972464,,0,0,0,PDP
SS139,,1998,1957,,2631449,30016506,7972464,,2631449,30016506,7972464,,0,0,0,PDP
SS139,,1999,1957,,2642890,30157197,8008939,,2631449,30016506,7972464,,11441,140691,36475,PDP
SS139,,2000,1957,,2763469,32622103,8568114,,2653277,30396587,8061922,,110192,2225516,506192,PDP
SS139,,2001,1957,,2937949,36087699,9359248,,2718378,31820572,8380401,,219571,4267127,978847,PDP
SS139,,2002,1957,,2937949,36087699,9359248,,2868021,34427282,8993872,,69928,1660417,365376,PDP
SS139,,2003,1957,,3019351,37284269,9653563,,2931415,36183916,9369834,,87936,1100353,283729,PDP
SS139,,2004,1957,,4077587,52737625,13461506,,3044987,37998210,9806234,,1032600,14739415,3655272,PDP
SS139,,2005,1957,,4255284,55744147,14174171,,3113922,39548272,10150981,,1141362,16195875,4023190,PDP
SS139,,2006,1957,,4315137,56739702,14411169,,3229431,42048651,10711397,,1085706,14691051,3699772,PDP
SS139,,2007,1957,,4487825,57991398,14806579,,3372518,44574991,11304011,,1115307,13416407,3502568,PDP
SS139,,2008,1957,,4487825,57992476,14806771,,3462822,45097393,11487269,,1025003,12895083,3319502,PDP
SS139,,2009,1957,,3841174,53173705,13302690,,3476990,45834769,11632645,,364184,7338936,1670044,PDP
SS139,,2010,1957,,3841174,53173705,13302690,,3505667,46049247,11699485,,335507,7124458,1603205,PDP
SS139,,2011,1957,,3841174,53173705,13302690,,3606161,48023020,12151185,,235013,5150685,1151506,PDP
SS139,,2012,1957,,3841174,53173705,13302690,,3633768,48701814,12299573,,207406,4471891,1003116,PDP
SS139,,2013,1957,,3842411,53215787,13311415,,3677664,49853466,12548390,,164747,3362321,763025,PDP
SS139,,2014,1957,,4030205,56431794,14071451,,3766306,50899239,12823112,,263899,5532555,1248339,PDP
SS139,,2015,1957,,4082559,56431794,14123805,,3848291,52005194,13101886,,234268,4426600,1021919,PDP
SS139,,2016,1957,,4082559,56431794,14123805,,3869843,52329867,13181209,,212716,4101927,942596,PDP
SS139,,2017,1957,,4061238,54245862,13713529,,3902960,52746904,13288532,,158278,1498958,424996,PDP
SS139,,2017,1957,,4061238,54245862,13713529,,3902960,52746904,13288532,,158278,1498958,424996,PDP
SS151,,1997,1997,,307382,338120,367546,,0,0,0,,307382,338120,367546,PDP
SS151,,1998,1997,,2521033,2142878,2902328,,336383,232995,377841,,2184650,1909883,2524487,PDP
SS151,,1999,1997,,2521033,2142878,2902328,,1019685,766867,1156138,,1501348,1376011,1746190,PDP
SS151,,2000,1997,,2521033,2142878,2902328,,1528121,1080940,1720459,,992912,1061938,1181869,PDP
SS151,,2001,1997,,2521033,2142878,2902328,,1890594,1371978,2134718,,630439,770900,767610,PDP
SS151,,2002,1997,,2521033,2142878,2902328,,2052594,1526024,2324129,,468439,616854,578199,PDP
SS151,,2003,1997,,2521033,2142878,2902328,,2276739,1792064,2595612,,244294,350814,306716,PDP
SS151,,2004,1997,,2557598,2046078,2921669,,2461167,1909356,2800910,,96431,136722,120759,PDP
SS151,,2005,1997,,2557598,2046078,2921669,,2555707,1964696,2905297,,1891,81382,16372,PDP
SS151,,2006,1997,,2603269,2082615,2973841,,2578255,1974871,2929656,,25014,107744,44185,PDP
SS151,,2007,1997,,2750949,2104476,3125411,,2690707,2040688,3053819,,60242,63788,71592,PDP
SS151,,2008,1997,,2750949,2104476,3125411,,2742791,2049323,3107439,,8158,55153,17972,PDP
SS151,,2009,1997,,2906206,2159311,3290425,,2778364,2074949,3147572,,127842,84362,142853,PDP
SS151,,2010,1997,,2906206,2159311,3290425,,2837096,2106868,3211984,,69110,52443,78441,PDP
SS151,,2011,1997,,3187316,2422360,3618341,,2929436,2202079,3321265,,257880,220281,297076,PDP
SS151,,2012,1997,,3187316,2422360,3618341,,3036568,2341056,3453126,,150748,81304,165215,PDP
SS151,,2013,1997,,3187316,2422360,3618341,,3087551,2365514,3508461,,99765,56846,109880,PDP
SS151,,2014,1997,,3432494,2608695,3896675,,3231739,2461136,3669664,,200755,147559,227011,PDP
SS151,,2015,1997,,3432494,2608695,3896675,,3280487,2487426,3723089,,152007,121269,173585,PDP
SS151,,2016,1997,,3432494,2608695,3896675,,3301346,2496513,3745565,,131148,112182,151109,PDP
SS151,,2017,1997,,3386114,2542972,3838600,,3322668,2507816,3768899,,63446,35156,69702,PDP
SS151,,2017,1997,,3386114,2542972,3838600,,3322668,2507816,3768899,,63446,35156,69702,PDP
SS154,,1975,1955,,48000000,20016000,51561566,,41023506,16409981,43943431,,6976494,3606019,7618135,PDP
SS154,,1976,1955,,52000000,24024000,56274733,,43664923,18476186,46952501,,8335077,5547814,9322232,PDP
SS154,,1977,1955,,52000000,24024000,56274733,,45723306,20729111,49411760,,6276694,3294889,6862973,PDP
SS154,,1978,1955,,63257033,36387192,69731622,,49480591,27299734,54338195,,13776442,9087458,15393427,PDP
SS154,,1979,1955,,66520321,41757886,73950550,,50858728,29219372,56057905,,15661593,12538514,17892645,PDP
SS154,,1980,1955,,68606595,45995834,76790907,,52582830,32459959,58358623,,16023765,13535875,18432284,PDP
SS154,,1981,1955,,67717712,43481096,75454562,,53817280,34150462,59893875,,13900432,9330634,15560687,PDP
SS154,,1982,1955,,71804471,49746386,80656141,,54975080,37797198,61700560,,16829391,11949188,18955581,PDP
SS154,,1983,1955,,72883520,61063506,83748913,,55947229,40476728,63149494,,16936291,20586778,20599419,PDP
SS154,,1984,1955,,75093472,65099075,86676937,,57087375,44018565,64919860,,18006097,21080510,21757077,PDP
SS154,,1985,1955,,83444282,81074654,97870377,,58210963,47809037,66717909,,25233319,33265617,31152468,PDP
SS154,,1986,1955,,84908825,90755890,101057560,,59508426,50986226,68580708,,25400399,39769664,32476852,PDP
SS154,,1987,1955,,82935514,90978711,99123897,,61740377,55197531,71562002,,21195137,35781180,27561895,PDP
SS154,,1988,1955,,83478783,95646619,100497754,,63166632,59060308,73675584,,20312151,36586311,26822170,PDP
SS154,,1989,1955,,72073351,87049616,87562607,,64335757,63324934,75603539,,7737594,23724682,11959068,PDP
SS154,,1990,1955,,72894331,105792691,91718653,,64972752,66609351,76824950,,7921579,39183340,14893703,PDP
SS154,,1991,1955,,70172254,106115514,89054018,,65454755,69244164,77775781,,4717499,36871350,11278237,PDP
SS154,,1992,1955,,70448792,106864505,89463828,,65932178,71245694,78609348,,4516614,35618811,10854480,PDP
SS154,,1993,1955,,67937168,86608043,83347852,,66197787,73628585,79298959,,1739381,12979458,4048893,PDP
SS154,,1994,1955,,69362602,95492191,86354095,,67153239,77490077,80941509,,2209363,18002114,5412586,PDP
SS154,,1995,1955,,73024216,98290227,90513580,,68624279,80604271,82966676,,4399937,17685956,7546904,PDP
SS154,,1996,1955,,78918426,134305990,102816289,,72235865,95389410,89209070,,6682561,38916580,13607219,PDP
SS154,,1997,1955,,81928576,140382504,106907669,,75088815,108809187,94449880,,6839761,31573317,12457789,PDP
SS154,,1998,1955,,82028093,140251139,106983812,,76940703,118165146,97966530,,5087390,22085993,9017282,PDP
SS154,,1999,1955,,84344085,142630814,109723233,,79133226,122932849,101007398,,5210859,19697965,8715835,PDP
SS154,,2000,1955,,92711276,156104391,120487858,,80840562,126662367,103378350,,11870714,29442024,17109508,PDP
SS154,,2001,1955,,93377023,180445859,125484827,,83035644,133122456,106722914,,10341379,47323403,18761913,PDP
SS154,,2002,1955,,93441653,181851250,125799527,,84993083,139979300,109900432,,8448570,41871950,15899095,PDP
SS154,,2003,1955,,93838400,182927610,126387797,,86399021,146277091,112426973,,7439379,36650519,13960824,PDP
SS154,,2004,1955,,93288689,172762857,124029411,,87607244,148259653,113987965,,5681445,24503204,10041446,PDP
SS154,,2005,1955,,95270454,180796570,127440663,,88711486,150037354,115408524,,6558968,30759216,12032139,PDP
SS154,,2006,1955,,94494153,169346810,124627038,,90293481,154309723,117750727,,4200672,15037087,6876311,PDP
SS154,,2007,1955,,95397389,183493524,128047483,,92266154,160955699,120905958,,3131235,22537825,7141525,PDP
SS154,,2008,1955,,95739444,187535374,129108728,,93327972,168687660,123343570,,2411472,18847714,5765158,PDP
SS154,,2009,1955,,96650157,192497673,130902414,,94063493,176721115,125508533,,2586664,15776558,5393883,PDP
SS154,,2010,1955,,96650725,192540217,130910553,,94943516,184159379,127712090,,1707209,8380838,3198463,PDP
SS154,,2011,1955,,96650725,192540217,130910553,,95592419,188338023,129104524,,1058306,4202194,1806028,PDP
SS154,,2012,1955,,97130044,194580616,131752932,,96032646,190203252,129876642,,1097398,4377364,1876291,PDP
SS154,,2013,1955,,97130971,194580616,131753859,,96350021,191301313,130389402,,780950,3279303,1364456,PDP
SS154,,2014,1955,,97397850,194751358,132051119,,96644528,192000674,130808349,,753322,2750684,1242764,PDP
SS154,,2015,1955,,97175668,194351322,131757757,,96837075,192571888,131102538,,338593,1779434,655219,PDP
SS154,,2016,1955,,97489974,195299810,132240830,,96949036,192986328,131288241,,540938,2313482,952588,PDP
SS154,,2017,1955,,97783983,195521030,132574201,,97159435,193583012,131604813,,624548,1938018,969389,PDP
SS154,,2017,1955,,97783983,195521030,132574201,,97159435,193583012,131604813,,624548,1938018,969389,PDP
SS158,,1977,1960,,5329722,399234000,76367800,,317861,269359459,48246590,,5011861,129874541,28121210,PDN
SS158,,1978,1960,,5329722,399234000,76367800,,334456,287017387,51405165,,4995266,112216613,24962635,PDN
SS158,,1979,1960,,5162777,399047000,76167581,,342127,300707269,53848758,,4820650,98339731,22318823,PDN
SS158,,1980,1960,,5217686,386011364,73902982,,397796,296367162,53132166,,4819890,89644202,20770816,PDN
SS158,,1981,1960,,507331,357285411,64081248,,475610,307867469,55256298,,31721,49417942,8824950,PDN
SS158,,1982,1960,,821604,492652145,88482128,,539704,316633817,56880241,,281900,176018328,31601887,PDN
SS158,,1983,1960,,821604,492652145,88482128,,584765,323296883,58110901,,236839,169355262,30371227,PDN
SS158,,1984,1960,,834807,498189218,89480575,,612381,333361900,59929445,,222426,164827318,29551130,PDN
SS158,,1985,1960,,894015,502265306,90265066,,631075,338470596,60857160,,262940,163794710,29407906,PDN
SS158,,1986,1960,,783874,378465363,68126465,,657546,344455086,61948487,,126328,34010277,6177978,PDN
SS158,,1987,1960,,846090,380146688,68487849,,690537,348905984,62773452,,155553,31240704,5714397,PDN
SS158,,1988,1960,,978206,383957799,69298099,,782873,353749529,63727629,,195333,30208270,5570470,PDN
SS158,,1989,1960,,1066396,383957799,69386289,,879275,354596895,63974808,,187121,29360904,5411481,PDN
SS158,,1990,1960,,1502091,357405065,65097298,,951379,354952041,64110105,,550712,2453024,987193,PDN
SS158,,1991,1960,,1537277,361565549,65872784,,975524,356193737,64355193,,561753,5371812,1517591,PDN
SS158,,1992,1960,,1568949,373345970,68000616,,990202,358260043,64737541,,578747,15085927,3263075,PDN
SS158,,1993,1960,,995618,365248019,65986369,,990760,360528026,65141654,,4858,4719993,844715,PDN
SS158,,1994,1960,,995618,365248019,65986369,,991302,362889026,65562303,,4316,2358993,424066,PDN
SS158,,1995,1960,,1011472,367235770,66355915,,992827,363905065,65744618,,18645,3330705,611297,PDN
SS158,,1996,1960,,424668,346947914,62159172,,417648,344786606,61767578,,7020,2161308,391594,PDN
SS158,,1997,1960,,441493,351525341,62990486,,422955,346454091,62069590,,18538,5071250,920896,PDN
SS158,,1998,1960,,441493,351525341,62990486,,431154,348682409,62474287,,10339,2842932,516199,PDN
SS158,,1999,1960,,455289,348843285,62527048,,434750,342683137,61410397,,20539,6160148,1116651,PDN
SS158,,2000,1960,,455289,348843285,62527048,,439582,345064300,61838924,,15707,3778985,688124,PDN
SS158,,2001,1960,,454895,350641680,62846653,,443056,347140427,62211815,,11839,3501253,634838,PDN
SS158,,2002,1960,,455719,350912370,62895642,,444842,348667564,62485334,,10877,2244806,410308,PDN
SS158,,2003,1960,,455719,350912370,62895642,,449082,350312870,62782333,,6637,599500,113309,PDN
SS158,,2004,1960,,520070,376212555,67461806,,464397,356698585,63933896,,55673,19513970,3527910,PDN
SS158,,2005,1960,,520070,376212555,67461806,,485928,364533381,65349519,,34142,11679174,2112287,PDN
SS158,,2006,1960,,520382,376276847,67473558,,494815,368322072,66032550,,25567,7954775,1441008,PDN
SS158,,2007,1960,,520767,376555156,67523464,,500573,370202236,66372857,,20194,6352920,1150607,PDN
SS158,,2008,1960,,520567,376500912,67513612,,505748,371275440,66568994,,14819,5225472,944618,PDN
SS158,,2009,1960,,522546,384081253,68864406,,507232,378808776,67910929,,15314,5272477,953477,PDN
SS158,,2010,1960,,522546,384081253,68864406,,509782,379641290,68061613,,12764,4439963,802793,PDN
SS158,,2011,1960,,522546,384081253,68864406,,511931,380391707,68197288,,10615,3689546,667118,PDN
SS158,,2012,1960,,522546,384081253,68864406,,513979,380891633,68288291,,8567,3189620,576115,PDN
SS158,,2013,1960,,519922,383722773,68797995,,515093,381235056,68350512,,4829,2487717,447483,PDN
SS158,,2014,1960,,519921,383722774,68797996,,515857,381789740,68449976,,4064,1933034,348020,PDN
SS158,,2015,1960,,520684,384002588,68848548,,517233,382201325,68524587,,3451,1801263,323960,PDN
SS158,,2016,1960,,520684,384002588,68848548,,517755,382411851,68562570,,2929,1590737,285978,PDN
SS158,,2017,1960,,520684,384002588,68848548,,517755,382411851,68562570,,2929,1590737,285978,PDN
SS158,,2017,1960,,520684,384002588,68848548,,517755,382411851,68562570,,2929,1590737,285978,PDN
SS160,,1987,1985,,268151,955690,438203,,0,0,0,,268151,955690,438203,PDN
SS160,,1989,1985,,155655,18404942,3430556,,6226,654625,122707,,149429,17750317,3307849,PDN
SS160,,1990,1985,,147481,16289350,3045942,,23469,2347640,441199,,124012,13941710,2604743,PDN
SS160,,1991,1985,,147481,16289350,3045942,,41899,4152185,780722,,105582,12137165,2265220,PDN
SS160,,1992,1985,,147481,16289350,3045942,,56682,5698715,1070688,,90799,10590635,1975254,PDN
SS160,,1993,1985,,147481,16289350,3045942,,70099,7511074,1406589,,77382,8778276,1639353,PDN
SS160,,1994,1985,,109885,13224194,2462944,,80858,9254972,1727650,,29027,3969222,735294,PDN
SS160,,1995,1985,,109885,13224194,2462944,,91211,11056019,2058474,,18674,2168175,404470,PDN
SS160,,1996,1985,,115575,14526783,2700412,,101368,12693377,2359976,,14207,1833406,340436,PDN
SS160,,1997,1985,,115575,14526783,2700412,,106967,13824410,2566826,,8608,702373,133586,PDN
SS160,,1998,1985,,118457,16228592,3006107,,110330,14577601,2704209,,8127,1650991,301898,PDN
SS160,,1999,1985,,185371,25025056,4638228,,112821,15077205,2795598,,72550,9947851,1842630,PDN
SS160,,2000,1985,,185371,25025056,4638228,,114112,15315168,2839231,,71259,9709888,1798997,PDN
SS160,,2001,1985,,114112,15315168,2839231,,114112,15315168,2839231,,0,0,0,PDN
SS160,,2002,1985,,114112,15315168,2839231,,114112,15315168,2839231,,0,0,0,PDN
SS160,,2003,1985,,114112,15315168,2839231,,114112,15315168,2839231,,0,0,0,PDN
SS160,,2004,1985,,114112,15315168,2839231,,114112,15315168,2839231,,0,0,0,PDN
SS160,,2005,1985,,114112,15315168,2839231,,114112,15315168,2839231,,0,0,0,PDN
SS160,,2006,1985,,114112,15315168,2839231,,114112,15315168,2839231,,0,0,0,PDN
SS160,,2007,1985,,114112,15315168,2839231,,114112,15315168,2839231,,0,0,0,PDN
SS160,,2008,1985,,114112,15315168,2839231,,114112,15315168,2839231,,0,0,0,PDN
SS160,,2009,1985,,114112,15602216,2890307,,114112,15602216,2890307,,0,0,0,PDN
SS160,,2010,1985,,114112,15602216,2890307,,114112,15602216,2890307,,0,0,0,PDN
SS160,,2011,1985,,114112,15602216,2890307,,114112,15602216,2890307,,0,0,0,PDN
SS160,,2012,1985,,114112,15602216,2890307,,114112,15602216,2890307,,0,0,0,PDN
SS160,,2013,1985,,114112,15602216,2890307,,114112,15602216,2890307,,0,0,0,PDN
SS160,,2014,1985,,114112,15602216,2890307,,114112,15602216,2890307,,0,0,0,PDN
SS160,,2015,1985,,114112,15602216,2890307,,114112,15602216,2890307,,0,0,0,PDN
SS160,,2016,1985,,114112,15602216,2890307,,114112,15602216,2890307,,0,0,0,PDN
SS160,,2017,1985,,114112,15602216,2890307,,114112,15602216,2890307,,0,0,0,PDN
SS160,,2017,1985,,114112,15602216,2890307,,114112,15602216,2890307,,0,0,0,PDN
SS165,,1985,1983,,17883,1072965,208802,,0,0,0,,17883,1072965,208802,PDN
SS165,,1986,1983,,17883,1072965,208802,,0,0,0,,17883,1072965,208802,PDN
SS165,,1987,1983,,0,1697217,301996,,0,1151923,204969,,0,545294,97027,PDN
SS165,,1988,1983,,0,2086741,371306,,0,1776474,316099,,0,310267,55207,PDN
SS165,,1989,1983,,9990,3268010,591486,,0,1881794,334839,,9990,1386216,256647,PDN
SS165,,1990,1983,,51246,11220822,2047834,,0,2411276,429053,,51246,8809546,1618781,PDN
SS165,,1991,1983,,0,2572553,457750,,0,2572553,457750,,0,0,0,PDN
SS165,,1992,1983,,0,2572553,457750,,0,2572553,457750,,0,0,0,PDN
SS165,,1993,1983,,0,2572553,457750,,0,2572553,457750,,0,0,0,PDN
SS165,,1994,1983,,0,2572553,457750,,0,2572553,457750,,0,0,0,PDN
SS165,,1995,1983,,0,2572553,457750,,0,2572553,457750,,0,0,0,PDN
SS165,,1996,1983,,0,2572553,457750,,0,2572553,457750,,0,0,0,PDN
SS165,,1997,1983,,0,2572553,457750,,0,2572553,457750,,0,0,0,PDN
SS165,,1998,1983,,0,2572553,457750,,0,2572553,457750,,0,0,0,PDN
SS165,,1999,1983,,0,2572553,457750,,0,2572553,457750,,0,0,0,PDN
SS165,,2000,1983,,0,2572553,457750,,0,2572553,457750,,0,0,0,PDN
SS165,,2001,1983,,0,2572553,457750,,0,2572553,457750,,0,0,0,PDN
SS165,,2002,1983,,0,2572553,457750,,0,2572553,457750,,0,0,0,PDN
SS165,,2003,1983,,0,2572553,457750,,0,2572553,457750,,0,0,0,PDN
SS165,,2004,1983,,0,2572553,457750,,0,2572553,457750,,0,0,0,PDN
SS165,,2005,1983,,0,2572553,457750,,0,2572553,457750,,0,0,0,PDN
SS165,,2006,1983,,0,2572553,457750,,0,2572553,457750,,0,0,0,PDN
SS165,,2007,1983,,0,2572553,457750,,0,2572553,457750,,0,0,0,PDN
SS165,,2008,1983,,0,2572553,457750,,0,2572553,457750,,0,0,0,PDN
SS165,,2009,1983,,0,2624074,466917,,0,2624074,466917,,0,0,0,PDN
SS165,,2010,1983,,0,2624074,466917,,0,2624074,466917,,0,0,0,PDN
SS165,,2011,1983,,0,2624074,466917,,0,2624074,466917,,0,0,0,PDN
SS165,,2012,1983,,0,2624074,466917,,0,2624074,466917,,0,0,0,PDN
SS165,,2013,1983,,0,2624074,466917,,0,2624074,466917,,0,0,0,PDN
SS165,,2014,1983,,0,2624074,466917,,0,2624074,466917,,0,0,0,PDN
SS165,,2015,1983,,0,2624074,466917,,0,2624074,466917,,0,0,0,PDN
SS165,,2016,1983,,0,2624074,466917,,0,2624074,466917,,0,0,0,PDN
SS165,,2017,1983,,0,2624074,466917,,0,2624074,466917,,0,0,0,PDN
SS165,,2017,1983,,0,2624074,466917,,0,2624074,466917,,0,0,0,PDN
SS167,,1975,1965,,0,7800000,1387900,,0,0,0,,0,7800000,1387900,PDN
SS167,,1976,1965,,82979,7800000,1470879,,0,0,0,,82979,7800000,1470879,PDN
SS167,,1977,1965,,82979,7800000,1470879,,0,0,0,,82979,7800000,1470879,PDN
SS167,,1978,1965,,82979,7800000,1470879,,8046,2335300,423580,,74933,5464700,1047299,PDN
SS167,,1979,1965,,82979,7800000,1470879,,17975,5965070,1079375,,65004,1834930,391504,PDN
SS167,,1980,1965,,51781,17175569,3107932,,24811,8530987,1542780,,26970,8644582,1565152,PDN
SS167,,1981,1965,,51781,17175569,3107932,,31221,9784246,1772190,,20560,7391323,1335742,PDN
SS167,,1982,1965,,51781,17175569,3107932,,35110,10955218,1984437,,16671,6220351,1123495,PDN
SS167,,1983,1965,,51781,17175569,3107932,,36425,11747905,2126800,,15356,5427664,981132,PDN
SS167,,1984,1965,,51781,17175569,3107932,,37719,12742636,2305092,,14062,4432933,802840,PDN
SS167,,1985,1965,,250796,28209289,5270242,,51013,13569187,2465459,,199783,14640102,2804783,PDN
SS167,,1986,1965,,819470,47661841,9300225,,142270,17158856,3195447,,677200,30502985,6104778,PDN
SS167,,1987,1965,,850038,49762670,9704606,,192293,19304779,3627307,,657745,30457891,6077299,PDN
SS167,,1988,1965,,1008461,59579000,11609707,,250103,24128898,4543501,,758358,35450102,7066206,PDN
SS167,,1989,1965,,1064126,66160992,12836545,,252481,25052750,4710266,,811645,41108242,8126279,PDN
SS167,,1990,1965,,379214,38310191,7195974,,252743,25860464,4854249,,126471,12449727,2341725,PDN
SS167,,1991,1965,,325005,34527497,6468688,,253801,27301744,5111763,,71204,7225753,1356925,PDN
SS167,,1992,1965,,263071,37848179,6997622,,256036,29768598,5552940,,7035,8079581,1444682,PDN
SS167,,1993,1965,,263071,37848179,6997622,,256650,31237490,5814922,,6421,6610689,1182700,PDN
SS167,,1994,1965,,390657,42047117,7872350,,257006,32317066,6007374,,133651,9730051,1864976,PDN
SS167,,1995,1965,,393309,48112679,8954284,,265790,35408619,6566256,,127519,12704060,2388028,PDN
SS167,,1996,1965,,320177,52708751,9698958,,282907,40653394,7516607,,37270,12055357,2182351,PDN
SS167,,1997,1965,,567697,65111595,12153390,,305036,45711886,8438824,,262661,19399709,3714566,PDN
SS167,,1998,1965,,575511,69838437,13002279,,405909,52750563,9792130,,169602,17087874,3210149,PDN
SS167,,1999,1965,,593100,78323501,14529666,,472892,59772517,11108571,,120208,18550984,3421095,PDN
SS167,,2000,1965,,701554,82021780,15296177,,534840,66602334,12385789,,166714,15419446,2910388,PDN
SS167,,2001,1965,,609967,77677456,14431578,,565449,71132869,13222543,,44518,6544587,1209035,PDN
SS167,,2002,1965,,623354,78667058,14621051,,567576,72756042,13513491,,55778,5911016,1107560,PDN
SS167,,2003,1965,,623511,79798448,14822523,,580791,74267250,13795604,,42720,5531198,1026919,PDN
SS167,,2004,1965,,623511,79798448,14822523,,581853,75089206,13942922,,41658,4709242,879601,PDN
SS167,,2005,1965,,683420,82092761,15290673,,588682,76013400,14114198,,94738,6079361,1176475,PDN
SS167,,2006,1965,,847962,87623098,16439261,,606933,76767613,14266651,,241029,10855485,2172610,PDN
SS167,,2007,1965,,890825,92921933,17424977,,713895,81866714,15280926,,176930,11055219,2144051,PDN
SS167,,2008,1965,,924104,93741523,17604090,,815757,87553107,16394602,,108347,6188416,1209488,PDN
SS167,,2009,1965,,918533,94317311,17700970,,869682,90645327,16998742,,48851,3671984,702230,PDN
SS167,,2010,1965,,916002,94274618,17690842,,900669,93072760,17461656,,15333,1201858,229187,PDN
SS167,,2011,1965,,915997,94277708,17691387,,902746,93370008,17516625,,13251,907700,174764,PDN
SS167,,2012,1965,,915997,94277708,17691387,,903338,93460070,17533242,,12659,817638,158146,PDN
SS167,,2013,1965,,903338,93460070,17533242,,903338,93460070,17533242,,0,0,0,PDN
SS167,,2014,1965,,903338,93460070,17533242,,903338,93460070,17533242,,0,0,0,PDN
SS167,,2015,1965,,903338,93460070,17533242,,903338,93460070,17533242,,0,0,0,PDN
SS167,,2016,1965,,903338,93460070,17533242,,903338,93460070,17533242,,0,0,0,PDN
SS167,,2017,1965,,903338,93460070,17533242,,903338,93460070,17533242,,0,0,0,PDN
SS167,,2017,1965,,903338,93460070,17533242,,903338,93460070,17533242,,0,0,0,PDN
SS169,,1975,1960,,7500000,600000000,114261566,,4652559,339866534,65127031,,2847441,260133466,49134535,PDP
SS169,,1976,1960,,7500000,600000000,114261566,,5070065,387025979,73935898,,2429935,212974021,40325668,PDP
SS169,,1977,1960,,30159308,309331911,85200573,,3782109,176854772,35250930,,26377199,132477139,49949643,PDP
SS169,,1978,1960,,30606378,325028575,88440644,,6101447,196316181,41033152,,24504931,128712394,47407492,PDP
SS169,,1979,1960,,31791736,371070638,97818540,,10278000,213211517,48215992,,21513736,157859121,49602548,PDP
SS169,,1980,1960,,31791736,385325037,100354910,,13725043,225602755,53867882,,18066693,159722282,46487028,PDP
SS169,,1981,1960,,34903788,545592367,131984280,,16854837,255916904,62391653,,18048951,289675463,69592627,PDP
SS169,,1982,1960,,35729252,573938881,137853608,,20629537,274208910,69421158,,15099715,299729971,68432450,PDP
SS169,,1983,1960,,58007696,620966255,168499912,,26190057,296772792,78996604,,31817639,324193463,89503308,PDP
SS169,,1984,1960,,59226078,619378742,169435819,,36293031,330603818,95119333,,22933047,288774924,74316486,PDP
SS169,,1985,1960,,89485638,727439471,218923266,,46798105,364082809,111581523,,42687533,363356662,107341743,PDP
SS169,,1986,1960,,101636287,697784725,225797270,,57228033,402216630,128796828,,44408254,295568095,97000442,PDP
SS169,,1987,1960,,92754140,698113117,216973556,,66357664,451384226,146675142,,26396476,246728891,70298414,PDP
SS169,,1988,1960,,123007496,761677760,258537347,,73092341,495120108,161192004,,49915155,266557652,97345343,PDP
SS169,,1989,1960,,123129601,706930340,248917918,,79358552,520357532,171948860,,43771049,186572808,76969058,PDP
SS169,,1990,1960,,112411640,700278171,237016297,,85000172,546925546,182317885,,27411468,153352625,54698412,PDP
SS169,,1991,1960,,116859289,699152467,241263643,,89192577,561836491,189163483,,27666712,137315976,52100160,PDP
SS169,,1992,1960,,119540506,706872472,245318526,,94298984,579829421,197471479,,25241522,127043051,47847047,PDP
SS169,,1993,1960,,119754639,706104727,245396049,,98864354,596974894,205087645,,20890285,109129833,40308404,PDP
SS169,,1994,1960,,121406196,721839994,249847476,,102945801,625510646,214246628,,18460395,96329348,35600848,PDP
SS169,,1995,1960,,121854775,738849616,253322678,,106956880,635558108,220045511,,14897895,103291508,33277167,PDP
SS169,,1996,1960,,136198963,725290975,265254297,,113225086,666300994,231783982,,22973877,58989981,33470315,PDP
SS169,,1997,1960,,139316247,742018987,271348095,,121234973,684582886,243046874,,18081274,57436101,28301221,PDP
SS169,,1998,1960,,141066222,768554942,277819770,,127198186,703370179,252353022,,13868036,65184763,25466748,PDP
SS169,,1999,1960,,144576747,773655205,282237816,,131653756,729771584,261506351,,12922991,43883621,20731465,PDP
SS169,,2000,1960,,153430357,830529128,301211341,,136119975,750498443,269660623,,17310382,80030685,31550718,PDP
SS169,,2001,1960,,153846710,812946266,298499071,,140071223,752607967,273987231,,13775487,60338299,24511840,PDP
SS169,,2002,1960,,154780868,814165330,299650143,,143444049,763345865,279270715,,11336819,50819465,20379428,PDP
SS169,,2003,1960,,157226906,860359279,310315745,,146644314,775581649,284648166,,10582592,84777630,25667579,PDP
SS169,,2004,1960,,159459922,847597853,310278045,,149782595,799151497,291980370,,9677327,48446356,18297675,PDP
SS169,,2005,1960,,160537330,854584855,312598692,,152124246,812449049,296688134,,8413084,42135806,15910558,PDP
SS169,,2006,1960,,165122573,889066594,323319475,,154347680,825149649,301171461,,10774893,63916945,22148014,PDP
SS169,,2007,1960,,165368425,891811621,324053766,,156827166,838609548,306045947,,8541259,53202073,18007819,PDP
SS169,,2008,1960,,166259521,901413208,326653330,,158343918,846119998,308899078,,7915603,55293210,17754252,PDP
SS169,,2009,1960,,166525556,895966160,325950140,,159441812,862209574,312859886,,7083744,33756586,13090254,PDP
SS169,,2010,1960,,166561266,896061975,326002899,,160688075,868204252,315172817,,5873191,27857723,10830082,PDP
SS169,,2011,1960,,167491010,898300843,327331015,,162138160,874541308,317750490,,5352850,23759535,9580528,PDP
SS169,,2012,1960,,167647329,903096497,328340652,,163368312,882125542,320330152,,4279017,20970955,8010502,PDP
SS169,,2013,1960,,168856076,905440358,329966456,,164480948,888058848,322498535,,4375128,17381510,7467924,PDP
SS169,,2014,1960,,169882712,907616598,331380322,,165686947,892866986,324560073,,4195765,14749612,6820252,PDP
SS169,,2015,1960,,172155378,909436882,333976882,,166805679,894607874,325988572,,5349699,14829008,7988314,PDP
SS169,,2016,1960,,172201379,910022533,334127093,,167879611,896013869,327312679,,4321768,14008664,6814412,PDP
SS169,,2017,1960,,172537766,910996945,334636863,,168819924,897253806,328473622,,3717842,13743139,6163244,PDP
SS169,,2017,1960,,172537766,910996945,334636863,,168819924,897253806,328473622,,3717842,13743139,6163244,PDP
SS176,,1975,1956,,51523460,811257523,195875332,,27259579,308386810,82132677,,24263881,502870713,113742655,PDP
SS176,,1976,1956,,51523460,811257523,195875332,,28914063,343713979,90073134,,22609397,467543544,105802198,PDP
SS176,,1977,1956,,54448467,873222268,209826095,,31428898,392228243,101220400,,23019569,480994025,108605695,PDP
SS176,,1978,1956,,54520560,879894649,211085444,,32636775,440384950,110997086,,21883785,439509699,100088358,PDP
SS176,,1979,1956,,49087509,905557569,210218749,,29647605,481925921,115399548,,19439904,423631648,94819201,PDP
SS176,,1980,1956,,59536649,963201526,230924821,,39050935,507423635,129339838,,20485714,455777891,101584983,PDP
SS176,,1981,1956,,52866524,870726539,207800072,,34258028,575904456,136732130,,18608496,294822083,71067942,PDP
SS176,,1982,1956,,53786329,899810468,213894953,,35417333,648313135,150775542,,18368996,251497333,63119411,PDP
SS176,,1983,1956,,55533528,1021678309,237326821,,36911052,704052752,162187342,,18622476,317625557,75139479,PDP
SS176,,1984,1956,,57966255,1058268815,246270315,,38076010,775819709,176122222,,19890245,282449106,70148093,PDP
SS176,,1985,1956,,62713470,1124086385,262728841,,38916336,807994813,182687655,,23797134,316091572,80041186,PDP
SS176,,1986,1956,,65446012,1114819189,263812416,,40339673,842749942,190295179,,25106339,272069247,73517237,PDP
SS176,,1987,1956,,63519590,1223295922,281187904,,42284576,908288333,203901717,,21235014,315007589,77286187,PDP
SS176,,1988,1956,,69971902,1323464943,305463885,,43949917,957791906,214375523,,26021985,365673037,91088362,PDP
SS176,,1989,1956,,63090832,1269293277,288943728,,45924998,993465822,222698276,,17165834,275827455,66245452,PDP
SS176,,1990,1956,,57928824,1252240021,280747333,,47802172,1032590216,231537086,,10126652,219649805,49210247,PDP
SS176,,1991,1956,,58398436,1287278222,287451500,,49472466,1066357147,239215731,,8925970,220921075,48235769,PDP
SS176,,1992,1956,,57737610,1269475812,283622986,,51251979,1099124014,246825647,,6485631,170351798,36797339,PDP
SS176,,1993,1956,,58835339,1309248003,291797617,,52700264,1131224373,253985740,,6135075,178023630,37811877,PDP
SS176,,1994,1956,,58704725,1318582809,293328001,,54022165,1158604248,260179505,,4682560,159978561,33148496,PDP
SS176,,1995,1956,,59871370,1289863338,289384419,,55021308,1176129490,264297018,,4850062,113733848,25087401,PDP
SS176,,1996,1956,,59346835,1304826845,291522430,,55853795,1199703480,269324165,,3493040,105123365,22198265,PDP
SS176,,1997,1956,,59737652,1273174073,286281081,,56762113,1212388744,272489648,,2975539,60785329,13791433,PDP
SS176,,1998,1956,,62002580,1277208144,289263816,,57500525,1219445215,274483659,,4502055,57762929,14780157,PDP
SS176,,1999,1956,,61716282,1280639494,289588078,,58338966,1226456450,276569651,,3377316,54183044,13018427,PDP
SS176,,2000,1956,,62416872,1290122745,291976079,,59112850,1231002895,278152511,,3304022,59119850,13823568,PDP
SS176,,2001,1956,,62149698,1283359136,290505416,,59784420,1233921139,279343342,,2365278,49437997,11162074,PDP
SS176,,2002,1956,,62401638,1285644607,291164024,,60230478,1235366356,280046556,,2171160,50278251,11117468,PDP
SS176,,2003,1956,,63212546,1288571449,292495722,,60898645,1238874012,281338861,,2313901,49697437,11156861,PDP
SS176,,2004,1956,,64004261,1295775638,294569321,,61542274,1244630753,283006821,,2461987,51144885,11562500,PDP
SS176,,2005,1956,,65787695,1303403653,297710053,,62221851,1252117215,285018508,,3565844,51286438,12691545,PDP
SS176,,2006,1956,,65706215,1304614950,297844107,,62936899,1261706423,287439821,,2769316,42908527,10404286,PDP
SS176,,2007,1956,,65604923,1305206743,297848116,,63837393,1270089569,289831978,,1767530,35117174,8016138,PDP
SS176,,2008,1956,,65642717,1305532719,297943913,,64243654,1273334683,290815662,,1399063,32198036,7128251,PDP
SS176,,2009,1956,,66408225,1316566314,300672694,,64579617,1299507267,295808668,,1828608,17059047,4864026,PDP
SS176,,2010,1956,,66454773,1319719408,301280290,,65034432,1305088063,297256507,,1420341,14631345,4023783,PDP
SS176,,2011,1956,,66476440,1320380990,301419677,,65446696,1308263440,298233785,,1029744,12117550,3185892,PDP
SS176,,2012,1956,,66763906,1321857661,301969894,,65817508,1309532679,298830440,,946398,12324982,3139457,PDP
SS176,,2013,1956,,67525370,1325742782,303422661,,66454452,1311233105,299769948,,1070918,14509677,3652711,PDP
SS176,,2014,1956,,68628430,1330094183,305299994,,67226501,1313770656,300993522,,1401929,16323527,4306473,PDP
SS176,,2015,1956,,68834135,1330705460,305614466,,67810995,1315161957,301825575,,1023140,15543503,3788890,PDP
SS176,,2016,1956,,69520924,1331954537,306523511,,68334729,1316358496,302562218,,1186195,15596041,3961293,PDP
SS176,,2017,1956,,69549548,1332789883,306700773,,68836851,1317450251,303258603,,712697,15339632,3442169,PDP
SS176,,2017,1956,,69549548,1332789883,306700773,,68836851,1317450251,303258603,,712697,15339632,3442169,PDP
SS178,,1985,1984,,9664680,15418036,12408103,,9985,9313,11642,,9654695,15408723,12396461,PDP
SS178,,1986,1984,,15641355,35210030,21906485,,3367382,3792246,4042159,,12273973,31417784,17864326,PDP
SS178,,1987,1984,,15641355,36413722,22120665,,5433938,6977898,6675557,,10207417,29435824,15445108,PDP
SS178,,1988,1984,,15641355,36413722,22120665,,6517276,8518634,8033047,,9124079,27895088,14087618,PDP
SS178,,1989,1984,,14345408,20920386,18067897,,7296319,9619355,9007948,,7049089,11301031,9059949,PDP
SS178,,1990,1984,,14345408,20920386,18067897,,7759286,11025874,9721185,,6586122,9894512,8346712,PDP
SS178,,1991,1984,,14345408,20920386,18067897,,8289658,11748250,10380094,,6055750,9172136,7687803,PDP
SS178,,1992,1984,,14345408,20920386,18067897,,8700765,12318536,10892675,,5644643,8601850,7175222,PDP
SS178,,1993,1984,,11364753,18168452,14597574,,9013325,12677169,11269049,,2351428,5491283,3328525,PDP
SS178,,1994,1984,,11364749,18168450,14597569,,9501278,13479772,11899814,,1863471,4688678,2697755,PDP
SS178,,1995,1984,,11595750,21260989,15378844,,10273333,15187402,12975718,,1322417,6073587,2403126,PDP
SS178,,1996,1984,,13549035,23573354,17743582,,11034071,16630794,13993287,,2514964,6942560,3750295,PDP
SS178,,1997,1984,,13549035,23573354,17743582,,11549992,17007918,14576312,,1999043,6565436,3167270,PDP
SS178,,1998,1984,,13549035,23573354,17743582,,11851100,17326466,14934101,,1697935,6246888,2809481,PDP
SS178,,1999,1984,,13549035,23847047,17792282,,12187473,18336503,15450196,,1361562,5510544,2342086,PDP
SS178,,2000,1984,,14018470,20270360,17625296,,12592503,18589039,15900161,,1425967,1681321,1725135,PDP
SS178,,2001,1984,,14166818,39412347,21179691,,12953728,18856635,16309001,,1213090,20555712,4870690,PDP
SS178,,2002,1984,,14166818,39412347,21179691,,13300610,19200507,16717070,,866208,20211840,4462621,PDP
SS178,,2003,1984,,14255217,39662641,21312626,,13551300,19403677,17003912,,703917,20258964,4308714,PDP
SS178,,2004,1984,,14255217,39662641,21312626,,13801963,19551139,17280813,,453254,20111502,4031813,PDP
SS178,,2005,1984,,14572575,39899390,21672111,,14006336,19694385,17510675,,566239,20205005,4161436,PDP
SS178,,2006,1984,,14696763,39960521,21807176,,14205638,19833241,17734684,,491125,20127280,4072492,PDP
SS178,,2007,1984,,14696763,39960521,21807176,,14385078,19982090,17940610,,311685,19978431,3866566,PDP
SS178,,2008,1984,,14696763,39985198,21811567,,14488825,20112792,18067614,,207938,19872406,3743953,PDP
SS178,,2009,1984,,15217745,40899639,22495261,,14584669,20482151,18229179,,633076,20417488,4266081,PDP
SS178,,2010,1984,,15324622,40931900,22607879,,14710512,20496746,18357620,,614110,20435154,4250258,PDP
SS178,,2011,1984,,15324622,40931900,22607879,,14824873,20556648,18482639,,499749,20375252,4125239,PDP
SS178,,2012,1984,,15324622,40931900,22607879,,14878524,20570775,18538803,,446098,20361125,4069074,PDP
SS178,,2013,1984,,15324622,40931900,22607879,,14997648,20627647,18668047,,326974,20304253,3939831,PDP
SS178,,2014,1984,,15379202,40931026,22662303,,15104511,20637403,18776646,,274691,20293623,3885656,PDP
SS178,,2015,1984,,15540615,40962341,22829288,,15204757,20658376,18880625,,335858,20303965,3948663,PDP
SS178,,2016,1984,,15540615,40962341,22829288,,15292012,20674569,18970760,,248603,20287772,3858527,PDP
SS178,,2017,1984,,15592867,40975038,22883799,,15377474,20707426,19062069,,215393,20267612,3821729,PDP
SS178,,2017,1984,,15592867,40975038,22883799,,15377474,20707426,19062069,,215393,20267612,3821729,PDP
SS189,,1975,1961,,0,30887000,5495907,,0,3687118,656071,,0,27199882,4839836,PDP
SS189,,1976,1961,,0,30887000,5495907,,0,5986392,1065194,,0,24900608,4430713,PDP
SS189,,1977,1961,,0,30887000,5495907,,0,8096483,1440655,,0,22790517,4055252,PDP
SS189,,1978,1961,,0,30887000,5495907,,0,10113002,1799467,,0,20773998,3696440,PDP
SS189,,1979,1961,,0,30887000,5495907,,0,13708022,2439150,,0,17178978,3056757,PDP
SS189,,1980,1961,,0,30887000,5495907,,0,17404335,3096857,,0,13482665,2399050,PDP
SS189,,1981,1961,,0,30887000,5495907,,0,21139935,3761554,,0,9747065,1734353,PDP
SS189,,1982,1961,,0,30887000,5495907,,0,24699356,4394903,,0,6187644,1101004,PDP
SS189,,1983,1961,,0,30887000,5495907,,0,26750434,4759864,,0,4136566,736043,PDP
SS189,,1984,1961,,114537,37759236,6833262,,0,29958119,5330626,,114537,7801117,1502636,PDP
SS189,,1985,1961,,114537,46057244,8309776,,0,32220119,5733117,,114537,13837125,2576659,PDP
SS189,,1986,1961,,114537,46057244,8309776,,0,33369942,5937712,,114537,12687302,2372064,PDP
SS189,,1987,1961,,420552,91364796,16677633,,62567,41095146,7374871,,357985,50269650,9302762,PDP
SS189,,1988,1961,,446829,96993923,17705534,,112345,50770420,9146228,,334484,46223503,8559306,PDP
SS189,,1989,1961,,552775,108111370,19789674,,200992,61813855,11199899,,351783,46297515,8589775,PDP
SS189,,1990,1961,,1033911,179556252,32983422,,289120,70625493,12855934,,744791,108930759,20127488,PDP
SS189,,1991,1961,,736015,142031676,26008555,,303608,72981573,13289653,,432407,69050103,12718902,PDP
SS189,,1992,1961,,675010,134381051,24586229,,325706,76119960,13870183,,349304,58261091,10716046,PDP
SS189,,1993,1961,,584242,126089732,23020137,,337737,78104687,14235368,,246505,47985045,8784769,PDP
SS189,,1994,1961,,584242,126089733,23020138,,353884,80554538,14687432,,230358,45535195,8332706,PDP
SS189,,1995,1961,,655259,126089733,23091155,,371181,84287001,15368868,,284078,41802732,7722287,PDP
SS189,,1996,1961,,640682,123560064,22626459,,382330,87750377,15996276,,258352,35809687,6630183,PDP
SS189,,1997,1961,,640682,123560064,22626459,,390890,90933479,16571224,,249792,32626585,6055235,PDP
SS189,,1998,1961,,640682,123560064,22626459,,391267,93269745,16987307,,249415,30290319,5639152,PDP
SS189,,1999,1961,,610301,123801726,22639078,,414283,98555031,17950765,,196018,25246695,4688313,PDP
SS189,,2000,1961,,757020,138883516,25469389,,513396,112215051,20480487,,243624,26668465,4988902,PDP
SS189,,2001,1961,,898935,169410954,31043233,,638726,129956407,23762642,,260209,39454547,7280591,PDP
SS189,,2002,1961,,898939,169413273,31043649,,739659,147153925,26923631,,159280,22259348,4120018,PDP
SS189,,2003,1961,,962815,176969501,32452050,,806551,156897082,28724181,,156264,20072419,3727869,PDP
SS189,,2004,1961,,857761,167495436,30661219,,819681,160666971,29408110,,38080,6828465,1253109,PDP
SS189,,2005,1961,,882871,167479364,30683470,,823780,162126832,29671971,,59091,5352532,1011499,PDP
SS189,,2006,1961,,882871,167479364,30683470,,846698,164275908,30077287,,36173,3203456,606183,PDP
SS189,,2007,1961,,882871,167479364,30683470,,866436,165312360,30281447,,16435,2167004,402023,PDP
SS189,,2008,1961,,1297202,184431849,34114257,,874802,165961714,30405356,,422400,18470135,3708901,PDP
SS189,,2009,1961,,1718237,221979792,41216419,,1041458,182138004,33450353,,676779,39841788,7766066,PDP
SS189,,2010,1961,,1751654,229390729,42568507,,1337192,201199216,37137762,,414462,28191513,5430745,PDP
SS189,,2011,1961,,1751654,229390729,42568507,,1518801,215569132,39876295,,232853,13821597,2692212,PDP
SS189,,2012,1961,,2012971,260451124,48356586,,1726919,227617262,42228210,,286052,32833862,6128377,PDP
SS189,,2013,1961,,2003917,260319303,48324076,,1834014,243709361,45198668,,169903,16609942,3125409,PDP
SS189,,2014,1961,,2157907,272616197,50666126,,1955286,260051583,48227808,,202621,12564614,2438317,PDP
SS189,,2015,1961,,2379436,284718790,53041140,,2157076,273632958,50846213,,222360,11085832,2194928,PDP
SS189,,2016,1961,,2517767,292307424,54529762,,2317704,283397118,52744235,,200063,8910306,1785527,PDP
SS189,,2017,1961,,2535733,298070944,55573266,,2411224,292037195,54375136,,124509,6033749,1198131,PDP
SS189,,2017,1961,,2535733,298070944,55573266,,2411224,292037195,54375136,,124509,6033749,1198131,PDP
SS207,,1975,1967,,100000000,400000000,171174377,,53555297,199654180,89080952,,46444703,200345820,82093425,PDP
SS207,,1976,1967,,100000000,400000000,171174377,,59902822,213514559,97894736,,40097178,186485441,73279641,PDP
SS207,,1977,1967,,100000000,400000000,171174377,,66681298,226541677,106991205,,33318702,173458323,64183172,PDP
SS207,,1978,1967,,100000000,400000000,171174377,,70953580,238226933,113342714,,29046420,161773067,57831663,PDP
SS207,,1979,1967,,100000000,400000000,171174377,,71885300,257132196,117638360,,28114700,142867804,53536017,PDP
SS207,,1980,1967,,92672950,312948891,148357806,,74959239,264292347,121986347,,17713711,48656544,26371459,PDP
SS207,,1981,1967,,87672950,307948891,142468126,,77799110,270830080,125989516,,9873840,37118811,16478610,PDP
SS207,,1982,1967,,88443968,309118877,143447327,,81852078,276169363,130992534,,6591890,32949514,12454793,PDP
SS207,,1983,1967,,90540686,314037152,146419183,,82526322,280304724,132402607,,8014364,33732428,14016576,PDP
SS207,,1984,1967,,98843546,324615155,156604250,,84625927,284700292,135284342,,14217619,39914863,21319908,PDP
SS207,,1985,1967,,104849303,335631029,164570127,,86491377,290106352,138111724,,18357926,45524677,26458403,PDP
SS207,,1986,1967,,108862003,337765514,168962628,,88198283,294654512,140627911,,20663720,43111002,28334717,PDP
SS207,,1987,1967,,114704143,397228915,185385445,,89403640,298171916,142459141,,25300503,99056999,42926304,PDP
SS207,,1988,1967,,103846528,367882109,169305978,,90399293,300530438,143874460,,13447235,67351671,25431518,PDP
SS207,,1989,1967,,103852661,368750144,169466566,,91188868,302833676,145073864,,12663793,65916468,24392702,PDP
SS207,,1990,1967,,104707539,374002096,171255955,,92023673,305326199,146352178,,12683866,68675897,24903777,PDP
SS207,,1991,1967,,100490023,345839307,162027266,,92985959,312849062,148653052,,7504064,32990245,13374214,PDP
SS207,,1992,1967,,100490023,345839307,162027266,,93733627,318176938,150348741,,6756396,27662369,11678525,PDP
SS207,,1993,1967,,100622580,344184704,161865410,,94529670,321517026,151739105,,6092910,22667678,10126305,PDP
SS207,,1994,1967,,100700276,346475730,162350762,,95414696,328078758,153791699,,5285580,18396972,8559063,PDP
SS207,,1995,1967,,100285697,378695787,167669289,,96392054,338457812,156615864,,3893643,40237975,11053425,PDP
SS207,,1996,1967,,103300648,447954732,183007896,,97781567,363438656,162450367,,5519081,84516076,20557529,PDP
SS207,,1997,1967,,101156343,434747453,178513541,,98544126,385181011,167081672,,2612217,49566442,11431869,PDP
SS207,,1998,1967,,101481380,442529961,180223366,,99314172,405134534,171402167,,2167208,37395427,8821199,PDP
SS207,,1999,1967,,101767574,445815861,181094239,,99765832,412627582,173187110,,2001742,33188279,7907129,PDP
SS207,,2000,1967,,104775669,466498453,187782511,,100483976,417710814,174809744,,4291693,48787639,12972767,PDP
SS207,,2001,1967,,104891906,464463549,187536665,,101544734,427542659,177619940,,3347172,36920890,9916725,PDP
SS207,,2002,1967,,105346642,462449691,187633064,,102361524,431431760,179128741,,2985118,31017931,8504323,PDP
SS207,,2003,1967,,107035588,479018796,192270249,,103652512,437076543,181424139,,3383076,41942253,10846110,PDP
SS207,,2004,1967,,106756910,466902028,189835562,,104364085,445791850,183686478,,2392825,21110178,6149084,PDP
SS207,,2005,1967,,106959611,467788842,190196060,,104999467,453437906,185682368,,1960144,14350936,4513692,PDP
SS207,,2006,1967,,107227721,462659013,189551389,,105840327,455803695,186944187,,1387394,6855318,2607202,PDP
SS207,,2007,1967,,107890789,465176900,190662479,,106487354,457782624,187943337,,1403435,7394276,2719142,PDP
SS207,,2008,1967,,107994607,467443840,191169667,,106826588,458802200,188463990,,1168019,8641640,2705677,PDP
SS207,,2009,1967,,109496023,476452976,194274134,,106826587,466831225,189892644,,2669436,9621751,4381491,PDP
SS207,,2010,1967,,109496023,476452976,194274134,,107304862,467731374,190531088,,2191161,8721602,3743049,PDP
SS207,,2011,1967,,109604092,476550867,194399621,,107864445,469549917,191414253,,1739647,7000950,2985367,PDP
SS207,,2012,1967,,109624447,477028913,194505038,,108288074,470253840,191963136,,1336373,6775073,2541902,PDP
SS207,,2013,1967,,109624445,477032950,194505755,,108659266,471248754,192511358,,965179,5784196,1994395,PDP
SS207,,2014,1967,,110224138,479189644,195489202,,109037120,472196371,193057827,,1187018,6993273,2431371,PDP
SS207,,2015,1967,,110299490,479373794,195597320,,109371652,472679404,193478309,,927838,6694390,2119011,PDP
SS207,,2016,1967,,110852863,481098670,196457610,,109657935,473011636,193823707,,1194928,8087034,2633902,PDP
SS207,,2017,1967,,111375801,479394780,196677364,,109989969,473446131,194233052,,1385832,5948649,2444310,PDP
SS207,,2017,1967,,111375801,479394780,196677364,,109989969,473446131,194233052,,1385832,5948649,2444310,PDP
SS208,,1975,1960,,188000000,1417896000,440294662,,108144835,704182677,233444244,,79855165,713713323,206850418,PDP
SS208,,1976,1960,,175000000,1243548000,396271886,,116029364,772732663,253526279,,58970636,470815337,142745607,PDP
SS208,,1977,1960,,175000000,1250028000,397424911,,127594502,829772195,275240800,,47405498,420255805,122184111,PDP
SS208,,1978,1960,,175000000,1250028000,397424911,,132867996,873819950,288351973,,42132004,376208050,109072938,PDP
SS208,,1979,1960,,175000000,1250028000,397424911,,132210034,912710816,294614094,,42789966,337317184,102810817,PDP
SS208,,1980,1960,,175000000,1250028000,397424911,,136530067,935983485,303075171,,38469933,314044515,94349740,PDP
SS208,,1981,1960,,162297840,1097368653,357559166,,140338139,955680982,310388136,,21959701,141687671,47171030,PDP
SS208,,1982,1960,,163037574,1105560569,359756536,,144171111,976555898,317935506,,18866463,129004671,41821030,PDP
SS208,,1983,1960,,184503696,1127991110,385213858,,147558467,988458550,323440771,,36945229,139532560,61773087,PDP
SS208,,1984,1960,,195992742,1188368012,407446125,,151014808,1000473796,329035056,,44977934,187894216,78411069,PDP
SS208,,1985,1960,,200429668,1203770451,414623698,,156019987,1017389733,337050189,,44409681,186380718,77573509,PDP
SS208,,1986,1960,,205428080,1279475724,433092800,,161659063,1037080201,346192907,,43769017,242395523,86899893,PDP
SS208,,1987,1960,,210107631,1273367910,436685551,,168683084,1054468668,356310961,,41424547,218899242,80374590,PDP
SS208,,1988,1960,,220378201,1258164657,444250916,,172615616,1065827189,362264582,,47762585,192337468,81986334,PDP
SS208,,1989,1960,,221814507,1296720471,452547687,,175837375,1074350553,367002954,,45977132,222369918,85544733,PDP
SS208,,1990,1960,,203320704,1188163059,414737618,,178665170,1084509257,371638347,,24655534,103653802,43099271,PDP
SS208,,1991,1960,,204175245,1194749467,416764118,,181573843,1094689248,376358407,,22601402,100060219,40405711,PDP
SS208,,1992,1960,,207036443,1191560801,419057938,,184855781,1103066193,381130904,,22180662,88494608,37927034,PDP
SS208,,1993,1960,,205997760,1175010315,415074329,,188347982,1118515838,387372152,,17649778,56494477,27702177,PDP
SS208,,1994,1960,,207077225,1185532084,418025994,,191026256,1130979118,392268092,,16050969,54552966,25757902,PDP
SS208,,1995,1960,,210937821,1231590271,430081997,,193617925,1149221889,398105806,,17319896,82368382,31976191,PDP
SS208,,1996,1960,,208017922,1242055595,429024256,,196438129,1171626453,404912587,,11579793,70429142,24111669,PDP
SS208,,1997,1960,,208491333,1298879820,439608739,,198995162,1197721543,412112874,,9496171,101158277,27495865,PDP
SS208,,1998,1960,,209235829,1304518447,441356549,,201126128,1224717473,419047387,,8109701,79800974,22309162,PDP
SS208,,1999,1960,,214108005,1337120285,452029764,,203139596,1242499505,424224917,,10968409,94620780,27804847,PDP
SS208,,2000,1960,,220154877,1423676596,473478114,,206703014,1267658203,432264972,,13451863,156018393,41213142,PDP
SS208,,2001,1960,,220379419,1424523114,473853282,,209411148,1293399956,439553489,,10968271,131123158,34299793,PDP
SS208,,2002,1960,,220369966,1431188056,475029762,,211107195,1307361254,443733753,,9262771,123826802,31296009,PDP
SS208,,2003,1960,,221169493,1436113184,476705646,,212660523,1319464320,447440651,,8508970,116648864,29264995,PDP
SS208,,2004,1960,,223428737,1437286267,479173624,,213970249,1327063519,450102548,,9458488,110222748,29071076,PDP
SS208,,2005,1960,,223518318,1443489479,480366979,,215192740,1333551734,452479525,,8325578,109937745,27887454,PDP
SS208,,2006,1960,,222484527,1412578933,473833091,,215995826,1338528760,454168203,,6488701,74050173,19664888,PDP
SS208,,2007,1960,,222484527,1412578933,473833091,,217055166,1342278157,455894696,,5429361,70300776,17938395,PDP
SS208,,2008,1960,,222721138,1413105263,474163355,,217590802,1344843816,456886855,,5130336,68261447,17276500,PDP
SS208,,2009,1960,,223559372,1411544496,474723866,,217690333,1371469678,461724083,,5869039,40074818,12999788,PDP
SS208,,2010,1960,,223616358,1419763387,476243288,,218216171,1373498082,462610846,,5400187,46265305,13632444,PDP
SS208,,2011,1960,,224005090,1418936337,476484860,,219296610,1378305426,464546685,,4708480,40630911,11938175,PDP
SS208,,2012,1960,,224261924,1419413518,476826601,,220205451,1382674258,466232900,,4056473,36739260,10593705,PDP
SS208,,2013,1960,,225382491,1421060513,478240226,,221193359,1386279346,467862280,,4189132,34781167,10377949,PDP
SS208,,2014,1960,,227029250,1424513575,480501409,,222645626,1389939700,469965855,,4383624,34573875,10535555,PDP
SS208,,2015,1960,,230259541,1429552157,484628246,,224227170,1393758015,472226820,,6032371,35794142,12401431,PDP
SS208,,2016,1960,,233516971,1433700083,488623743,,225462368,1396518477,473953200,,8054603,37181606,14670545,PDP
SS208,,2017,1960,,233990355,1433822622,489118931,,226362671,1399061272,475305956,,7627684,34761350,13812975,PDP
SS208,,2017,1960,,233990355,1433822622,489118931,,226362671,1399061272,475305956,,7627684,34761350,13812975,PDP
SS222,,1975,1966,,45968470,693292074,169330049,,18898934,314434896,74848204,,27069536,378857178,94481845,PDP
SS222,,1976,1966,,45968470,693292074,169330049,,22499032,379092212,89953162,,23469438,314199862,79376887,PDP
SS222,,1977,1966,,51857746,814272899,196746162,,29069201,491574122,116537906,,22788545,322698777,80208256,PDP
SS222,,1978,1966,,54116215,816215722,199350329,,32213090,542664284,128772571,,21903125,273551438,70577758,PDP
SS222,,1979,1966,,54115011,857833455,206754416,,29101170,576823064,131738726,,25013841,281010391,75015690,PDP
SS222,,1980,1966,,54800718,877008119,210851985,,32517356,609703319,141005491,,22283362,267304800,69846494,PDP
SS222,,1981,1966,,55699200,885461745,213254671,,34204555,610945358,142913693,,21494645,274516387,70340978,PDP
SS222,,1982,1966,,60069512,994213058,236975750,,37925052,632374793,150447257,,22144460,361838265,86528493,PDP
SS222,,1983,1966,,56945212,824976513,203738186,,40210237,652267063,156271992,,16734975,172709450,47466194,PDP
SS222,,1984,1966,,60095822,856352832,212471771,,42258238,672261541,161877729,,17837584,184091291,50594042,PDP
SS222,,1985,1966,,63058492,871714470,218167828,,44835180,690345607,167672477,,18223312,181368863,50495351,PDP
SS222,,1986,1966,,63952064,879197805,220392955,,46456772,698559669,170755645,,17495292,180638136,49637310,PDP
SS222,,1987,1966,,64160655,859277816,217057064,,48102326,707355165,173966234,,16058329,151922651,43090830,PDP
SS222,,1988,1966,,66268342,908979776,228008516,,49339704,716699808,176866360,,16928638,192279968,51142156,PDP
SS222,,1989,1966,,62126457,798941016,204286780,,50438197,726030465,179625112,,11688260,72910551,24661668,PDP
SS222,,1990,1966,,64416537,826585312,211495774,,51577806,734310328,182238007,,12838731,92274984,29257767,PDP
SS222,,1991,1966,,64721384,827671086,211993819,,52794006,743960201,185171266,,11927378,83710885,26822553,PDP
SS222,,1992,1966,,61708484,796081481,203359993,,54109531,751563450,187839682,,7598953,44518031,15520311,PDP
SS222,,1993,1966,,62333896,797513781,204240263,,55476255,756970034,190168432,,6857641,40543747,14071831,PDP
SS222,,1994,1966,,62854437,798454488,204928189,,56719710,761047835,192137474,,6134727,37406653,12790715,PDP
SS222,,1995,1966,,64827502,807105084,208440506,,58050592,767559208,194626964,,6776910,39545876,13813542,PDP
SS222,,1996,1966,,64272573,829398525,211852382,,59186655,776013186,197267293,,5085918,53385339,14585089,PDP
SS222,,1997,1966,,65126927,837456957,214140620,,60239391,788250103,200497416,,4887536,49206854,13643204,PDP
SS222,,1998,1966,,65257837,833625924,213589852,,61151362,797249015,203010617,,4106475,36376909,10579235,PDP
SS222,,1999,1966,,67122887,841082261,216781652,,62189308,803109939,205091432,,4933579,37972322,11690220,PDP
SS222,,2000,1966,,66079265,838905229,215350658,,62981102,806984828,206572708,,3098163,31920401,8777950,PDP
SS222,,2001,1966,,65446167,828345684,212838637,,63526789,811192442,207867081,,1919378,17153242,4971556,PDP
SS222,,2002,1966,,65817238,830760965,213639474,,63947834,813178582,208641532,,1869404,17582383,4997942,PDP
SS222,,2003,1966,,66875061,833042956,215103345,,64585586,816648324,209896676,,2289475,16394632,5206669,PDP
SS222,,2004,1966,,67166600,829856522,214827903,,65240195,820534875,211242842,,1926405,9321647,3585061,PDP
SS222,,2005,1966,,67316599,831028031,215186355,,65905462,823558269,212446079,,1411137,7469762,2740276,PDP
SS222,,2006,1966,,67316490,830998202,215180939,,66362744,825866916,213314153,,953746,5131286,1866786,PDP
SS222,,2007,1966,,67416528,832234234,215500911,,66839750,828811039,214315024,,576778,3423195,1185887,PDP
SS222,,2008,1966,,68433309,837355291,217428912,,67232809,831059085,215108091,,1200500,6296206,2320821,PDP
SS222,,2009,1966,,70421701,862561459,223902388,,67634557,849533711,218797138,,2787144,13027748,5105249,PDP
SS222,,2010,1966,,71239850,863435476,224876056,,68385861,851757984,219944220,,2853989,11677492,4931838,PDP
SS222,,2011,1966,,71239850,863461842,224880748,,69164978,853434924,221021725,,2074872,10026918,3859022,PDP
SS222,,2012,1966,,71755276,863928909,225479283,,69680349,854675392,221757821,,2074927,9253517,3721460,PDP
SS222,,2013,1966,,71953172,864277734,225739248,,70071696,855481442,222292592,,1881476,8796292,3446652,PDP
SS222,,2014,1966,,71993797,864342016,225791310,,70400140,856191873,222747447,,1593657,8150143,3043859,PDP
SS222,,2015,1966,,72251519,865334288,226225593,,70683188,856847694,223147189,,1568331,8486594,3078403,PDP
SS222,,2016,1966,,72354914,865541121,226365791,,70930821,857383751,223490206,,1424093,8157370,2875584,PDP
SS222,,2017,1966,,72233908,860238757,225301303,,71197103,858028111,223871142,,1036805,2210646,1430157,PDP
SS222,,2017,1966,,72233908,860238757,225301303,,71197103,858028111,223871142,,1036805,2210646,1430157,PDP
SS230,,1975,1962,,102000000,234960000,143807829,,42715050,110073837,62301142,,59284950,124886163,81506687,PDP
SS230,,1976,1962,,102000000,234960000,143807829,,48850607,124952123,71084081,,53149393,110007877,72723748,PDP
SS230,,1977,1962,,102000000,234960000,143807829,,55623732,139169712,80387026,,46376268,95790288,63420803,PDP
SS230,,1978,1962,,97908106,246459988,141762196,,60934810,149034065,87453327,,36973296,97425923,54308869,PDP
SS230,,1979,1962,,96608106,246459988,140462196,,64452588,159062565,92755536,,32155518,87397423,47706660,PDP
SS230,,1980,1962,,106836304,273079107,155426892,,68764181,166508356,98392002,,38072123,106570751,57034890,PDP
SS230,,1981,1962,,107609179,276131342,156742870,,72651986,174254338,103658096,,34957193,101877004,53084774,PDP
SS230,,1982,1962,,111638667,284265945,162219796,,77168153,180563181,109296833,,34470514,103702764,52922963,PDP
SS230,,1983,1962,,117264176,336814223,177195532,,79819244,186130781,112938600,,37444932,150683442,64256932,PDP
SS230,,1984,1962,,131590735,365569625,196638711,,83416115,192862692,117733320,,48174620,172706933,78905391,PDP
SS230,,1985,1962,,149811615,360755414,214002970,,86702330,198769008,122070481,,63109285,161986406,91932489,PDP
SS230,,1986,1962,,139807706,312626696,195435232,,89978078,204783852,126416486,,49829628,107842844,69018746,PDP
SS230,,1987,1962,,131683808,310296888,186896777,,92773899,208905355,129945670,,38909909,101391533,56951107,PDP
SS230,,1988,1962,,134407084,316965903,190806711,,95243443,215243080,133542923,,39163641,101722823,57263788,PDP
SS230,,1989,1962,,135367781,332216819,194481094,,97396124,221515587,136811709,,37971657,110701232,57669385,PDP
SS230,,1990,1962,,135617533,335476898,195310931,,99143389,226644048,139471511,,36474144,108832850,55839420,PDP
SS230,,1991,1962,,110188506,265031827,157347194,,100632339,232045650,141921601,,9556167,32986177,15425593,PDP
SS230,,1992,1962,,110443072,268288922,158181314,,102158555,234973468,143968781,,8284517,33315454,14212533,PDP
SS230,,1993,1962,,112235858,269455265,160181635,,103667083,237281597,145888008,,8568775,32173668,14293627,PDP
SS230,,1994,1962,,114500016,276794636,163751731,,105138243,241568962,148122044,,9361773,35225674,15629687,PDP
SS230,,1995,1962,,117878581,302805201,171758510,,106810319,257531400,152634412,,11068262,45273801,19124098,PDP
SS230,,1996,1962,,117016603,335044902,176633134,,108772592,280460340,158676567,,8244011,54584562,17956567,PDP
SS230,,1997,1962,,121998694,352881228,184788948,,111193911,295888426,163843097,,10804783,56992802,20945851,PDP
SS230,,1998,1962,,122939630,365041536,187893640,,113813927,305581912,168187933,,9125703,59459624,19705707,PDP
SS230,,1999,1962,,123825452,371750978,189973313,,115776322,312952896,171461891,,8049130,58798082,18511422,PDP
SS230,,2000,1962,,129298456,394688589,199527742,,117322366,318311326,173961392,,11976090,76377263,25566350,PDP
SS230,,2001,1962,,129442221,387036127,198309859,,118762398,322397927,176128577,,10679823,64638200,22181282,PDP
SS230,,2002,1962,,129252206,389610601,198577936,,119720945,327668046,178024868,,9531261,61942555,20553068,PDP
SS230,,2003,1962,,130136510,391166008,199739003,,120539627,332971580,179787239,,9596883,58194428,19951764,PDP
SS230,,2004,1962,,131797968,390451305,201273289,,121272011,336431027,181135183,,10525957,54020278,20138106,PDP
SS230,,2005,1962,,133451575,404906916,205499069,,122534318,343300754,183619861,,10917257,61606162,21879208,PDP
SS230,,2006,1962,,133466482,404957901,205523048,,123860899,351901268,186476783,,9605583,53056633,19046265,PDP
SS230,,2007,1962,,133651735,403879512,205516416,,124951410,360661091,189125981,,8700325,43218421,16390435,PDP
SS230,,2008,1962,,133698519,404801522,205727259,,125609291,365265289,190603115,,8089228,39536233,15124144,PDP
SS230,,2009,1962,,138981625,426319815,214839243,,126295875,374866025,192998015,,12685750,51453790,21841228,PDP
SS230,,2010,1962,,141335915,436777036,219054249,,128010463,382260462,196028337,,13325452,54516574,23025912,PDP
SS230,,2011,1962,,141428355,442785621,220215832,,129587618,388495983,198715013,,11840737,54289638,21500817,PDP
SS230,,2012,1962,,142284077,445372090,221531783,,130967261,392855606,200870390,,11316816,52516484,20661390,PDP
SS230,,2013,1962,,143355391,446247776,222758912,,132590089,401239858,203985080,,10765302,45007918,18773828,PDP
SS230,,2014,1962,,144391012,455140782,225376917,,134236932,409709135,207138910,,10154080,45431647,18238008,PDP
SS230,,2015,1962,,146094198,461129504,228145714,,135693874,416283922,209765745,,10400324,44845582,18379965,PDP
SS230,,2016,1962,,147798674,468538303,231168480,,136924018,421217809,211873802,,10874656,47320494,19294674,PDP
SS230,,2017,1962,,147944126,471112483,231771970,,137957432,425641315,213694324,,9986694,45471168,18077649,PDP
SS230,,2017,1962,,147944126,471112483,231771970,,137957432,425641315,213694324,,9986694,45471168,18077649,PDP
SS235,,2007,2007,,20,4211517,749400,,0,0,0,,20,4211517,749400,PDN
SS235,,2008,2007,,20,4211517,749400,,7,1755655,312401,,13,2455862,436999,PDN
SS235,,2009,2007,,7,4296715,764547,,7,3459537,615583,,0,837178,148964,PDN
SS235,,2010,2007,,89,3610168,642468,,89,3608212,642120,,0,1956,348,PDN
SS235,,2011,2007,,89,3610168,642468,,89,3610168,642468,,0,0,0,PDN
SS235,,2012,2007,,89,3610168,642468,,89,3610168,642468,,0,0,0,PDN
SS235,,2013,2007,,89,3610168,642468,,89,3610168,642468,,0,0,0,PDN
SS235,,2014,2007,,89,3610168,642468,,89,3610168,642468,,0,0,0,PDN
SS235,,2015,2007,,89,3610168,642468,,89,3610168,642468,,0,0,0,PDN
SS235,,2016,2007,,89,3610168,642468,,89,3610168,642468,,0,0,0,PDN
SS235,,2017,2007,,89,3610168,642468,,89,3610168,642468,,0,0,0,PDN
SS235,,2017,2007,,89,3610168,642468,,89,3610168,642468,,0,0,0,PDN
SS237,,1980,1980,,10000,10000000,1789359,,0,0,0,,10000,10000000,1789359,PDN
SS237,,1981,1980,,10000,10000000,1789359,,0,0,0,,10000,10000000,1789359,PDN
SS237,,1982,1980,,10000,10000000,1789359,,0,0,0,,10000,10000000,1789359,PDN
SS237,,1983,1980,,10000,10000000,1789359,,0,0,0,,10000,10000000,1789359,PDN
SS237,,1984,1980,,10000,10000000,1789359,,0,321963,57289,,10000,9678037,1732070,PDN
SS237,,1985,1980,,0,3528763,627894,,0,1491816,265448,,0,2036947,362446,PDN
SS237,,1986,1980,,1000,9373063,1668805,,0,5826370,1036721,,1000,3546693,632084,PDN
SS237,,1987,1980,,349,9701736,1726637,,243,8382227,1491742,,106,1319509,234895,PDN
SS237,,1988,1980,,563,11716329,2085319,,243,9168156,1631587,,320,2548173,453732,PDN
SS237,,1989,1980,,563,11716329,2085319,,243,9537068,1697230,,320,2179261,388089,PDN
SS237,,1990,1980,,243,9537068,1697230,,243,9537068,1697230,,0,0,0,PDN
SS237,,1991,1980,,243,9537068,1697230,,243,9537068,1697230,,0,0,0,PDN
SS237,,1992,1980,,243,9537068,1697230,,243,9537068,1697230,,0,0,0,PDN
SS237,,1993,1980,,243,9537068,1697230,,243,9537068,1697230,,0,0,0,PDN
SS237,,1994,1980,,243,9537068,1697230,,243,9537068,1697230,,0,0,0,PDN
SS237,,1995,1980,,243,9537068,1697230,,243,9537068,1697230,,0,0,0,PDN
SS237,,1996,1980,,243,9537068,1697230,,243,9537068,1697230,,0,0,0,PDN
SS237,,1997,1980,,243,9537068,1697230,,243,9537068,1697230,,0,0,0,PDN
SS237,,1998,1980,,243,9537068,1697230,,243,9537068,1697230,,0,0,0,PDN
SS237,,1999,1980,,243,9537068,1697230,,243,9537068,1697230,,0,0,0,PDN
SS237,,2000,1980,,243,9537068,1697230,,243,9537068,1697230,,0,0,0,PDN
SS237,,2001,1980,,243,9537068,1697230,,243,9537068,1697230,,0,0,0,PDN
SS237,,2002,1980,,243,9537068,1697230,,243,9537068,1697230,,0,0,0,PDN
SS237,,2003,1980,,243,9537068,1697230,,243,9537068,1697230,,0,0,0,PDN
SS237,,2004,1980,,243,9537068,1697230,,243,9537068,1697230,,0,0,0,PDN
SS237,,2005,1980,,243,9537068,1697230,,243,9537068,1697230,,0,0,0,PDN
SS237,,2006,1980,,243,9537068,1697230,,243,9537068,1697230,,0,0,0,PDN
SS237,,2007,1980,,243,9537068,1697230,,243,9537068,1697230,,0,0,0,PDN
SS237,,2008,1980,,243,9537068,1697230,,243,9537068,1697230,,0,0,0,PDN
SS237,,2009,1980,,243,9728070,1731216,,243,9728070,1731216,,0,0,0,PDN
SS237,,2010,1980,,243,9728070,1731216,,243,9728070,1731216,,0,0,0,PDN
SS237,,2011,1980,,243,9728070,1731216,,243,9728070,1731216,,0,0,0,PDN
SS237,,2012,1980,,243,9728070,1731216,,243,9728070,1731216,,0,0,0,PDN
SS237,,2013,1980,,243,9728070,1731216,,243,9728070,1731216,,0,0,0,PDN
SS237,,2014,1980,,243,9728070,1731216,,243,9728070,1731216,,0,0,0,PDN
SS237,,2015,1980,,243,9728070,1731216,,243,9728070,1731216,,0,0,0,PDN
SS237,,2016,1980,,243,9728070,1731216,,243,9728070,1731216,,0,0,0,PDN
SS237,,2017,1980,,243,9728070,1731216,,243,9728070,1731216,,0,0,0,PDN
SS237,,2017,1980,,243,9728070,1731216,,243,9728070,1731216,,0,0,0,PDN
SS239,,1975,1965,,2793582,45253400,10845788,,2147763,32041234,7849050,,645819,13212166,2996738,PDP
SS239,,1976,1965,,2793582,45253400,10845788,,2253055,36256758,8704435,,540527,8996642,2141353,PDP
SS239,,1977,1965,,2793582,45253400,10845788,,2329368,37435695,8990524,,464214,7817705,1855264,PDP
SS239,,1978,1965,,2885821,46774400,11208668,,2381399,39425868,9396678,,504422,7348532,1811990,PDP
SS239,,1979,1965,,2405821,46774400,10728668,,2122542,41863231,9571515,,283279,4911169,1157153,PDP
SS239,,1980,1965,,2352491,58245394,12716440,,2157799,46091128,10359067,,194692,12154266,2357373,PDP
SS239,,1981,1965,,2352491,58245394,12716440,,2201177,48878206,10898367,,151314,9367188,1818073,PDP
SS239,,1982,1965,,2749206,83084921,17533000,,2353650,57063527,12507302,,395556,26021394,5025698,PDP
SS239,,1983,1965,,13707028,128582683,36586509,,3323674,77799260,17166959,,10383354,50783423,19419550,PDP
SS239,,1984,1965,,13799214,137039958,38183548,,4320851,94906679,21208160,,9478363,42133279,16975388,PDP
SS239,,1985,1965,,17860609,155517634,45532786,,5039050,105873683,23877784,,12821559,49643951,21655002,PDP
SS239,,1986,1965,,17861994,156276783,45669251,,5699531,114349209,26046365,,12162463,41927574,19622886,PDP
SS239,,1987,1965,,13967220,159335640,42318757,,6220897,121850893,27902551,,7746323,37484747,14416206,PDP
SS239,,1988,1965,,10618830,155002735,38199388,,6731278,126500431,29240251,,3887552,28502304,8959137,PDP
SS239,,1989,1965,,10858936,155002329,38439422,,7221364,130077160,30366766,,3637572,24925169,8072656,PDP
SS239,,1990,1965,,10858936,158637314,39086216,,7699156,132635517,31299782,,3159780,26001797,7786434,PDP
SS239,,1991,1965,,10654760,154114760,38077315,,8042015,135100953,32081330,,2612745,19013807,5995985,PDP
SS239,,1992,1965,,10651232,153444990,37954611,,8434753,137183633,32844652,,2216479,16261357,5109959,PDP
SS239,,1993,1965,,11256674,147510053,37504014,,8838606,139400432,33642953,,2418068,8109621,3861061,PDP
SS239,,1994,1965,,11257582,148138924,37616821,,9239669,141890366,34487065,,2017913,6248558,3129756,PDP
SS239,,1995,1965,,11478977,165009931,40840175,,9573225,151577200,36544257,,1905752,13432731,4295918,PDP
SS239,,1996,1965,,14619463,198051161,49859883,,10389629,160974710,39032816,,4229834,37076451,10827067,PDP
SS239,,1997,1965,,15711067,228749047,56413744,,12021132,180881540,44206459,,3689935,47867507,12207285,PDP
SS239,,1998,1965,,16516333,230084930,57456712,,13161967,196956421,48207594,,3354366,33128509,9249118,PDP
SS239,,1999,1965,,16908904,230743187,57966411,,13886056,205595553,50468895,,3022848,25147634,7497516,PDP
SS239,,2000,1965,,16100113,232194865,57415925,,14458371,211626075,52114256,,1641742,20568790,5301669,PDP
SS239,,2001,1965,,15637172,226069671,55863092,,14793670,217089554,53421705,,843502,8980117,2441387,PDP
SS239,,2002,1965,,15637022,226085583,55865773,,15046003,219158494,54042176,,591019,6927089,1823597,PDP
SS239,,2003,1965,,16158112,226607964,56479814,,15238023,220018940,54387301,,920089,6589024,2092513,PDP
SS239,,2004,1965,,16461182,226532817,56769512,,15531293,220277336,54726549,,929889,6255481,2042963,PDP
SS239,,2005,1965,,16534974,226458297,56830045,,15734984,220560253,54980581,,799990,5898044,1849464,PDP
SS239,,2006,1965,,16534974,226458297,56830045,,15862210,220818094,55153686,,672764,5640203,1676359,PDP
SS239,,2007,1965,,16619227,228199637,57224145,,15968539,221111266,55312181,,650688,7088371,1911964,PDP
SS239,,2008,1965,,16903709,232444877,58264007,,16018822,221700544,55467317,,884887,10744333,2796690,PDP
SS239,,2009,1965,,16287687,229974216,57208367,,16174859,227548390,56663897,,112828,2425826,544470,PDP
SS239,,2010,1965,,16424362,231887166,57685424,,16232279,228718731,56929563,,192083,3168435,755861,PDP
SS239,,2011,1965,,16424362,231887166,57685424,,16259936,229707501,57133158,,164426,2179665,552267,PDP
SS239,,2012,1965,,16428551,231945807,57700047,,16286856,230721286,57340466,,141695,1224521,359581,PDP
SS239,,2013,1965,,20113250,235000139,61928222,,16410448,230943014,57503511,,3702802,4057125,4424711,PDP
SS239,,2014,1965,,20113250,235000139,61928222,,16934552,231444581,58116862,,3178698,3555558,3811360,PDP
SS239,,2015,1965,,20112523,235000139,61927495,,17121535,231662907,58342692,,2990988,3337232,3584801,PDP
SS239,,2016,1965,,20112523,235000139,61927495,,17276662,231838436,58529053,,2835861,3161703,3398442,PDP
SS239,,2017,1965,,17669223,232209631,58987663,,17376837,231937506,58646856,,292386,272125,340806,PDP
SS239,,2017,1965,,17669223,232209631,58987663,,17376837,231937506,58646856,,292386,272125,340806,PDP
SS246,,1975,1966,,10366826,145551180,36265612,,0,684343,121769,,10366826,144866837,36143843,PDP
SS246,,1976,1966,,10366826,145551180,36265612,,98546,8929184,1687369,,10268280,136621996,34578243,PDP
SS246,,1977,1966,,10497195,162511120,39413764,,295356,19886002,3833791,,10201839,142625118,35579973,PDP
SS246,,1978,1966,,10648136,167825130,40510259,,530306,30251512,5913137,,10117830,137573618,34597122,PDP
SS246,,1979,1966,,12523203,203520766,48736862,,2654745,60827897,13478214,,9868458,142692869,35258648,PDP
SS246,,1980,1966,,14000367,236213245,56031194,,4665293,94218925,21430226,,9335074,141994320,34600968,PDP
SS246,,1981,1966,,14661946,245241198,58299170,,5785845,136272095,30033549,,8876101,108969103,28265621,PDP
SS246,,1982,1966,,14494460,251594556,59262175,,6457804,174717760,37546373,,8036656,76876796,21715802,PDP
SS246,,1983,1966,,16346144,432064883,93226016,,7158263,201732860,43053790,,9187881,230332023,50172226,PDP
SS246,,1984,1966,,19123956,447737227,98792502,,7660907,237014833,49834365,,11463049,210722394,48958137,PDP
SS246,,1985,1966,,17713872,446065169,97084899,,8009053,266728372,55469617,,9704819,179336797,41615282,PDP
SS246,,1986,1966,,17355882,462813075,99706963,,8224731,286063368,59125686,,9131151,176749707,40581277,PDP
SS246,,1987,1966,,16492126,456568793,97732125,,8396803,303370570,62377331,,8095323,153198223,35354794,PDP
SS246,,1988,1966,,17136985,514331805,108655100,,9828610,352956569,72632270,,7308375,161375236,36022830,PDP
SS246,,1989,1966,,14045207,511698253,105094718,,10126673,373560425,76596500,,3918534,138137828,28498218,PDP
SS246,,1990,1966,,14044393,511027995,104974641,,10379238,393283625,80358531,,3665155,117744370,24616110,PDP
SS246,,1991,1966,,14040281,511009694,104967273,,10538068,406294321,82832431,,3502213,104715373,22134842,PDP
SS246,,1992,1966,,14022190,509412960,104665065,,10669941,416838410,84840477,,3352249,92574550,19824588,PDP
SS246,,1993,1966,,13620159,510076912,104381175,,10764409,424711573,86335863,,2855750,85365339,18045312,PDP
SS246,,1994,1966,,13917463,578637958,116877954,,10872507,461803589,93043964,,3044956,116834369,23833990,PDP
SS246,,1995,1966,,14203795,587233672,118693772,,11236986,492530608,98875884,,2966809,94703064,19817888,PDP
SS246,,1996,1966,,14614431,591531830,119869205,,11528935,519701861,104002576,,3085496,71829969,15866629,PDP
SS246,,1997,1966,,14627686,597453281,120936099,,11743116,538118117,107493671,,2884570,59335164,13442428,PDP
SS246,,1998,1966,,15153019,598172622,121589429,,11908126,550833986,109921291,,3244893,47338636,11668138,PDP
SS246,,1999,1966,,14502741,635781468,127631116,,12249110,563637108,112540410,,2253631,72144360,15090706,PDP
SS246,,2000,1966,,17533259,653870483,133880320,,12728065,574659104,114980575,,4805194,79211379,18899745,PDP
SS246,,2001,1966,,15293933,646480336,130326021,,13455554,588047595,118090357,,1838379,58432741,12235664,PDP
SS246,,2002,1966,,15404189,647335621,130588463,,13676616,596214827,119764664,,1727573,51120794,10823799,PDP
SS246,,2003,1966,,15647333,653349493,131901691,,13889271,603780260,121323481,,1758062,49569233,10578210,PDP
SS246,,2004,1966,,15226931,641400167,129355075,,14122552,611308924,122896382,,1104379,30091243,6458693,PDP
SS246,,2005,1966,,15365932,646346146,130374143,,14288401,617028177,124079892,,1077531,29317969,6294251,PDP
SS246,,2006,1966,,15365932,646258903,130358619,,14449497,622993198,125302379,,916435,23265705,5056240,PDP
SS246,,2007,1966,,15395691,646600828,130449219,,14572399,627335028,126197849,,823292,19265800,4251370,PDP
SS246,,2008,1966,,15395949,647213014,130558407,,14635889,629262781,126604355,,760060,17950233,3954052,PDP
SS246,,2009,1966,,15491568,659955423,132921357,,14680401,641571310,128838996,,811167,18384113,4082362,PDP
SS246,,2010,1966,,15573423,661754633,133323355,,14756439,643375802,129236117,,816984,18378831,4087235,PDP
SS246,,2011,1966,,15595180,663370416,133632618,,14830073,644730514,129550802,,765107,18639902,4081814,PDP
SS246,,2012,1966,,15928367,667135637,134635772,,14944383,648432515,130323834,,983984,18703122,4311941,PDP
SS246,,2013,1966,,15974860,676589570,136364461,,15101103,654199707,131506745,,873757,22389863,4857720,PDP
SS246,,2014,1966,,16003979,676629696,136400720,,15142572,655950326,131859711,,861407,20679370,4541009,PDP
SS246,,2015,1966,,16021658,676844645,136456646,,15175088,656767859,132037695,,846570,20076786,4418950,PDP
SS246,,2016,1966,,16060832,677699225,136647881,,15217030,657433727,132198118,,843802,20265498,4449760,PDP
SS246,,2017,1966,,15758852,668256384,134665682,,15264248,658434001,132423322,,494604,9822383,2242359,PDP
SS246,,2017,1966,,15758852,668256384,134665682,,15264248,658434001,132423322,,494604,9822383,2242359,PDP
SS250,,1998,1981,,1181038,1299142,1412202,,0,0,0,,1181038,1299142,1412202,PDN
SS250,,1999,1981,,558253,6347340,1687673,,222274,2432179,655046,,335979,3915161,1032627,PDN
SS250,,2000,1981,,709160,17060243,3744790,,492993,7312733,1794191,,216167,9747510,1950599,PDN
SS250,,2001,1981,,599886,14083614,3105867,,523712,9088254,2140839,,76174,4995360,965028,PDN
SS250,,2002,1981,,599886,14083614,3105867,,523987,9097148,2142697,,75899,4986466,963170,PDN
SS250,,2003,1981,,599886,14083614,3105867,,523987,9097148,2142697,,75899,4986466,963170,PDN
SS250,,2004,1981,,578882,13720025,3020167,,528372,9174129,2160779,,50510,4545896,859388,PDN
SS250,,2005,1981,,607305,14578878,3201411,,528372,9174129,2160779,,78933,5404749,1040632,PDN
SS250,,2006,1981,,607269,14575648,3200801,,546130,9774028,2285281,,61139,4801620,915520,PDN
SS250,,2007,1981,,710105,15057378,3389354,,596038,10191827,2409530,,114067,4865551,979824,PDN
SS250,,2008,1981,,710105,15057378,3389354,,633380,10219029,2451713,,76725,4838349,937641,PDN
SS250,,2009,1981,,723918,15340558,3453555,,655859,10268026,2482910,,68059,5072532,970645,PDN
SS250,,2010,1981,,773483,15141963,3467782,,692564,10350340,2534262,,80919,4791623,933522,PDN
SS250,,2011,1981,,773483,15141963,3467782,,713195,10400656,2563845,,60288,4741307,903937,PDN
SS250,,2012,1981,,773483,15141963,3467782,,722657,10556526,2601042,,50826,4585437,866740,PDN
SS250,,2013,1981,,722657,10555797,2600912,,722657,10555797,2600912,,0,0,0,PDN
SS250,,2014,1981,,722657,10555797,2600912,,722657,10555797,2600912,,0,0,0,PDN
SS250,,2015,1981,,722657,10555797,2600912,,722657,10555797,2600912,,0,0,0,PDN
SS250,,2016,1981,,722909,10555797,2601164,,722909,10555797,2601164,,0,0,0,PDN
SS250,,2017,1981,,722909,10555797,2601164,,722909,10555797,2601164,,0,0,0,PDN
SS250,,2017,1981,,722909,10555797,2601164,,722909,10555797,2601164,,0,0,0,PDN
SS253,,1975,1962,,20353003,96419087,37509424,,10265289,59890095,20921890,,10087714,36528992,16587534,PDP
SS253,,1976,1962,,20353003,96419087,37509424,,11731552,70636746,24300368,,8621451,25782341,13209056,PDP
SS253,,1977,1962,,23728312,135966787,47921690,,13688631,83486492,28543879,,10039681,52480295,19377811,PDP
SS253,,1978,1962,,24522134,143333406,50026299,,14496423,93628978,31156383,,10025711,49704428,18869916,PDP
SS253,,1979,1962,,26702766,170774704,57089724,,14495813,99849823,32262685,,12206953,70924881,24827039,PDP
SS253,,1980,1962,,27270016,173874252,58208495,,15108339,104901521,33774090,,12161677,68972731,24434405,PDP
SS253,,1981,1962,,27455829,177826825,59097613,,15593474,109473940,35072823,,11862355,68352885,24024790,PDP
SS253,,1982,1962,,32430835,210963610,69968844,,16544169,115369967,37072633,,15886666,95593643,32896211,PDP
SS253,,1983,1962,,37202797,255454927,82657410,,17201282,121625543,38842838,,20001515,133829384,43814572,PDP
SS253,,1984,1962,,39049331,266390457,86449768,,17802036,124891202,40024670,,21247295,141499255,46425098,PDP
SS253,,1985,1962,,40350936,270867972,88548084,,18290062,127494337,40975887,,22060874,143373635,47572197,PDP
SS253,,1986,1962,,24201738,158505928,52405640,,18811186,130116870,41963654,,5390552,28389058,10441986,PDP
SS253,,1987,1962,,24905760,159577479,53300329,,19239739,133930093,43070716,,5666021,25647386,10229613,PDP
SS253,,1988,1962,,25478344,175650387,56732861,,19773634,139659814,44624135,,5704710,35990573,12108726,PDP
SS253,,1989,1962,,25875888,183870683,58593091,,20307989,144938588,46097773,,5567899,38932095,12495318,PDP
SS253,,1990,1962,,26682441,201988259,62623412,,20913949,152948425,48128971,,5768492,49039834,14494441,PDP
SS253,,1991,1962,,28522928,218812117,67457468,,21616101,167017505,51334518,,6906827,51794612,16122950,PDP
SS253,,1992,1962,,26482077,233716303,68068608,,22213902,179105703,54083244,,4268175,54610600,13985364,PDP
SS253,,1993,1962,,26895936,256316378,72503832,,22848844,194112687,57388468,,4047092,62203691,15115364,PDP
SS253,,1994,1962,,27478608,265812793,74776258,,23660225,212233585,61424208,,3818383,53579208,13352050,PDP
SS253,,1995,1962,,28443295,283104967,78817844,,24586417,233212448,66083294,,3856878,49892519,12734550,PDP
SS253,,1996,1962,,29554279,302297533,83343876,,25596588,248964175,69896263,,3957691,53333358,13447613,PDP
SS253,,1997,1962,,30478208,303187977,84426247,,26641561,258409224,72621850,,3836647,44778753,11804397,PDP
SS253,,1998,1962,,31113449,304457684,85287414,,27478051,262779139,74235905,,3635398,41678545,11051509,PDP
SS253,,1999,1962,,33648401,298858526,86826075,,28130683,265476164,75368435,,5517718,33382362,11457640,PDP
SS253,,2000,1962,,35275774,314229501,91188497,,29167387,270143201,77235572,,6108387,44086300,13952925,PDP
SS253,,2001,1962,,33258008,300958942,86809421,,30050392,275675429,79102959,,3207616,25283513,7706462,PDP
SS253,,2002,1962,,33448214,304634688,87653674,,30726203,280495762,80636481,,2722011,24138926,7017193,PDP
SS253,,2003,1962,,33730184,306057688,88188847,,31282729,283011250,81640603,,2447455,23046438,6548244,PDP
SS253,,2004,1962,,35154613,293773603,87427496,,31915273,285667615,82745809,,3239340,8105988,4681687,PDP
SS253,,2005,1962,,35888493,294841884,88351462,,33239772,288567699,84586338,,2648721,6274185,3765124,PDP
SS253,,2006,1962,,35888493,294841884,88351462,,33973565,290406537,85647326,,1914928,4435347,2704136,PDP
SS253,,2007,1962,,36336653,297333958,89243051,,34594133,292112752,86571491,,1742520,5221206,2671560,PDP
SS253,,2008,1962,,36334946,297400381,89253163,,34998374,293433377,87210719,,1336572,3967004,2042444,PDP
SS253,,2009,1962,,38217406,318028940,94806187,,34998650,298714877,88150762,,3218756,19314063,6655422,PDP
SS253,,2010,1962,,38589183,319407718,95423299,,35643064,301460570,89283736,,2946119,17947148,6139563,PDP
SS253,,2011,1962,,38589183,319407718,95423299,,36389152,305540229,90755741,,2200031,13867489,4667557,PDP
SS253,,2012,1962,,38978915,320174777,95949519,,37085198,309815938,92212588,,1893717,10358839,3736928,PDP
SS253,,2013,1962,,39159565,321120263,96298406,,37812335,315472572,93946245,,1347230,5647691,2352158,PDP
SS253,,2014,1962,,39820975,329537477,98457540,,38371382,320183022,95343452,,1449593,9354455,3114087,PDP
SS253,,2015,1962,,40083611,330871817,98957603,,38768735,323855317,96394236,,1314876,7016500,2563360,PDP
SS253,,2016,1962,,40278882,333754544,99665814,,39104274,327342787,97350325,,1174608,6411757,2315489,PDP
SS253,,2017,1962,,40905153,343972873,102110291,,39355510,330365718,98139446,,1549643,13607155,3970843,PDP
SS253,,2017,1962,,40905153,343972873,102110291,,39355510,330365718,98139446,,1549643,13607155,3970843,PDP
SS259,,1984,1967,,138667,8320012,1619096,,0,0,0,,138667,8320012,1619096,PDP
SS259,,1985,1967,,138667,8320012,1619096,,0,0,0,,138667,8320012,1619096,PDP
SS259,,1986,1967,,138667,8320012,1619096,,0,0,0,,138667,8320012,1619096,PDP
SS259,,1987,1967,,1251251,85994766,16552811,,0,0,0,,1251251,85994766,16552811,PDP
SS259,,1988,1967,,1948323,141112042,27057227,,146678,6027151,1219125,,1801645,135084891,25838102,PDP
SS259,,1989,1967,,3040843,155820937,30766988,,578375,24577694,4951630,,2462468,131243243,25815358,PDP
SS259,,1990,1967,,4167264,182827449,36698839,,956059,42273095,8477962,,3211205,140554354,28220877,PDP
SS259,,1991,1967,,4167264,182827449,36698839,,1311261,60319403,12044251,,2856003,122508046,24654588,PDP
SS259,,1992,1967,,4167264,182827449,36698839,,1616908,76541891,15236462,,2550356,106285558,21462377,PDP
SS259,,1993,1967,,3502649,176804136,34962460,,1892262,91675573,18204642,,1610387,85128563,16757818,PDP
SS259,,1994,1967,,3502649,176804136,34962460,,2151255,109026021,21550903,,1351394,67778115,13411557,PDP
SS259,,1995,1967,,3533571,180667282,35680774,,2415402,134024463,26263171,,1118169,46642819,9417603,PDP
SS259,,1996,1967,,3220934,202880726,39320707,,2690760,160270357,31208617,,530174,42610369,8112090,PDP
SS259,,1997,1967,,3404727,229922891,44316273,,2926796,183260033,35535343,,477931,46662858,8780930,PDP
SS259,,1998,1967,,3404727,229922891,44316273,,3039197,200918812,38789875,,365530,29004079,5526398,PDP
SS259,,1999,1967,,3411417,238057403,45770386,,3131911,213544464,41129147,,279506,24512939,4641239,PDP
SS259,,2000,1967,,3778104,254655637,49090495,,3197669,222119972,42720796,,580435,32535665,6369699,PDP
SS259,,2001,1967,,4748574,268444485,52514497,,3683508,229781499,44569896,,1065066,38662986,7944601,PDP
SS259,,2002,1967,,4871099,268672119,52677526,,3920408,236654770,46029798,,950691,32017349,6647728,PDP
SS259,,2003,1967,,4894924,271121385,53137163,,4248770,241618507,47241387,,646154,29502878,5895776,PDP
SS259,,2004,1967,,5372748,310817771,60678401,,4463456,251010197,49127192,,909292,59807574,11551209,PDP
SS259,,2005,1967,,5372748,310817771,60678401,,4630948,263233635,51469673,,741800,47584136,9208728,PDP
SS259,,2006,1967,,5647696,311923531,61150104,,4806742,273268603,53431049,,840954,38654928,7719055,PDP
SS259,,2007,1967,,5647696,311923531,61150104,,4908355,279628733,54664357,,739341,32294798,6485747,PDP
SS259,,2008,1967,,5645909,312081628,61176448,,4971991,283308875,55382823,,673918,28772753,5793625,PDP
SS259,,2009,1967,,5538759,315898806,61748510,,5009346,289815735,56577983,,529413,26083071,5170529,PDP
SS259,,2010,1967,,5723786,321452092,62921666,,5068587,291832073,56996003,,655199,29620019,5925665,PDP
SS259,,2011,1967,,5732347,330004061,64451929,,5121061,297084446,57983062,,611286,32919615,6468868,PDP
SS259,,2012,1967,,5732347,330004061,64451929,,5169055,301966391,58899728,,563292,28037670,5552200,PDP
SS259,,2013,1967,,5634944,322538998,63026224,,5196220,303767133,59247314,,438724,18771865,3778913,PDP
SS259,,2014,1967,,5632242,322498459,63016309,,5201760,304538031,59390023,,430482,17960428,3626288,PDP
SS259,,2015,1967,,5632242,322498459,63016309,,5207133,305298767,59530757,,425109,17199692,3485552,PDP
SS259,,2016,1967,,5634812,322788717,63070527,,5213999,305999467,59662305,,420813,16789250,3408223,PDP
SS259,,2017,1967,,5634812,322788717,63070527,,5214733,306081621,59677656,,420079,16707096,3392872,PDP
SS259,,2017,1967,,5634812,322788717,63070527,,5214733,306081621,59677656,,420079,16707096,3392872,PDP
SS263,,1991,1984,,0,14761745,2626645,,0,384411,68401,,0,14377334,2558244,PDN
SS263,,1992,1984,,0,14761745,2626645,,0,6943920,1235573,,0,7817825,1391072,PDN
SS263,,1993,1984,,0,27234100,4845925,,0,11001956,1957643,,0,16232144,2888282,PDN
SS263,,1994,1984,,0,27234100,4845925,,0,18079243,3216947,,0,9154857,1628978,PDN
SS263,,1995,1984,,0,27234100,4845925,,0,22687175,4036864,,0,4546925,809061,PDN
SS263,,1996,1984,,0,22874699,4070231,,0,22874699,4070231,,0,0,0,PDN
SS263,,1997,1984,,0,22874699,4070231,,0,22874699,4070231,,0,0,0,PDN
SS263,,1998,1984,,0,22874699,4070231,,0,22874699,4070231,,0,0,0,PDN
SS263,,1999,1984,,0,22874699,4070231,,0,22874699,4070231,,0,0,0,PDN
SS263,,2000,1984,,0,22874699,4070231,,0,22874699,4070231,,0,0,0,PDN
SS263,,2001,1984,,0,22874699,4070231,,0,22874699,4070231,,0,0,0,PDN
SS263,,2002,1984,,0,22874699,4070231,,0,22874699,4070231,,0,0,0,PDN
SS263,,2003,1984,,0,22874699,4070231,,0,22874699,4070231,,0,0,0,PDN
SS263,,2004,1984,,0,22874699,4070231,,0,22874699,4070231,,0,0,0,PDN
SS263,,2005,1984,,0,22874699,4070231,,0,22874699,4070231,,0,0,0,PDN
SS263,,2006,1984,,0,22874699,4070231,,0,22874699,4070231,,0,0,0,PDN
SS263,,2007,1984,,0,22874699,4070231,,0,22874699,4070231,,0,0,0,PDN
SS263,,2008,1984,,0,22874699,4070231,,0,22874699,4070231,,0,0,0,PDN
SS263,,2009,1984,,0,23332815,4151746,,0,23332815,4151746,,0,0,0,PDN
SS263,,2010,1984,,547625,32697206,6365633,,156642,26327924,4841326,,390983,6369282,1524307,PDN
SS263,,2011,1984,,547625,32697206,6365633,,376280,29857659,5689030,,171345,2839547,676602,PDN
SS263,,2012,1984,,547625,32697206,6365633,,482394,31618846,6108523,,65231,1078360,257110,PDN
SS263,,2013,1984,,547625,32697206,6365633,,492590,31858287,6161324,,55035,838919,204309,PDN
SS263,,2014,1984,,547625,32697206,6365633,,497860,31993876,6190720,,49765,703330,174913,PDN
SS263,,2015,1984,,547625,32697206,6365633,,501738,32082378,6210346,,45887,614828,155287,PDN
SS263,,2016,1984,,501738,32082378,6210346,,501738,32082378,6210346,,0,0,0,PDN
SS263,,2017,1984,,501738,32076139,6209236,,501738,32076139,6209236,,0,0,0,PDN
SS263,,2017,1984,,501738,32076139,6209236,,501738,32076139,6209236,,0,0,0,PDN
SS271,,1975,1965,,0,50000000,8896797,,0,0,0,,0,50000000,8896797,PDN
SS271,,1976,1965,,573508,204248000,36916568,,4513,4125172,738529,,568995,200122828,36178039,PDN
SS271,,1977,1965,,4541099,397890460,75340113,,141385,15525918,2904004,,4399714,382364542,72436109,PDN
SS271,,1978,1965,,1086485,271706061,49432759,,146596,20020305,3708928,,939889,251685756,45723831,PDN
SS271,,1979,1965,,1098679,279706061,50868441,,180883,31489312,5783963,,917796,248216749,45084478,PDN
SS271,,1980,1965,,2874609,350020001,65155748,,127254,47728107,8619800,,2747355,302291894,56535948,PDN
SS271,,1981,1965,,3255320,632881511,115867689,,583759,67198889,12540857,,2671561,565682622,103326832,PDN
SS271,,1982,1965,,2972702,629376836,114961463,,817302,78851152,14847756,,2155400,550525684,100113707,PDN
SS271,,1983,1965,,3120221,632836645,115724606,,994291,88952861,16822202,,2125930,543883784,98902404,PDN
SS271,,1984,1965,,2931084,567566649,103921591,,1117119,100439426,18988903,,1813965,467127223,84932688,PDN
SS271,,1985,1965,,3274344,316167820,59531963,,1246980,109783234,20781363,,2027364,206384586,38750600,PDN
SS271,,1986,1965,,2011350,178627042,33795521,,1308854,115557853,21870750,,702496,63069189,11924771,PDN
SS271,,1987,1965,,2058812,185824384,35123649,,1381445,123756342,23402146,,677367,62068042,11721503,PDN
SS271,,1988,1965,,274142,122526633,22076034,,182418,82217590,14811882,,91724,40309043,7264152,PDN
SS271,,1989,1965,,192796,104787910,18838332,,182589,85185842,15340212,,10207,19602068,3498120,PDN
SS271,,1990,1965,,213110,104787910,18858646,,183442,87564896,15764384,,29668,17223014,3094262,PDN
SS271,,1991,1965,,213110,104787910,18858646,,183467,90003770,16198373,,29643,14784140,2660273,PDN
SS271,,1992,1965,,215396,104787910,18860932,,183939,93207939,16768982,,31457,11579971,2091950,PDN
SS271,,1993,1965,,213503,106372082,19140920,,183939,96809219,17409779,,29564,9562863,1731141,PDN
SS271,,1994,1965,,178479,73395803,13238230,,174954,71029511,12813657,,3525,2366292,424573,PDN
SS271,,1995,1965,,178479,73395803,13238230,,174954,71228637,12849089,,3525,2167166,389141,PDN
SS271,,1996,1965,,181182,72629302,13104545,,174954,71233531,12849960,,6228,1395771,254585,PDN
SS271,,1997,1965,,181182,72629302,13104545,,174954,71233531,12849960,,6228,1395771,254585,PDN
SS271,,1998,1965,,181182,72629302,13104545,,174954,71233531,12849960,,6228,1395771,254585,PDN
SS271,,1999,1965,,181182,72629302,13104545,,174954,71233531,12849960,,6228,1395771,254585,PDN
SS271,,2000,1965,,197355,80311448,14487648,,174954,71233531,12849960,,22401,9077917,1637688,PDN
SS271,,2001,1965,,197355,80311448,14487648,,174954,71233531,12849960,,22401,9077917,1637688,PDN
SS271,,2002,1965,,197355,80311448,14487648,,174954,71233531,12849960,,22401,9077917,1637688,PDN
SS271,,2003,1965,,197355,80311448,14487648,,174954,71233531,12849960,,22401,9077917,1637688,PDN
SS271,,2004,1965,,197355,80311448,14487648,,174954,71233531,12849960,,22401,9077917,1637688,PDN
SS271,,2005,1965,,197355,80311448,14487648,,174954,71233531,12849960,,22401,9077917,1637688,PDN
SS271,,2006,1965,,197355,80311448,14487648,,174954,71233531,12849960,,22401,9077917,1637688,PDN
SS271,,2007,1965,,197355,80311448,14487648,,174954,71233531,12849960,,22401,9077917,1637688,PDN
SS271,,2008,1965,,197355,80311448,14487648,,174954,71233531,12849960,,22401,9077917,1637688,PDN
SS271,,2009,1965,,197802,81919954,14774308,,174954,72660128,13103803,,22848,9259826,1670505,PDN
SS271,,2010,1965,,197802,81919954,14774308,,174954,72660128,13103803,,22848,9259826,1670505,PDN
SS271,,2011,1965,,197802,81919954,14774308,,174954,72660128,13103803,,22848,9259826,1670505,PDN
SS271,,2012,1965,,197802,81919954,14774308,,174954,72660128,13103803,,22848,9259826,1670505,PDN
SS271,,2013,1965,,197802,81919954,14774308,,174954,72660128,13103803,,22848,9259826,1670505,PDN
SS271,,2014,1965,,197802,81919954,14774308,,174954,72660128,13103803,,22848,9259826,1670505,PDN
SS271,,2015,1965,,197802,81919954,14774308,,174954,72660128,13103803,,22848,9259826,1670505,PDN
SS271,,2016,1965,,197802,81919954,14774308,,174954,72660128,13103803,,22848,9259826,1670505,PDN
SS271,,2017,1965,,197802,81919954,14774308,,174954,72660128,13103803,,22848,9259826,1670505,PDN
SS271,,2017,1965,,197802,81919954,14774308,,174954,72660128,13103803,,22848,9259826,1670505,PDN
SS274,,1975,1963,,30000000,300000000,83380783,,11437716,135097235,35476370,,18562284,164902765,47904413,PDP
SS274,,1976,1963,,38335567,386868370,107173355,,13306922,164808692,42632312,,25028645,222059678,64541043,PDP
SS274,,1977,1963,,38800202,421490800,113798565,,15436029,194333743,50014987,,23364173,227157057,63783578,PDP
SS274,,1978,1963,,39181781,419929526,113902337,,16034073,210941747,53568192,,23147708,208987779,60334145,PDP
SS274,,1979,1963,,33418021,421549138,108426764,,12445932,221235666,51811709,,20972089,200313472,56615055,PDP
SS274,,1980,1963,,33591078,425959255,109384540,,12924773,228948468,53662935,,20666305,197010787,55721605,PDP
SS274,,1981,1963,,33677576,400466368,104934937,,13365530,232474709,54731137,,20312046,167991659,50203800,PDP
SS274,,1982,1963,,32135467,394307306,102296909,,13856030,240682101,56682027,,18279437,153625205,45614882,PDP
SS274,,1983,1963,,32135467,394307306,102296909,,14620487,246744406,58525186,,17514980,147562900,43771723,PDP
SS274,,1984,1963,,32208734,396610190,102779942,,15267727,251509121,60020240,,16941007,145101069,42759702,PDP
SS274,,1985,1963,,32340036,400277657,103563818,,16008628,255386280,61451027,,16331408,144891377,42112791,PDP
SS274,,1986,1963,,32298202,395871174,102737913,,16653383,260249040,62961041,,15644819,135622134,39776872,PDP
SS274,,1987,1963,,35779085,426823878,111726394,,17611197,270664525,65772145,,18167888,156159353,45954249,PDP
SS274,,1988,1963,,35301265,434050473,112534445,,18681061,283020852,69040643,,16620204,151029621,43493802,PDP
SS274,,1989,1963,,24721621,364080644,89504654,,19673296,293299481,71861816,,5048325,70781163,17642838,PDP
SS274,,1990,1963,,30203256,391481309,99861852,,20822065,305945011,75260679,,9381191,85536298,24601173,PDP
SS274,,1991,1963,,32864633,413804372,106495304,,22758806,322251816,80098987,,10105827,91552556,26396317,PDP
SS274,,1992,1963,,32771566,409547530,105644792,,24520721,336459215,84388909,,8250845,73088315,21255883,PDP
SS274,,1993,1963,,32402542,410178187,105387985,,25978710,348546652,87997687,,6423832,61631535,17390298,PDP
SS274,,1994,1963,,35865995,428640955,112136628,,27827380,367434315,93207151,,8038615,61206640,18929477,PDP
SS274,,1995,1963,,37416892,459125627,119111843,,29778062,407390821,102267532,,7638830,51734806,16844311,PDP
SS274,,1996,1963,,36947372,483209317,122927678,,30854869,427763748,106969415,,6092503,55445569,15958263,PDP
SS274,,1997,1963,,36356081,484513414,122568432,,31643741,439011805,109759721,,4712340,45501609,12808711,PDP
SS274,,1998,1963,,36722583,483676131,122785952,,32372672,445893505,111713153,,4349911,37782626,11072799,PDP
SS274,,1999,1963,,37598971,497224342,126073053,,32948056,452348062,113437035,,4650915,44876280,12636018,PDP
SS274,,2000,1963,,39932470,506833013,130116280,,33861263,458951227,115525182,,6071207,47881786,14591098,PDP
SS274,,2001,1963,,40664530,500746334,129765301,,34803588,464524977,117459278,,5860942,36221357,12306023,PDP
SS274,,2002,1963,,40478768,502998602,129980299,,35309826,468847063,118734570,,5168942,34151539,11245729,PDP
SS274,,2003,1963,,40454036,503611766,130064671,,35706224,472263286,119738837,,4747812,31348480,10325834,PDP
SS274,,2004,1963,,40697445,494604627,128705386,,36055646,474495163,120485390,,4641799,20109464,8219996,PDP
SS274,,2005,1963,,40696821,494603254,128704518,,36391925,476372993,121155803,,4304896,18230261,7548715,PDP
SS274,,2006,1963,,40893524,495144481,128997524,,36678927,477426585,121630277,,4214597,17717896,7367247,PDP
SS274,,2007,1963,,41005487,495291842,129135708,,36957659,479227715,122229494,,4047828,16064127,6906214,PDP
SS274,,2008,1963,,41014357,495619742,129202923,,37124470,481133887,122735482,,3889887,14485855,6467441,PDP
SS274,,2009,1963,,41653307,508499692,132133679,,37133798,491535008,124595543,,4519509,16964684,7538137,PDP
SS274,,2010,1963,,41672135,508518673,132155885,,37473349,493519238,125288159,,4198786,14999435,6867725,PDP
SS274,,2011,1963,,41674823,508525706,132159824,,37776310,494864997,125830580,,3898513,13660709,6329244,PDP
SS274,,2012,1963,,41783133,508653590,132290889,,38026956,495809449,126249278,,3756177,12844141,6041611,PDP
SS274,,2013,1963,,41924638,509158104,132522165,,38286555,496634799,126655734,,3638083,12523305,5866430,PDP
SS274,,2014,1963,,42193489,512383582,133364946,,38521047,497475975,127039905,,3672442,14907607,6325039,PDP
SS274,,2015,1963,,42609295,513109711,133909956,,38764897,498762195,127512620,,3844398,14347516,6397335,PDP
SS274,,2016,1963,,42728727,513260730,134056260,,38984354,499635373,127887449,,3744373,13625357,6168811,PDP
SS274,,2017,1963,,42828980,513894800,134269338,,39130292,500239903,128140953,,3698688,13654897,6128383,PDP
SS274,,2017,1963,,42828980,513894800,134269338,,39130292,500239903,128140953,,3698688,13654897,6128383,PDP
SS278,,1999,1986,,524,5238487,932639,,0,0,0,,524,5238487,932639,PDN
SS278,,2000,1986,,524,5238487,932639,,0,817318,145430,,524,4421169,787209,PDN
SS278,,2001,1986,,571,5705936,1015862,,0,3681802,655125,,571,2024134,360737,PDN
SS278,,2002,1986,,571,5705936,1015862,,0,4111758,731630,,571,1594178,284232,PDN
SS278,,2003,1986,,272,5780942,1028909,,0,4410873,784853,,272,1370069,244056,PDN
SS278,,2004,1986,,272,5780942,1028909,,0,5017126,892727,,272,763816,136182,PDN
SS278,,2005,1986,,272,5780942,1028909,,0,5413527,963261,,272,367415,65648,PDN
SS278,,2006,1986,,272,5780942,1028909,,0,5460116,971551,,272,320826,57358,PDN
SS278,,2007,1986,,0,5460471,971614,,0,5460471,971614,,0,0,0,PDN
SS278,,2008,1986,,0,5460471,971614,,0,5460471,971614,,0,0,0,PDN
SS278,,2009,1986,,0,5460471,971614,,0,5460471,971614,,0,0,0,PDN
SS278,,2010,1986,,0,5460471,971614,,0,5460471,971614,,0,0,0,PDN
SS278,,2011,1986,,0,5460471,971614,,0,5460471,971614,,0,0,0,PDN
SS278,,2012,1986,,0,5460471,971614,,0,5460471,971614,,0,0,0,PDN
SS278,,2013,1986,,0,5460471,971614,,0,5460471,971614,,0,0,0,PDN
SS278,,2014,1986,,0,5460471,971614,,0,5460471,971614,,0,0,0,PDN
SS278,,2015,1986,,0,5460471,971614,,0,5460471,971614,,0,0,0,PDN
SS278,,2016,1986,,0,5460471,971614,,0,5460471,971614,,0,0,0,PDN
SS278,,2017,1986,,0,5460471,971614,,0,5460471,971614,,0,0,0,PDN
SS278,,2017,1986,,0,5460471,971614,,0,5460471,971614,,0,0,0,PDN
SS279,,2001,2001,,36024,22067968,3962709,,0,0,0,,36024,22067968,3962709,PDN
SS279,,2002,2001,,56187,25191938,4538738,,7889,3339257,602063,,48298,21852681,3936675,PDN
SS279,,2003,2001,,56187,25191938,4538738,,20648,9820713,1768106,,35539,15371225,2770632,PDN
SS279,,2004,2001,,56187,25191938,4538738,,31447,16187289,2911748,,24740,9004649,1626990,PDN
SS279,,2005,2001,,56193,25179433,4536519,,35079,18749229,3371241,,21114,6430204,1165278,PDN
SS279,,2006,2001,,56193,25179433,4536519,,36764,20093089,3612047,,19429,5086344,924472,PDN
SS279,,2007,2001,,56193,25179433,4536519,,36030,20500428,3683793,,20163,4679005,852726,PDN
SS279,,2008,2001,,56193,25179433,4536519,,22875,21017287,3762606,,33318,4162146,773913,PDN
SS279,,2009,2001,,57333,25688155,4628179,,22875,21017287,3762606,,34458,4670868,865573,PDN
SS279,,2010,2001,,22954,21087521,3775182,,22875,21017287,3762606,,79,70234,12576,PDN
SS279,,2011,2001,,22954,21087521,3775182,,22875,21017287,3762606,,79,70234,12576,PDN
SS279,,2012,2001,,22954,21087521,3775182,,22875,21017287,3762606,,79,70234,12576,PDN
SS279,,2013,2001,,22875,21017287,3762606,,22875,21017287,3762606,,0,0,0,PDN
SS279,,2014,2001,,22875,21017287,3762606,,22875,21017287,3762606,,0,0,0,PDN
SS279,,2015,2001,,22875,21017287,3762606,,22875,21017287,3762606,,0,0,0,PDN
SS279,,2016,2001,,22875,21017287,3762606,,22875,21017287,3762606,,0,0,0,PDN
SS279,,2017,2001,,22875,21017287,3762606,,22875,21017287,3762606,,0,0,0,PDN
SS279,,2017,2001,,22875,21017287,3762606,,22875,21017287,3762606,,0,0,0,PDN
SS291,,1976,1973,,9334000,28002000,14316562,,0,0,0,,9334000,28002000,14316562,PDP
SS291,,1977,1973,,6020067,4283802,6782309,,1300238,928871,1465518,,4719829,3354931,5316791,PDP
SS291,,1978,1973,,15577725,11459228,17616734,,4517096,3336351,5110753,,11060629,8122877,12505981,PDP
SS291,,1979,1973,,15577725,11459228,17616734,,7441742,5898227,8491249,,8135983,5561001,9125485,PDP
SS291,,1980,1973,,52513789,44271694,60391315,,10074424,9131338,11699217,,42439365,35140356,48692098,PDP
SS291,,1981,1973,,52139818,43994488,59968019,,12693712,11914545,14813738,,39446106,32079943,45154281,PDP
SS291,,1982,1973,,52139818,43994488,59968019,,15037221,15528258,17800256,,37102597,28466230,42167763,PDP
SS291,,1983,1973,,56484299,48338969,65085539,,17195971,18560107,20498481,,39288328,29778862,44587058,PDP
SS291,,1984,1973,,56478839,49754499,65331953,,19054748,21233864,22833016,,37424091,28520635,42498937,PDP
SS291,,1985,1973,,56484571,53025446,65919704,,20838557,23255655,24976574,,35646014,29769791,40943130,PDP
SS291,,1986,1973,,37554595,39423249,44569408,,22511128,24817493,26927052,,15043467,14605756,17642356,PDP
SS291,,1987,1973,,37552537,39383249,44560233,,23900885,26019456,28530681,,13651652,13363793,16029552,PDP
SS291,,1988,1973,,37552537,39383249,44560233,,24994376,26858503,29773469,,12558161,12524746,14786764,PDP
SS291,,1989,1973,,38667835,44766217,46633354,,25813965,28434279,30873445,,12853870,16331938,15759909,PDP
SS291,,1990,1973,,34619180,67040988,46548181,,27181559,35084756,33424398,,7437621,31956232,13123783,PDP
SS291,,1991,1973,,34619180,67040988,46548181,,28368540,42398795,35912810,,6250640,24642193,10635371,PDP
SS291,,1992,1973,,42022444,74669740,55308875,,29396849,48467735,38021001,,12625595,26202005,17287874,PDP
SS291,,1993,1973,,42022636,103864762,60503910,,30295670,79400281,44423834,,11726966,24464481,16080076,PDP
SS291,,1994,1973,,36501630,116508177,57232622,,31095445,90639014,47223383,,5406185,25869163,10009239,PDP
SS291,,1995,1973,,36520994,119510228,57786159,,31728480,100196605,49557057,,4792514,19313623,8229102,PDP
SS291,,1996,1973,,39286151,129852356,62391552,,32422052,108199055,51674553,,6864099,21653301,10716999,PDP
SS291,,1997,1973,,39184451,134503061,63117380,,32965535,113565147,53172857,,6218916,20937914,9944523,PDP
SS291,,1998,1973,,39185114,141130168,64297244,,33437299,119862481,54765143,,5747815,21267687,9532101,PDP
SS291,,1999,1973,,39447834,153890882,66830553,,33866410,125657317,56225363,,5581424,28233565,10605190,PDP
SS291,,2000,1973,,35483834,145649611,61400135,,34213686,131094891,57540179,,1270148,14554720,3859956,PDP
SS291,,2001,1973,,35451743,144710970,61201026,,34479882,134544853,58420247,,971861,10166117,2780779,PDP
SS291,,2002,1973,,35450134,144140253,61097866,,34685788,137180034,59095047,,764346,6960219,2002819,PDP
SS291,,2003,1973,,35545747,144084049,61183478,,34872127,139629811,59717289,,673620,4454238,1466189,PDP
SS291,,2004,1973,,35542693,145157500,61371430,,35088482,141523133,60270534,,454211,3634367,1100896,PDP
SS291,,2005,1973,,35364429,145433865,61242341,,35219125,142879062,60642446,,145304,2554803,599895,PDP
SS291,,2006,1973,,35364536,145486606,61251832,,35294105,143349252,60801089,,70431,2137354,450743,PDP
SS291,,2007,1973,,35386444,145463769,61269677,,35310230,143499092,60843876,,76214,1964677,425801,PDP
SS291,,2008,1973,,35386444,145463769,61269677,,35317894,143575755,60865181,,68550,1888014,404496,PDP
SS291,,2009,1973,,35858919,147637525,62128940,,35350592,146026314,61333921,,508327,1611211,795019,PDP
SS291,,2010,1973,,36039771,149384558,62620652,,35476889,146513010,61546819,,562882,2871548,1073834,PDP
SS291,,2011,1973,,36039771,149384558,62620652,,35605319,147033421,61767848,,434452,2351137,852804,PDP
SS291,,2012,1973,,36039771,149384558,62620652,,35732155,147738106,62020074,,307616,1646452,600579,PDP
SS291,,2013,1973,,36068315,150121597,62780343,,35930976,148979795,62439834,,137339,1141802,340506,PDP
SS291,,2014,1973,,36261298,150496521,63040038,,36070098,149618615,62692626,,191200,877906,347412,PDP
SS291,,2015,1973,,36477180,150998832,63345299,,36221121,150030481,62916935,,256059,968351,428363,PDP
SS291,,2016,1973,,36477180,150998832,63345299,,36223334,150034034,62919780,,253846,964798,425518,PDP
SS291,,2017,1973,,36477556,150996618,63345281,,36272961,150124969,62985587,,204595,871649,359693,PDP
SS291,,2017,1973,,36477556,150996618,63345281,,36272961,150124969,62985587,,204595,871649,359693,PDP
SS292,,1993,1994,,4236421,7722111,5610462,,0,0,0,,4236421,7722111,5610462,PDN
SS292,,1994,1994,,4235357,7720709,5609149,,0,0,0,,4235357,7720709,5609149,PDN
SS292,,1995,1994,,3924047,21581019,7764086,,589933,2300898,999345,,3334114,19280121,6764741,PDN
SS292,,1996,1994,,2570638,16552062,5515845,,996372,4247190,1752100,,1574266,12304872,3763745,PDN
SS292,,1997,1994,,2570638,16552058,5515844,,1241317,4781229,2092069,,1329321,11770829,3423775,PDN
SS292,,1998,1994,,2570638,16552058,5515844,,1402098,5145566,2317679,,1168540,11406492,3198165,PDN
SS292,,1999,1994,,2504604,9050006,4114925,,1479999,5524137,2462942,,1024605,3525869,1651983,PDN
SS292,,2000,1994,,2078752,8067034,3514167,,1618522,5589969,2613178,,460230,2477065,900989,PDN
SS292,,2001,1994,,1976356,7872990,3377244,,1712941,5791385,2743437,,263415,2081605,633807,PDN
SS292,,2002,1994,,1884636,5935738,2940817,,1759715,5805909,2792795,,124921,129829,148022,PDN
SS292,,2003,1994,,1884636,5935738,2940817,,1810161,5826156,2846844,,74475,109582,93973,PDN
SS292,,2004,1994,,1884636,5935738,2940817,,1840753,5847561,2881244,,43883,88177,59573,PDN
SS292,,2005,1994,,1841221,5849704,2882094,,1841221,5849704,2882094,,0,0,0,PDN
SS292,,2006,1994,,1841221,5849704,2882094,,1841221,5849704,2882094,,0,0,0,PDN
SS292,,2007,1994,,1841221,5849704,2882094,,1841221,5849704,2882094,,0,0,0,PDN
SS292,,2008,1994,,1841221,5849704,2882094,,1841221,5849704,2882094,,0,0,0,PDN
SS292,,2009,1994,,1841221,5949649,2899878,,1841221,5949649,2899878,,0,0,0,PDN
SS292,,2010,1994,,1841221,5949649,2899878,,1841221,5949649,2899878,,0,0,0,PDN
SS292,,2011,1994,,1841221,5949649,2899878,,1841221,5949649,2899878,,0,0,0,PDN
SS292,,2012,1994,,1841221,5949649,2899878,,1841221,5949649,2899878,,0,0,0,PDN
SS292,,2013,1994,,1841221,5949649,2899878,,1841221,5949649,2899878,,0,0,0,PDN
SS292,,2014,1994,,1841221,5949649,2899878,,1841221,5949649,2899878,,0,0,0,PDN
SS292,,2015,1994,,1841221,5949649,2899878,,1841221,5949649,2899878,,0,0,0,PDN
SS292,,2016,1994,,1841221,5949649,2899878,,1841221,5949649,2899878,,0,0,0,PDN
SS292,,2017,1994,,1841221,5949649,2899878,,1841221,5949649,2899878,,0,0,0,PDN
SS292,,2017,1994,,1841221,5949649,2899878,,1841221,5949649,2899878,,0,0,0,PDN
SS299,,1975,1965,,7500000,28500000,12571174,,0,0,0,,7500000,28500000,12571174,PDP
SS299,,1976,1965,,7500000,28500000,12571174,,0,0,0,,7500000,28500000,12571174,PDP
SS299,,1977,1965,,7674,7673760,1373112,,47,618533,110106,,7627,7055227,1263006,PDP
SS299,,1978,1965,,7674,7673760,1373112,,98,3278842,583522,,7576,4394918,789590,PDP
SS299,,1979,1965,,7674,7673760,1373112,,151,7389832,1315068,,7523,283928,58044,PDP
SS299,,1980,1965,,20769,22787544,4075492,,265,11239260,2000133,,20504,11548284,2075359,PDP
SS299,,1981,1965,,20769,22787544,4075492,,268,16174889,2878362,,20501,6612655,1197130,PDP
SS299,,1982,1965,,2611,26111440,4648775,,268,18233866,3244728,,2343,7877574,1404047,PDP
SS299,,1983,1965,,2611,26111440,4648775,,268,19222455,3420634,,2343,6888985,1228141,PDP
SS299,,1984,1965,,2611,26111440,4648775,,268,20597348,3665277,,2343,5514092,983498,PDP
SS299,,1985,1965,,2611,26111440,4648775,,268,21502527,3826340,,2343,4608913,822435,PDP
SS299,,1986,1965,,2219,22194720,3951457,,268,21518957,3829264,,1951,675763,122193,PDP
SS299,,1987,1965,,268,21518957,3829264,,268,21518957,3829264,,0,0,0,PDP
SS299,,1988,1965,,268,21518957,3829264,,268,21518957,3829264,,0,0,0,PDP
SS299,,1989,1965,,268,21518957,3829264,,268,21518957,3829264,,0,0,0,PDP
SS299,,1990,1965,,268,21518957,3829264,,268,21518957,3829264,,0,0,0,PDP
SS299,,1991,1965,,3125842,35694194,9477122,,584951,22734041,4630154,,2540891,12960153,4846968,PDP
SS299,,1992,1965,,5039001,45933413,13212206,,1216232,23549448,5406525,,3822769,22383965,7805681,PDP
SS299,,1993,1965,,11140779,50342622,20098541,,4364635,16638346,7325195,,6776144,33704276,12773346,PDP
SS299,,1994,1965,,12947203,56641853,23025825,,7034691,29639251,12308579,,5912512,27002602,10717246,PDP
SS299,,1995,1965,,13947218,63752875,25291146,,9751971,37967215,16507703,,4195247,25785660,8783443,PDP
SS299,,1996,1965,,17872797,65065360,29450263,,12037021,45647722,20159391,,5835776,19417638,9290872,PDP
SS299,,1997,1965,,18954545,67415422,30950172,,14111241,50385931,23076709,,4843304,17029491,7873463,PDP
SS299,,1998,1965,,19159428,71630330,31905038,,15535947,54814159,25289356,,3623481,16816171,6615682,PDP
SS299,,1999,1965,,19871884,73308022,32916016,,16397230,56094107,26378388,,3474654,17213915,6537628,PDP
SS299,,2000,1965,,19903149,73201848,32928389,,17069811,55806799,26999846,,2833338,17395049,5928543,PDP
SS299,,2001,1965,,19987770,70155743,32470999,,17757161,57899304,28059528,,2230609,12256439,4411471,PDP
SS299,,2002,1965,,19987770,70204377,32479652,,18273934,58578737,28697197,,1713836,11625640,3782455,PDP
SS299,,2003,1965,,20746162,70994881,33378703,,18670838,59060291,29179787,,2075324,11934590,4198916,PDP
SS299,,2004,1965,,20997468,63656774,32324296,,19157720,59653293,29772185,,1839748,4003481,2552111,PDP
SS299,,2005,1965,,20997468,63656774,32324296,,19458148,59964340,30127959,,1539320,3692434,2196337,PDP
SS299,,2006,1965,,21193712,61934205,32214034,,19733867,60324802,30467818,,1459845,1609403,1746216,PDP
SS299,,2007,1965,,21194346,63167336,32434086,,19964566,60766512,30777113,,1229780,2400824,1656973,PDP
SS299,,2008,1965,,23770728,66740898,35646333,,20503374,62683627,31657044,,3267354,4057271,3989289,PDP
SS299,,2009,1965,,23843419,67839833,35914565,,21320447,64918797,32871834,,2522972,2921036,3042730,PDP
SS299,,2010,1965,,23899710,67875797,35977255,,22048749,65730403,33744551,,1850961,2145394,2232705,PDP
SS299,,2011,1965,,23943130,67930741,36030452,,22524377,66231324,34309311,,1418753,1699417,1721139,PDP
SS299,,2012,1965,,24189914,68517829,36381700,,22819875,66573877,34665761,,1370039,1943952,1715937,PDP
SS299,,2013,1965,,24615741,69834178,37041752,,23309507,67277843,35280653,,1306234,2556335,1761098,PDP
SS299,,2014,1965,,24686082,73220748,37714686,,23540797,67521087,35555227,,1145285,5699661,2159459,PDP
SS299,,2015,1965,,24825310,73264495,37861698,,23704789,67700273,35751102,,1120521,5564222,2110596,PDP
SS299,,2016,1965,,25183162,73569361,38273797,,23890442,67975480,35985725,,1292720,5593881,2288070,PDP
SS299,,2017,1965,,25947446,69706428,38350728,,24175102,68276276,36323908,,1772344,1430152,2026819,PDP
SS299,,2017,1965,,25947446,69706428,38350728,,24175102,68276276,36323908,,1772344,1430152,2026819,PDP
SS321,,1986,1984,,45281,2768177,537839,,0,0,0,,45281,2768177,537839,PDN
SS321,,1997,1984,,124688,12637055,2373274,,13593,1392426,261356,,111095,11244629,2111918,PDN
SS321,,1998,1984,,106294,10563330,1985890,,44242,4623845,866990,,62052,5939485,1118900,PDN
SS321,,1999,1984,,108902,10822546,2034622,,72204,6922961,1304048,,36698,3899585,730574,PDN
SS321,,2000,1984,,178430,14969995,2842130,,98018,9019955,1702992,,80412,5950040,1139138,PDN
SS321,,2001,1984,,178430,14969995,2842130,,114621,10243026,1937223,,63809,4726969,904907,PDN
SS321,,2002,1984,,178430,14969995,2842130,,119000,10554814,1997081,,59430,4415181,845049,PDN
SS321,,2003,1984,,178430,14969995,2842130,,137540,11803622,2237829,,40890,3166373,604301,PDN
SS321,,2004,1984,,302144,23630002,4506771,,247367,17825153,3419102,,54777,5804849,1087669,PDN
SS321,,2005,1984,,302144,23630002,4506771,,270148,22023494,4188919,,31996,1606508,317852,PDN
SS321,,2006,1984,,332424,27868145,5291169,,283015,23720441,4503734,,49409,4147704,787435,PDN
SS321,,2007,1984,,332424,27868145,5291169,,293931,24690171,4687200,,38493,3177974,603969,PDN
SS321,,2008,1984,,332424,27868145,5291169,,304019,25081514,4766922,,28405,2786631,524247,PDN
SS321,,2009,1984,,339169,28433417,5398496,,307175,25302096,4809327,,31994,3131321,589169,PDN
SS321,,2010,1984,,317157,26294143,4995830,,307175,25302096,4809327,,9982,992047,186503,PDN
SS321,,2011,1984,,307175,25302096,4809327,,307175,25302096,4809327,,0,0,0,PDN
SS321,,2012,1984,,307175,25302096,4809327,,307175,25302096,4809327,,0,0,0,PDN
SS321,,2013,1984,,307175,25302096,4809327,,307175,25302096,4809327,,0,0,0,PDN
SS321,,2014,1984,,307175,25302096,4809327,,307175,25302096,4809327,,0,0,0,PDN
SS321,,2015,1984,,307175,25302096,4809327,,307175,25302096,4809327,,0,0,0,PDN
SS321,,2016,1984,,307175,25302096,4809327,,307175,25302096,4809327,,0,0,0,PDN
SS321,,2017,1984,,307175,25302096,4809327,,307175,25302096,4809327,,0,0,0,PDN
SS321,,2017,1984,,307175,25302096,4809327,,307175,25302096,4809327,,0,0,0,PDN
SS323,,1984,1970,,17287,1037215,201845,,0,0,0,,17287,1037215,201845,PDN
SS323,,1985,1970,,23142,2208204,416061,,0,1800,320,,23142,2206404,415741,PDN
SS323,,1986,1970,,23142,2208204,416061,,0,1800,320,,23142,2206404,415741,PDN
SS323,,1987,1970,,2403659,36340233,8869893,,0,1800,320,,2403659,36338433,8869573,PDN
SS323,,1988,1970,,2403659,36340233,8869893,,0,1800,320,,2403659,36338433,8869573,PDN
SS323,,1989,1970,,2403659,42496566,9965326,,0,3244631,577336,,2403659,39251935,9387990,PDN
SS323,,1990,1970,,132264,52372002,9451126,,0,11468263,2040616,,132264,40903739,7410510,PDN
SS323,,1991,1970,,407533,56695103,10495630,,1120,21759495,3872916,,406413,34935608,6622714,PDN
SS323,,1992,1970,,407533,54269528,10064033,,5122,32102869,5717376,,402411,22166659,4346657,PDN
SS323,,1993,1970,,155965,60919535,10995740,,11084,38715355,6899937,,144881,22204180,4095803,PDN
SS323,,1994,1970,,29716,62490483,11149019,,17502,44976496,8020437,,12214,17513987,3128582,PDN
SS323,,1995,1970,,29748,62812098,11206278,,20537,50969127,9089777,,9211,11842971,2116501,PDN
SS323,,1996,1970,,25776,64027070,11418493,,22031,54982639,9805419,,3745,9044431,1613074,PDN
SS323,,1997,1970,,25776,64027070,11418493,,22642,58227471,10383402,,3134,5799599,1035091,PDN
SS323,,1998,1970,,25776,64027070,11418493,,22737,60106001,10717755,,3039,3921069,700738,PDN
SS323,,1999,1970,,84833,64838361,11621908,,22842,61267894,10924602,,61991,3570467,697306,PDN
SS323,,2000,1970,,210235,67102096,12150110,,22856,61928862,11042226,,187379,5173234,1107884,PDN
SS323,,2001,1970,,22857,62240452,11097671,,22857,62240452,11097671,,0,0,0,PDN
SS323,,2002,1970,,22857,62240452,11097671,,22857,62240452,11097671,,0,0,0,PDN
SS323,,2003,1970,,22857,62240452,11097671,,22857,62240452,11097671,,0,0,0,PDN
SS323,,2004,1970,,22857,62240452,11097671,,22857,62240452,11097671,,0,0,0,PDN
SS323,,2005,1970,,22857,62240452,11097671,,22857,62240452,11097671,,0,0,0,PDN
SS323,,2006,1970,,22857,62240452,11097671,,22857,62240452,11097671,,0,0,0,PDN
SS323,,2007,1970,,22857,62240452,11097671,,22857,62240452,11097671,,0,0,0,PDN
SS323,,2008,1970,,22857,62240452,11097671,,22857,62240452,11097671,,0,0,0,PDN
SS323,,2009,1970,,22857,63434788,11310184,,22857,63434788,11310184,,0,0,0,PDN
SS323,,2010,1970,,22857,63434788,11310184,,22857,63434788,11310184,,0,0,0,PDN
SS323,,2011,1970,,22857,63434788,11310184,,22857,63434788,11310184,,0,0,0,PDN
SS323,,2012,1970,,22857,63434788,11310184,,22857,63434788,11310184,,0,0,0,PDN
SS323,,2013,1970,,22857,63434788,11310184,,22857,63434788,11310184,,0,0,0,PDN
SS323,,2014,1970,,22857,63434788,11310184,,22857,63434788,11310184,,0,0,0,PDN
SS323,,2015,1970,,22857,63434788,11310184,,22857,63434788,11310184,,0,0,0,PDN
SS323,,2016,1970,,22857,63434788,11310184,,22857,63434788,11310184,,0,0,0,PDN
SS323,,2017,1970,,22857,63434788,11310184,,22857,63434788,11310184,,0,0,0,PDN
SS323,,2017,1970,,22857,63434788,11310184,,22857,63434788,11310184,,0,0,0,PDN
SS326,,1998,1977,,804,8039289,1431282,,0,65708,11692,,804,7973581,1419590,PDN
SS326,,1999,1977,,804,8039289,1431282,,0,2693014,479184,,804,5346275,952098,PDN
SS326,,2000,1977,,804,8039289,1431282,,0,3919721,697459,,804,4119568,733823,PDN
SS326,,2001,1977,,0,4154255,739191,,0,4137939,736288,,0,16316,2903,PDN
SS326,,2002,1977,,0,4154255,739191,,0,4154255,739191,,0,0,0,PDN
SS326,,2003,1977,,0,4154255,739191,,0,4154255,739191,,0,0,0,PDN
SS326,,2004,1977,,0,4154255,739191,,0,4154255,739191,,0,0,0,PDN
SS326,,2005,1977,,0,4154255,739191,,0,4154255,739191,,0,0,0,PDN
SS326,,2006,1977,,0,4154255,739191,,0,4154255,739191,,0,0,0,PDN
SS326,,2007,1977,,0,4154255,739191,,0,4154255,739191,,0,0,0,PDN
SS326,,2008,1977,,0,4154255,739191,,0,4154255,739191,,0,0,0,PDN
SS326,,2009,1977,,0,4154255,739191,,0,4154255,739191,,0,0,0,PDN
SS326,,2010,1977,,0,4154255,739191,,0,4154255,739191,,0,0,0,PDN
SS326,,2011,1977,,0,4154255,739191,,0,4154255,739191,,0,0,0,PDN
SS326,,2012,1977,,0,4154255,739191,,0,4154255,739191,,0,0,0,PDN
SS326,,2013,1977,,0,4154255,739191,,0,4154255,739191,,0,0,0,PDN
SS326,,2014,1977,,0,4154255,739191,,0,4154255,739191,,0,0,0,PDN
SS326,,2015,1977,,0,4154255,739191,,0,4154255,739191,,0,0,0,PDN
SS326,,2016,1977,,0,4154255,739191,,0,4154255,739191,,0,0,0,PDN
SS326,,2017,1977,,0,4154255,739191,,0,4154255,739191,,0,0,0,PDN
SS326,,2017,1977,,0,4154255,739191,,0,4154255,739191,,0,0,0,PDN
SS332,,1985,1983,,1703481,18183341,4938951,,0,0,0,,1703481,18183341,4938951,PDP
SS332,,1986,1983,,3958118,83428825,18803105,,509207,13830497,2970150,,3448911,69598328,15832955,PDP
SS332,,1987,1983,,4163280,91174686,20386534,,942492,27324671,5804533,,3220788,63850015,14582001,PDP
SS332,,1988,1983,,4420584,98893797,22017345,,1351340,38867007,8267178,,3069244,60026790,13750167,PDP
SS332,,1989,1983,,5604653,137770158,30118916,,2284595,57009685,12428667,,3320058,80760473,17690249,PDP
SS332,,1990,1983,,6503437,128613105,29388331,,2921336,68327419,15079240,,3582101,60285686,14309091,PDP
SS332,,1991,1983,,6173047,134650791,30132262,,3262013,74964834,16600951,,2911034,59685957,13531311,PDP
SS332,,1992,1983,,3313177,75351569,16720929,,3313177,75351569,16720929,,0,0,0,PDP
SS332,,1993,1983,,3313177,75351569,16720929,,3313177,75351569,16720929,,0,0,0,PDP
SS332,,1994,1983,,3313177,75351569,16720929,,3313177,75351569,16720929,,0,0,0,PDP
SS332,,1995,1983,,3313177,75351569,16720929,,3313177,75351569,16720929,,0,0,0,PDP
SS332,,1996,1983,,3313177,75351569,16720929,,3313177,75351569,16720929,,0,0,0,PDP
SS332,,1997,1983,,3313177,75351569,16720929,,3313177,75351569,16720929,,0,0,0,PDP
SS332,,1998,1983,,4586236,79553793,18741715,,3577016,73586370,16670676,,1009220,5967423,2071039,PDP
SS332,,1999,1983,,4529568,78618908,18518698,,4201020,77307047,17956722,,328548,1311861,561976,PDP
SS332,,2000,1983,,4751247,81646456,19279086,,4566792,80302502,18855493,,184455,1343954,423593,PDP
SS332,,2001,1983,,5099523,89052989,20945251,,4791048,83952397,19729197,,308475,5100592,1216054,PDP
SS332,,2002,1983,,5099490,89052461,20945124,,4799004,84428015,19821782,,300486,4624446,1123342,PDP
SS332,,2003,1983,,5134185,89405023,21042552,,4910789,86298177,20266337,,223396,3106846,776215,PDP
SS332,,2004,1983,,5018157,88666103,20795044,,5002344,88502883,20750188,,15813,163220,44856,PDP
SS332,,2005,1983,,5018157,88666103,20795044,,5004162,88517151,20754545,,13995,148952,40499,PDP
SS332,,2006,1983,,6252219,100390358,24115272,,5270530,91526856,21556447,,981689,8863502,2558825,PDP
SS332,,2007,1983,,6252219,100390358,24115272,,5618613,95189833,22556306,,633606,5200525,1558966,PDP
SS332,,2008,1983,,6325805,102447603,24554916,,5848819,97496416,23196936,,476986,4951187,1357980,PDP
SS332,,2009,1983,,6370946,104322715,24933708,,6074858,101072889,24059358,,296088,3249826,874348,PDP
SS332,,2010,1983,,6635265,105246410,25362385,,6210966,102177827,24392075,,424299,3068583,970309,PDP
SS332,,2011,1983,,6635265,105246410,25362385,,6320065,103130354,24670662,,315200,2116056,691722,PDP
SS332,,2012,1983,,6635265,105246410,25362385,,6417269,103900529,24904908,,217996,1345881,457476,PDP
SS332,,2013,1983,,6560209,104798689,25207663,,6479851,104402692,25056842,,80358,395997,150819,PDP
SS332,,2014,1983,,6560209,104798689,25207663,,6522085,104668973,25146457,,38124,129716,61204,PDP
SS332,,2015,1983,,6647130,105015991,25333250,,6567292,104881290,25229443,,79838,134701,103805,PDP
SS332,,2016,1983,,6647130,105015991,25333250,,6567293,104883050,25229757,,79837,132941,103491,PDP
SS332,,2017,1983,,6647130,105015991,25333250,,6589491,104883050,25251955,,57639,132941,81293,PDP
SS332,,2017,1983,,6647130,105015991,25333250,,6589491,104883050,25251955,,57639,132941,81293,PDP
SS343,,1975,1972,,4000000,353000000,66811388,,0,0,0,,4000000,353000000,66811388,PDN
SS343,,1976,1972,,177221,177220344,31711090,,0,12262,2182,,177221,177208082,31708908,PDN
SS343,,1977,1972,,177221,184720344,33045610,,0,25607081,4556420,,177221,159113263,28489190,PDN
SS343,,1978,1972,,184193,184192344,32958631,,697,54129615,9632301,,183496,130062729,23326330,PDN
SS343,,1979,1972,,190117,190116905,34018748,,1504,83183467,14802833,,188613,106933438,19215915,PDN
SS343,,1980,1972,,191013,228433335,40837514,,1504,109526963,19490287,,189509,118906372,21347227,PDN
SS343,,1981,1972,,191013,228433335,40837514,,1504,128306298,22831806,,189509,100127037,18005708,PDN
SS343,,1982,1972,,191013,228433335,40837514,,1504,139526660,24828312,,189509,88906675,16009202,PDN
SS343,,1983,1972,,191013,228433335,40837514,,1504,151400931,26941171,,189509,77032404,13896343,PDN
SS343,,1984,1972,,191013,228433335,40837514,,1504,164480095,29268425,,189509,63953240,11569089,PDN
SS343,,1985,1972,,160871,212610801,37991974,,1504,173377992,30851681,,159367,39232809,7140293,PDN
SS343,,1986,1972,,160871,216083378,38609871,,1504,178140786,31699153,,159367,37942592,6910718,PDN
SS343,,1987,1972,,0,220854097,39297882,,0,183810332,32706465,,0,37043765,6591417,PDN
SS343,,1988,1972,,0,223375132,39746465,,0,195265202,34744698,,0,28109930,5001767,PDN
SS343,,1989,1972,,0,228998905,40747136,,0,202064915,35954611,,0,26933990,4792525,PDN
SS343,,1990,1972,,0,233857369,41611631,,0,205912405,36639218,,0,27944964,4972413,PDN
SS343,,1991,1972,,0,237883375,42328003,,0,210464147,37449136,,0,27419228,4878867,PDN
SS343,,1992,1972,,0,233606718,41567032,,0,214616266,38187948,,0,18990452,3379084,PDN
SS343,,1993,1972,,0,234317536,41693512,,0,216732081,38564427,,0,17585455,3129085,PDN
SS343,,1994,1972,,0,229086507,40762724,,0,219099895,38985746,,0,9986612,1776978,PDN
SS343,,1995,1972,,0,229095550,40764333,,0,219800350,39110383,,0,9295200,1653950,PDN
SS343,,1996,1972,,0,219836411,39116799,,0,219836411,39116799,,0,0,0,PDN
SS343,,1997,1972,,0,219836411,39116799,,0,219836411,39116799,,0,0,0,PDN
SS343,,1998,1972,,0,219836411,39116799,,0,219836411,39116799,,0,0,0,PDN
SS343,,1999,1972,,0,219836411,39116799,,0,219836411,39116799,,0,0,0,PDN
SS343,,2000,1972,,0,219836411,39116799,,0,219836411,39116799,,0,0,0,PDN
SS343,,2001,1972,,0,219836411,39116799,,0,219836411,39116799,,0,0,0,PDN
SS343,,2002,1972,,0,219836411,39116799,,0,219836411,39116799,,0,0,0,PDN
SS343,,2003,1972,,0,219836411,39116799,,0,219836411,39116799,,0,0,0,PDN
SS343,,2004,1972,,0,219836411,39116799,,0,219836411,39116799,,0,0,0,PDN
SS343,,2005,1972,,0,219836411,39116799,,0,219836411,39116799,,0,0,0,PDN
SS343,,2006,1972,,0,219836411,39116799,,0,219836411,39116799,,0,0,0,PDN
SS343,,2007,1972,,0,219836411,39116799,,0,219836411,39116799,,0,0,0,PDN
SS343,,2008,1972,,0,219836411,39116799,,0,219836411,39116799,,0,0,0,PDN
SS343,,2009,1972,,0,224239095,39900195,,0,224239095,39900195,,0,0,0,PDN
SS343,,2010,1972,,0,224239095,39900195,,0,224239095,39900195,,0,0,0,PDN
SS343,,2011,1972,,0,224239095,39900195,,0,224239095,39900195,,0,0,0,PDN
SS343,,2012,1972,,0,224239095,39900195,,0,224239095,39900195,,0,0,0,PDN
SS343,,2013,1972,,0,224239095,39900195,,0,224239095,39900195,,0,0,0,PDN
SS343,,2014,1972,,0,224239095,39900195,,0,224239095,39900195,,0,0,0,PDN
SS343,,2015,1972,,0,224239095,39900195,,0,224239095,39900195,,0,0,0,PDN
SS343,,2016,1972,,0,224239095,39900195,,0,224239095,39900195,,0,0,0,PDN
SS343,,2017,1972,,0,224239095,39900195,,0,224239095,39900195,,0,0,0,PDN
SS343,,2017,1972,,0,224239095,39900195,,0,224239095,39900195,,0,0,0,PDN
SS349,,1995,1993,,3173552,4689300,4007947,,0,0,0,,3173552,4689300,4007947,PDP
SS349,,1996,1993,,9866301,14607019,12465415,,0,0,0,,9866301,14607019,12465415,PDP
SS349,,1997,1993,,22170204,37433041,28830887,,3258211,5698958,4272260,,18911993,31734083,24558627,PDP
SS349,,1998,1993,,22170204,37433041,28830887,,7704676,14310751,10251073,,14465528,23122290,18579814,PDP
SS349,,1999,1993,,19848144,38902779,26770347,,11357313,22299195,15325141,,8490831,16603584,11445206,PDP
SS349,,2000,1993,,21559265,40541559,28773066,,13682757,26611800,18417953,,7876508,13929759,10355113,PDP
SS349,,2001,1993,,22630126,43552772,30379730,,15192047,30328699,20588613,,7438079,13224073,9791117,PDP
SS349,,2002,1993,,22630126,43552773,30379730,,16223486,32568297,22018557,,6406640,10984476,8361173,PDP
SS349,,2003,1993,,22720897,44032868,30555927,,17105333,34736626,23286227,,5615564,9296242,7269700,PDP
SS349,,2004,1993,,21953488,43038657,29611612,,17808488,36252466,24259105,,4145000,6786191,5352507,PDP
SS349,,2005,1993,,21843618,43290834,29546614,,18329959,37350945,24976035,,3513659,5939889,4570579,PDP
SS349,,2006,1993,,21875407,43367197,29591990,,19028196,38807850,25933507,,2847211,4559347,3658483,PDP
SS349,,2007,1993,,21954379,43460141,29687501,,19620630,39875678,26715946,,2333749,3584463,2971555,PDP
SS349,,2008,1993,,22245115,44051839,30083521,,20368848,41253934,27709406,,1876267,2797905,2374115,PDP
SS349,,2009,1993,,24656610,49154809,33403018,,21186116,42994691,28836417,,3470494,6160118,4566600,PDP
SS349,,2010,1993,,24656610,49154809,33403018,,21968172,44395057,29867648,,2688438,4759752,3535369,PDP
SS349,,2011,1993,,26041964,53007585,35473919,,22497778,45275362,30553892,,3544186,7732223,4920026,PDP
SS349,,2012,1993,,30113628,61369221,41033418,,23645950,48324564,32244627,,6467678,13044657,8788791,PDP
SS349,,2013,1993,,36070955,71642883,48818799,,25972332,52905718,35386161,,10098623,18737165,13432638,PDP
SS349,,2014,1993,,37052292,73618475,50151665,,28392756,57580677,38638427,,8659536,16037798,11513238,PDP
SS349,,2015,1993,,38594333,77236212,52337430,,31164018,62831757,42344045,,7430315,14404455,9993385,PDP
SS349,,2016,1993,,38594333,77236212,52337430,,32761507,65962217,44498556,,5832826,11273995,7838874,PDP
SS349,,2017,1993,,43056059,85602769,58287868,,35035857,70372880,47557721,,8020202,15229889,10730147,PDP
SS349,,2017,1993,,43056059,85602769,58287868,,35035857,70372880,47557721,,8020202,15229889,10730147,PDP
SS351,,2007,1986,,1760205,3125996,2316432,,248401,849254,399514,,1511804,2276742,1916918,PDN
SS351,,2008,1986,,1760205,3125996,2316432,,909063,1503973,1176674,,851142,1622023,1139758,PDN
SS351,,2009,1986,,2454445,2905911,2971510,,1662279,2169108,2048240,,792166,736803,923270,PDN
SS351,,2010,1986,,2454445,2905911,2971510,,1932600,2452006,2368899,,521845,453905,602610,PDN
SS351,,2011,1986,,2454445,2905911,2971510,,2050964,2562124,2506858,,403481,343787,464652,PDN
SS351,,2012,1986,,2454445,2905911,2971510,,2161307,2653028,2633377,,293138,252883,338136,PDN
SS351,,2013,1986,,2454445,2905911,2971510,,2212947,2710216,2695193,,241498,195695,276320,PDN
SS351,,2014,1986,,2787106,3184535,3353749,,2298104,2795081,2795450,,489002,389454,558300,PDN
SS351,,2015,1986,,2804149,3227127,3378370,,2398069,2870487,2908832,,406080,356640,469539,PDN
SS351,,2016,1986,,2805760,3256677,3385239,,2445903,2918856,2965272,,359857,337821,419967,PDN
SS351,,2017,1986,,2445903,2918856,2965272,,2445903,2918856,2965272,,0,0,0,PDN
SS351,,2017,1986,,2445903,2918856,2965272,,2445903,2918856,2965272,,0,0,0,PDN
SS361,,1998,1996,,3721577,33706320,9719143,,261853,2192055,651898,,3459724,31514265,9067245,PDN
SS361,,1999,1996,,3723803,33726488,9724957,,424397,3843693,1108328,,3299406,29882795,8616629,PDN
SS361,,2000,1996,,477266,5504414,1456699,,470086,4838845,1331090,,7180,665569,125609,PDN
SS361,,2001,1996,,477266,5504414,1456699,,472168,5080656,1376199,,5098,423758,80500,PDN
SS361,,2002,1996,,477252,5503982,1456608,,473255,5178989,1394783,,3997,324993,61825,PDN
SS361,,2003,1996,,477252,5503982,1456608,,473424,5193416,1397519,,3828,310566,59089,PDN
SS361,,2004,1996,,477252,5503982,1456608,,473424,5193416,1397519,,3828,310566,59089,PDN
SS361,,2005,1996,,473539,5200893,1398965,,473539,5200893,1398965,,0,0,0,PDN
SS361,,2006,1996,,473539,5200893,1398965,,473539,5200893,1398965,,0,0,0,PDN
SS361,,2007,1996,,473539,5200893,1398965,,473539,5200893,1398965,,0,0,0,PDN
SS361,,2008,1996,,473539,5200893,1398965,,473539,5200893,1398965,,0,0,0,PDN
SS361,,2009,1996,,473539,5212401,1401013,,473539,5212401,1401013,,0,0,0,PDN
SS361,,2010,1996,,473539,5212401,1401013,,473539,5212401,1401013,,0,0,0,PDN
SS361,,2011,1996,,473539,5212401,1401013,,473539,5212401,1401013,,0,0,0,PDN
SS361,,2012,1996,,473539,5212401,1401013,,473539,5212401,1401013,,0,0,0,PDN
SS361,,2013,1996,,473539,5212401,1401013,,473539,5212401,1401013,,0,0,0,PDN
SS361,,2014,1996,,473539,5212401,1401013,,473539,5212401,1401013,,0,0,0,PDN
SS361,,2015,1996,,473539,5212401,1401013,,473539,5212401,1401013,,0,0,0,PDN
SS361,,2016,1996,,473539,5212401,1401013,,473539,5212401,1401013,,0,0,0,PDN
SS361,,2017,1996,,473539,5212401,1401013,,473539,5212401,1401013,,0,0,0,PDN
SS361,,2017,1996,,473539,5212401,1401013,,473539,5212401,1401013,,0,0,0,PDN
ST021,,1975,1957,,200000000,250000000,244483986,,149529722,230520305,190547570,,50470278,19479695,53936416,PDP
ST021,,1976,1957,,200000000,255040000,245380783,,156453851,239347050,199042294,,43546149,15692950,46338489,PDP
ST021,,1977,1957,,200000000,255040000,245380783,,163965324,249585612,208375575,,36034676,5454388,37005208,PDP
ST021,,1978,1957,,205000000,284540000,255629893,,169985887,259744700,216203805,,35014113,24795300,39426088,PDP
ST021,,1979,1957,,210868273,335285818,270527671,,189310895,285725811,240151787,,21557378,49560007,30375884,PDP
ST021,,1980,1957,,218036359,357412429,281632877,,189165799,285196327,239912476,,28870560,72216102,41720401,PDP
ST021,,1981,1957,,216622867,352100870,279274267,,192122634,297056973,244979747,,24500233,55043897,34294520,PDP
ST021,,1982,1957,,222724757,358612064,286534733,,195794145,302900742,249691074,,26930612,55711322,36843659,PDP
ST021,,1983,1957,,228769695,379501990,296296739,,198848217,308125262,253674776,,29921478,71376728,42621963,PDP
ST021,,1984,1957,,242680097,428751771,318970448,,205139479,317087265,261560701,,37540618,111664506,57409747,PDP
ST021,,1985,1957,,245767124,433290606,322865097,,207680528,323298988,265207038,,38086596,109991618,57658059,PDP
ST021,,1986,1957,,245506028,433591105,322657470,,210517469,327472274,268786557,,34988559,106118831,53870913,PDP
ST021,,1987,1957,,247566017,419090874,322137347,,213089158,330625684,271919351,,34476859,88465190,50217996,PDP
ST021,,1988,1957,,245734893,407425036,318230451,,214837991,333329963,274149372,,30896902,74095073,44081079,PDP
ST021,,1989,1957,,229497302,360891315,293712838,,216801885,336022373,276592343,,12695417,24868942,17120495,PDP
ST021,,1990,1957,,231204006,366216510,296367086,,219165226,339485913,279571972,,12038780,26730597,16795114,PDP
ST021,,1991,1957,,232498298,367780024,297939583,,221300595,342834451,282303166,,11197703,24945573,15636417,PDP
ST021,,1992,1957,,236447643,377427156,303605500,,223423218,346684404,285110834,,13024425,30742752,18494666,PDP
ST021,,1993,1957,,239963997,375463643,306772474,,225403915,349401674,287575031,,14560082,26061969,19197443,PDP
ST021,,1994,1957,,240205017,375997536,307108493,,227071612,351740787,289658941,,13133405,24256749,17449552,PDP
ST021,,1995,1957,,241959745,382865542,310085286,,229157240,356623611,292613399,,12802505,26241931,17471887,PDP
ST021,,1996,1957,,245304450,392075989,315068861,,231270302,362146463,295709174,,14034148,29929526,19359687,PDP
ST021,,1997,1957,,248191397,419985497,322921912,,233404312,367576776,298809432,,14787085,52408721,24112480,PDP
ST021,,1998,1957,,250970446,425621990,326703896,,235008230,373525079,301471767,,15962216,52096911,25232129,PDP
ST021,,1999,1957,,247799112,411719202,321058757,,236409377,377995595,303668380,,11389735,33723607,17390377,PDP
ST021,,2000,1957,,246822572,401920784,318338726,,237361430,379839341,304948501,,9461142,22081443,13390225,PDP
ST021,,2001,1957,,247280726,403674732,319108970,,238337555,382345443,306370552,,8943171,21329289,12738418,PDP
ST021,,2002,1957,,248080124,406283286,320372524,,239102509,384353567,307492823,,8977615,21929719,12879701,PDP
ST021,,2003,1957,,255134597,425355873,330820696,,240535851,387471862,309481022,,14598746,37884011,21339674,PDP
ST021,,2004,1957,,250913406,407107780,323352513,,242009389,389602112,311333608,,8904017,17505668,12018905,PDP
ST021,,2005,1957,,264845525,467094046,347958344,,243775121,391614610,313457436,,21070404,75479436,34500908,PDP
ST021,,2006,1957,,275590789,475218020,360149155,,246004148,396531348,316561327,,29586641,78686672,43587828,PDP
ST021,,2007,1957,,276760899,491285581,364178262,,248966128,401721427,320446809,,27794771,89564154,43731453,PDP
ST021,,2008,1957,,269965487,444503222,349058587,,251021920,406984946,323439170,,18943567,37518276,25619417,PDP
ST021,,2009,1957,,264483023,436360729,342127278,,252960997,418366018,327403345,,11522026,17994711,14723933,PDP
ST021,,2010,1957,,264480963,436359237,342124953,,254375342,420458387,329190002,,10105621,15900850,12934952,PDP
ST021,,2011,1957,,263706015,435837209,341257118,,255399717,421895413,330470076,,8306298,13941796,10787045,PDP
ST021,,2012,1957,,263694536,435576002,341199161,,256135354,422908429,331385963,,7559182,12667573,9813201,PDP
ST021,,2013,1957,,261366703,430533487,337974085,,256783116,423762398,332185679,,4583587,6771089,5788405,PDP
ST021,,2014,1957,,259313769,426939456,335281639,,257368727,424558816,332912998,,1945042,2380640,2368641,PDP
ST021,,2015,1957,,259407706,428299932,335617654,,257885051,425243034,333551068,,1522655,3056898,2066585,PDP
ST021,,2016,1957,,259565681,428419566,335796918,,258372862,426066674,334185438,,1192819,2352892,1611485,PDP
ST021,,2017,1957,,259718825,428930960,336041056,,258759791,426605313,334668208,,959034,2325647,1372848,PDP
ST021,,2017,1957,,259718825,428930960,336041056,,258759791,426605313,334668208,,959034,2325647,1372848,PDP
ST030,,1995,1979,,9397,9396992,1681460,,0,1975695,351547,,9397,7421297,1329913,PDP
ST030,,1996,1979,,9397,9396992,1681460,,0,4819724,857602,,9397,4577268,823858,PDP
ST030,,1997,1979,,9397,9396992,1681460,,0,5586647,994065,,9397,3810345,687395,PDP
ST030,,1998,1979,,9397,9396992,1681460,,0,5963466,1061115,,9397,3433526,620345,PDP
ST030,,1999,1979,,9397,9396992,1681460,,0,6480221,1153064,,9397,2916771,528396,PDP
ST030,,2000,1979,,9397,9396992,1681460,,0,6708524,1193688,,9397,2688468,487772,PDP
ST030,,2001,1979,,9397,9396992,1681460,,0,6854984,1219748,,9397,2542008,461712,PDP
ST030,,2002,1979,,9445,9445018,1690053,,0,6854984,1219748,,9445,2590034,470305,PDP
ST030,,2003,1979,,61442,12999229,2374472,,8900,7187164,1287755,,52542,5812065,1086717,PDP
ST030,,2004,1979,,163896,17973119,3361960,,52004,9001237,1653648,,111892,8971882,1708312,PDP
ST030,,2005,1979,,132710,13277800,2495308,,109469,9680954,1832059,,23241,3596846,663249,PDP
ST030,,2006,1979,,415109,16765281,3398255,,130347,10065437,1921350,,284762,6699844,1476905,PDP
ST030,,2007,1979,,415109,16765281,3398255,,183238,11034385,2146652,,231871,5730896,1251603,PDP
ST030,,2008,1979,,731216,19439589,4190218,,204239,11242268,2204643,,526977,8197321,1985575,PDP
ST030,,2009,1979,,733154,12638544,2982006,,223336,11491879,2268155,,509818,1146665,713851,PDP
ST030,,2010,1979,,733154,12638544,2982006,,232371,11675451,2309854,,500783,963093,672152,PDP
ST030,,2011,1979,,733154,12638544,2982006,,285210,12055988,2430405,,447944,582556,551602,PDP
ST030,,2012,1979,,733154,12638544,2982006,,332362,12104015,2486102,,400792,534529,495904,PDP
ST030,,2013,1979,,733154,12638544,2982006,,369485,12137285,2529145,,363669,501259,452861,PDP
ST030,,2014,1979,,379202,12155883,2542171,,379202,12155883,2542171,,0,0,0,PDP
ST030,,2015,1979,,466499,14653683,3073916,,400323,12548375,2633130,,66176,2105308,440786,PDP
ST030,,2016,1979,,764552,14300145,3309062,,451998,12683290,2708812,,312554,1616855,600251,PDP
ST030,,2017,1979,,764552,14300145,3309062,,503826,12783418,2778456,,260726,1516727,530606,PDP
ST030,,2017,1979,,764552,14300145,3309062,,503826,12783418,2778456,,260726,1516727,530606,PDP
ST036,,1977,1975,,15355278,73149072,28371127,,206726,2977299,736495,,15148552,70171773,27634632,PDP
ST036,,1978,1975,,16252200,74974082,29592784,,665399,9489819,2353979,,15586801,65484263,27238805,PDP
ST036,,1979,1975,,21603508,147591934,47865418,,2109942,32227766,7844420,,19493566,115364168,40020998,PDP
ST036,,1980,1975,,25603129,196993591,60655369,,4287322,60719512,15091506,,21315807,136274079,45563863,PDP
ST036,,1981,1975,,27054150,225283345,67140154,,6087221,85852406,21363450,,20966929,139430939,45776704,PDP
ST036,,1982,1975,,27362967,246205939,71171853,,7539713,104848465,26196023,,19823254,141357474,44975830,PDP
ST036,,1983,1975,,28050349,261146043,74517616,,8777056,119923797,30115810,,19273293,141222246,44401806,PDP
ST036,,1984,1975,,30905344,274430117,79736326,,9723675,130693580,32978760,,21181669,143736537,46757566,PDP
ST036,,1985,1975,,31174855,273490694,79838680,,10544406,140999324,35633254,,20630449,132491370,44205426,PDP
ST036,,1986,1975,,29745352,302034264,83488104,,11362774,151323987,38288750,,18382578,150710277,45199354,PDP
ST036,,1987,1975,,31070470,315829425,87267877,,12632163,167968255,42519753,,18438307,147861170,44748124,PDP
ST036,,1988,1975,,36207487,418255789,110630225,,13561089,186994730,46834173,,22646398,231261059,63796052,PDP
ST036,,1989,1975,,27001695,373743581,93504112,,14241628,199505336,49740798,,12760067,174238245,43763314,PDP
ST036,,1990,1975,,22485654,341780211,83300638,,14913834,210086624,52295796,,7571820,131693587,31004842,PDP
ST036,,1991,1975,,22793287,346598040,84465536,,15727796,221589572,55156545,,7065491,125008468,29308991,PDP
ST036,,1992,1975,,22344760,328113505,80727946,,16331952,231005784,57436184,,6012808,97107721,23291762,PDP
ST036,,1993,1975,,21722995,332801589,80940360,,16694481,238071441,59055947,,5028514,94730148,21884413,PDP
ST036,,1994,1975,,19925344,292473265,71966850,,17063791,242878149,60280543,,2861553,49595116,11686307,PDP
ST036,,1995,1975,,19986691,286727551,71005828,,17438680,247191681,61422965,,2548011,39535870,9582863,PDP
ST036,,1996,1975,,20909556,288695397,72278844,,17743785,250157697,62255831,,3165771,38537700,10023013,PDP
ST036,,1997,1975,,21118304,295191564,73643493,,18018175,252415304,62931930,,3100129,42776260,10711563,PDP
ST036,,1998,1975,,22600779,307158178,77255259,,18311605,254762900,63643082,,4289174,52395278,13612177,PDP
ST036,,1999,1975,,26371926,336085822,86173674,,19026259,248710369,63280773,,7345667,87375453,22892901,PDP
ST036,,2000,1975,,26899715,342397257,87824493,,19619179,257417153,65422943,,7280536,84980104,22401550,PDP
ST036,,2001,1975,,27433476,361196669,91703345,,20068779,266230027,67440670,,7364697,94966642,24262675,PDP
ST036,,2002,1975,,29296048,363515550,93978530,,20895238,272950352,69462916,,8400810,90565198,24515614,PDP
ST036,,2003,1975,,34730547,362544137,99240179,,21613937,278531824,71174760,,13116610,84012313,28065419,PDP
ST036,,2004,1975,,29366486,353156724,92205761,,22199055,280768617,72157884,,7167431,72388107,20047877,PDP
ST036,,2005,1975,,29910771,380619434,97636649,,22612988,287489936,73767781,,7297783,93129498,23868868,PDP
ST036,,2006,1975,,30068298,381165195,97891286,,23134568,300353312,76578218,,6933730,80811883,21313068,PDP
ST036,,2007,1975,,24788948,324201214,82475997,,23495981,306108082,77963611,,1292967,18093132,4512386,PDP
ST036,,2008,1975,,25867719,362335289,90340190,,23637804,308714335,78569180,,2229915,53620954,11771010,PDP
ST036,,2009,1975,,26415233,366962091,91710979,,23970125,320087988,80925284,,2445108,46874103,10785695,PDP
ST036,,2010,1975,,26421139,366491605,91633169,,24468482,329169809,83039623,,1952657,37321796,8593546,PDP
ST036,,2011,1975,,26421139,366491605,91633169,,24929579,337609152,85002383,,1491560,28882453,6630787,PDP
ST036,,2012,1975,,26244149,362076025,90670488,,25116925,342080106,85985273,,1127224,19995919,4685217,PDP
ST036,,2013,1975,,26244149,362076168,90670514,,25417935,348279174,87389320,,826214,13796994,3281195,PDP
ST036,,2014,1975,,26303884,362114667,90737099,,25684980,354180307,88706388,,618904,7934360,2030713,PDP
ST036,,2015,1975,,26303785,362114667,90737000,,25810716,356126775,89178470,,493069,5987892,1558532,PDP
ST036,,2016,1975,,26239133,361845794,90624506,,25906318,356980389,89425962,,332815,4865405,1198545,PDP
ST036,,2017,1975,,26424663,361930983,90825194,,25992668,357239712,89558454,,431995,4691271,1266742,PDP
ST036,,2017,1975,,26316385,362523709,90822383,,25992668,357239712,89558454,,323717,5283997,1263931,PDP
ST037,,1976,1974,,23000000,79994000,37233808,,41278,401772,112768,,22958722,79592228,37121040,PDP
ST037,,1977,1974,,21070551,98683042,38629811,,1042033,7999266,2465390,,20028518,90683776,36164421,PDP
ST037,,1978,1974,,22267396,105293542,41002902,,2038896,15235527,4749844,,20228500,90058015,36253058,PDP
ST037,,1979,1974,,23171896,110221988,42784349,,2917105,20225095,6515876,,20254791,89996893,36268473,PDP
ST037,,1980,1974,,25253768,119154151,46455574,,3295120,24446311,7644997,,21958648,94707840,38810577,PDP
ST037,,1981,1974,,23674409,98467788,41195368,,3925138,26661984,8669263,,19749271,71805804,32526105,PDP
ST037,,1982,1974,,16406055,75235340,29793126,,4502161,29557219,9761453,,11903894,45678121,20031673,PDP
ST037,,1983,1974,,16771055,76385140,30362717,,5085896,31801929,10744602,,11685159,44583211,19618115,PDP
ST037,,1984,1974,,19804144,82484609,34481121,,5642175,33922068,11678130,,14161969,48562541,22802991,PDP
ST037,,1985,1974,,20221265,82970972,34984783,,6248343,36435858,12731592,,13972922,46535114,22253191,PDP
ST037,,1986,1974,,20221265,82970972,34984783,,6699957,37980983,13458139,,13521308,44989989,21526644,PDP
ST037,,1987,1974,,20991769,87077645,36486012,,7457690,41459708,14834862,,13534079,45617937,21651150,PDP
ST037,,1988,1974,,22429797,129940479,45550879,,8030146,43680502,15802477,,14399651,86259977,29748402,PDP
ST037,,1989,1974,,21222662,104987083,39903638,,8413214,44679902,16363374,,12809448,60307181,23540264,PDP
ST037,,1990,1974,,21288053,105108438,39990622,,8732686,45305590,16794179,,12555367,59802848,23196443,PDP
ST037,,1991,1974,,19955973,92120763,36347568,,9029798,46219039,17253826,,10926175,45901724,19093742,PDP
ST037,,1992,1974,,20066526,92644540,36551320,,9424372,47526760,17881091,,10642154,45117780,18670229,PDP
ST037,,1993,1974,,19973774,90397080,36058664,,9711334,48064240,18263690,,10262440,42332840,17794974,PDP
ST037,,1994,1974,,13404297,80346776,27700876,,9881397,48287430,18473466,,3522900,32059346,9227410,PDP
ST037,,1995,1974,,20245936,91694953,36561764,,10265004,49203089,19020002,,9980932,42491864,17541762,PDP
ST037,,1996,1974,,25302112,155653102,52998393,,10914271,54373427,20589258,,14387841,101279675,32409135,PDP
ST037,,1997,1974,,42851757,272594897,91356187,,14942844,86812091,30389835,,27908913,185782806,60966352,PDP
ST037,,1998,1974,,53423978,304743397,107648782,,20640971,127696169,43362709,,32783007,177047228,64286073,PDP
ST037,,1999,1974,,48696431,295548901,101285204,,26510532,158771410,54761673,,22185899,136777491,46523531,PDP
ST037,,2000,1974,,60498681,313371231,116258686,,35124901,190044854,68940711,,25373780,123326377,47317975,PDP
ST037,,2001,1974,,66257614,342006222,127112813,,44226045,209826006,81561633,,22031569,132180216,45551180,PDP
ST037,,2002,1974,,69471297,342880032,130481979,,51544538,230897935,92629580,,17926759,111982097,37852399,PDP
ST037,,2003,1974,,78063687,393832698,148140679,,56989401,242323835,100107521,,21074286,151508863,48033158,PDP
ST037,,2004,1974,,92395229,412897868,165864600,,64173047,262049208,110801020,,28222182,150848660,55063580,PDP
ST037,,2005,1974,,96518866,415333336,170421595,,68307744,270524368,116443753,,28211122,144808968,53977842,PDP
ST037,,2006,1974,,91305929,404172937,163222822,,71877520,278155263,121371339,,19428409,126017674,41851483,PDP
ST037,,2007,1974,,92828610,396581101,163394642,,74835324,285681513,125668333,,17993286,110899588,37726309,PDP
ST037,,2008,1974,,92905140,341461469,153663409,,77091889,290443580,128772241,,15813251,51017889,24891168,PDP
ST037,,2009,1974,,94870764,341568017,155647991,,79377638,296826251,132193699,,15493126,44741766,23454298,PDP
ST037,,2010,1974,,95666084,343654789,156814622,,81491535,302368423,135293745,,14174549,41286366,21520880,PDP
ST037,,2011,1974,,96088116,344320766,157355156,,83653939,307645557,138395141,,12434177,36675209,18960017,PDP
ST037,,2012,1974,,96584966,342905088,157600105,,85507983,312778002,141162426,,11076983,30127086,16437673,PDP
ST037,,2013,1974,,96258496,342715507,157239900,,87449709,317588469,143960114,,8808787,25127038,13279791,PDP
ST037,,2014,1974,,95550818,336919364,155500878,,89108824,320861983,146201705,,6441994,16057381,9299182,PDP
ST037,,2015,1974,,95569194,337332931,155592843,,90264393,323520908,147830391,,5304801,13812023,7762458,PDP
ST037,,2016,1974,,95229783,335077405,154852093,,91407844,325733992,149367630,,3821939,9343413,5484466,PDP
ST037,,2017,1974,,95839251,334836544,155418704,,92576589,327067868,150773721,,3262662,7768676,4644988,PDP
ST037,,2017,1974,,95839251,334836544,155418704,,92576589,327067868,150773721,,3262662,7768676,4644988,PDP
ST041,,2004,2004,,7377945,144258820,33046774,,42692,2608565,506849,,7335253,141650255,32539925,PDP
ST041,,2005,2004,,11944421,149705208,38582358,,637029,22837870,4700707,,11307392,126867338,33881651,PDP
ST041,,2006,2004,,11944421,149705208,38582358,,1362623,53007204,10794510,,10581798,96698004,27787848,PDP
ST041,,2007,2004,,14490719,164768300,43808922,,2197072,78618280,16186090,,12293647,86150020,27622832,PDP
ST041,,2008,2004,,11973689,171114332,42421079,,2526359,87897091,18166411,,9447330,83217241,24254668,PDP
ST041,,2009,2004,,7278808,134343310,31183312,,2716260,97769600,20112987,,4562548,36573710,11070328,PDP
ST041,,2010,2004,,7278808,134343310,31183312,,3213160,111053339,22973542,,4065648,23289971,8209772,PDP
ST041,,2011,2004,,6068094,127193104,28700319,,3555485,113790459,23802898,,2512609,13402645,4897422,PDP
ST041,,2012,2004,,6068094,127193104,28700319,,3977111,116109497,24637165,,2090983,11083607,4063155,PDP
ST041,,2013,2004,,5727935,125094799,27986797,,4269188,116888824,25067911,,1458747,8205975,2918886,PDP
ST041,,2014,2004,,6065160,123478079,28036349,,4499637,117649551,25433720,,1565523,5828528,2602629,PDP
ST041,,2015,2004,,5719739,124303652,27837827,,4721872,118321374,25775497,,997867,5982278,2062330,PDP
ST041,,2016,2004,,5410371,120340066,26823194,,4898801,118833092,26043479,,511570,1506974,779715,PDP
ST041,,2017,2004,,5432886,121500391,27052173,,5050331,119181189,26256949,,382555,2319202,795224,PDP
ST041,,2017,2004,,5432886,121500391,27052173,,5050331,119181189,26256949,,382555,2319202,795224,PDP
ST046,,1998,1998,,192359,11156796,2177554,,0,0,0,,192359,11156796,2177554,PDN
ST046,,1999,1998,,84872,5216008,1012987,,62445,3753764,730375,,22427,1462244,282612,PDN
ST046,,2000,1998,,86007,7219787,1370667,,69080,5902689,1119381,,16927,1317098,251286,PDN
ST046,,2001,1998,,69909,6175022,1168667,,69909,6175022,1168667,,0,0,0,PDN
ST046,,2002,1998,,69909,6175022,1168667,,69909,6175022,1168667,,0,0,0,PDN
ST046,,2003,1998,,69909,6175022,1168667,,69909,6175022,1168667,,0,0,0,PDN
ST046,,2004,1998,,69909,6175022,1168667,,69909,6175022,1168667,,0,0,0,PDN
ST046,,2005,1998,,132686,9947898,1902775,,69909,6175022,1168667,,62777,3772876,734108,PDN
ST046,,2006,1998,,132686,9947898,1902775,,69909,6175022,1168667,,62777,3772876,734108,PDN
ST046,,2007,1998,,259622,17308089,3339353,,154030,12034157,2295339,,105592,5273932,1044014,PDN
ST046,,2008,1998,,352436,24972189,4795886,,185631,14585777,2780965,,166805,10386412,2014921,PDN
ST046,,2009,1998,,239536,19372904,3686673,,223094,17833926,3396391,,16442,1538978,290281,PDN
ST046,,2010,1998,,239536,19372904,3686673,,235192,19134549,3639917,,4344,238355,46756,PDN
ST046,,2011,1998,,239536,19372904,3686673,,237313,19274948,3667020,,2223,97956,19653,PDN
ST046,,2012,1998,,239536,19342417,3681248,,239536,19342417,3681248,,0,0,0,PDN
ST046,,2013,1998,,239536,19342417,3681248,,239536,19342417,3681248,,0,0,0,PDN
ST046,,2014,1998,,239536,19342417,3681248,,239536,19342417,3681248,,0,0,0,PDN
ST046,,2015,1998,,239536,19342417,3681248,,239536,19342417,3681248,,0,0,0,PDN
ST046,,2016,1998,,239536,19342417,3681248,,239536,19342417,3681248,,0,0,0,PDN
ST046,,2017,1998,,239536,19342417,3681248,,239536,19342417,3681248,,0,0,0,PDN
ST046,,2017,1998,,239536,19342417,3681248,,239536,19342417,3681248,,0,0,0,PDN
ST052,,1975,1948,,9919632,37264714,16550364,,1109335,3813860,1787958,,8810297,33450854,14762406,PDP
ST052,,1976,1948,,9919632,37264714,16550364,,1404021,5269676,2341686,,8515611,31995038,14208678,PDP
ST052,,1977,1948,,11057179,43870389,18863298,,1984265,7012887,3232110,,9072914,36857502,15631188,PDP
ST052,,1978,1948,,11206163,44931645,19201118,,2952248,10465058,4814358,,8253915,34466587,14386760,PDP
ST052,,1979,1948,,16121783,68782696,28360697,,4115431,15586416,6888815,,12006352,53196280,21471882,PDP
ST052,,1980,1948,,16769449,72336497,29640712,,5257498,22565417,9272697,,11511951,49771080,20368015,PDP
ST052,,1981,1948,,27546950,127739581,50276413,,7239857,35407316,13540091,,20307093,92332265,36736322,PDP
ST052,,1982,1948,,28226670,127739682,50956151,,9893668,62441145,21004192,,18333002,65298537,29951959,PDP
ST052,,1983,1948,,34343523,297124201,87212598,,12492028,88777848,28288798,,21851495,208346353,58923800,PDP
ST052,,1984,1948,,37175364,343306446,98261920,,15627523,116550581,36366061,,21547841,226755865,61895859,PDP
ST052,,1985,1948,,47346089,337796073,107452152,,20506636,136357877,44769603,,26839453,201438196,62682549,PDP
ST052,,1986,1948,,58491327,355499954,121747547,,27735670,161294895,56435829,,30755657,194205059,65311718,PDP
ST052,,1987,1948,,71051279,447487552,150675399,,34299877,193040116,68648652,,36751402,254447436,82026747,PDP
ST052,,1988,1948,,75132077,496009583,163390010,,39381884,233386135,80909666,,35750193,262623448,82480344,PDP
ST052,,1989,1948,,72981552,486661944,159576204,,43420748,257546290,89247490,,29560804,229115654,70328714,PDP
ST052,,1990,1948,,67822701,473091308,152002649,,47062966,279583107,96810850,,20759735,193508201,55191799,PDP
ST052,,1991,1948,,69380166,455380024,150408640,,50907494,293689953,103165493,,18472672,161690071,47243147,PDP
ST052,,1992,1948,,69596934,452399420,150095051,,54497197,300482350,107963807,,15099737,151917070,42131244,PDP
ST052,,1993,1948,,74447782,439275286,152610644,,57695597,308187944,112533309,,16752185,131087342,40077335,PDP
ST052,,1994,1948,,71146150,402044978,142684402,,61199647,317118485,117626424,,9946503,84926493,25057978,PDP
ST052,,1995,1948,,74069638,400239099,145286560,,66552453,330888643,125429436,,7517185,69350456,19857124,PDP
ST052,,1996,1948,,85391268,449548669,165382134,,70935294,344061697,132156237,,14455974,105486972,33225897,PDP
ST052,,1997,1948,,99962554,498276105,188623783,,75040249,359094462,138936061,,24922305,139181643,49687722,PDP
ST052,,1998,1948,,104963314,571919161,206728289,,79268735,391495042,148929775,,25694579,180424119,57798514,PDP
ST052,,1999,1948,,94905885,542006351,191348297,,82753404,430924392,159430342,,12152481,111081959,31917955,PDP
ST052,,2000,1948,,98698789,532396194,193431208,,85232889,451870217,165636842,,13465900,80525977,27794366,PDP
ST052,,2001,1948,,100892717,618734994,210987912,,87338378,472652677,171440278,,13554339,146082317,39547634,PDP
ST052,,2002,1948,,101369488,619654977,211628381,,89433532,504346122,179174835,,11935956,115308855,32453546,PDP
ST052,,2003,1948,,102359572,634327400,215229217,,91187305,535225086,186423085,,11172267,99102314,28806132,PDP
ST052,,2004,1948,,106580806,654215628,222989281,,92692693,550041291,190564809,,13888113,104174337,32424472,PDP
ST052,,2005,1948,,112338399,662290457,230183677,,94200231,558323169,193545991,,18138168,103967288,36637686,PDP
ST052,,2006,1948,,108382552,636436839,221627542,,95337807,562113699,195358038,,13044745,74323140,26269504,PDP
ST052,,2007,1948,,108984630,635000095,221973971,,96651498,566482027,197449012,,12333132,68518068,24524959,PDP
ST052,,2008,1948,,105867255,633266622,218548149,,97603252,570759644,199161908,,8264003,62506978,19386241,PDP
ST052,,2009,1948,,106740945,635532650,219825045,,98605169,582179757,202195870,,8135776,53352893,17629177,PDP
ST052,,2010,1948,,107008937,630495678,219196778,,99306731,586535976,203672564,,7702206,43959702,15524218,PDP
ST052,,2011,1948,,107465813,621179002,217995883,,100058046,590667326,205158991,,7407767,30511676,12836891,PDP
ST052,,2012,1948,,108433973,622845261,219260531,,101176911,593355507,206756183,,7257062,29489754,12504350,PDP
ST052,,2013,1948,,106117036,614473443,215453947,,102153337,595935775,208191729,,3963699,18537668,7262217,PDP
ST052,,2014,1948,,106638844,626389315,218096015,,103258350,601895541,210357198,,3380494,24493774,7738815,PDP
ST052,,2015,1948,,107805379,627759546,219506366,,104358919,608125937,212566378,,3446460,19633609,6939985,PDP
ST052,,2016,1948,,108193594,628068294,219949518,,105279629,611896916,214158081,,2913965,16171378,5791438,PDP
ST052,,2017,1948,,108433259,630045984,220541085,,105995482,613547781,215167684,,2437777,16498203,5373402,PDP
ST052,,2017,1948,,108433259,630045984,220541085,,105995482,613547781,215167684,,2437777,16498203,5373402,PDP
ST054,,1975,1955,,24000000,210000000,61366548,,19518511,161952124,48335615,,4481489,48047876,13030933,PDP
ST054,,1976,1955,,24000000,210000000,61366548,,20316675,177624363,51922434,,3683325,32375637,9444114,PDP
ST054,,1977,1955,,24000000,210000000,61366548,,22569246,194684661,57210645,,1430754,15315339,4155903,PDP
ST054,,1978,1955,,26500000,239639500,69140480,,23299513,210024998,60670509,,3200487,29614502,8469971,PDP
ST054,,1979,1955,,29330790,288673808,80696236,,22185118,227276222,62625727,,7145672,61397586,18070509,PDP
ST054,,1980,1955,,30872883,291347040,82713993,,22327370,227248166,62762987,,8545513,64098874,19951006,PDP
ST054,,1981,1955,,31656447,294328570,84028079,,22845861,233385496,64373529,,8810586,60943074,19654550,PDP
ST054,,1982,1955,,31823860,298094568,84865598,,23255883,238735809,65735564,,8567977,59358759,19130034,PDP
ST054,,1983,1955,,43394645,312543219,99007317,,24626826,242005949,67688383,,18767819,70537270,31318934,PDP
ST054,,1984,1955,,46665128,325067613,104506340,,27156329,248431435,71361211,,19508799,76636178,33145129,PDP
ST054,,1985,1955,,49896772,328303525,108313769,,30422756,252898760,75422535,,19474016,75404765,32891234,PDP
ST054,,1986,1955,,46554899,307635034,101294229,,32064785,257186890,77827577,,14490114,50448144,23466652,PDP
ST054,,1987,1955,,46399195,308151049,101230343,,34538184,261404905,81051512,,11861011,46746144,20178831,PDP
ST054,,1988,1955,,48005039,311231747,103384353,,36418146,265228287,83611791,,11586893,46003460,19772562,PDP
ST054,,1989,1955,,46962790,311607179,102408907,,37984742,270969368,86199932,,8978048,40637811,16208975,PDP
ST054,,1990,1955,,47842474,312912272,103520814,,39699348,276305677,88864059,,8143126,36606595,14656755,PDP
ST054,,1991,1955,,47753113,309711760,102861967,,41386859,279075993,91044509,,6366254,30635767,11817458,PDP
ST054,,1992,1955,,48171847,309456452,103235273,,42855930,281912475,93018292,,5315917,27543977,10216981,PDP
ST054,,1993,1955,,49924508,314240683,105839220,,44267965,286129846,95180749,,5656543,28110837,10658471,PDP
ST054,,1994,1955,,50621271,320443891,107639757,,45534162,289888731,97115787,,5087109,30555160,10523970,PDP
ST054,,1995,1955,,51284440,311222232,106662061,,46588579,294300131,98955150,,4695861,16922101,7706911,PDP
ST054,,1996,1955,,55860841,317339887,112327013,,48174530,299233190,101418870,,7686311,18106697,10908143,PDP
ST054,,1997,1955,,63398168,348517252,125411914,,49709282,303550252,103721782,,13688886,44967000,21690132,PDP
ST054,,1998,1955,,66192516,355205665,129396371,,51801108,306032865,106255354,,14391408,49172800,23141017,PDP
ST054,,1999,1955,,61657043,349912482,123919051,,53727535,313035172,109427744,,7929508,36877310,14491307,PDP
ST054,,2000,1955,,63592575,370853315,129580709,,55689412,327932578,114040405,,7903163,42920737,15540304,PDP
ST054,,2001,1955,,64613238,393410622,134615128,,57576041,340309159,118129272,,7037197,53101463,16485856,PDP
ST054,,2002,1955,,67334999,401131434,138710699,,59319790,354628892,122421016,,8015209,46502542,16289683,PDP
ST054,,2003,1955,,68821969,418282784,143249510,,61144685,365965421,126263087,,7677284,52317363,16986423,PDP
ST054,,2004,1955,,69049482,422600652,144245327,,62731002,375070140,129469461,,6318480,47530512,14775866,PDP
ST054,,2005,1955,,72821162,455833403,153930309,,63961433,379527846,131493078,,8859729,76305557,22437231,PDP
ST054,,2006,1955,,73194377,459514197,154958469,,65213699,382780332,133324078,,7980678,76733865,21634391,PDP
ST054,,2007,1955,,72865182,451395419,153184652,,66454620,387627374,135427462,,6410562,63768045,17757190,PDP
ST054,,2008,1955,,78535521,467904174,161792491,,67567304,393150688,137522942,,10968217,74753486,24269549,PDP
ST054,,2009,1955,,78805243,450142090,158901708,,69667752,407416933,142161876,,9137491,42725157,16739834,PDP
ST054,,2010,1955,,79398376,453642582,160117703,,71096802,417139439,145320907,,8301574,36503143,14796795,PDP
ST054,,2011,1955,,79230567,464584354,161896829,,72265944,423621838,147643501,,6964623,40962516,14253327,PDP
ST054,,2012,1955,,79386731,464347851,162010911,,73195873,429642944,149644802,,6190858,34704907,12366108,PDP
ST054,,2013,1955,,78582885,460159281,160461768,,74141181,435551214,151641404,,4441704,24608067,8820365,PDP
ST054,,2014,1955,,78945405,462490857,161239157,,75136841,441529608,153700833,,3808564,20961249,7538323,PDP
ST054,,2015,1955,,79375202,462689597,161704318,,76002982,446777643,155500790,,3372220,15911954,6203530,PDP
ST054,,2016,1955,,79943376,457209076,161297310,,76837267,450371954,156974631,,3106109,6837122,4322679,PDP
ST054,,2017,1955,,80329410,459694526,162125594,,77699646,452795928,158268323,,2629764,6898598,3857273,PDP
ST054,,2017,1955,,80329410,459694526,162125594,,77699646,452795928,158268323,,2629764,6898598,3857273,PDP
ST076,,1987,1985,,282537,23496803,4463463,,0,0,0,,282537,23496803,4463463,PDN
ST076,,1988,1985,,4927877,56724788,15021256,,167560,2131752,546875,,4760317,54593036,14474381,PDN
ST076,,1989,1985,,4927877,56724788,15021256,,430408,6002124,1498402,,4497469,50722664,13522854,PDN
ST076,,1990,1985,,4927877,56724788,15021256,,738656,10352318,2580705,,4189221,46372470,12440551,PDN
ST076,,1991,1985,,3730428,54753138,13472979,,1258619,17983032,4458447,,2471809,36770106,9014532,PDN
ST076,,1992,1985,,3620610,50838789,12666658,,1680161,24435243,6028069,,1940449,26403546,6638589,PDN
ST076,,1993,1985,,3620610,50838789,12666658,,2016445,29310859,7231900,,1604165,21527930,5434758,PDN
ST076,,1994,1985,,3620610,50838789,12666658,,2287422,33456506,8240537,,1333188,17382283,4426121,PDN
ST076,,1995,1985,,3379291,49784402,12237726,,2681175,39436167,9698287,,698116,10348235,2539439,PDN
ST076,,1996,1985,,3992516,58878527,14469122,,2987069,44013754,10818698,,1005447,14864773,3650424,PDN
ST076,,1997,1985,,3992516,58878527,14469122,,3225221,47650860,11704022,,767295,11227667,2765100,PDN
ST076,,1998,1985,,3992516,58878527,14469122,,3403055,50221381,12339244,,589461,8657146,2129878,PDN
ST076,,1999,1985,,3956794,62375510,15055639,,3503776,51664987,12696834,,453018,10710523,2358805,PDN
ST076,,2000,1985,,3956794,62375510,15055639,,3548003,52226939,12841053,,408791,10148571,2214586,PDN
ST076,,2001,1985,,3953920,62332886,15045181,,3582161,52741209,12966718,,371759,9591677,2078463,PDN
ST076,,2002,1985,,4038823,63658503,15365959,,3604750,53111003,13055106,,434073,10547500,2310853,PDN
ST076,,2003,1985,,4038823,63658503,15365959,,3619868,53454759,13131391,,418955,10203744,2234568,PDN
ST076,,2004,1985,,4038823,63658503,15365959,,3636567,53742921,13199364,,402256,9915582,2166595,PDN
ST076,,2005,1985,,4038823,63658503,15365959,,3655006,54007420,13264867,,383817,9651083,2101092,PDN
ST076,,2006,1985,,4038823,63658503,15365959,,3665009,54098355,13291051,,373814,9560148,2074908,PDN
ST076,,2007,1985,,3848025,56824007,13959058,,3668650,54183495,13309841,,179375,2640512,649217,PDN
ST076,,2008,1985,,3848025,56824007,13959058,,3680123,54329448,13347285,,167902,2494559,611773,PDN
ST076,,2009,1985,,3701955,55604098,13595923,,3697809,55552378,13582574,,4146,51720,13349,PDN
ST076,,2010,1985,,3701955,55604098,13595923,,3701955,55604098,13595923,,0,0,0,PDN
ST076,,2011,1985,,3701955,55604098,13595923,,3701955,55604098,13595923,,0,0,0,PDN
ST076,,2012,1985,,3701955,55604098,13595923,,3701955,55604098,13595923,,0,0,0,PDN
ST076,,2013,1985,,3701955,55604098,13595923,,3701955,55604098,13595923,,0,0,0,PDN
ST076,,2014,1985,,3701955,55604098,13595923,,3701955,55604098,13595923,,0,0,0,PDN
ST076,,2015,1985,,3701955,55604098,13595923,,3701955,55604098,13595923,,0,0,0,PDN
ST076,,2016,1985,,3701955,55604098,13595923,,3701955,55604098,13595923,,0,0,0,PDN
ST076,,2017,1985,,3701955,55604098,13595923,,3701955,55604098,13595923,,0,0,0,PDN
ST076,,2017,1985,,3701955,55604098,13595923,,3701955,55604098,13595923,,0,0,0,PDN
ST077,,1984,1982,,2834401,14957490,5495876,,6239,18378,9509,,2828162,14939112,5486367,PDN
ST077,,1985,1982,,3432357,25672092,8000345,,425613,3185686,992461,,3006744,22486406,7007884,PDN
ST077,,1986,1982,,4195717,38762734,11093001,,719982,5208229,1646713,,3475735,33554505,9446288,PDN
ST077,,1987,1982,,4195717,38762734,11093001,,924306,6118567,2013019,,3271411,32644167,9079982,PDN
ST077,,1988,1982,,4195717,38762734,11093001,,1071311,6453204,2219568,,3124406,32309530,8873433,PDN
ST077,,1989,1982,,4015071,34788534,10205202,,1248471,7697118,2618065,,2766600,27091416,7587137,PDN
ST077,,1990,1982,,4015071,34788534,10205202,,1397060,8832109,2968610,,2618011,25956425,7236592,PDN
ST077,,1991,1982,,2577605,22387488,6561144,,1429756,9924478,3195677,,1147849,12463010,3365467,PDN
ST077,,1992,1982,,2611654,21781313,6487332,,1467671,10170138,3277304,,1143983,11611175,3210028,PDN
ST077,,1993,1982,,3333348,24986467,7779339,,1597951,10990243,3553510,,1735397,13996224,4225829,PDN
ST077,,1994,1982,,3333465,24986591,7779478,,1781538,11316680,3795182,,1551927,13669911,3984296,PDN
ST077,,1995,1982,,2665291,16289697,5563814,,1897872,11934402,4021431,,767419,4355295,1542383,PDN
ST077,,1996,1982,,2980510,19520232,6453861,,2000321,12873078,4290904,,980189,6647154,2162957,PDN
ST077,,1997,1982,,2980510,19520232,6453861,,2078997,14131904,4593571,,901513,5388328,1860290,PDN
ST077,,1998,1982,,2951967,19870676,6487674,,2117568,14444928,4687840,,834399,5425748,1799834,PDN
ST077,,1999,1982,,2676690,19468601,6140853,,2150109,14765044,4777341,,526581,4703557,1363512,PDN
ST077,,2000,1982,,2880620,22509664,6885898,,2322804,16291784,5221698,,557816,6217880,1664200,PDN
ST077,,2001,1982,,2974471,22934153,7055281,,2375423,16652986,5338588,,599048,6281167,1716693,PDN
ST077,,2002,1982,,2974389,22932044,7054824,,2400593,16681967,5368915,,573796,6250077,1685909,PDN
ST077,,2003,1982,,2929553,21331781,6725244,,2414508,16699019,5385864,,515045,4632762,1339380,PDN
ST077,,2004,1982,,2929553,21331781,6725244,,2418076,16748192,5398181,,511477,4583589,1327063,PDN
ST077,,2005,1982,,4668964,40483494,11872432,,2455068,18202521,5693951,,2213896,22280973,6178481,PDN
ST077,,2006,1982,,4597038,41777539,12030763,,2543573,19423034,5999629,,2053465,22354505,6031134,PDN
ST077,,2007,1982,,4405155,43699610,12180886,,2780467,23707188,6998828,,1624688,19992422,5182058,PDN
ST077,,2008,1982,,4323512,40490367,11528204,,2791307,23806592,7027355,,1532205,16683775,4500849,PDN
ST077,,2009,1982,,2792501,24106908,7081986,,2792397,24105642,7081656,,104,1266,329,PDN
ST077,,2010,1982,,2792501,24106908,7081986,,2792397,24106908,7081882,,104,0,104,PDN
ST077,,2011,1982,,2792501,24106908,7081986,,2792501,24106908,7081986,,0,0,0,PDN
ST077,,2012,1982,,2792501,24106908,7081986,,2792501,24106908,7081986,,0,0,0,PDN
ST077,,2013,1982,,2792501,24106908,7081986,,2792501,24106908,7081986,,0,0,0,PDN
ST077,,2014,1982,,2792501,24106908,7081986,,2792501,24106908,7081986,,0,0,0,PDN
ST077,,2015,1982,,2792501,24106908,7081986,,2792501,24106908,7081986,,0,0,0,PDN
ST077,,2016,1982,,2792501,24106908,7081986,,2792501,24106908,7081986,,0,0,0,PDN
ST077,,2017,1982,,2792501,24106908,7081986,,2792501,24106908,7081986,,0,0,0,PDN
ST077,,2017,1982,,2792501,24106908,7081986,,2792501,24106908,7081986,,0,0,0,PDN
ST086,,1975,1956,,8814924,310909342,64136871,,3194594,61120612,14070148,,5620330,249788730,50066723,PDP
ST086,,1976,1956,,8814924,310909342,64136871,,3297015,65546421,14960079,,5517909,245362921,49176792,PDP
ST086,,1977,1956,,11225937,338136782,71392624,,3462206,70038449,15924563,,7763731,268098333,55468061,PDP
ST086,,1978,1956,,8038032,204110239,44356580,,4141526,82563218,18832490,,3896506,121547021,25524090,PDP
ST086,,1979,1956,,5677072,215023701,43937517,,3420705,91437493,19690722,,2256367,123586208,24246795,PDP
ST086,,1980,1956,,7929227,225571120,48066437,,4007715,100455923,21882434,,3921512,125115197,26184003,PDP
ST086,,1981,1956,,8015568,234554650,49751271,,4184371,105015279,22870364,,3831197,129539371,26880907,PDP
ST086,,1982,1956,,8084619,236964522,50249125,,4554658,112316937,24539878,,3529961,124647585,25709247,PDP
ST086,,1983,1956,,9539378,236895107,51691532,,5608834,116191465,26283472,,3930544,120703642,25408060,PDP
ST086,,1984,1956,,15407765,275740763,64471958,,6085245,120522114,27530461,,9322520,155218649,36941497,PDP
ST086,,1985,1956,,14363111,236168169,56385917,,6500842,124370899,28630895,,7862269,111797270,27755022,PDP
ST086,,1986,1956,,14064786,236278830,56107282,,6961329,131043403,30278660,,7103457,105235427,25828622,PDP
ST086,,1987,1956,,14181046,253750130,59332315,,7568973,138769820,32261112,,6612073,114980310,27071203,PDP
ST086,,1988,1956,,15385175,261235563,61868371,,7808512,142350945,33137862,,7576663,118884618,28730509,PDP
ST086,,1989,1956,,11703213,213938457,49770554,,8266088,149645712,34893439,,3437125,64292745,14877115,PDP
ST086,,1990,1956,,11732401,210816021,49244149,,8408143,152258909,35500476,,3324258,58557112,13743673,PDP
ST086,,1991,1956,,12834828,208866959,49999767,,8729853,155071713,36322684,,4104975,53795246,13677083,PDP
ST086,,1992,1956,,14174712,217822473,52933159,,9203916,158413678,37391403,,4970796,59408795,15541756,PDP
ST086,,1993,1956,,12849451,223833770,52677524,,9632930,163468939,38719930,,3216521,60364831,13957594,PDP
ST086,,1994,1956,,13234972,239948825,55930492,,9937880,169751400,40142755,,3297092,70197425,15787737,PDP
ST086,,1995,1956,,14225086,253139495,59267701,,10334748,180290707,42414945,,3890338,72848788,16852756,PDP
ST086,,1996,1956,,18962342,318353436,75608861,,11033925,193455780,45456662,,7928417,124897656,30152199,PDP
ST086,,1997,1956,,19756989,359052235,83645287,,11815048,212129439,49560500,,7941941,146922796,34084787,PDP
ST086,,1998,1956,,21020152,363613838,85720123,,12338850,227359343,52794249,,8681302,136254495,32925874,PDP
ST086,,1999,1956,,15636075,311747594,71107177,,12927700,243625020,56277348,,2708375,68122574,14829829,PDP
ST086,,2000,1956,,15529732,326845415,73687279,,13476500,257602449,59313235,,2053232,69242966,14374044,PDP
ST086,,2001,1956,,15817317,342230338,76712395,,13947119,266979320,61452336,,1870198,75251018,15260059,PDP
ST086,,2002,1956,,16535523,346133029,78125030,,14356630,274930818,63276704,,2178893,71202211,14848326,PDP
ST086,,2003,1956,,16682450,367491813,82072452,,14821754,281440451,64900126,,1860696,86051362,17172326,PDP
ST086,,2004,1956,,16214480,332132595,75312807,,15025364,286673083,66034809,,1189116,45459512,9277998,PDP
ST086,,2005,1956,,16218487,332354578,75356312,,15099047,290008566,66701995,,1119440,42346012,8654317,PDP
ST086,,2006,1956,,15925163,341142509,76626677,,15164353,293139572,67324419,,760810,48002937,9302258,PDP
ST086,,2007,1956,,17378733,320648617,74433647,,15182243,294513713,67586818,,2196490,26134904,6846829,PDP
ST086,,2008,1956,,17383930,334816139,76959755,,15401321,298099269,68443896,,1982609,36716870,8515859,PDP
ST086,,2009,1956,,15811696,326770980,73955999,,15558681,306157228,70035058,,253015,20613752,3920942,PDP
ST086,,2010,1956,,15811696,326770980,73955999,,15624873,309206642,70643848,,186823,17564338,3312150,PDP
ST086,,2011,1956,,15733533,327075985,73932108,,15654944,312409728,71243864,,78589,14666257,2688244,PDP
ST086,,2012,1956,,15733533,327075985,73932108,,15665443,314039524,71544363,,68090,13036461,2387745,PDP
ST086,,2013,1956,,15733533,327075985,73932108,,15679404,316945691,72075436,,54129,10130294,1856674,PDP
ST086,,2014,1956,,15741951,327830995,74074870,,15689502,319113185,72471209,,52449,8717810,1603661,PDP
ST086,,2015,1956,,15727959,326774241,73872843,,15700139,320335719,72699379,,27820,6438522,1173464,PDP
ST086,,2016,1956,,15727022,326619864,73844436,,15708845,321089542,72842216,,18177,5530322,1002220,PDP
ST086,,2017,1956,,15741878,327809076,74070895,,15719084,321359102,72900420,,22794,6449974,1170476,PDP
ST086,,2017,1956,,15741878,327809076,74070895,,15719084,321359102,72900420,,22794,6449974,1170476,PDP
ST107,,1990,1989,,654602,16405300,3573695,,236268,4790663,1088699,,418334,11614637,2484996,PDN
ST107,,1991,1989,,1010880,33905300,7043852,,433745,13152574,2774061,,577135,20752726,4269791,PDN
ST107,,1992,1989,,1062003,47155770,9452709,,457546,15501301,3215785,,604457,31654469,6236924,PDN
ST107,,1993,1989,,1062003,47155770,9452709,,462408,16202107,3345345,,599595,30953663,6107364,PDN
ST107,,1994,1989,,462408,16202107,3345345,,462408,16202107,3345345,,0,0,0,PDN
ST107,,1995,1989,,462408,16202107,3345345,,462408,16202107,3345345,,0,0,0,PDN
ST107,,1996,1989,,462408,16202107,3345345,,462408,16202107,3345345,,0,0,0,PDN
ST107,,1997,1989,,462408,16202107,3345345,,462408,16202107,3345345,,0,0,0,PDN
ST107,,1998,1989,,462408,16202107,3345345,,462408,16202107,3345345,,0,0,0,PDN
ST107,,1999,1989,,462408,16202107,3345345,,462408,16202107,3345345,,0,0,0,PDN
ST107,,2000,1989,,501917,17189825,3560605,,462408,16202107,3345345,,39509,987718,215260,PDN
ST107,,2001,1989,,681221,21284521,4468502,,501608,17825252,3673361,,179613,3459269,795141,PDN
ST107,,2002,1989,,681221,21284521,4468502,,579168,19302260,4013734,,102053,1982261,454768,PDN
ST107,,2003,1989,,679332,21248524,4460208,,619510,20089858,4194218,,59822,1158666,265990,PDN
ST107,,2004,1989,,714035,25722044,5290911,,648154,20662962,4324838,,65881,5059082,966073,PDN
ST107,,2005,1989,,717108,22005069,4632601,,654789,20847264,4364267,,62319,1157805,268334,PDN
ST107,,2006,1989,,660690,20980280,4393836,,660690,20980280,4393836,,0,0,0,PDN
ST107,,2007,1989,,660690,20980280,4393836,,660690,20980280,4393836,,0,0,0,PDN
ST107,,2008,1989,,660690,20980280,4393836,,660690,20980280,4393836,,0,0,0,PDN
ST107,,2009,1989,,660690,21304762,4451574,,660690,21304762,4451574,,0,0,0,PDN
ST107,,2010,1989,,660690,21304762,4451574,,660690,21304762,4451574,,0,0,0,PDN
ST107,,2011,1989,,660690,21304762,4451574,,660690,21304762,4451574,,0,0,0,PDN
ST107,,2012,1989,,660690,21304762,4451574,,660690,21304762,4451574,,0,0,0,PDN
ST107,,2013,1989,,660690,21304762,4451574,,660690,21304762,4451574,,0,0,0,PDN
ST107,,2014,1989,,660690,21304762,4451574,,660690,21304762,4451574,,0,0,0,PDN
ST107,,2015,1989,,660690,21304762,4451574,,660690,21304762,4451574,,0,0,0,PDN
ST107,,2016,1989,,660690,21304762,4451574,,660690,21304762,4451574,,0,0,0,PDN
ST107,,2017,1989,,660690,21304762,4451574,,660690,21304762,4451574,,0,0,0,PDN
ST107,,2017,1989,,660690,21304762,4451574,,660690,21304762,4451574,,0,0,0,PDN
ST111,,1986,1971,,343074,23659715,4552988,,7426,787708,147588,,335648,22872007,4405400,PDP
ST111,,1987,1971,,343074,23659715,4552988,,46617,4199739,793902,,296457,19459976,3759086,PDP
ST111,,1988,1971,,429520,30294812,5820056,,225182,12405617,2432587,,204338,17889195,3387469,PDP
ST111,,1989,1971,,1042850,59318293,11597706,,460257,21763486,4332763,,582593,37554807,7264943,PDP
ST111,,1990,1971,,1323180,63875420,12688913,,604822,27904385,5570015,,718358,35971035,7118898,PDP
ST111,,1991,1971,,1451338,73142640,14466043,,784238,34025298,6838561,,667100,39117342,7627482,PDP
ST111,,1992,1971,,1451338,73142640,14466043,,955631,39972191,8068121,,495707,33170449,6397922,PDP
ST111,,1993,1971,,1451338,73142640,14466043,,1127768,45909582,9296733,,323570,27233058,5169310,PDP
ST111,,1994,1971,,1519201,81410708,16005092,,1260339,51584255,10439032,,258862,29826453,5566060,PDP
ST111,,1995,1971,,1480616,83718056,16377067,,1327234,58634640,11760444,,153382,25083416,4616623,PDP
ST111,,1996,1971,,1552739,93905066,18261825,,1390211,65632214,13068541,,162528,28272852,5193284,PDP
ST111,,1997,1971,,1550788,96958261,18803148,,1434075,70498925,13978368,,116713,26459336,4824780,PDP
ST111,,1998,1971,,1763542,99531611,19473793,,1472750,74064426,14651473,,290792,25467185,4822320,PDP
ST111,,1999,1971,,1683434,93668306,18350392,,1512809,77392582,15283731,,170625,16275724,3066661,PDP
ST111,,2000,1971,,1734260,94019154,18463647,,1549984,79524529,15700256,,184276,14494625,2763391,PDP
ST111,,2001,1971,,1733946,96726623,18945089,,1574681,80858956,15962396,,159265,15867667,2982693,PDP
ST111,,2002,1971,,1733946,96726623,18945089,,1579799,82963860,16342052,,154147,13762763,2603037,PDP
ST111,,2003,1971,,1745146,96642849,18941382,,1583470,84553366,16628553,,161676,12089483,2312829,PDP
ST111,,2004,1971,,1735793,94566777,18562622,,1622826,85606697,16855334,,112967,8960080,1707288,PDP
ST111,,2005,1971,,1736880,95803418,18783752,,1659457,86096695,16979154,,77423,9706723,1804598,PDP
ST111,,2006,1971,,1799417,94438889,18603490,,1687259,86530124,17084078,,112158,7908765,1519412,PDP
ST111,,2007,1971,,1778025,100430021,19648135,,1702974,87503360,17272967,,75051,12926661,2375168,PDP
ST111,,2008,1971,,1906719,107209291,20983105,,1721893,89676142,17678502,,184826,17533149,3304603,PDP
ST111,,2009,1971,,1931017,109683551,21447664,,1749699,94169589,18505854,,181318,15513962,2941811,PDP
ST111,,2010,1971,,1931017,109683551,21447664,,1772545,96459340,18936131,,158472,13224211,2511535,PDP
ST111,,2011,1971,,1930841,107637344,21083393,,1800906,99224148,19456448,,129935,8413196,1626946,PDP
ST111,,2012,1971,,1930841,107637344,21083393,,1825332,101442005,19875511,,105509,6195339,1207884,PDP
ST111,,2013,1971,,1930841,107637344,21083393,,1846516,102956768,20166226,,84325,4680576,917168,PDP
ST111,,2014,1971,,1928143,106605842,20897154,,1867082,104161942,20401235,,61061,2443900,495918,PDP
ST111,,2015,1971,,1928143,106605842,20897154,,1882313,104949662,20556630,,45830,1656180,340524,PDP
ST111,,2016,1971,,1928143,106605842,20897154,,1889749,105626192,20684445,,38394,979650,212709,PDP
ST111,,2017,1971,,1906399,106738747,20899058,,1892712,105978120,20750029,,13687,760627,149030,PDP
ST111,,2017,1971,,1906399,106738747,20899058,,1892712,105978120,20750029,,13687,760627,149030,PDP
ST127,,2013,2013,,178254,15385455,2915879,,0,0,0,,178254,15385455,2915879,PDP
ST127,,2014,2013,,178254,15385455,2915879,,60778,5246111,994250,,117476,10139344,1921630,PDP
ST127,,2015,2013,,300662,18408657,3576224,,180721,11827384,2285238,,119941,6581273,1290986,PDP
ST127,,2016,2013,,300662,18408657,3576224,,228843,15821172,3043998,,71819,2587485,532226,PDP
ST127,,2017,2013,,444806,31671047,6080224,,298100,21718550,4162611,,146706,9952497,1917613,PDP
ST127,,2017,2013,,444806,31671047,6080224,,298100,21718550,4162611,,146706,9952497,1917613,PDP
ST131,,1975,1958,,50000000,120000000,71352313,,35158238,66924450,47066503,,14841762,53075550,24285810,PDP
ST131,,1976,1958,,45000000,94995000,61903025,,36927583,72399986,49810143,,8072417,22595014,12092882,PDP
ST131,,1977,1958,,45000000,94995000,61903025,,38735795,78914900,52777592,,6264205,16080100,9125433,PDP
ST131,,1978,1958,,53410006,132717739,77025262,,40262732,107624744,59413042,,13147274,25092995,17612220,PDP
ST131,,1979,1958,,54191530,143096790,79653592,,40931864,109665814,60445354,,13259666,33430976,19208238,PDP
ST131,,1980,1958,,56206155,139944708,81107349,,41458550,112088359,61403098,,14747605,27856349,19704251,PDP
ST131,,1981,1958,,51181646,142485005,76534850,,42186662,119178856,63392864,,8994984,23306149,13141986,PDP
ST131,,1982,1958,,52394985,143781930,77978958,,42400880,120516558,63845107,,9994105,23265372,14133851,PDP
ST131,,1983,1958,,57070080,153444693,84373406,,42691867,121714510,64349253,,14378213,31730183,20024153,PDP
ST131,,1984,1958,,51630940,145653192,77547878,,43054481,123662842,65058545,,8576459,21990350,12489333,PDP
ST131,,1985,1958,,52828258,154417148,80304619,,43414109,124936578,65644817,,9414149,29480570,14659802,PDP
ST131,,1986,1958,,53926210,161659369,82691222,,43984787,122081996,65707562,,9941423,39577373,16983660,PDP
ST131,,1987,1958,,59493651,201073483,95271851,,45816420,137216243,70232122,,13677231,63857240,25039729,PDP
ST131,,1988,1958,,61235460,223974008,101088486,,46983985,146553726,73061160,,14251475,77420282,28027326,PDP
ST131,,1989,1958,,61225770,250628068,105821512,,48077161,159313372,76424736,,13148609,91314696,29396776,PDP
ST131,,1990,1958,,61859011,250487201,106429687,,49063986,165814100,78568274,,12795025,84673101,27861413,PDP
ST131,,1991,1958,,53939101,200781788,89665398,,49819016,170771789,80205455,,4120085,30009999,9459943,PDP
ST131,,1992,1958,,57675978,212440505,95476780,,50904248,176569755,82322354,,6771730,35870750,13154426,PDP
ST131,,1993,1958,,58138151,231589610,99346267,,51576084,184349456,84378478,,6562067,47240154,14967789,PDP
ST131,,1994,1958,,58123744,231575567,99329361,,52023565,189218537,85692344,,6100179,42357030,13637017,PDP
ST131,,1995,1958,,55628692,224600000,95593105,,52371908,196376971,87314430,,3256784,28223029,8278675,PDP
ST131,,1996,1958,,58733591,256521327,104377955,,52749602,206733129,89534856,,5983989,49788198,14843099,PDP
ST131,,1997,1958,,63047676,295138590,115563439,,53539517,210346618,90967741,,9508159,84791972,24595698,PDP
ST131,,1998,1958,,63494978,325121329,121345748,,54020820,216906706,92616319,,9474158,108214623,28729429,PDP
ST131,,1999,1958,,55057435,251422518,99794538,,54274499,231124513,95399857,,782936,20298005,4394681,PDP
ST131,,2000,1958,,57378419,257893871,103267008,,54622627,237674849,96913525,,2755792,20219022,6353483,PDP
ST131,,2001,1958,,58532297,279382089,108244412,,55165641,249172766,99502432,,3366656,30209323,8741980,PDP
ST131,,2002,1958,,58703915,279641240,108462142,,55501065,253155147,100546465,,3202850,26486093,7915677,PDP
ST131,,2003,1958,,60026226,286452227,110996373,,55891699,255311155,101320730,,4134527,31141072,9675643,PDP
ST131,,2004,1958,,60575005,270573768,108719803,,56339518,257274967,102117982,,4235487,13298801,6601821,PDP
ST131,,2005,1958,,60489029,270341243,108592453,,56524121,258054708,102441329,,3964908,12286535,6151124,PDP
ST131,,2006,1958,,60692011,273171156,109298978,,56537172,258096164,102461756,,4154839,15074992,6837222,PDP
ST131,,2007,1958,,58869908,265757654,106157747,,56684710,258612456,102701161,,2185198,7145198,3456586,PDP
ST131,,2008,1958,,60341312,270679362,108504900,,56754913,259045102,102848348,,3586399,11634260,5656552,PDP
ST131,,2009,1958,,58225072,277157442,107541329,,56886238,265123806,104061277,,1338834,12033636,3480049,PDP
ST131,,2010,1958,,58225072,277585314,107617463,,56956159,265789518,104249652,,1268913,11795796,3367807,PDP
ST131,,2011,1958,,58206314,275418290,107213114,,57232412,267386612,104810088,,973902,8031678,2403026,PDP
ST131,,2012,1958,,58176635,275354190,107172030,,57402162,269214668,105305115,,774473,6139522,1866915,PDP
ST131,,2013,1958,,58176635,275354190,107172030,,57496036,270028276,105543760,,680599,5325914,1628270,PDP
ST131,,2014,1958,,58074264,274672744,106948404,,57569869,270823983,105759176,,504395,3848761,1189229,PDP
ST131,,2015,1958,,58968123,275401363,107971910,,57637637,271343621,105919405,,1330486,4057742,2052504,PDP
ST131,,2016,1958,,60254355,275226943,109227107,,58510824,272612543,107018378,,1743531,2614400,2208726,PDP
ST131,,2017,1958,,60856963,274420499,109686218,,59340139,273506834,108006819,,1516824,913665,1679397,PDP
ST131,,2017,1958,,60856963,274420499,109686218,,59340139,273506834,108006819,,1516824,913665,1679397,PDP
ST135,,1975,1956,,156000000,299988000,209378648,,124624410,224060071,164492750,,31375590,75927929,44885898,PDP
ST135,,1976,1956,,156000000,299988000,209378648,,129836216,237535756,172102365,,26163784,62452244,37276283,PDP
ST135,,1977,1956,,156000000,299988000,209378648,,133784449,251213531,178484366,,22215551,48774469,30894282,PDP
ST135,,1978,1956,,156000000,299988000,209378648,,135624098,257065364,181365266,,20375902,42922636,28013382,PDP
ST135,,1979,1956,,156642281,450368073,236778949,,129366392,306894239,183973908,,27275889,143473834,52805041,PDP
ST135,,1980,1956,,175566598,559050443,275041766,,131427589,313439743,187199785,,44139009,245610700,87841981,PDP
ST135,,1981,1956,,176013132,565094279,276563715,,133496592,319762011,190393747,,42516540,245332268,86169968,PDP
ST135,,1982,1956,,186239393,581102627,289638437,,135032375,324152549,192710765,,51207018,256950078,96927672,PDP
ST135,,1983,1956,,189418016,572548732,291295015,,136007106,327446781,194271658,,53410910,245101951,97023357,PDP
ST135,,1984,1956,,192518922,576535044,295105229,,137216577,330547875,196032925,,55302345,245987169,99072304,PDP
ST135,,1985,1956,,187378093,565666346,288030468,,138983087,334078916,198427734,,48395006,231587430,89602734,PDP
ST135,,1986,1956,,185301498,527070707,279086321,,140137289,336701527,200048593,,45164209,190369180,79037728,PDP
ST135,,1987,1956,,163518510,466656201,246553421,,141202679,340338798,201761184,,22315831,126317403,44792237,PDP
ST135,,1988,1956,,167723851,485342200,254083673,,142866243,349820924,205111959,,24857608,135521276,48971714,PDP
ST135,,1989,1956,,160462514,459256124,242180686,,144189138,359846188,208218709,,16273376,99409936,33961977,PDP
ST135,,1990,1956,,161304883,474912948,245808966,,145475023,368378730,211022840,,15829860,106534218,34786126,PDP
ST135,,1991,1956,,162711377,451884066,243117794,,147208023,374704423,213881408,,15503354,77179643,29236386,PDP
ST135,,1992,1956,,158218414,424333067,233722518,,148422513,380617749,216148091,,9795901,43715318,17574427,PDP
ST135,,1993,1956,,159321594,442878505,238125598,,149556389,387920474,218581384,,9765205,54958031,19544214,PDP
ST135,,1994,1956,,160859312,456968350,242170406,,150789001,398761949,221743084,,10070311,58206401,20427322,PDP
ST135,,1995,1956,,159175053,453815106,239925072,,151848086,408571184,224547585,,7326967,45243922,15377487,PDP
ST135,,1996,1956,,162595441,511207533,253557635,,152978586,421955581,228059650,,9616855,89251952,25497985,PDP
ST135,,1997,1956,,165406565,567027995,266301226,,153856917,439078661,231984793,,11549648,127949334,34316433,PDP
ST135,,1998,1956,,166767119,589757740,271706219,,154641194,458814072,236280709,,12125925,130943668,35425510,PDP
ST135,,1999,1956,,164784638,563755427,265096992,,156022170,481504912,241699201,,8762468,82250515,23397791,PDP
ST135,,2000,1956,,170051082,580829693,273401561,,157831588,502367344,247220795,,12219494,78462349,26180766,PDP
ST135,,2001,1956,,172579857,598582641,279089224,,160300160,525612085,253825442,,12279697,72970556,25263782,PDP
ST135,,2002,1956,,176387522,870957212,331362115,,161668756,540332030,257813245,,14718766,330625182,73548870,PDP
ST135,,2003,1956,,183878162,878391775,340175631,,162778082,553308986,261231638,,21100080,325082789,78943993,PDP
ST135,,2004,1956,,174737771,617514407,284615779,,164089195,567139639,265003722,,10648576,50374768,19612057,PDP
ST135,,2005,1956,,177024849,629009368,288948224,,164966341,571401469,266639200,,12058508,57607899,22309024,PDP
ST135,,2006,1956,,176715275,643123335,291150032,,165669877,579493226,268782551,,11045398,63630109,22367481,PDP
ST135,,2007,1956,,172320949,624857149,283505495,,166191228,587623814,270750626,,6129721,37233335,12754869,PDP
ST135,,2008,1956,,171384024,630925258,283648305,,166592528,592432558,272007574,,4791496,38492700,11640731,PDP
ST135,,2009,1956,,170293537,626708429,281807492,,166828246,606008697,274658976,,3465291,20699732,7148516,PDP
ST135,,2010,1956,,170528307,626154026,281943615,,167054613,609530563,275512009,,3473694,16623463,6431606,PDP
ST135,,2011,1956,,171249344,627696530,282939119,,167274438,611784905,276132964,,3974906,15911625,6806155,PDP
ST135,,2012,1956,,170986352,630578682,283188965,,167479018,614272667,276780206,,3507334,16306015,6408759,PDP
ST135,,2013,1956,,171195218,629986349,283292434,,167817961,616434843,277503876,,3377257,13551506,5788557,PDP
ST135,,2014,1956,,170900626,632874950,283511828,,168209078,620872144,278684550,,2691548,12002806,4827278,PDP
ST135,,2015,1956,,170623848,634279893,283485040,,168724816,623834000,279727307,,1899032,10445893,3757731,PDP
ST135,,2016,1956,,171885726,634834464,284845595,,169432245,625381643,280710117,,2453481,9452821,4135476,PDP
ST135,,2017,1956,,171780950,635362052,284834696,,169796932,626502277,281274206,,1984018,8859775,3560489,PDP
ST135,,2017,1956,,171780950,635362052,284834696,,169796932,626502277,281274206,,1984018,8859775,3560489,PDP
ST139,,1998,1998,,64640,6464042,1214825,,48051,1429998,302499,,16589,5034044,912326,PDN
ST139,,1999,1998,,285621,12281716,2470980,,148415,5207567,1075028,,137206,7074149,1395952,PDN
ST139,,2000,1998,,284536,12235058,2461593,,207114,8521370,1723372,,77422,3713688,738221,PDN
ST139,,2001,1998,,958590,32940366,6819865,,340238,12319984,2532406,,618352,20620382,4287459,PDN
ST139,,2002,1998,,546975,27315657,5407412,,419903,16057495,3277109,,127072,11258162,2130303,PDN
ST139,,2003,1998,,546975,27315657,5407412,,465304,20074975,4037364,,81671,7240682,1370048,PDN
ST139,,2004,1998,,556236,27315657,5416673,,484108,22777286,4537006,,72128,4538371,879667,PDN
ST139,,2005,1998,,556236,27315657,5416673,,489837,23741391,4714284,,66399,3574266,702389,PDN
ST139,,2006,1998,,556236,27315657,5416673,,489849,23743185,4714615,,66387,3572472,702058,PDN
ST139,,2007,1998,,556236,27315657,5416673,,501378,24899173,4931836,,54858,2416484,484837,PDN
ST139,,2008,1998,,556236,27315657,5416673,,510391,25772906,5096317,,45845,1542751,320356,PDN
ST139,,2009,1998,,523522,27121956,5349493,,518240,26672669,5264267,,5282,449287,85226,PDN
ST139,,2010,1998,,523522,27121956,5349493,,523517,27119420,5349037,,5,2536,456,PDN
ST139,,2011,1998,,523522,27121956,5349493,,523522,27121956,5349493,,0,0,0,PDN
ST139,,2012,1998,,523522,27121956,5349493,,523522,27121956,5349493,,0,0,0,PDN
ST139,,2013,1998,,523522,27121956,5349493,,523522,27121956,5349493,,0,0,0,PDN
ST139,,2014,1998,,523522,27121956,5349493,,523522,27121956,5349493,,0,0,0,PDN
ST139,,2015,1998,,523522,27121956,5349493,,523522,27121956,5349493,,0,0,0,PDN
ST139,,2016,1998,,523522,27121956,5349493,,523522,27121956,5349493,,0,0,0,PDN
ST139,,2017,1998,,523522,27121956,5349493,,523522,27121956,5349493,,0,0,0,PDN
ST139,,2017,1998,,523522,27121956,5349493,,523522,27121956,5349493,,0,0,0,PDN
ST140,,1975,1970,,10000000,117000000,30818505,,0,0,0,,10000000,117000000,30818505,PDN
ST140,,1976,1970,,10000000,117000000,30818505,,11847,346818,73558,,9988153,116653182,30744947,PDN
ST140,,1977,1970,,200000,6000000,1267616,,26177,543762,122932,,173823,5456238,1144684,PDN
ST140,,1978,1970,,200000,6000000,1267616,,39030,726269,168259,,160970,5273731,1099357,PDN
ST140,,1979,1970,,200000,6000000,1267616,,40064,737750,171336,,159936,5262250,1096280,PDN
ST140,,1980,1970,,39093,739953,170757,,39093,739953,170757,,0,0,0,PDN
ST140,,1981,1970,,39093,739953,170757,,39093,739953,170757,,0,0,0,PDN
ST140,,1982,1970,,39093,739953,170757,,39093,739953,170757,,0,0,0,PDN
ST140,,1983,1970,,39093,739953,170757,,39093,739953,170757,,0,0,0,PDN
ST140,,1984,1970,,39093,739953,170757,,39093,739953,170757,,0,0,0,PDN
ST140,,1985,1970,,39093,739953,170757,,39093,739953,170757,,0,0,0,PDN
ST140,,1986,1970,,39093,739953,170757,,39093,739953,170757,,0,0,0,PDN
ST140,,1987,1970,,39093,739953,170757,,39093,739953,170757,,0,0,0,PDN
ST140,,1988,1970,,39093,739953,170757,,39093,739953,170757,,0,0,0,PDN
ST140,,1989,1970,,39093,739953,170757,,39093,739953,170757,,0,0,0,PDN
ST140,,1990,1970,,39093,739953,170757,,39093,739953,170757,,0,0,0,PDN
ST140,,1991,1970,,39093,739953,170757,,39093,739953,170757,,0,0,0,PDN
ST140,,1992,1970,,39093,739953,170757,,39093,739953,170757,,0,0,0,PDN
ST140,,1993,1970,,39093,739953,170757,,39093,739953,170757,,0,0,0,PDN
ST140,,1994,1970,,39093,739953,170757,,39093,739953,170757,,0,0,0,PDN
ST140,,1995,1970,,39093,739953,170757,,39093,739953,170757,,0,0,0,PDN
ST140,,1996,1970,,39093,739953,170757,,39093,739953,170757,,0,0,0,PDN
ST140,,1997,1970,,39093,739953,170757,,39093,739953,170757,,0,0,0,PDN
ST140,,1998,1970,,39093,739953,170757,,39093,739953,170757,,0,0,0,PDN
ST140,,1999,1970,,39093,739953,170757,,39093,739953,170757,,0,0,0,PDN
ST140,,2000,1970,,39093,739953,170757,,39093,739953,170757,,0,0,0,PDN
ST140,,2001,1970,,39093,739953,170757,,39093,739953,170757,,0,0,0,PDN
ST140,,2002,1970,,39093,739953,170757,,39093,739953,170757,,0,0,0,PDN
ST140,,2003,1970,,39093,739953,170757,,39093,739953,170757,,0,0,0,PDN
ST140,,2004,1970,,39093,739953,170757,,39093,739953,170757,,0,0,0,PDN
ST140,,2005,1970,,39093,739953,170757,,39093,739953,170757,,0,0,0,PDN
ST140,,2006,1970,,39093,739953,170757,,39093,739953,170757,,0,0,0,PDN
ST140,,2007,1970,,39093,739953,170757,,39093,739953,170757,,0,0,0,PDN
ST140,,2008,1970,,39093,739953,170757,,39093,739953,170757,,0,0,0,PDN
ST140,,2009,1970,,39093,754775,173395,,39093,754775,173395,,0,0,0,PDN
ST140,,2010,1970,,39093,754775,173395,,39093,754775,173395,,0,0,0,PDN
ST140,,2011,1970,,39093,754775,173395,,39093,754775,173395,,0,0,0,PDN
ST140,,2012,1970,,39093,754775,173395,,39093,754775,173395,,0,0,0,PDN
ST140,,2013,1970,,39093,754775,173395,,39093,754775,173395,,0,0,0,PDN
ST140,,2014,1970,,39093,754775,173395,,39093,754775,173395,,0,0,0,PDN
ST140,,2015,1970,,39093,754775,173395,,39093,754775,173395,,0,0,0,PDN
ST140,,2016,1970,,39093,754775,173395,,39093,754775,173395,,0,0,0,PDN
ST140,,2017,1970,,39093,754775,173395,,39093,754775,173395,,0,0,0,PDN
ST140,,2017,1970,,39093,754775,173395,,39093,754775,173395,,0,0,0,PDN
ST146,,1981,1978,,15000,5632000,1017135,,11970,4720937,851994,,3030,911063,165141,PDN
ST146,,1982,1978,,70000,15000000,2739039,,49823,5149598,966122,,20177,9850402,1772917,PDN
ST146,,1983,1978,,175000,15000000,2844039,,70158,5999197,1137631,,104842,9000803,1706408,PDN
ST146,,1984,1978,,134141,10479729,1998861,,80821,6486584,1235017,,53320,3993145,763844,PDN
ST146,,1985,1978,,134141,10479729,1998861,,80821,6805751,1291809,,53320,3673978,707052,PDN
ST146,,1986,1978,,134141,10479729,1998861,,80821,6918184,1311815,,53320,3561545,687046,PDN
ST146,,1987,1978,,82751,10479729,1947471,,80870,7347818,1388311,,1881,3131911,559160,PDN
ST146,,1988,1978,,156671,27920995,5124820,,97287,13026355,2415144,,59384,14894640,2709676,PDN
ST146,,1989,1978,,197745,35254590,6470804,,102404,15319142,2828230,,95341,19935448,3642574,PDN
ST146,,1990,1978,,143463,23240942,4278862,,103178,16832444,3098275,,40285,6408498,1180587,PDN
ST146,,1991,1978,,136158,24860904,4559806,,105009,18797403,3449743,,31149,6063501,1110063,PDN
ST146,,1992,1978,,138333,27255430,4988054,,107543,20780347,3805114,,30790,6475083,1182940,PDN
ST146,,1993,1978,,138467,28596589,5226828,,108215,22013163,4025148,,30252,6583426,1201680,PDN
ST146,,1994,1978,,138467,28596589,5226828,,108715,22684562,4145114,,29752,5912027,1081714,PDN
ST146,,1995,1978,,111853,27372652,4982432,,109058,23343454,4262698,,2795,4029198,719734,PDN
ST146,,1996,1978,,109058,23343659,4262734,,109058,23343659,4262734,,0,0,0,PDN
ST146,,1997,1978,,396784,30536816,5830381,,109058,23343659,4262734,,287726,7193157,1567647,PDN
ST146,,1998,1978,,433548,34212490,6521180,,116216,25883491,4721819,,317332,8328999,1799361,PDN
ST146,,1999,1978,,122956,32086605,5832316,,120103,27283011,4974731,,2853,4803594,857585,PDN
ST146,,2000,1978,,122476,33312813,6050022,,120660,29325709,5338758,,1816,3987104,711264,PDN
ST146,,2001,1978,,122460,34073262,6185318,,120685,30310750,5514057,,1775,3762512,671261,PDN
ST146,,2002,1978,,122460,34073262,6185318,,120685,30411775,5532033,,1775,3661487,653285,PDN
ST146,,2003,1978,,140742,34084057,6205520,,120714,30462176,5541030,,20028,3621881,664490,PDN
ST146,,2004,1978,,121027,31266646,5684487,,120725,30500588,5547876,,302,766058,136611,PDN
ST146,,2005,1978,,120736,30514089,5550289,,120736,30514089,5550289,,0,0,0,PDN
ST146,,2006,1978,,120736,30514089,5550289,,120736,30514089,5550289,,0,0,0,PDN
ST146,,2007,1978,,120736,30514089,5550289,,120736,30514089,5550289,,0,0,0,PDN
ST146,,2008,1978,,120736,30514089,5550289,,120736,30514089,5550289,,0,0,0,PDN
ST146,,2009,1978,,120736,30999461,5636654,,120736,30999461,5636654,,0,0,0,PDN
ST146,,2010,1978,,120736,30999461,5636654,,120736,30999461,5636654,,0,0,0,PDN
ST146,,2011,1978,,120736,30999461,5636654,,120736,30999461,5636654,,0,0,0,PDN
ST146,,2012,1978,,120736,30999461,5636654,,120736,30999461,5636654,,0,0,0,PDN
ST146,,2013,1978,,120736,30999461,5636654,,120736,30999461,5636654,,0,0,0,PDN
ST146,,2014,1978,,120736,30999461,5636654,,120736,30999461,5636654,,0,0,0,PDN
ST146,,2015,1978,,120736,30999461,5636654,,120736,30999461,5636654,,0,0,0,PDN
ST146,,2016,1978,,120736,30999461,5636654,,120736,30999461,5636654,,0,0,0,PDN
ST146,,2017,1978,,120736,30999461,5636654,,120736,30999461,5636654,,0,0,0,PDN
ST146,,2017,1978,,120736,30999461,5636654,,120736,30999461,5636654,,0,0,0,PDN
ST156,,1978,1975,,10000,10000000,1789359,,0,0,0,,10000,10000000,1789359,PDP
ST156,,1979,1975,,50000,50000000,8946797,,0,0,0,,50000,50000000,8946797,PDP
ST156,,1980,1975,,302670,50000000,9199467,,0,0,0,,302670,50000000,9199467,PDP
ST156,,1981,1975,,302670,50000000,9199467,,53020,12493540,2276070,,249650,37506460,6923397,PDP
ST156,,1982,1975,,302670,50000000,9199467,,107199,30728583,5574918,,195471,19271417,3624549,PDP
ST156,,1983,1975,,302670,50000000,9199467,,119118,35266484,6394293,,183552,14733516,2805174,PDP
ST156,,1984,1975,,228340,55570063,10116252,,129554,38307070,6945759,,98786,17262993,3170493,PDP
ST156,,1985,1975,,228969,58235332,10591128,,143669,42511771,7708041,,85300,15723561,2883087,PDP
ST156,,1986,1975,,229485,58235332,10591644,,153898,47847700,8667724,,75587,10387632,1923920,PDP
ST156,,1987,1975,,244278,69410598,12594918,,168227,54670782,9896124,,76051,14739816,2698794,PDP
ST156,,1988,1975,,240896,90650515,16370881,,179767,61891476,11192485,,61129,28759039,5178396,PDP
ST156,,1989,1975,,201740,79438336,14336675,,180013,62418426,11286494,,21727,17019910,3050181,PDP
ST156,,1990,1975,,201740,79438336,14336675,,180479,63128016,11413222,,21261,16310320,2923453,PDP
ST156,,1991,1975,,201740,79438336,14336675,,180755,63650371,11506444,,20985,15787965,2830231,PDP
ST156,,1992,1975,,201740,79438336,14336675,,180769,63717543,11518410,,20971,15720793,2818265,PDP
ST156,,1993,1975,,180769,63717543,11518410,,180769,63717543,11518410,,0,0,0,PDP
ST156,,1994,1975,,180769,63717543,11518410,,180769,63717543,11518410,,0,0,0,PDP
ST156,,1995,1975,,180769,63717543,11518410,,180769,63717543,11518410,,0,0,0,PDP
ST156,,1996,1975,,180769,63717543,11518410,,180769,63717543,11518410,,0,0,0,PDP
ST156,,1997,1975,,180769,63717543,11518410,,180769,63717543,11518410,,0,0,0,PDP
ST156,,1998,1975,,180769,63717543,11518410,,180769,63717543,11518410,,0,0,0,PDP
ST156,,1999,1975,,180769,63717543,11518410,,180769,63717543,11518410,,0,0,0,PDP
ST156,,2000,1975,,180769,63717543,11518410,,180769,63717543,11518410,,0,0,0,PDP
ST156,,2001,1975,,180769,63717543,11518410,,180769,63717543,11518410,,0,0,0,PDP
ST156,,2002,1975,,180769,63717543,11518410,,180769,63717543,11518410,,0,0,0,PDP
ST156,,2003,1975,,825888,128229481,23642522,,388063,64527547,11869833,,437825,63701934,11772689,PDP
ST156,,2004,1975,,2548662,72571247,15461695,,1059294,66963725,12974548,,1489368,5607522,2487147,PDP
ST156,,2005,1975,,2548662,72571247,15461695,,1182476,67401949,13175705,,1366186,5169298,2285990,PDP
ST156,,2006,1975,,2548662,72571247,15461695,,1767768,69596195,14151433,,780894,2975052,1310262,PDP
ST156,,2007,1975,,2548662,72571247,15461695,,2165970,71154337,14826884,,382692,1416910,634811,PDP
ST156,,2008,1975,,3424326,77900987,17285712,,2406755,72239736,15260801,,1017571,5661251,2024911,PDP
ST156,,2009,1975,,3427426,79362240,17548820,,2661148,74930822,15994033,,766278,4431418,1554787,PDP
ST156,,2010,1975,,3427426,79362240,17548820,,2673433,75004197,16019374,,753993,4358043,1529445,PDP
ST156,,2011,1975,,3427426,79362240,17548820,,2863053,76148296,16412571,,564373,3213944,1136249,PDP
ST156,,2012,1975,,3427426,79362240,17548820,,2969586,76807317,16636367,,457840,2554923,912453,PDP
ST156,,2013,1975,,3427426,79362240,17548820,,3033476,77217258,16773200,,393950,2144982,775619,PDP
ST156,,2014,1975,,3427426,79362240,17548820,,3080243,77504646,16871104,,347183,1857594,677716,PDP
ST156,,2015,1975,,3427426,79362240,17548820,,3137007,77722655,16966660,,290419,1639585,582160,PDP
ST156,,2016,1975,,3427426,79362240,17548820,,3168532,77874060,17025125,,258894,1488180,523695,PDP
ST156,,2017,1975,,3183153,77961469,17055299,,3183153,77961469,17055299,,0,0,0,PDP
ST156,,2017,1975,,3183153,77961469,17055299,,3183153,77961469,17055299,,0,0,0,PDP
ST163,,1976,1976,,183437,49003000,8902832,,0,0,0,,183437,49003000,8902832,PDN
ST163,,1977,1976,,189956,52462400,9524903,,51357,17446194,3155662,,138599,35016206,6369241,PDN
ST163,,1978,1976,,303997,101024500,18279887,,76831,39621178,7126863,,227166,61403322,11153024,PDN
ST163,,1979,1976,,303997,101024500,18279887,,157022,52335454,9469380,,146975,48689046,8810507,PDN
ST163,,1980,1976,,357719,84746400,15437150,,169445,57785959,10451644,,188274,26960441,4985506,PDN
ST163,,1981,1976,,357719,84746400,15437150,,172409,58599089,10599293,,185310,26147311,4837857,PDN
ST163,,1982,1976,,190538,65309438,11811434,,177357,59191185,10709596,,13181,6118253,1101838,PDN
ST163,,1983,1976,,190538,65309438,11811434,,176592,59129576,10697869,,13946,6179862,1113565,PDN
ST163,,1984,1976,,190538,65309438,11811434,,176678,59258687,10720928,,13860,6050751,1090506,PDN
ST163,,1985,1976,,190538,65309438,11811434,,176790,59373413,10741454,,13748,5936025,1069980,PDN
ST163,,1986,1976,,190538,65309438,11811434,,177120,59854175,10827329,,13418,5455263,984105,PDN
ST163,,1987,1976,,181044,61935643,11201621,,177395,60066218,10865334,,3649,1869425,336287,PDN
ST163,,1988,1976,,181044,61935643,11201621,,177531,60174279,10884698,,3513,1761364,316923,PDN
ST163,,1989,1976,,178310,61033784,11038414,,177561,60240999,10896600,,749,792785,141814,PDN
ST163,,1990,1976,,178310,61033784,11038414,,177617,60268285,10901511,,693,765499,136903,PDN
ST163,,1991,1976,,177925,60434822,10931452,,177664,60307179,10908479,,261,127643,22973,PDN
ST163,,1992,1976,,179049,60606085,10963050,,177866,60344012,10915235,,1183,262073,47815,PDN
ST163,,1993,1976,,179049,60606085,10963050,,177866,60363589,10918718,,1183,242496,44332,PDN
ST163,,1994,1976,,179049,60606085,10963050,,177866,60376830,10921074,,1183,229255,41976,PDN
ST163,,1995,1976,,177938,60420309,10928883,,177866,60391323,10923653,,72,28986,5230,PDN
ST163,,1996,1976,,177874,60737210,10985207,,177867,60424821,10929615,,7,312389,55592,PDN
ST163,,1997,1976,,179506,60955620,11025702,,178006,60528179,10948145,,1500,427441,77557,PDN
ST163,,1998,1976,,181728,66161888,11954306,,178469,61456864,11113854,,3259,4705024,840452,PDN
ST163,,1999,1976,,181728,66163393,11954574,,178990,62900134,11371185,,2738,3263259,583389,PDN
ST163,,2000,1976,,184185,72387490,13064521,,180952,68278855,12330214,,3233,4108635,734307,PDN
ST163,,2001,1976,,183562,72407444,13067449,,181940,70874460,12793054,,1622,1532984,274395,PDN
ST163,,2002,1976,,183562,72407444,13067449,,181940,70936905,12804165,,1622,1470539,263284,PDN
ST163,,2003,1976,,183562,72407444,13067449,,181940,70955066,12807397,,1622,1452378,260052,PDN
ST163,,2004,1976,,181940,70960298,12808328,,181940,70960298,12808328,,0,0,0,PDN
ST163,,2005,1976,,181940,70960298,12808328,,181940,70960298,12808328,,0,0,0,PDN
ST163,,2006,1976,,181940,70960298,12808328,,181940,70960298,12808328,,0,0,0,PDN
ST163,,2007,1976,,181940,70960298,12808328,,181940,70960298,12808328,,0,0,0,PDN
ST163,,2008,1976,,181940,70960298,12808328,,181940,70960298,12808328,,0,0,0,PDN
ST163,,2009,1976,,181940,72184960,13026239,,181940,72184960,13026239,,0,0,0,PDN
ST163,,2010,1976,,181940,72184960,13026239,,181940,72184960,13026239,,0,0,0,PDN
ST163,,2011,1976,,181940,72184960,13026239,,181940,72184960,13026239,,0,0,0,PDN
ST163,,2012,1976,,181940,72184960,13026239,,181940,72184960,13026239,,0,0,0,PDN
ST163,,2013,1976,,181940,72184960,13026239,,181940,72184960,13026239,,0,0,0,PDN
ST163,,2014,1976,,181940,72184960,13026239,,181940,72184960,13026239,,0,0,0,PDN
ST163,,2015,1976,,181940,72184960,13026239,,181940,72184960,13026239,,0,0,0,PDN
ST163,,2016,1976,,181940,72184960,13026239,,181940,72184960,13026239,,0,0,0,PDN
ST163,,2017,1976,,181940,72184960,13026239,,181940,72184960,13026239,,0,0,0,PDN
ST163,,2017,1976,,181940,72184960,13026239,,181940,72184960,13026239,,0,0,0,PDN
ST172,,1975,1962,,2852955,627752810,114552743,,599554,256080152,46165417,,2253401,371672658,68387326,PDN
ST172,,1976,1962,,2852955,477888450,87886487,,723620,312211704,56277304,,2129335,165676746,31609183,PDN
ST172,,1977,1962,,3987967,502294332,93364183,,1911381,372281412,68153625,,2076586,130012920,25210558,PDN
ST172,,1978,1962,,2542581,671391922,122007336,,2053692,440743584,80477817,,488889,230648338,41529519,PDN
ST172,,1979,1962,,1713747,710309042,128103256,,1146794,508446630,91617725,,566953,201862412,36485531,PDN
ST172,,1980,1962,,2001565,854204815,153995304,,1326861,574661980,103579882,,674704,279542835,50415422,PDN
ST172,,1981,1962,,2335746,888070801,160355461,,1518355,668263913,120426525,,817391,219806888,39928936,PDN
ST172,,1982,1962,,2353640,909888478,164255504,,2070941,781327293,141097150,,282699,128561185,23158354,PDN
ST172,,1983,1962,,8348491,1328551301,244745520,,3125801,839312643,152469688,,5222690,489238658,92275832,PDN
ST172,,1984,1962,,13431447,1473102375,275549307,,4070350,931447507,169808341,,9361097,541654868,105740966,PDN
ST172,,1985,1962,,14427162,1496575400,280721717,,4832854,1004506075,183570590,,9594308,492069325,97151127,PDN
ST172,,1986,1962,,14418415,1552891978,290733714,,5501613,1066657152,195298259,,8916802,486234826,95435455,PDN
ST172,,1987,1962,,11842976,1547071862,287122667,,6319697,1118091133,205268297,,5523279,428980729,81854370,PDN
ST172,,1988,1962,,11580567,1575449068,291909583,,6824057,1191289030,218797194,,4756510,384160038,73112389,PDN
ST172,,1989,1962,,11778016,1593283272,295280378,,7267084,1280714341,235152198,,4510932,312568931,60128180,PDN
ST172,,1990,1962,,9940133,1903742767,348684398,,7587233,1358602456,249331442,,2352900,545140311,99352956,PDN
ST172,,1991,1962,,9259031,1714732552,314371585,,7741419,1335229642,245326765,,1517612,379502910,69044820,PDN
ST172,,1992,1962,,9674380,1658471749,304776115,,8020364,1394040902,256070347,,1654016,264430847,48705768,PDN
ST172,,1993,1962,,9542251,1761207527,322924373,,8191774,1444376039,265198187,,1350477,316831488,57726186,PDN
ST172,,1994,1962,,9663131,1784340080,327161366,,8303176,1509347926,276870423,,1359955,274992154,50290943,PDN
ST172,,1995,1962,,8953444,1733832457,317464557,,8353971,1552971097,284683348,,599473,180861360,32781209,PDN
ST172,,1996,1962,,10569103,1841527906,338243108,,8533424,1608066139,294666189,,2035679,233461767,43576919,PDN
ST172,,1997,1962,,12573976,1881268859,347319325,,8961300,1653986415,303264933,,3612676,227282444,44054392,PDN
ST172,,1998,1962,,12976563,1916122817,353923683,,9376370,1686150272,309403109,,3600193,229972545,44520574,PDN
ST172,,1999,1962,,11044488,1795989358,330615548,,9617253,1708174110,313562824,,1427235,87815248,17052724,PDN
ST172,,2000,1962,,10914840,1793478443,330039118,,9915164,1731769738,318059245,,999676,61708705,11979873,PDN
ST172,,2001,1962,,11122028,1810874830,333341749,,10182747,1749645019,321507483,,939281,61229811,11834266,PDN
ST172,,2002,1962,,11588247,1827403382,336748991,,10413090,1764730505,324422077,,1175157,62672877,12326914,PDN
ST172,,2003,1962,,11507378,1829674614,337072256,,10572685,1776093639,326603582,,934693,53580975,10468674,PDN
ST172,,2004,1962,,12554828,1899017168,350458239,,10993662,1801593843,331561961,,1561166,97423325,18896278,PDN
ST172,,2005,1962,,12394128,1908755820,352030395,,11242789,1822173509,335472951,,1151339,86582311,16557444,PDN
ST172,,2006,1962,,13975702,1907332123,353358642,,11469326,1831855643,337422287,,2506376,75476480,15936355,PDN
ST172,,2007,1962,,15746011,1913230894,356178554,,11640579,1837734018,338639515,,4105432,75496876,17539039,PDN
ST172,,2008,1962,,14326790,1920074672,355977088,,11733056,1841929976,339478603,,2593734,78144696,16498485,PDN
ST172,,2009,1962,,13646198,1928267070,356754215,,11844149,1883545520,346994594,,1802049,44721550,9759620,PDN
ST172,,2010,1962,,13646803,1928504440,356797057,,11907918,1889595431,348134859,,1738885,38909009,8662196,PDN
ST172,,2011,1962,,13621423,1921650932,355552190,,11957577,1894455275,349049260,,1663846,27195657,6502930,PDN
ST172,,2012,1962,,13461338,1914581509,354134201,,11986261,1897595003,349636615,,1475077,16986506,4497588,PDN
ST172,,2013,1962,,11990339,1899058401,349901083,,11989395,1898781330,349850837,,944,277071,50244,PDN
ST172,,2014,1962,,11989961,1898909026,349874125,,11989961,1898909026,349874125,,0,0,0,PDN
ST172,,2015,1962,,11989881,1898908949,349874031,,11989881,1898908949,349874031,,0,0,0,PDN
ST172,,2016,1962,,11989881,1898908949,349874031,,11989881,1898908949,349874031,,0,0,0,PDN
ST172,,2017,1962,,11989881,1898908949,349874031,,11989881,1898908949,349874031,,0,0,0,PDN
ST172,,2017,1962,,11989881,1898908949,349874031,,11989881,1898908949,349874031,,0,0,0,PDN
ST176,,1975,1963,,45002972,530000000,139309022,,30352536,270542693,78491805,,14650436,259457307,60817217,PDP
ST176,,1976,1963,,45000000,445005000,124182384,,33181160,294721434,85622696,,11818840,150283566,38559688,PDP
ST176,,1977,1963,,45000000,445005000,124182384,,36754776,317907945,93322026,,8245224,127097055,30860358,PDP
ST176,,1978,1963,,52000000,445120000,131202847,,39156716,334555340,98686136,,12843284,110564660,32516711,PDP
ST176,,1979,1963,,52000000,445120000,131202847,,39436790,366163629,104590461,,12563210,78956371,26612386,PDP
ST176,,1980,1963,,46470829,489920011,133645208,,41122594,394542918,111325960,,5348235,95377093,22319248,PDP
ST176,,1981,1963,,47317786,508532993,137804084,,42485947,421753044,117530973,,4831839,86779949,20273111,PDP
ST176,,1982,1963,,47849268,513006333,139131534,,43681101,443961056,122677730,,4168167,69045277,16453804,PDP
ST176,,1983,1963,,55691491,589354674,160558871,,44732625,462801743,127081690,,10958866,126552931,33477181,PDP
ST176,,1984,1963,,62007969,646631135,177066890,,45948118,481717416,131662961,,16059851,164913719,45403929,PDP
ST176,,1985,1963,,73286136,697306515,197362028,,47015814,496076947,135285733,,26270322,201229568,62076295,PDP
ST176,,1986,1963,,55361897,606725283,163320132,,48221332,516470639,140120022,,7140565,90254644,23200110,PDP
ST176,,1987,1963,,58699718,654735195,175200642,,49757531,537989354,145485174,,8942187,116745841,29715468,PDP
ST176,,1988,1963,,70759845,785320886,210496657,,51712667,574336854,153907837,,19047178,210984032,56588820,PDP
ST176,,1989,1963,,72421206,813893569,217242126,,53561083,618348169,163587448,,18860123,195545400,53654678,PDP
ST176,,1990,1963,,66861479,894451351,226016524,,55365149,659576678,172727547,,11496330,234874673,53288977,PDP
ST176,,1991,1963,,67692114,907444762,229159154,,57230308,699599554,181714214,,10461806,207845208,47444940,PDP
ST176,,1992,1963,,68157747,924472698,232654668,,58504937,729601534,188327274,,9652810,194871164,44327394,PDP
ST176,,1993,1963,,69924979,890832389,228436080,,59763562,755600117,194211981,,10161417,135232272,34224099,PDP
ST176,,1994,1963,,71606222,922244093,235706594,,61929784,788814228,202288188,,9676438,133429865,33418406,PDP
ST176,,1995,1963,,71633803,901945058,232122247,,63894130,817738707,209399238,,7739673,84206351,22723009,PDP
ST176,,1996,1963,,75979864,1032431254,259686493,,65975935,850896936,217381084,,10003929,181534318,42305409,PDP
ST176,,1997,1963,,81230119,1097165111,276455228,,68899864,904230979,229795056,,12330255,192934132,46660172,PDP
ST176,,1998,1963,,82934962,1134426924,284790287,,71347977,961437431,242422253,,11586985,172989493,42368034,PDP
ST176,,1999,1963,,78228230,1057561212,266406382,,73136567,993285865,249877824,,5091663,64275347,16528558,PDP
ST176,,2000,1963,,79559013,1089679805,273452216,,74771120,1013106756,255039226,,4787893,76573049,18412990,PDP
ST176,,2001,1963,,80288045,1119532451,279493107,,75619976,1031884557,259229328,,4668069,87647894,20263779,PDP
ST176,,2002,1963,,81827776,1226660324,300094737,,76406092,1060004422,265018978,,5421684,166655902,35075759,PDP
ST176,,2003,1963,,82285565,1234406905,301930921,,77107654,1090289770,271109392,,5177911,144117135,30821529,PDP
ST176,,2004,1963,,90049983,1317702263,324516577,,79383905,1132632492,280919936,,10666078,185069771,43596641,PDP
ST176,,2005,1963,,90186126,1313501095,323905182,,80592756,1152809287,285718964,,9593370,160691808,38186218,PDP
ST176,,2006,1963,,89736164,1320012112,324613764,,81507392,1171501719,289959655,,8228772,148510393,34654109,PDP
ST176,,2007,1963,,96351976,1519697717,366760822,,82884122,1193568136,295262794,,13467854,326129581,71498028,PDP
ST176,,2008,1963,,93033101,1318738757,327684125,,83265135,1202876318,297300067,,9767966,115862439,30384058,PDP
ST176,,2009,1963,,88301194,1285326436,317006966,,83496307,1227425584,301899438,,4804887,57900852,15107532,PDP
ST176,,2010,1963,,89968903,1289118986,319349506,,83939901,1233867446,303489271,,6029002,55251540,15860237,PDP
ST176,,2011,1963,,91938015,1296830346,322690747,,84619818,1241274592,305487184,,7318197,55555754,17203563,PDP
ST176,,2012,1963,,93394079,1292736748,323418414,,85877631,1248559903,308041315,,7516448,44176845,15377096,PDP
ST176,,2013,1963,,93130158,1292848133,323174313,,87552737,1256006768,311041489,,5577421,36841365,12132824,PDP
ST176,,2014,1963,,92635073,1289117120,322015345,,88655453,1262830088,313358318,,3979620,26287032,8657028,PDP
ST176,,2015,1963,,92635073,1289117120,322015345,,89221540,1266816946,314633810,,3413533,22300174,7381537,PDP
ST176,,2016,1963,,92412574,1286604505,321345763,,89604772,1269516034,315497309,,2807802,17088471,5848456,PDP
ST176,,2017,1963,,92307145,1286404403,321204728,,90109763,1272283344,316494705,,2197382,14121059,4710026,PDP
ST176,,2017,1963,,92307145,1286404403,321204728,,90109763,1272283344,316494705,,2197382,14121059,4710026,PDP
ST185,,1975,1970,,1615731,40638778,8846830,,0,111961,19922,,1615731,40526817,8826908,PDN
ST185,,1976,1970,,1615731,40638778,8846830,,201809,3361224,799892,,1413922,37277554,8046938,PDN
ST185,,1977,1970,,1809359,40638766,9040456,,290021,5108166,1198947,,1519338,35530600,7841509,PDN
ST185,,1978,1970,,1809359,40638766,9040456,,409727,6822304,1623660,,1399632,33816462,7416796,PDN
ST185,,1979,1970,,1828074,41634866,9236413,,479046,8175193,1933707,,1349028,33459673,7302706,PDN
ST185,,1980,1970,,2189530,110183239,21795089,,565170,20176532,4155300,,1624360,90006707,17639789,PDN
ST185,,1981,1970,,2189530,110183239,21795089,,666473,34102361,6734509,,1523057,76080878,15060580,PDN
ST185,,1982,1970,,2189530,110183239,21795089,,738612,47786336,9241519,,1450918,62396903,12553570,PDN
ST185,,1983,1970,,1756475,105649662,20555347,,797850,60961256,11645049,,958625,44688406,8910298,PDN
ST185,,1984,1970,,1400620,129267309,24401921,,846034,70787863,13441739,,554586,58479446,10960182,PDN
ST185,,1985,1970,,1263143,123757867,23284116,,881728,79086854,14954122,,381415,44671013,8329994,PDN
ST185,,1986,1970,,1263143,123757867,23284116,,909738,87308992,16445146,,353405,36448875,6838970,PDN
ST185,,1987,1970,,1263143,123757867,23284116,,923247,91511259,17206389,,339896,32246608,6077727,PDN
ST185,,1988,1970,,1226239,130308970,24412888,,941266,96310960,18078447,,284973,33998010,6334441,PDN
ST185,,1989,1970,,1226239,130308970,24412888,,957337,103060282,19295465,,268902,27248688,5117423,PDN
ST185,,1990,1970,,1058165,138643184,25727771,,975141,110474912,20632599,,83024,28168272,5095172,PDN
ST185,,1991,1970,,1067631,140421004,26053575,,987963,116511699,21719582,,79668,23909305,4333993,PDN
ST185,,1992,1970,,1168220,154619937,28680664,,1059951,133170108,24755700,,108269,21449829,3924964,PDN
ST185,,1993,1970,,1168220,154619937,28680664,,1065341,135625005,25197904,,102879,18994932,3482760,PDN
ST185,,1994,1970,,1168220,154619937,28680664,,1068433,136931730,25433510,,99787,17688207,3247154,PDN
ST185,,1995,1970,,1073564,138927775,25793809,,1070640,137631658,25560259,,2924,1296117,233550,PDN
ST185,,1996,1970,,1085548,138927775,25805793,,1072818,138178828,25659798,,12730,748947,145995,PDN
ST185,,1997,1970,,1086487,143110275,26550949,,1074662,138534845,25724990,,11825,4575430,825959,PDN
ST185,,1998,1970,,1284400,147725062,27569998,,1075971,138619741,25741405,,208429,9105321,1828593,PDN
ST185,,1999,1970,,1268483,147787420,27565177,,1160678,142872240,26582785,,107805,4915180,982392,PDN
ST185,,2000,1970,,1312281,156478993,29155518,,1227713,147255376,27429737,,84568,9223617,1725781,PDN
ST185,,2001,1970,,1637963,180696181,33790308,,1296177,151589135,28269333,,341786,29107046,5520975,PDN
ST185,,2002,1970,,1603256,180665868,33750207,,1393688,157095556,29346634,,209568,23570312,4403573,PDN
ST185,,2003,1970,,1841496,186423641,35012962,,1473478,162672291,30418726,,368018,23751350,4594236,PDN
ST185,,2004,1970,,1962817,198555665,37293006,,1557367,169974141,31801876,,405450,28581524,5491130,PDN
ST185,,2005,1970,,1968664,208502840,39068813,,1614690,174859322,32728448,,353974,33643518,6340365,PDN
ST185,,2006,1970,,1942207,206149969,38623696,,1662435,179754935,33647299,,279772,26395034,4976397,PDN
ST185,,2007,1970,,1994581,206002797,38649883,,1670223,181232062,33917921,,324358,24770735,4731962,PDN
ST185,,2008,1970,,1810324,197924387,37028186,,1674409,182121421,34080356,,135915,15802966,2947830,PDN
ST185,,2009,1970,,1700883,187029513,34980155,,1677683,185629230,34707795,,23200,1400283,272360,PDN
ST185,,2010,1970,,1717189,188431734,35245967,,1680381,186116050,34797115,,36808,2315684,448852,PDN
ST185,,2011,1970,,1717189,188431734,35245967,,1683904,186416542,34854107,,33285,2015192,391860,PDN
ST185,,2012,1970,,1691524,186917773,34950913,,1690077,186757102,34920877,,1447,160671,30036,PDN
ST185,,2013,1970,,1691524,186917773,34950913,,1691524,186917773,34950913,,0,0,0,PDN
ST185,,2014,1970,,1685818,186510594,34872756,,1685818,186510594,34872756,,0,0,0,PDN
ST185,,2015,1970,,1691524,186917773,34950913,,1691524,186917773,34950913,,0,0,0,PDN
ST185,,2016,1970,,1691524,186917773,34950913,,1691524,186917773,34950913,,0,0,0,PDN
ST185,,2017,1970,,1691524,186917773,34950913,,1691524,186917773,34950913,,0,0,0,PDN
ST185,,2017,1970,,1691524,186917773,34950913,,1691524,186917773,34950913,,0,0,0,PDN
ST186,,1975,1967,,1102255,17786720,4267152,,1081020,12488886,3303242,,21235,5297834,963910,PDN
ST186,,1976,1967,,1102255,17786720,4267152,,1082136,12577940,3320204,,20119,5208780,946948,PDN
ST186,,1977,1967,,1107813,18349520,4372852,,1084382,12805359,3362916,,23431,5544161,1009936,PDN
ST186,,1978,1967,,1109014,18775730,4449891,,1087707,13393623,3470914,,21307,5382107,978977,PDN
ST186,,1979,1967,,894605,21083720,4646157,,871458,13890305,3343043,,23147,7193415,1303114,PDN
ST186,,1980,1967,,974065,27082010,5792928,,889544,17342337,3975369,,84521,9739673,1817559,PDN
ST186,,1981,1967,,986214,27835167,5939091,,932625,19874472,4469008,,53589,7960695,1470083,PDN
ST186,,1982,1967,,986214,27835167,5939091,,948903,21237459,4727810,,37311,6597708,1211281,PDN
ST186,,1983,1967,,1009818,27710450,5940503,,961554,22371546,4942256,,48264,5338904,998247,PDN
ST186,,1984,1967,,1095823,33963721,7139190,,971721,24356963,5305700,,124102,9606758,1833490,PDN
ST186,,1985,1967,,1095823,33963721,7139190,,975168,25466538,5506580,,120655,8497183,1632610,PDN
ST186,,1986,1967,,1095823,33963721,7139190,,978463,26544184,5701627,,117360,7419537,1437563,PDN
ST186,,1987,1967,,1102240,36602973,7615225,,980128,27238241,5826790,,122112,9364732,1788435,PDN
ST186,,1988,1967,,1085593,36258404,7537266,,981428,27932174,5951566,,104165,8326230,1585700,PDN
ST186,,1989,1967,,1085593,36258404,7537266,,982094,28509936,6055036,,103499,7748468,1482230,PDN
ST186,,1990,1967,,989688,30929443,6493148,,983431,28933456,6131733,,6257,1995987,361415,PDN
ST186,,1991,1967,,989688,30929443,6493148,,983688,29123595,6165822,,6000,1805848,327326,PDN
ST186,,1992,1967,,918137,15825893,3734132,,918137,15825893,3734132,,0,0,0,PDN
ST186,,1993,1967,,918137,15825893,3734132,,918137,15825893,3734132,,0,0,0,PDN
ST186,,1994,1967,,918137,15825893,3734132,,918137,15825893,3734132,,0,0,0,PDN
ST186,,1995,1967,,918137,15825893,3734132,,918137,15825893,3734132,,0,0,0,PDN
ST186,,1996,1967,,918137,15825893,3734132,,918137,15825893,3734132,,0,0,0,PDN
ST186,,1997,1967,,2528635,43698407,10304152,,1063945,20737267,4753850,,1464690,22961140,5550302,PDN
ST186,,1998,1967,,3458534,54950186,13236147,,1498322,30416772,6910559,,1960212,24533414,6325588,PDN
ST186,,1999,1967,,3233795,62064666,14277330,,2203875,42816991,9822557,,1029920,19247675,4454773,PDN
ST186,,2000,1967,,3857963,73087040,16862774,,2684789,51676648,11879922,,1173174,21410392,4982852,PDN
ST186,,2001,1967,,4844204,93970550,21564942,,3581822,69761696,15994935,,1262382,24208854,5570007,PDN
ST186,,2002,1967,,4844204,93970550,21564942,,4088511,81661443,18619017,,755693,12309107,2945925,PDN
ST186,,2003,1967,,4907440,94975643,21807020,,4207758,84690880,19277310,,699682,10284763,2529710,PDN
ST186,,2004,1967,,5039111,95275444,21992037,,4425859,90455209,20521092,,613252,4820235,1470945,PDN
ST186,,2005,1967,,5069989,96774448,22289642,,4491221,92155360,20888972,,578768,4619088,1400670,PDN
ST186,,2006,1967,,5168041,102420558,23392339,,4579221,94586723,21409599,,588820,7833835,1982740,PDN
ST186,,2007,1967,,5159657,102859426,23462046,,4652491,96371886,21800513,,507166,6487540,1661533,PDN
ST186,,2008,1967,,5369627,110034877,24948787,,4705885,97632058,22078137,,663742,12402819,2870650,PDN
ST186,,2009,1967,,4960035,106450627,23901426,,4739306,99361382,22419266,,220729,7089245,1482161,PDN
ST186,,2010,1967,,4960035,106450627,23901426,,4813950,101707918,22911442,,146085,4742709,989984,PDN
ST186,,2011,1967,,4960035,106450627,23901426,,4850442,102922477,23164048,,109593,3528150,737378,PDN
ST186,,2012,1967,,4960035,106450627,23901426,,4867691,103486774,23281706,,92344,2963853,619720,PDN
ST186,,2013,1967,,4960035,106450627,23901426,,4877545,103805970,23348356,,82490,2644657,553070,PDN
ST186,,2014,1967,,4960035,106450627,23901426,,4884639,104047846,23398488,,75396,2402781,502937,PDN
ST186,,2015,1967,,4884656,104049109,23398730,,4884656,104049109,23398730,,0,0,0,PDN
ST186,,2016,1967,,4884656,104049109,23398730,,4884656,104049109,23398730,,0,0,0,PDN
ST186,,2017,1967,,4884656,104049109,23398730,,4884656,104049109,23398730,,0,0,0,PDN
ST186,,2017,1967,,4884656,104049109,23398730,,4884656,104049109,23398730,,0,0,0,PDN
ST187,,2002,2002,,183317,22914600,4260648,,0,0,0,,183317,22914600,4260648,PDN
ST187,,2003,2002,,24515,2961973,551556,,2239,274061,51004,,22276,2687912,500552,PDN
ST187,,2004,2002,,24515,2961973,551556,,15367,1877642,349467,,9148,1084331,202089,PDN
ST187,,2005,2002,,24515,2961973,551556,,19411,2294836,427745,,5104,667137,123811,PDN
ST187,,2006,2002,,24515,2961973,551556,,19919,2404059,447688,,4596,557914,103868,PDN
ST187,,2007,2002,,24515,2961973,551556,,19919,2405879,448011,,4596,556094,103545,PDN
ST187,,2008,2002,,88897,8474363,1596791,,36326,3654555,686603,,52571,4819808,910188,PDN
ST187,,2009,2002,,78228,7830645,1471581,,61839,5560910,1051324,,16389,2269735,420256,PDN
ST187,,2010,2002,,78228,7830645,1471581,,71987,6742513,1271723,,6241,1088132,199859,PDN
ST187,,2011,2002,,78228,7830645,1471581,,74372,7128810,1342843,,3856,701835,128738,PDN
ST187,,2012,2002,,80208,7904242,1486656,,78336,7604851,1431512,,1872,299391,55144,PDN
ST187,,2013,2002,,80208,7904242,1486656,,80208,7904242,1486656,,0,0,0,PDN
ST187,,2014,2002,,80208,7904242,1486656,,80208,7904242,1486656,,0,0,0,PDN
ST187,,2015,2002,,80208,7904242,1486656,,80208,7904242,1486656,,0,0,0,PDN
ST187,,2016,2002,,80208,7904242,1486656,,80208,7904242,1486656,,0,0,0,PDN
ST187,,2017,2002,,80208,7904242,1486656,,80208,7904242,1486656,,0,0,0,PDN
ST187,,2017,2002,,80208,7904242,1486656,,80208,7904242,1486656,,0,0,0,PDN
ST190,,1975,1963,,0,110000000,19572954,,0,0,0,,0,110000000,19572954,PDP
ST190,,1976,1963,,0,110000000,19572954,,0,0,0,,0,110000000,19572954,PDP
ST190,,1977,1963,,0,110000000,19572954,,0,0,0,,0,110000000,19572954,PDP
ST190,,1978,1963,,402362,402362000,71997024,,0,0,0,,402362,402362000,71997024,PDP
ST190,,1979,1963,,402362,402362000,71997024,,24649,5071478,927047,,377713,397290522,71069977,PDP
ST190,,1980,1963,,402362,402362000,71997024,,49944,10688335,1951783,,352418,391673665,70045241,PDP
ST190,,1981,1963,,436634,402362000,72031296,,57962,14849587,2700237,,378672,387512413,69331059,PDP
ST190,,1982,1963,,382439,205162123,36888155,,63330,18234346,3307876,,319109,186927777,33580279,PDP
ST190,,1983,1963,,382439,205162123,36888155,,69131,19302305,3503705,,313308,185859818,33384450,PDP
ST190,,1984,1963,,382439,205162123,36888155,,79087,21608085,3923942,,303352,183554038,32964213,PDP
ST190,,1985,1963,,382439,205162123,36888155,,82348,22859070,4149798,,300091,182303053,32738357,PDP
ST190,,1986,1963,,814007,223697041,40617751,,85186,23497212,4266185,,728821,200199829,36351566,PDP
ST190,,1987,1963,,814007,223697041,40617751,,86973,24412224,4430785,,727034,199284817,36186966,PDP
ST190,,1988,1963,,814007,223697041,40617751,,87516,24839023,4507271,,726491,198858018,36110480,PDP
ST190,,1989,1963,,241827,67676045,12283828,,87617,24975626,4531679,,154210,42700419,7752149,PDP
ST190,,1990,1963,,241827,67676045,12283828,,87636,25600526,4642890,,154191,42075519,7640938,PDP
ST190,,1991,1963,,239426,67342871,12222143,,89756,26487884,4802903,,149670,40854987,7419240,PDP
ST190,,1992,1963,,391313,86559661,15793388,,122214,33415590,6068049,,269099,53144071,9725339,PDP
ST190,,1993,1963,,432225,104307402,18992261,,168398,43379333,7887141,,263827,60928069,11105120,PDP
ST190,,1994,1963,,432225,104307402,18992261,,222465,53127481,9675753,,209760,51179921,9316508,PDP
ST190,,1995,1963,,405371,103245793,18776509,,246877,58033518,10573126,,158494,45212275,8203383,PDP
ST190,,1996,1963,,508708,108499372,19814646,,294296,64275929,11731294,,214412,44223443,8083352,PDP
ST190,,1997,1963,,828080,158968627,29114313,,338986,72805526,13293706,,489094,86163101,15820607,PDP
ST190,,1998,1963,,828080,158968627,29114313,,391539,93664574,17057833,,436541,65304053,12056480,PDP
ST190,,1999,1963,,1075195,344945660,62453426,,435876,114088050,20736241,,639319,230857610,41717185,PDP
ST190,,2000,1963,,12489301,499051187,101288444,,486127,137411910,24936645,,12003174,361639277,76351799,PDP
ST190,,2001,1963,,11385322,616087378,121009411,,2700859,196147984,37602636,,8684463,419939394,83406775,PDP
ST190,,2002,1963,,11229615,625442799,122518370,,8593584,324528908,66338941,,2636031,300913891,56179429,PDP
ST190,,2003,1963,,12126201,660497580,129652461,,10076946,391354523,79712982,,2049255,269143057,49939479,PDP
ST190,,2004,1963,,13803913,683965368,135505936,,10758666,421849891,85820924,,3045247,262115477,49685012,PDP
ST190,,2005,1963,,13824189,691852027,136929532,,11290110,440801530,89724546,,2534079,251050497,47204986,PDP
ST190,,2006,1963,,13979718,712143218,140695593,,11761510,457530363,93172607,,2218208,254612855,47522986,PDP
ST190,,2007,1963,,13551574,575821815,116010972,,11668253,462423108,93949945,,1883321,113398707,22061027,PDP
ST190,,2008,1963,,13561096,578599993,116514831,,11875400,468447606,95229067,,1685696,110152387,21285764,PDP
ST190,,2009,1963,,12733373,500941330,101868841,,12017341,475242904,96580136,,716032,25698426,5288706,PDP
ST190,,2010,1963,,12757337,500941330,101892805,,12126085,478479821,97264845,,631252,22461509,4627960,PDP
ST190,,2011,1963,,12757104,500857649,101877682,,12200105,480270797,97657544,,556999,20586852,4220138,PDP
ST190,,2012,1963,,12874503,508962477,103437221,,12322120,485931489,98786798,,552383,23030988,4650423,PDP
ST190,,2013,1963,,12856185,508336444,103307509,,12417252,490614030,99715123,,438933,17722414,3592386,PDP
ST190,,2014,1963,,12716876,497085872,101166320,,12483185,492198939,100063069,,233691,4886933,1103252,PDP
ST190,,2015,1963,,12716876,497085872,101166320,,12539635,493118838,100283202,,177241,3967034,883119,PDP
ST190,,2016,1963,,12697471,495466500,100858771,,12581073,493787241,100443572,,116398,1679259,415199,PDP
ST190,,2017,1963,,12687122,495299977,100818792,,12614468,494299182,100568060,,72654,1000795,250732,PDP
ST190,,2017,1963,,12687122,495299977,100818792,,12614468,494299182,100568060,,72654,1000795,250732,PDP
ST196,,1975,1966,,2337060,67612000,14367665,,1743394,53375959,11240896,,593666,14236041,3126769,PDP
ST196,,1976,1966,,2372888,72628000,15296020,,1945870,60017639,12625165,,427018,12610361,2670855,PDP
ST196,,1977,1966,,2360499,76107400,15902741,,2025529,65732921,13721778,,334970,10374479,2180963,PDP
ST196,,1978,1966,,2980252,80180200,17247192,,2203390,67824430,14271794,,776862,12355770,2975398,PDP
ST196,,1979,1966,,2550252,80180200,16817192,,1983125,69733492,14391220,,567127,10446708,2425972,PDP
ST196,,1980,1966,,2530037,87487786,18097259,,2112368,73188197,15135179,,417669,14299589,2962080,PDP
ST196,,1981,1966,,3176585,90473786,19275123,,2318558,77386461,16088391,,858027,13087325,3186732,PDP
ST196,,1982,1966,,3434842,103188245,21795740,,2470967,84106119,17436469,,963875,19082126,4359271,PDP
ST196,,1983,1966,,3535305,105842160,22368430,,2630260,91550123,18920317,,905045,14292037,3448113,PDP
ST196,,1984,1966,,3739522,122922483,25611850,,2795057,98076237,20246345,,944465,24846246,5365505,PDP
ST196,,1985,1966,,5001978,126098975,27439518,,2950940,102556163,21199368,,2051038,23542812,6240150,PDP
ST196,,1986,1966,,5008977,138476751,29648968,,3356013,110098999,22946582,,1652964,28377752,6702386,PDP
ST196,,1987,1966,,6164930,139555566,30996881,,3678631,115327944,24199617,,2486299,24227622,6797264,PDP
ST196,,1988,1966,,6082366,158140007,34221157,,3928912,121128414,25482011,,2153454,37011593,8739146,PDP
ST196,,1989,1966,,6080949,144574503,31805950,,4166479,127425017,26839970,,1914470,17149486,4965980,PDP
ST196,,1990,1966,,6229018,162921341,35218580,,4382094,134709849,28351818,,1846924,28211492,6866762,PDP
ST196,,1991,1966,,5561246,308413843,60439154,,4670398,228606004,45347623,,890848,79807839,15091531,PDP
ST196,,1992,1966,,5564126,308413843,60442034,,4870524,239572336,47499054,,693602,68841507,12942980,PDP
ST196,,1993,1966,,6190202,349466238,68372807,,5064034,249550302,49468002,,1126168,99915936,18904805,PDP
ST196,,1994,1966,,6190202,349466237,68372806,,5255210,259232301,51381954,,934992,90233936,16990852,PDP
ST196,,1995,1966,,5789934,295578056,58383894,,5362497,267611719,52980241,,427437,27966337,5403653,PDP
ST196,,1996,1966,,5913675,308807893,60861699,,5553937,276209331,54701505,,359738,32598562,6160194,PDP
ST196,,1997,1966,,7072954,334970737,66676288,,5818555,283137260,56198850,,1254399,51833477,10477438,PDP
ST196,,1998,1966,,6747271,337290737,66763416,,6178657,299339643,59441939,,568614,37951094,7321477,PDP
ST196,,1999,1966,,6764834,329547104,65403109,,6412579,306087418,60876532,,352255,23459686,4526577,PDP
ST196,,2000,1966,,6840462,345195869,68263214,,6576602,317514930,63073921,,263860,27680939,5189293,PDP
ST196,,2001,1966,,6836992,346683950,68524528,,6748038,329700206,65413555,,88954,16983744,3110973,PDP
ST196,,2002,1966,,7107001,360225777,71204114,,6877045,336650260,66779226,,229956,23575517,4424888,PDP
ST196,,2003,1966,,7422232,383201059,75607474,,6967320,345235033,68397041,,454912,37966026,7210433,PDP
ST196,,2004,1966,,7363534,377331256,74504327,,7047776,350258205,69371300,,315758,27073051,5133027,PDP
ST196,,2005,1966,,7813775,381608159,75715583,,7105307,354531025,70189119,,708468,27077134,5526464,PDP
ST196,,2006,1966,,7770350,368728414,73380388,,7177773,357284898,70751598,,592577,11443516,2628790,PDP
ST196,,2007,1966,,7770350,368728414,73380388,,7244116,359285356,71173895,,526234,9443058,2206493,PDP
ST196,,2008,1966,,7575967,373205580,73982654,,7281876,360230506,71379831,,294091,12975074,2602823,PDP
ST196,,2009,1966,,7295844,369920530,73118000,,7281876,366154770,72433968,,13968,3765760,684032,PDP
ST196,,2010,1966,,7295844,369920530,73118000,,7282203,366237001,72448927,,13641,3683529,669073,PDP
ST196,,2011,1966,,7295844,369920530,73118000,,7284699,367297890,72640193,,11145,2622640,477807,PDP
ST196,,2012,1966,,7295844,369920530,73118000,,7285774,368194596,72800824,,10070,1725934,317176,PDP
ST196,,2013,1966,,7295844,369920530,73118000,,7286411,368942674,72934571,,9433,977856,183429,PDP
ST196,,2014,1966,,7295844,369920530,73118000,,7287074,369376201,73012374,,8770,544329,105626,PDP
ST196,,2015,1966,,7287675,370495884,73212207,,7287257,369708940,73071763,,418,786944,140444,PDP
ST196,,2016,1966,,7287694,370853515,73275861,,7287490,369967843,73118065,,204,885672,157796,PDP
ST196,,2017,1966,,7289629,371216377,73342363,,7288016,370279043,73173964,,1613,937334,168398,PDP
ST196,,2017,1966,,7289629,371216377,73342363,,7288016,370279043,73173964,,1613,937334,168398,PDP
ST197,,1990,1988,,932887,35752169,7294483,,19920,2063963,387173,,912967,33688206,6907310,PDN
ST197,,1991,1988,,932887,35752169,7294483,,67215,7134512,1336701,,865672,28617657,5957782,PDN
ST197,,1992,1988,,1008997,42296140,8535001,,129375,13874421,2598133,,879622,28421719,5936868,PDN
ST197,,1993,1988,,1046314,34503579,7185741,,216022,18763454,3554715,,830292,15740125,3631026,PDN
ST197,,1994,1988,,1046503,34503854,7185979,,231639,19120444,3633853,,814864,15383410,3552126,PDN
ST197,,1995,1988,,454679,23195808,4582047,,258318,19322909,3696558,,196361,3872899,885489,PDN
ST197,,1996,1988,,454679,23195808,4582047,,275510,19351405,3718820,,179169,3844403,863227,PDN
ST197,,1997,1988,,1898886,23195808,6026254,,488162,19554164,3967551,,1410724,3641644,2058703,PDN
ST197,,1998,1988,,1898886,23324261,6049110,,834695,19987712,4391227,,1064191,3336549,1657883,PDN
ST197,,1999,1988,,1331191,23576272,5526257,,999195,20906854,4719276,,331996,2669418,806981,PDN
ST197,,2000,1988,,1332024,29795132,6633649,,1076891,22758897,5126517,,255133,7036235,1507132,PDN
ST197,,2001,1988,,1332054,30125858,6692527,,1135045,24566424,5506295,,197009,5559434,1186232,PDN
ST197,,2002,1988,,1332054,30125858,6692527,,1181049,24827487,5598751,,151005,5298371,1093776,PDN
ST197,,2003,1988,,1415181,30337999,6813401,,1228436,25012250,5679014,,186745,5325749,1134387,PDN
ST197,,2004,1988,,1458816,26608270,6193384,,1249481,25161899,5726687,,209335,1446371,466697,PDN
ST197,,2005,1988,,1459022,27430840,6339954,,1329017,25443983,5856416,,130005,1986857,483538,PDN
ST197,,2006,1988,,1459060,27775137,6401255,,1353676,25559705,5901666,,105384,2215432,499589,PDN
ST197,,2007,1988,,1459060,27775137,6401255,,1355764,25600582,5911028,,103296,2174555,490227,PDN
ST197,,2008,1988,,1355764,25604298,5911689,,1355764,25604298,5911689,,0,0,0,PDN
ST197,,2009,1988,,1355764,26000125,5982121,,1355764,26000125,5982121,,0,0,0,PDN
ST197,,2010,1988,,1355764,26000125,5982121,,1355764,26000125,5982121,,0,0,0,PDN
ST197,,2011,1988,,1355764,26000125,5982121,,1355764,26000125,5982121,,0,0,0,PDN
ST197,,2012,1988,,1355764,26000125,5982121,,1355764,26000125,5982121,,0,0,0,PDN
ST197,,2013,1988,,1355764,26000125,5982121,,1355764,26000125,5982121,,0,0,0,PDN
ST197,,2014,1988,,1355764,26000125,5982121,,1355764,26000125,5982121,,0,0,0,PDN
ST197,,2015,1988,,1355764,26000125,5982121,,1355764,26000125,5982121,,0,0,0,PDN
ST197,,2016,1988,,1355764,26000125,5982121,,1355764,26000125,5982121,,0,0,0,PDN
ST197,,2017,1988,,1355764,26000125,5982121,,1355764,26000125,5982121,,0,0,0,PDN
ST197,,2017,1988,,1355764,26000125,5982121,,1355764,26000125,5982121,,0,0,0,PDN
ST198,,1989,1988,,796282,32249427,6534614,,0,0,0,,796282,32249427,6534614,PDN
ST198,,1990,1988,,1154904,46773612,9477611,,112807,5885325,1160018,,1042097,40888287,8317593,PDN
ST198,,1991,1988,,1070162,43341575,8782186,,464286,23453096,4637435,,605876,19888479,4144751,PDN
ST198,,1992,1988,,1144498,61438495,12076615,,682567,35871074,7065320,,461931,25567421,5011295,PDN
ST198,,1993,1988,,1144498,68420031,13318881,,770558,41639087,8179648,,373940,26780944,5139233,PDN
ST198,,1994,1988,,1144498,68420031,13318881,,844660,46754684,9163999,,299838,21665347,4154882,PDN
ST198,,1995,1988,,1144498,68420031,13318881,,919461,50558351,9915609,,225037,17861680,3403272,PDN
ST198,,1996,1988,,1592651,88544958,17347982,,1079847,58268801,11447961,,512804,30276157,5900021,PDN
ST198,,1997,1988,,1732030,98998372,19347399,,1173511,63633912,12496271,,558519,35364460,6851128,PDN
ST198,,1998,1988,,1919065,108364836,21201064,,1212166,67569285,13235170,,706899,40795551,7965894,PDN
ST198,,1999,1988,,1431740,89142427,17293382,,1226288,70606263,13789680,,205452,18536164,3503702,PDN
ST198,,2000,1988,,1431740,89142427,17293382,,1236289,72178326,14079408,,195451,16964101,3213974,PDN
ST198,,2001,1988,,1449571,89899913,17445997,,1244179,73443616,14312438,,205392,16456297,3133559,PDN
ST198,,2002,1988,,1649013,109844099,21194226,,1249087,73965499,14410208,,399926,35878600,6784018,PDN
ST198,,2003,1988,,1329141,84757828,16410605,,1258305,75579267,14706573,,70836,9178561,1704032,PDN
ST198,,2004,1988,,1329141,84757828,16410605,,1260300,75921289,14769426,,68841,8836539,1641179,PDN
ST198,,2005,1988,,1329141,84757828,16410605,,1260300,76041237,14790769,,68841,8716591,1619836,PDN
ST198,,2006,1988,,1267622,77502022,15058017,,1260300,76146714,14809537,,7322,1355308,248480,PDN
ST198,,2007,1988,,1267622,77502022,15058017,,1260300,76171518,14813951,,7322,1330504,244066,PDN
ST198,,2008,1988,,1260300,76171518,14813951,,1260300,76171518,14813951,,0,0,0,PDN
ST198,,2009,1988,,1376479,88793090,17175961,,1357991,86608904,16768828,,18488,2184186,407133,PDN
ST198,,2010,1988,,1376479,88793090,17175961,,1368522,88014435,17029453,,7957,778655,146508,PDN
ST198,,2011,1988,,1370252,88187295,17061941,,1370252,88187295,17061941,,0,0,0,PDN
ST198,,2012,1988,,1370252,88187295,17061941,,1370252,88187295,17061941,,0,0,0,PDN
ST198,,2013,1988,,1370252,88187295,17061941,,1370252,88187295,17061941,,0,0,0,PDN
ST198,,2014,1988,,1370252,88187295,17061941,,1370252,88187295,17061941,,0,0,0,PDN
ST198,,2015,1988,,1370252,88187295,17061941,,1370252,88187295,17061941,,0,0,0,PDN
ST198,,2016,1988,,1370252,88187295,17061941,,1370252,88187295,17061941,,0,0,0,PDN
ST198,,2017,1988,,1370252,88187295,17061941,,1370252,88187295,17061941,,0,0,0,PDN
ST198,,2017,1988,,1370252,88187295,17061941,,1370252,88187295,17061941,,0,0,0,PDN
ST200,,1983,1981,,81431,24429150,4428255,,0,0,0,,81431,24429150,4428255,PDN
ST200,,1984,1981,,81431,24429150,4428255,,0,0,0,,81431,24429150,4428255,PDN
ST200,,1985,1981,,797432,100550006,18688892,,63777,7197437,1344460,,733655,93352569,17344432,PDN
ST200,,1986,1981,,797432,100550006,18688892,,148202,21975729,4058474,,649230,78574277,14630418,PDN
ST200,,1987,1981,,797432,100550006,18688892,,183142,29508557,5433775,,614290,71041449,13255117,PDN
ST200,,1988,1981,,685533,100550006,18576993,,192800,33162910,6093674,,492733,67387096,12483319,PDN
ST200,,1989,1981,,573361,79790789,14771010,,242484,39230617,7223021,,330877,40560172,7547989,PDN
ST200,,1990,1981,,685524,87642234,16280228,,310736,46977925,8669797,,374788,40664309,7610431,PDN
ST200,,1991,1981,,685524,87642234,16280228,,363623,52813622,9761065,,321901,34828612,6519163,PDN
ST200,,1992,1981,,571573,83250931,15384906,,423187,59261207,10967886,,148386,23989724,4417020,PDN
ST200,,1993,1981,,645684,86336351,16008024,,454573,62804948,11629831,,191111,23531403,4378193,PDN
ST200,,1994,1981,,645684,86336351,16008024,,491956,67199146,12449099,,153728,19137205,3558925,PDN
ST200,,1995,1981,,691866,88660724,16467796,,523051,71024466,13160856,,168815,17636258,3306940,PDN
ST200,,1996,1981,,763248,102886038,19070372,,556589,75796500,14043511,,206659,27089538,5026861,PDN
ST200,,1997,1981,,763248,102886038,19070372,,581125,80584039,14919922,,182123,22301999,4150450,PDN
ST200,,1998,1981,,763248,102886038,19070372,,588305,82268544,15226836,,174943,20617494,3843536,PDN
ST200,,1999,1981,,744535,104823404,19396387,,619779,86005108,15923179,,124756,18818296,3473208,PDN
ST200,,2000,1981,,755000,106021903,19620108,,664957,93402245,17284574,,90043,12619658,2335534,PDN
ST200,,2001,1981,,755000,106021903,19620108,,678798,95832666,17730874,,76202,10189237,1889234,PDN
ST200,,2002,1981,,1235037,153621916,28569898,,682918,96675960,17885046,,552119,56945956,10684852,PDN
ST200,,2003,1981,,1207849,151592858,28181667,,715444,99965923,18502975,,492405,51626935,9678692,PDN
ST200,,2004,1981,,1486340,173872166,32424448,,938631,121802029,22611590,,547709,52070137,9812858,PDN
ST200,,2005,1981,,1484880,173434015,32345025,,959902,124464063,23106532,,524978,48969952,9238493,PDN
ST200,,2006,1981,,1263837,155962627,29015194,,980627,126252667,23445514,,283210,29709960,5569680,PDN
ST200,,2007,1981,,1260316,154906357,28823725,,988649,127261992,23633132,,271667,27644365,5190593,PDN
ST200,,2008,1981,,1272323,162562964,30198117,,1003265,129468082,24040290,,269058,33094882,6157827,PDN
ST200,,2009,1981,,1058498,141346914,26209194,,1017553,133810163,24827190,,40945,7536751,1382005,PDN
ST200,,2010,1981,,1058498,141346914,26209194,,1021894,134953762,25035019,,36604,6393152,1174176,PDN
ST200,,2011,1981,,1032086,138874377,25742829,,1023703,135633345,25157750,,8383,3241032,585080,PDN
ST200,,2012,1981,,1025525,136209365,25262066,,1025386,136171404,25255173,,139,37961,6894,PDN
ST200,,2013,1981,,1025525,136209365,25262066,,1025525,136209365,25262066,,0,0,0,PDN
ST200,,2014,1981,,1025525,136209365,25262066,,1025525,136209365,25262066,,0,0,0,PDN
ST200,,2015,1981,,1025525,136209365,25262066,,1025525,136209365,25262066,,0,0,0,PDN
ST200,,2016,1981,,1025525,136209365,25262066,,1025525,136209365,25262066,,0,0,0,PDN
ST200,,2017,1981,,1025525,136209365,25262066,,1025525,136209365,25262066,,0,0,0,PDN
ST200,,2017,1981,,1025525,136209365,25262066,,1025525,136209365,25262066,,0,0,0,PDN
ST206,,1986,1984,,414882,34503211,6554243,,0,0,0,,414882,34503211,6554243,PDN
ST206,,1987,1984,,414882,34503211,6554243,,0,0,0,,414882,34503211,6554243,PDN
ST206,,1989,1984,,1765631,223357783,41509009,,0,0,0,,1765631,223357783,41509009,PDN
ST206,,1990,1984,,1449348,184111894,34209471,,75914,16771693,3060201,,1373434,167340201,31149270,PDN
ST206,,1991,1984,,1598276,211545978,39239909,,227743,54692869,9959570,,1370533,156853109,29280339,PDN
ST206,,1992,1984,,958103,262727731,47706810,,355165,88255208,16058939,,602938,174472523,31647871,PDN
ST206,,1993,1984,,958391,264167496,47963284,,562023,117882111,21537488,,396368,146285385,26425796,PDN
ST206,,1994,1984,,964185,264027446,47944158,,652896,141357560,25805487,,311289,122669886,22138671,PDN
ST206,,1995,1984,,1270655,259723906,47484873,,753535,166582208,30394497,,517120,93141698,17090376,PDN
ST206,,1996,1984,,1315910,269728873,49310371,,793276,186239348,33931950,,522634,83489525,15378421,PDN
ST206,,1997,1984,,1315910,269728873,49310371,,820341,202807644,36907110,,495569,66921229,12403261,PDN
ST206,,1998,1984,,1315910,269728873,49310371,,835059,213694750,38859036,,480851,56034123,10451335,PDN
ST206,,1999,1984,,857741,232186196,42172011,,842819,220725652,40117846,,14922,11460544,2054165,PDN
ST206,,2000,1984,,857713,232179586,42170807,,846796,224943903,40872402,,10917,7235683,1298405,PDN
ST206,,2001,1984,,859013,248251336,45031849,,850671,230863731,41929627,,8342,17387605,3102222,PDN
ST206,,2002,1984,,859326,249231008,45206480,,852432,234269533,42537402,,6894,14961475,2669078,PDN
ST206,,2003,1984,,857824,251921569,45683726,,852840,236302362,42899524,,4984,15619207,2784202,PDN
ST206,,2004,1984,,852850,240676257,43677807,,852850,237641302,43137779,,0,3034955,540028,PDN
ST206,,2005,1984,,852850,240676257,43677807,,852850,238598614,43308119,,0,2077643,369688,PDN
ST206,,2006,1984,,968856,255918666,46505985,,864078,240681751,43690012,,104778,15236915,2815973,PDN
ST206,,2007,1984,,968856,255918666,46505985,,875654,243246414,44157934,,93202,12672252,2348051,PDN
ST206,,2008,1984,,970186,258902351,47038220,,875924,243998597,44292044,,94262,14903754,2746176,PDN
ST206,,2009,1984,,878474,254515586,46165944,,875924,249067072,45193907,,2550,5448514,972037,PDN
ST206,,2010,1984,,878474,254515586,46165944,,875924,249478605,45267134,,2550,5036981,898809,PDN
ST206,,2011,1984,,878474,254515586,46165944,,876222,249971594,45355153,,2252,4543992,810791,PDN
ST206,,2012,1984,,877412,254094578,46089969,,876436,250981234,45535018,,976,3113344,554951,PDN
ST206,,2013,1984,,877412,254094578,46089969,,876915,251465882,45621733,,497,2628696,468236,PDN
ST206,,2014,1984,,876915,251469866,45622441,,876915,251469866,45622441,,0,0,0,PDN
ST206,,2015,1984,,876915,251469866,45622441,,876915,251469866,45622441,,0,0,0,PDN
ST206,,2016,1984,,876915,251469866,45622441,,876915,251469866,45622441,,0,0,0,PDN
ST206,,2017,1984,,876915,251469866,45622441,,876915,251469866,45622441,,0,0,0,PDN
ST206,,2017,1984,,876915,251469866,45622441,,876915,251469866,45622441,,0,0,0,PDN
ST209,,2002,2003,,19058,1905771,358163,,0,0,0,,19058,1905771,358163,PDN
ST209,,2003,2003,,45,3609386,642285,,0,416409,74094,,45,3192977,568191,PDN
ST209,,2004,2003,,45,3609386,642285,,29,1773000,315509,,16,1836386,326776,PDN
ST209,,2005,2003,,38,1990964,354302,,38,1990964,354302,,0,0,0,PDN
ST209,,2006,2003,,38,1991486,354395,,38,1991486,354395,,0,0,0,PDN
ST209,,2007,2003,,38,1991486,354395,,38,1991486,354395,,0,0,0,PDN
ST209,,2008,2003,,38,1991486,354395,,38,1991486,354395,,0,0,0,PDN
ST209,,2009,2003,,38,1991486,354395,,38,1991486,354395,,0,0,0,PDN
ST209,,2010,2003,,38,1991486,354395,,38,1991486,354395,,0,0,0,PDN
ST209,,2011,2003,,38,1991486,354395,,38,1991486,354395,,0,0,0,PDN
ST209,,2012,2003,,38,1991486,354395,,38,1991486,354395,,0,0,0,PDN
ST209,,2013,2003,,38,1991486,354395,,38,1991486,354395,,0,0,0,PDN
ST209,,2014,2003,,38,1991486,354395,,38,1991486,354395,,0,0,0,PDN
ST209,,2015,2003,,38,1991486,354395,,38,1991486,354395,,0,0,0,PDN
ST209,,2016,2003,,38,1991486,354395,,38,1991486,354395,,0,0,0,PDN
ST209,,2017,2003,,38,1991486,354395,,38,1991486,354395,,0,0,0,PDN
ST209,,2017,2003,,38,1991486,354395,,38,1991486,354395,,0,0,0,PDN
ST213,,1999,2000,,18181,2181772,406397,,0,0,0,,18181,2181772,406397,PDN
ST213,,2000,2000,,591,3925606,699097,,12,907269,161448,,579,3018337,537649,PDN
ST213,,2001,2000,,498,3448167,614051,,469,3196905,569313,,29,251262,44738,PDN
ST213,,2002,2000,,498,3448167,614051,,469,3300108,587677,,29,148059,26374,PDN
ST213,,2003,2000,,469,3300108,587677,,469,3300108,587677,,0,0,0,PDN
ST213,,2004,2000,,469,3300108,587677,,469,3300108,587677,,0,0,0,PDN
ST213,,2005,2000,,469,3300108,587677,,469,3300108,587677,,0,0,0,PDN
ST213,,2006,2000,,469,3300108,587677,,469,3300108,587677,,0,0,0,PDN
ST213,,2007,2000,,469,3300108,587677,,469,3300108,587677,,0,0,0,PDN
ST213,,2008,2000,,469,3300108,587677,,469,3300108,587677,,0,0,0,PDN
ST213,,2009,2000,,469,3300108,587677,,469,3300108,587677,,0,0,0,PDN
ST213,,2010,2000,,469,3300108,587677,,469,3300108,587677,,0,0,0,PDN
ST213,,2011,2000,,469,3300108,587677,,469,3300108,587677,,0,0,0,PDN
ST213,,2012,2000,,469,3300108,587677,,469,3300108,587677,,0,0,0,PDN
ST213,,2013,2000,,469,3300108,587677,,469,3300108,587677,,0,0,0,PDN
ST213,,2014,2000,,469,3300108,587677,,469,3300108,587677,,0,0,0,PDN
ST213,,2015,2000,,469,3300108,587677,,469,3300108,587677,,0,0,0,PDN
ST213,,2016,2000,,469,3300108,587677,,469,3300108,587677,,0,0,0,PDN
ST213,,2017,2000,,469,3300108,587677,,469,3300108,587677,,0,0,0,PDN
ST213,,2017,2000,,469,3300108,587677,,469,3300108,587677,,0,0,0,PDN
ST217,,1998,1998,,40391,23248319,4177103,,392,430742,77036,,39999,22817577,4100067,PDN
ST217,,1999,1998,,22302,24658531,4409941,,8271,9189989,1643500,,14031,15468542,2766441,PDN
ST217,,2000,1998,,22302,24658531,4409941,,10807,11939098,2135202,,11495,12719433,2274739,PDN
ST217,,2001,1998,,22302,24658531,4409941,,12001,13428401,2401396,,10301,11230130,2008545,PDN
ST217,,2002,1998,,22302,24658531,4409941,,12599,14358791,2567544,,9703,10299740,1842397,PDN
ST217,,2003,1998,,22302,24658531,4409941,,13005,14726903,2633450,,9297,9931628,1776491,PDN
ST217,,2004,1998,,13438,15321226,2739635,,13233,14930547,2669914,,205,390679,69721,PDN
ST217,,2005,1998,,13438,15321226,2739635,,13280,15020113,2685898,,158,301113,53737,PDN
ST217,,2006,1998,,13438,15321226,2739635,,13355,15170565,2712744,,83,150661,26891,PDN
ST217,,2007,1998,,13438,15321226,2739635,,13418,15233009,2723918,,20,88217,15717,PDN
ST217,,2008,1998,,70658,23628800,4275071,,36200,18259469,3285216,,34458,5369331,989855,PDN
ST217,,2009,1998,,71044,23628535,4275409,,44128,19919699,3588558,,26916,3708836,686851,PDN
ST217,,2010,1998,,53181,21471902,3873804,,45503,20595112,3710113,,7678,876790,163691,PDN
ST217,,2011,1998,,53181,21471902,3873804,,49187,21098971,3803452,,3994,372931,70352,PDN
ST217,,2012,1998,,53181,21471902,3873804,,53181,21471902,3873804,,0,0,0,PDN
ST217,,2013,1998,,53181,21471902,3873804,,53181,21471902,3873804,,0,0,0,PDN
ST217,,2014,1998,,53181,21471902,3873804,,53181,21471902,3873804,,0,0,0,PDN
ST217,,2015,1998,,53181,21471902,3873804,,53181,21471902,3873804,,0,0,0,PDN
ST217,,2016,1998,,53181,21471902,3873804,,53181,21471902,3873804,,0,0,0,PDN
ST217,,2017,1998,,53181,21472018,3873824,,53181,21472018,3873824,,0,0,0,PDN
ST217,,2017,1998,,53181,21472018,3873824,,53181,21472018,3873824,,0,0,0,PDN
ST219,,1997,1963,,355936,53583727,9890407,,392,32838,6235,,355544,53550889,9884172,PDN
ST219,,1998,1963,,660505,64587047,12152862,,122479,17850683,3298757,,538026,46736364,8854105,PDN
ST219,,1999,1963,,440010,60348123,11178110,,242876,31590804,5864016,,197134,28757319,5314094,PDN
ST219,,2000,1963,,459437,83670123,15347359,,322402,50795225,9360698,,137035,32874898,5986661,PDN
ST219,,2001,1963,,460160,85647785,15699979,,365402,65029364,11936463,,94758,20618421,3763516,PDN
ST219,,2002,1963,,460160,85647785,15699979,,378903,72499171,13279111,,81257,13148614,2420868,PDN
ST219,,2003,1963,,553420,93410364,17174481,,393152,76327301,13974522,,160268,17083063,3199959,PDN
ST219,,2004,1963,,576702,94162013,17331509,,407678,78337940,14346813,,169024,15824073,2984696,PDN
ST219,,2005,1963,,576702,94162014,17331509,,436423,81047536,14857693,,140279,13114478,2473816,PDN
ST219,,2006,1963,,750824,113817171,21002990,,466518,83517231,15327235,,284306,30299940,5675755,PDN
ST219,,2007,1963,,750824,113817171,21002990,,529850,90643219,16658537,,220974,23173952,4344453,PDN
ST219,,2008,1963,,738455,109508760,20223999,,554882,93848164,17253844,,183573,15660596,2970155,PDN
ST219,,2009,1963,,743354,110211785,20353992,,584757,96561108,17766449,,158597,13650677,2587543,PDN
ST219,,2010,1963,,664838,105411069,19421256,,623269,100073120,18429874,,41569,5337949,991382,PDN
ST219,,2011,1963,,708714,112372492,20703819,,652573,103637629,19093433,,56141,8734863,1610387,PDN
ST219,,2012,1963,,708714,112372492,20703819,,664838,105411069,19421256,,43876,6961423,1282563,PDN
ST219,,2013,1963,,708714,112372492,20703819,,664838,105411069,19421256,,43876,6961423,1282563,PDN
ST219,,2014,1963,,666013,107049006,19713879,,666013,107049006,19713879,,0,0,0,PDN
ST219,,2015,1963,,666013,107049006,19713879,,666013,107049006,19713879,,0,0,0,PDN
ST219,,2016,1963,,666013,107049006,19713879,,666013,107049006,19713879,,0,0,0,PDN
ST219,,2017,1963,,666013,107049006,19713879,,666013,107049006,19713879,,0,0,0,PDN
ST219,,2017,1963,,666013,107049006,19713879,,666013,107049006,19713879,,0,0,0,PDN
ST221,,1986,1984,,91491,25236988,4582058,,0,0,0,,91491,25236988,4582058,PDN
ST221,,1987,1984,,91491,25236988,4582058,,0,0,0,,91491,25236988,4582058,PDN
ST221,,1989,1984,,151759,13048464,2473550,,0,0,0,,151759,13048464,2473550,PDN
ST221,,1990,1984,,151759,13048464,2473550,,16882,1381645,262726,,134877,11666819,2210824,PDN
ST221,,1991,1984,,110220,9476573,1796443,,46344,3886261,737850,,63876,5590312,1058593,PDN
ST221,,1992,1984,,110220,9476573,1796443,,67103,5674642,1076826,,43117,3801931,719617,PDN
ST221,,1993,1984,,231989,19456149,3693937,,116345,9683503,1839388,,115644,9772646,1854549,PDN
ST221,,1994,1984,,244799,20507998,3893909,,164695,14042670,2663391,,80104,6465328,1230518,PDN
ST221,,1995,1984,,324394,28256610,5352261,,201330,17908830,3387955,,123064,10347780,1964306,PDN
ST221,,1996,1984,,354808,30504494,5782654,,241914,21522039,4071458,,112894,8982455,1711196,PDN
ST221,,1997,1984,,477727,41394880,7843364,,271894,24414837,4616171,,205833,16980043,3227193,PDN
ST221,,1998,1984,,477727,41394880,7843364,,286177,26011511,4914560,,191550,15383369,2928804,PDN
ST221,,1999,1984,,344231,30255182,5727715,,296047,27277951,5149775,,48184,2977231,577940,PDN
ST221,,2000,1984,,296603,27333133,5160150,,296603,27333133,5160150,,0,0,0,PDN
ST221,,2001,1984,,296603,27333133,5160150,,296603,27333133,5160150,,0,0,0,PDN
ST221,,2002,1984,,296603,27333133,5160150,,296603,27333133,5160150,,0,0,0,PDN
ST221,,2003,1984,,296603,27333133,5160150,,296603,27333133,5160150,,0,0,0,PDN
ST221,,2004,1984,,296603,27333133,5160150,,296603,27333133,5160150,,0,0,0,PDN
ST221,,2005,1984,,296603,27333133,5160150,,296603,27333133,5160150,,0,0,0,PDN
ST221,,2006,1984,,296603,27333133,5160150,,296603,27333133,5160150,,0,0,0,PDN
ST221,,2007,1984,,296603,27333133,5160150,,296603,27333133,5160150,,0,0,0,PDN
ST221,,2008,1984,,296603,27333133,5160150,,296603,27333133,5160150,,0,0,0,PDN
ST221,,2009,1984,,296603,27844586,5251155,,296603,27844586,5251155,,0,0,0,PDN
ST221,,2010,1984,,296603,27844586,5251155,,296603,27844586,5251155,,0,0,0,PDN
ST221,,2011,1984,,296603,27844586,5251155,,296603,27844586,5251155,,0,0,0,PDN
ST221,,2012,1984,,296603,27844586,5251155,,296603,27844586,5251155,,0,0,0,PDN
ST221,,2013,1984,,296603,27844586,5251155,,296603,27844586,5251155,,0,0,0,PDN
ST221,,2014,1984,,296603,27844586,5251155,,296603,27844586,5251155,,0,0,0,PDN
ST221,,2015,1984,,296603,27844586,5251155,,296603,27844586,5251155,,0,0,0,PDN
ST221,,2016,1984,,296603,27844586,5251155,,296603,27844586,5251155,,0,0,0,PDN
ST221,,2017,1984,,296603,27844586,5251155,,296603,27844586,5251155,,0,0,0,PDN
ST221,,2017,1984,,296603,27844586,5251155,,296603,27844586,5251155,,0,0,0,PDN
ST223,,2006,2006,,1756177,15324400,4482939,,0,0,0,,1756177,15324400,4482939,PDN
ST223,,2007,2006,,1756177,15324400,4482939,,248376,1981625,600978,,1507801,13342775,3881961,PDN
ST223,,2008,2006,,1756177,15324400,4482939,,518875,4578985,1333641,,1237302,10745415,3149298,PDN
ST223,,2009,2006,,716968,6758595,1919565,,645619,6011759,1715327,,71349,746836,204238,PDN
ST223,,2010,2006,,716968,6758595,1919565,,704891,6634229,1885359,,12077,124366,34206,PDN
ST223,,2011,2006,,716968,6758595,1919565,,716968,6758595,1919565,,0,0,0,PDN
ST223,,2012,2006,,716968,6758595,1919565,,716968,6758595,1919565,,0,0,0,PDN
ST223,,2013,2006,,716968,6758595,1919565,,716968,6758595,1919565,,0,0,0,PDN
ST223,,2014,2006,,716968,6758595,1919565,,716968,6758595,1919565,,0,0,0,PDN
ST223,,2015,2006,,716968,6758595,1919565,,716968,6758595,1919565,,0,0,0,PDN
ST223,,2016,2006,,716968,6758595,1919565,,716968,6758595,1919565,,0,0,0,PDN
ST223,,2017,2006,,716968,6758595,1919565,,716968,6758595,1919565,,0,0,0,PDN
ST223,,2017,2006,,716968,6758595,1919565,,716968,6758595,1919565,,0,0,0,PDN
ST224,,1991,1990,,33099,3104659,585529,,0,0,0,,33099,3104659,585529,PDN
ST224,,1992,1990,,56268,5277921,995400,,25362,3025891,563777,,30906,2252030,431623,PDN
ST224,,1993,1990,,25362,3025891,563777,,25362,3025891,563777,,0,0,0,PDN
ST224,,1994,1990,,25362,3025891,563777,,25362,3025891,563777,,0,0,0,PDN
ST224,,1995,1990,,25362,3025891,563777,,25362,3025891,563777,,0,0,0,PDN
ST224,,1996,1990,,25362,3025891,563777,,25362,3025891,563777,,0,0,0,PDN
ST224,,1997,1990,,25362,3025891,563777,,25362,3025891,563777,,0,0,0,PDN
ST224,,1998,1990,,25362,3025891,563777,,25362,3025891,563777,,0,0,0,PDN
ST224,,1999,1990,,25362,3025891,563777,,25362,3025891,563777,,0,0,0,PDN
ST224,,2000,1990,,25362,3025891,563777,,25362,3025891,563777,,0,0,0,PDN
ST224,,2001,1990,,25362,3025891,563777,,25362,3025891,563777,,0,0,0,PDN
ST224,,2002,1990,,25362,3025891,563777,,25362,3025891,563777,,0,0,0,PDN
ST224,,2003,1990,,25362,3025891,563777,,25362,3025891,563777,,0,0,0,PDN
ST224,,2004,1990,,25362,3025891,563777,,25362,3025891,563777,,0,0,0,PDN
ST224,,2005,1990,,25362,3025891,563777,,25362,3025891,563777,,0,0,0,PDN
ST224,,2006,1990,,25362,3025891,563777,,25362,3025891,563777,,0,0,0,PDN
ST224,,2007,1990,,25362,3025891,563777,,25362,3025891,563777,,0,0,0,PDN
ST224,,2008,1990,,25362,3025891,563777,,25362,3025891,563777,,0,0,0,PDN
ST224,,2009,1990,,25362,3086490,574560,,25362,3086490,574560,,0,0,0,PDN
ST224,,2010,1990,,25362,3086490,574560,,25362,3086490,574560,,0,0,0,PDN
ST224,,2011,1990,,25362,3086490,574560,,25362,3086490,574560,,0,0,0,PDN
ST224,,2012,1990,,25362,3086490,574560,,25362,3086490,574560,,0,0,0,PDN
ST224,,2013,1990,,25362,3086490,574560,,25362,3086490,574560,,0,0,0,PDN
ST224,,2014,1990,,25362,3086490,574560,,25362,3086490,574560,,0,0,0,PDN
ST224,,2015,1990,,25362,3086490,574560,,25362,3086490,574560,,0,0,0,PDN
ST224,,2016,1990,,25362,3086490,574560,,25362,3086490,574560,,0,0,0,PDN
ST224,,2017,1990,,25362,3086490,574560,,25362,3086490,574560,,0,0,0,PDN
ST224,,2017,1990,,25362,3086490,574560,,25362,3086490,574560,,0,0,0,PDN
ST225,,1987,1985,,57830,4809425,913600,,0,0,0,,57830,4809425,913600,PDN
ST225,,1989,1985,,27736,10521513,1899891,,0,0,0,,27736,10521513,1899891,PDN
ST225,,1990,1985,,40464,16992184,3063984,,4079,5184728,926628,,36385,11807456,2137356,PDN
ST225,,1991,1985,,43159,22586555,4062119,,5159,10024778,1788927,,38000,12561777,2273192,PDN
ST225,,1992,1985,,43159,22586555,4062119,,6028,14506271,2587215,,37131,8080284,1474904,PDN
ST225,,1993,1985,,43159,54813263,9796409,,6818,18003462,3210281,,36341,36809801,6586128,PDN
ST225,,1994,1985,,43159,54813263,9796409,,7194,20558037,3665208,,35965,34255226,6131201,PDN
ST225,,1995,1985,,29077,30533748,5462128,,7387,21966641,3916042,,21690,8567107,1546086,PDN
ST225,,1996,1985,,29077,30533748,5462128,,7394,22587971,4026606,,21683,7945777,1435522,PDN
ST225,,1997,1985,,29077,30533748,5462128,,7394,23002696,4100400,,21683,7531052,1361728,PDN
ST225,,1998,1985,,29077,30533748,5462128,,7394,23147325,4126135,,21683,7386423,1335993,PDN
ST225,,1999,1985,,7420,23890005,4258311,,7394,23375271,4166695,,26,514734,91616,PDN
ST225,,2000,1985,,7433,23762003,4235547,,7433,23494902,4188021,,0,267101,47526,PDN
ST225,,2001,1985,,8505,27029551,4818034,,8154,25832236,4604637,,351,1197315,213397,PDN
ST225,,2002,1985,,8505,27029551,4818034,,8226,26109350,4654018,,279,920201,164016,PDN
ST225,,2003,1985,,8505,27029551,4818034,,8226,26109350,4654018,,279,920201,164016,PDN
ST225,,2004,1985,,8226,26109350,4654018,,8226,26109350,4654018,,0,0,0,PDN
ST225,,2005,1985,,8226,26109350,4654018,,8226,26109350,4654018,,0,0,0,PDN
ST225,,2006,1985,,8226,26109350,4654018,,8226,26109350,4654018,,0,0,0,PDN
ST225,,2007,1985,,8226,26109350,4654018,,8226,26109350,4654018,,0,0,0,PDN
ST225,,2008,1985,,8226,26109350,4654018,,8226,26109350,4654018,,0,0,0,PDN
ST225,,2009,1985,,8226,26570924,4736148,,8226,26570924,4736148,,0,0,0,PDN
ST225,,2010,1985,,8226,26570924,4736148,,8226,26570924,4736148,,0,0,0,PDN
ST225,,2011,1985,,8226,26570924,4736148,,8226,26570924,4736148,,0,0,0,PDN
ST225,,2012,1985,,8226,26570924,4736148,,8226,26570924,4736148,,0,0,0,PDN
ST225,,2013,1985,,8226,26570924,4736148,,8226,26570924,4736148,,0,0,0,PDN
ST225,,2014,1985,,8226,26570924,4736148,,8226,26570924,4736148,,0,0,0,PDN
ST225,,2015,1985,,8226,26570924,4736148,,8226,26570924,4736148,,0,0,0,PDN
ST225,,2016,1985,,8226,26570924,4736148,,8226,26570924,4736148,,0,0,0,PDN
ST225,,2017,1985,,8226,26570924,4736148,,8226,26570924,4736148,,0,0,0,PDN
ST225,,2017,1985,,8226,26570924,4736148,,8226,26570924,4736148,,0,0,0,PDN
ST228,,1995,1965,,4176312,61783695,15169852,,0,0,0,,4176312,61783695,15169852,PDP
ST228,,1996,1965,,5446833,56018744,15414581,,199233,3718902,860959,,5247600,52299842,14553622,PDP
ST228,,1997,1965,,2572295,61796426,13568100,,622363,13359961,2999580,,1949932,48436465,10568520,PDP
ST228,,1998,1965,,2572295,61796426,13568100,,831898,18129309,4057754,,1740397,43667117,9510346,PDP
ST228,,1999,1965,,2363544,57578210,12608777,,875380,19922968,4420392,,1488164,37655242,8188385,PDP
ST228,,2000,1965,,2363545,57587776,12610480,,1057072,23981536,5324249,,1306473,33606240,7286231,PDP
ST228,,2001,1965,,2341763,60130312,13041107,,1167286,24939052,5604840,,1174477,35191260,7436267,PDP
ST228,,2002,1965,,2341763,60130312,13041107,,1272702,25589053,5825914,,1069061,34541259,7215193,PDP
ST228,,2003,1965,,2341763,60130312,13041107,,1462935,26318908,6146015,,878828,33811404,6895092,PDP
ST228,,2004,1965,,3641816,61707281,14621759,,1563897,26432835,6267248,,2077919,35274446,8354511,PDP
ST228,,2005,1965,,3641357,57118949,13804871,,1793747,26935792,6586593,,1847610,30183157,7218278,PDP
ST228,,2006,1965,,4479196,43145556,12156341,,2111067,27670205,7034591,,2368129,15475351,5121750,PDP
ST228,,2007,1965,,4479196,43158287,12158606,,2382307,28025017,7368965,,2096889,15133270,4789641,PDP
ST228,,2008,1965,,5805865,43880864,13613848,,2738506,28403617,7792530,,3067359,15477247,5821318,PDP
ST228,,2009,1965,,4704018,30416720,10116246,,3160545,29139881,8345577,,1543473,1276839,1770669,PDP
ST228,,2010,1965,,4704018,30416720,10116246,,3504493,29412880,8738102,,1199525,1003840,1378144,PDP
ST228,,2011,1965,,4704018,30416720,10116246,,3774245,29637012,9047735,,929773,779708,1068511,PDP
ST228,,2012,1965,,4704018,30416720,10116246,,3994034,29787832,9294360,,709984,628888,821886,PDP
ST228,,2013,1965,,4704018,30416720,10116246,,4205355,30027455,9548319,,498663,389265,567927,PDP
ST228,,2014,1965,,5828249,73004682,18818407,,4399691,30263357,9784631,,1428558,42741325,9033777,PDP
ST228,,2015,1965,,6071398,73099463,19078421,,4896536,43290499,12599472,,1174862,29808964,6478949,PDP
ST228,,2016,1965,,6071398,73099463,19078421,,5357460,56674325,15441860,,713938,16425138,3636560,PDP
ST228,,2017,1965,,6788469,97689681,24170974,,5811335,69632211,18201409,,977134,28057470,5969565,PDP
ST228,,2017,1965,,6788469,97689681,24170974,,5811335,69632211,18201409,,977134,28057470,5969565,PDP
ST235,,1999,1999,,2251,22508279,4007283,,0,177862,31648,,2251,22330417,3975635,PDN
ST235,,2000,1999,,2251,22508279,4007283,,532,7375417,1312884,,1719,15132862,2694399,PDN
ST235,,2001,1999,,2251,22508279,4007283,,862,12136463,2160375,,1389,10371816,1846908,PDN
ST235,,2002,1999,,2251,22508279,4007283,,1029,14732873,2622537,,1222,7775406,1384746,PDN
ST235,,2003,1999,,2251,22508279,4007283,,1057,15651596,2786038,,1194,6856683,1221245,PDN
ST235,,2004,1999,,2251,22508279,4007283,,1107,16071706,2860841,,1144,6436573,1146442,PDN
ST235,,2005,1999,,9647,23987518,4277889,,6908,17121037,3053356,,2739,6866481,1224533,PDN
ST235,,2006,1999,,7203,17214159,3070221,,7203,17214159,3070221,,0,0,0,PDN
ST235,,2007,1999,,7203,17214159,3070221,,7203,17214159,3070221,,0,0,0,PDN
ST235,,2008,1999,,7203,17214159,3070221,,7203,17214159,3070221,,0,0,0,PDN
ST235,,2009,1999,,7203,17214159,3070221,,7203,17214159,3070221,,0,0,0,PDN
ST235,,2010,1999,,7203,17214159,3070221,,7203,17214159,3070221,,0,0,0,PDN
ST235,,2011,1999,,7203,17214159,3070221,,7203,17214159,3070221,,0,0,0,PDN
ST235,,2012,1999,,7203,17214159,3070221,,7203,17214159,3070221,,0,0,0,PDN
ST235,,2013,1999,,7203,17214159,3070221,,7203,17214159,3070221,,0,0,0,PDN
ST235,,2014,1999,,7203,17214159,3070221,,7203,17214159,3070221,,0,0,0,PDN
ST235,,2015,1999,,7203,17214159,3070221,,7203,17214159,3070221,,0,0,0,PDN
ST235,,2016,1999,,7203,17214159,3070221,,7203,17214159,3070221,,0,0,0,PDN
ST235,,2017,1999,,7203,17214159,3070221,,7203,17214159,3070221,,0,0,0,PDN
ST235,,2017,1999,,7203,17214159,3070221,,7203,17214159,3070221,,0,0,0,PDN
ST241,,1995,1995,,340,339987,60836,,0,0,0,,340,339987,60836,PDN
ST241,,1996,1995,,11,1241219,220868,,11,1240125,220674,,0,1094,194,PDN
ST241,,1997,1995,,11,1241219,220868,,11,1241219,220868,,0,0,0,PDN
ST241,,1998,1995,,11,1241219,220868,,11,1241219,220868,,0,0,0,PDN
ST241,,1999,1995,,11,1241219,220868,,11,1241219,220868,,0,0,0,PDN
ST241,,2000,1995,,11,1241219,220868,,11,1241219,220868,,0,0,0,PDN
ST241,,2001,1995,,11,1241219,220868,,11,1241219,220868,,0,0,0,PDN
ST241,,2002,1995,,11,1241219,220868,,11,1241219,220868,,0,0,0,PDN
ST241,,2003,1995,,11,1241219,220868,,11,1241219,220868,,0,0,0,PDN
ST241,,2004,1995,,11,1241219,220868,,11,1241219,220868,,0,0,0,PDN
ST241,,2005,1995,,11,1241219,220868,,11,1241219,220868,,0,0,0,PDN
ST241,,2006,1995,,11,1241219,220868,,11,1241219,220868,,0,0,0,PDN
ST241,,2007,1995,,11,1241219,220868,,11,1241219,220868,,0,0,0,PDN
ST241,,2008,1995,,11,1241219,220868,,11,1241219,220868,,0,0,0,PDN
ST241,,2009,1995,,11,1266077,225292,,11,1266077,225292,,0,0,0,PDN
ST241,,2010,1995,,11,1266077,225292,,11,1266077,225292,,0,0,0,PDN
ST241,,2011,1995,,11,1266077,225292,,11,1266077,225292,,0,0,0,PDN
ST241,,2012,1995,,11,1266077,225292,,11,1266077,225292,,0,0,0,PDN
ST241,,2013,1995,,11,1266077,225292,,11,1266077,225292,,0,0,0,PDN
ST241,,2014,1995,,11,1266077,225292,,11,1266077,225292,,0,0,0,PDN
ST241,,2015,1995,,11,1266077,225292,,11,1266077,225292,,0,0,0,PDN
ST241,,2016,1995,,11,1266077,225292,,11,1266077,225292,,0,0,0,PDN
ST241,,2017,1995,,11,1266077,225292,,11,1266077,225292,,0,0,0,PDN
ST241,,2017,1995,,11,1266077,225292,,11,1266077,225292,,0,0,0,PDN
ST242,,1987,1985,,569,5691293,1013255,,0,0,0,,569,5691293,1013255,PDP
ST242,,2005,1985,,220634,18970299,3596132,,0,0,0,,220634,18970299,3596132,PDP
ST242,,2006,1985,,224752,29153649,5412234,,769,2127233,379280,,223983,27026416,5032954,PDP
ST242,,2007,1985,,4118,10183350,1816102,,1854,4491031,800970,,2264,5692319,1015132,PDP
ST242,,2008,1985,,4118,10183350,1816102,,1854,4757599,848402,,2264,5425751,967700,PDP
ST242,,2009,1985,,4200,10385885,1852222,,1912,4915096,876484,,2288,5470789,975738,PDP
ST242,,2010,1985,,4200,10385885,1852222,,1935,5089503,907541,,2265,5296382,944682,PDP
ST242,,2011,1985,,4200,10385885,1852222,,1953,5273434,940286,,2247,5112451,911936,PDP
ST242,,2012,1985,,2156,6303634,1123799,,2041,5424885,967323,,115,878749,156476,PDP
ST242,,2013,1985,,2156,6303634,1123799,,2056,5569040,992988,,100,734594,130811,PDP
ST242,,2014,1985,,2156,6303634,1123799,,2056,5627654,1003418,,100,675980,120381,PDP
ST242,,2015,1985,,2156,6303634,1123799,,2056,5737506,1022965,,100,566128,100835,PDP
ST242,,2016,1985,,2156,6303634,1123799,,2058,5825247,1038579,,98,478387,85220,PDP
ST242,,2017,1985,,2156,6303634,1123799,,2058,5887787,1049707,,98,415847,74092,PDP
ST242,,2017,1985,,2156,6303634,1123799,,2058,5887787,1049707,,98,415847,74092,PDP
ST245,,1986,1966,,473072,39342599,7473534,,0,0,0,,473072,39342599,7473534,PDN
ST245,,1987,1966,,473072,39342599,7473534,,0,0,0,,473072,39342599,7473534,PDN
ST245,,1988,1966,,1016222,87375710,16563501,,65208,1242178,286236,,951014,86133532,16277265,PDN
ST245,,1989,1966,,1016222,87375710,16563501,,164856,4062623,887743,,851366,83313087,15675758,PDN
ST245,,1990,1966,,1016222,87375710,16563501,,202229,5072303,1104774,,813993,82303407,15458727,PDN
ST245,,1991,1966,,1484252,100111610,19297706,,252199,6351516,1382362,,1232053,93760094,17915344,PDN
ST245,,1992,1966,,1535980,40087146,8668924,,536765,14105448,3046631,,999215,25981698,5622293,PDN
ST245,,1993,1966,,1602875,41805680,9041608,,677520,18021362,3884168,,925355,23784318,5157440,PDN
ST245,,1994,1966,,1602875,41805680,9041608,,723084,19473376,4188098,,879791,22332304,4853510,PDN
ST245,,1995,1966,,1594446,40382306,8779910,,747101,20295804,4358454,,847345,20086502,4421456,PDN
ST245,,1996,1966,,1594446,40382306,8779910,,762009,21002394,4499090,,832437,19379912,4280820,PDN
ST245,,1997,1966,,1594446,40382306,8779910,,780718,21579338,4620458,,813728,18802968,4159452,PDN
ST245,,1998,1966,,2305378,60146662,13007631,,797144,22088596,4727499,,1508234,38058066,8280132,PDN
ST245,,1999,1966,,1080350,30479255,6503705,,811999,22640039,4840476,,268351,7839216,1663229,PDN
ST245,,2000,1966,,1387624,38668149,8268078,,830086,23297205,4975496,,557538,15370944,3292582,PDN
ST245,,2001,1966,,1390570,40999038,8685773,,840659,23835530,5081857,,549911,17163508,3603916,PDN
ST245,,2002,1966,,1446594,42486988,9006556,,851792,24335890,5182022,,594802,18151098,3824534,PDN
ST245,,2003,1966,,1446594,42486988,9006556,,857892,24629225,5240316,,588702,17857763,3766240,PDN
ST245,,2004,1966,,1295125,37140628,7903778,,866420,24969606,5309410,,428705,12171022,2594368,PDN
ST245,,2005,1966,,1251723,35773463,7617108,,872878,25217576,5359991,,378845,10555887,2257117,PDN
ST245,,2006,1966,,1251723,35773463,7617108,,878062,25436263,5404087,,373661,10337200,2213021,PDN
ST245,,2007,1966,,925305,27077249,5743321,,881167,25558028,5428859,,44138,1519221,314462,PDN
ST245,,2008,1966,,881842,25810024,5474373,,881842,25810024,5474373,,0,0,0,PDN
ST245,,2009,1966,,881842,26249558,5552582,,881842,26249558,5552582,,0,0,0,PDN
ST245,,2010,1966,,881842,26249558,5552582,,881842,26249558,5552582,,0,0,0,PDN
ST245,,2011,1966,,881842,26249558,5552582,,881842,26249558,5552582,,0,0,0,PDN
ST245,,2012,1966,,881842,26249558,5552582,,881842,26249558,5552582,,0,0,0,PDN
ST245,,2013,1966,,881842,26249558,5552582,,881842,26249558,5552582,,0,0,0,PDN
ST245,,2014,1966,,881842,26249558,5552582,,881842,26249558,5552582,,0,0,0,PDN
ST245,,2015,1966,,881842,26249558,5552582,,881842,26249558,5552582,,0,0,0,PDN
ST245,,2016,1966,,881842,26249558,5552582,,881842,26249558,5552582,,0,0,0,PDN
ST245,,2017,1966,,881842,26249558,5552582,,881842,26249558,5552582,,0,0,0,PDN
ST245,,2017,1966,,881842,26249558,5552582,,881842,26249558,5552582,,0,0,0,PDN
ST248,,2001,2002,,363,3241798,577195,,0,0,0,,363,3241798,577195,PDN
ST248,,2002,2002,,363,3241798,577195,,52,1067718,190037,,311,2174080,387158,PDN
ST248,,2003,2002,,363,3241798,577195,,363,3241798,577195,,0,0,0,PDN
ST248,,2004,2002,,363,3241798,577195,,363,3241798,577195,,0,0,0,PDN
ST248,,2005,2002,,363,3241798,577195,,363,3241798,577195,,0,0,0,PDN
ST248,,2006,2002,,363,3241798,577195,,363,3241798,577195,,0,0,0,PDN
ST248,,2007,2002,,363,3241798,577195,,363,3241798,577195,,0,0,0,PDN
ST248,,2008,2002,,363,3241798,577195,,363,3241798,577195,,0,0,0,PDN
ST248,,2009,2002,,363,3241798,577195,,363,3241798,577195,,0,0,0,PDN
ST248,,2010,2002,,363,3241798,577195,,363,3241798,577195,,0,0,0,PDN
ST248,,2011,2002,,363,3241798,577195,,363,3241798,577195,,0,0,0,PDN
ST248,,2012,2002,,363,3241798,577195,,363,3241798,577195,,0,0,0,PDN
ST248,,2013,2002,,363,3241798,577195,,363,3241798,577195,,0,0,0,PDN
ST248,,2014,2002,,363,3241798,577195,,363,3241798,577195,,0,0,0,PDN
ST248,,2015,2002,,363,3241798,577195,,363,3241798,577195,,0,0,0,PDN
ST248,,2016,2002,,363,3241798,577195,,363,3241798,577195,,0,0,0,PDN
ST248,,2017,2002,,363,3241798,577195,,363,3241798,577195,,0,0,0,PDN
ST248,,2017,2002,,363,3241798,577195,,363,3241798,577195,,0,0,0,PDN
ST250,,2000,2000,,619,2838112,505621,,0,0,0,,619,2838112,505621,PDN
ST250,,2001,2000,,619,2838112,505621,,405,2262437,402974,,214,575675,102647,PDN
ST250,,2002,2000,,1228,5629377,1002897,,538,3540723,630560,,690,2088654,372337,PDN
ST250,,2003,2000,,1228,5629377,1002897,,717,4281818,762606,,511,1347559,240291,PDN
ST250,,2004,2000,,1228,5629377,1002897,,919,4562437,812741,,309,1066940,190156,PDN
ST250,,2005,2000,,1228,5629377,1002897,,927,5555338,989421,,301,74039,13476,PDN
ST250,,2006,2000,,927,6149341,1095116,,927,6149341,1095116,,0,0,0,PDN
ST250,,2007,2000,,927,6149444,1095134,,927,6149444,1095134,,0,0,0,PDN
ST250,,2008,2000,,927,6149444,1095134,,927,6149444,1095134,,0,0,0,PDN
ST250,,2009,2000,,927,6149444,1095134,,927,6149444,1095134,,0,0,0,PDN
ST250,,2010,2000,,927,6149444,1095134,,927,6149444,1095134,,0,0,0,PDN
ST250,,2011,2000,,927,6149444,1095134,,927,6149444,1095134,,0,0,0,PDN
ST250,,2012,2000,,927,6149444,1095134,,927,6149444,1095134,,0,0,0,PDN
ST250,,2013,2000,,927,6149444,1095134,,927,6149444,1095134,,0,0,0,PDN
ST250,,2014,2000,,927,6149444,1095134,,927,6149444,1095134,,0,0,0,PDN
ST250,,2015,2000,,927,6149444,1095134,,927,6149444,1095134,,0,0,0,PDN
ST250,,2016,2000,,927,6149444,1095134,,927,6149444,1095134,,0,0,0,PDN
ST250,,2017,2000,,927,6149444,1095134,,927,6149444,1095134,,0,0,0,PDN
ST250,,2017,2000,,927,6149444,1095134,,927,6149444,1095134,,0,0,0,PDN
ST254,,2004,2004,,32518,3251830,611135,,0,0,0,,32518,3251830,611135,PDN
ST254,,2005,2004,,60240,4304000,826076,,3927,1084022,196813,,56313,3219978,629263,PDN
ST254,,2006,2004,,60881,5430803,1027216,,8770,1885299,344232,,52111,3545504,682984,PDN
ST254,,2007,2004,,60881,5430803,1027216,,20659,2185007,409450,,40222,3245796,617766,PDN
ST254,,2008,2004,,199451,5430803,1165786,,21787,2201150,413451,,177664,3229653,752335,PDN
ST254,,2009,2004,,57878,2435023,491157,,51877,2375081,474489,,6001,59942,16666,PDN
ST254,,2010,2004,,57878,2435023,491157,,57878,2435023,491157,,0,0,0,PDN
ST254,,2011,2004,,57878,2435023,491157,,57878,2435023,491157,,0,0,0,PDN
ST254,,2012,2004,,57878,2435023,491157,,57878,2435023,491157,,0,0,0,PDN
ST254,,2013,2004,,57878,2435023,491157,,57878,2435023,491157,,0,0,0,PDN
ST254,,2014,2004,,57878,2435023,491157,,57878,2435023,491157,,0,0,0,PDN
ST254,,2015,2004,,57878,2435023,491157,,57878,2435023,491157,,0,0,0,PDN
ST254,,2016,2004,,57878,2435023,491157,,57878,2435023,491157,,0,0,0,PDN
ST254,,2017,2004,,57878,2435023,491157,,57878,2435023,491157,,0,0,0,PDN
ST254,,2017,2004,,57878,2435023,491157,,57878,2435023,491157,,0,0,0,PDN
ST260,,1995,1986,,10251188,16401901,13169676,,0,0,0,,10251188,16401901,13169676,PDN
ST260,,1996,1986,,10251188,16401901,13169676,,0,0,0,,10251188,16401901,13169676,PDN
ST260,,1997,1986,,11314547,22200269,15264773,,54203,1647958,347434,,11260344,20552311,14917339,PDN
ST260,,1998,1986,,11314547,22200269,15264773,,102239,3363392,700707,,11212308,18836877,14564066,PDN
ST260,,1999,1986,,11278700,24197398,15584287,,132700,4581893,947983,,11146000,19615505,14636304,PDN
ST260,,2000,1986,,11480902,28740285,16594832,,219202,6509522,1377480,,11261700,22230763,15217352,PDN
ST260,,2001,1986,,11480902,28740286,16594832,,308958,8619613,1842697,,11171944,20120673,14752135,PDN
ST260,,2002,1986,,11745862,31331732,17320904,,415490,10548915,2292521,,11330372,20782817,15028383,PDN
ST260,,2003,1986,,11745862,31331732,17320904,,541982,12289090,2728653,,11203880,19042642,14592251,PDN
ST260,,2004,1986,,11773753,33817309,17791068,,627970,13794928,3082584,,11145783,20022381,14708484,PDN
ST260,,2005,1986,,11939796,34500975,18078760,,667406,14572064,3260300,,11272390,19928911,14818460,PDN
ST260,,2006,1986,,11939796,34500975,18078760,,698304,15179079,3399208,,11241492,19321896,14679552,PDN
ST260,,2007,1986,,847912,16753961,3829044,,722356,15555504,3490239,,125556,1198457,338805,PDN
ST260,,2008,1986,,843119,16526716,3783816,,737068,15783901,3545591,,106051,742815,238225,PDN
ST260,,2009,1986,,785548,16444042,3711534,,758303,16131166,3628617,,27245,312876,82917,PDN
ST260,,2010,1986,,785548,16444042,3711534,,780233,16388916,3696410,,5315,55126,15124,PDN
ST260,,2011,1986,,785548,16444042,3711534,,785548,16444042,3711534,,0,0,0,PDN
ST260,,2012,1986,,785548,16444042,3711534,,785548,16444042,3711534,,0,0,0,PDN
ST260,,2013,1986,,785548,16444042,3711534,,785548,16444042,3711534,,0,0,0,PDN
ST260,,2014,1986,,785548,16444042,3711534,,785548,16444042,3711534,,0,0,0,PDN
ST260,,2015,1986,,785548,16444042,3711534,,785548,16444042,3711534,,0,0,0,PDN
ST260,,2016,1986,,785548,16444042,3711534,,785548,16444042,3711534,,0,0,0,PDN
ST260,,2017,1986,,785548,16444042,3711534,,785548,16444042,3711534,,0,0,0,PDN
ST260,,2017,1986,,785548,16444042,3711534,,785548,16444042,3711534,,0,0,0,PDN
ST264,,1985,1983,,53313,3227769,627649,,0,0,0,,53313,3227769,627649,PDN
ST264,,1986,1983,,53313,3227769,627649,,0,0,0,,53313,3227769,627649,PDN
ST264,,1987,1983,,53313,3227769,627649,,0,0,0,,53313,3227769,627649,PDN
ST264,,1995,1983,,504147,87854549,16136629,,2355,116900,23156,,501792,87737649,16113473,PDN
ST264,,1996,1983,,1093953,79358117,15214614,,209135,9143852,1836155,,884818,70214265,13378459,PDN
ST264,,1997,1983,,942892,63007235,12154144,,333399,14984391,2999661,,609493,48022844,9154483,PDN
ST264,,1998,1983,,942892,63007235,12154144,,346848,17838755,3521004,,596044,45168480,8633140,PDN
ST264,,1999,1983,,491862,47619294,8965046,,352183,19782613,3872221,,139679,27836681,5092825,PDN
ST264,,2000,1983,,727742,58246905,11091960,,359510,21124048,4118237,,368232,37122857,6973723,PDN
ST264,,2001,1983,,1238437,69104368,13534588,,541748,23595557,4740246,,696689,45508811,8794342,PDN
ST264,,2002,1983,,1237040,48461840,9860143,,724224,26549676,5448366,,512816,21912164,4411777,PDN
ST264,,2003,1983,,1228105,44719417,9185297,,752270,28462894,5816842,,475835,16256523,3368455,PDN
ST264,,2004,1983,,1001143,31016531,6520099,,838787,29467666,6082144,,162356,1548865,437955,PDN
ST264,,2005,1983,,1001143,31016531,6520099,,876660,29780144,6175618,,124483,1236387,344481,PDN
ST264,,2006,1983,,1001554,31100781,6535501,,927688,30166392,6295373,,73866,934389,240128,PDN
ST264,,2007,1983,,1001554,31100781,6535501,,967803,30539984,6401964,,33751,560797,133537,PDN
ST264,,2008,1983,,1085536,32227550,6819976,,990028,30755572,6462550,,95508,1471978,357426,PDN
ST264,,2009,1983,,1032298,31647368,6663501,,1014690,31393332,6600691,,17608,254036,62810,PDN
ST264,,2010,1983,,1032298,31647368,6663501,,1032298,31647368,6663501,,0,0,0,PDN
ST264,,2011,1983,,1032298,31647368,6663501,,1032298,31647368,6663501,,0,0,0,PDN
ST264,,2012,1983,,1032298,31647368,6663501,,1032298,31647368,6663501,,0,0,0,PDN
ST264,,2013,1983,,1032298,31647368,6663501,,1032298,31647368,6663501,,0,0,0,PDN
ST264,,2014,1983,,1032298,31647368,6663501,,1032298,31647368,6663501,,0,0,0,PDN
ST264,,2015,1983,,1032298,31647368,6663501,,1032298,31647368,6663501,,0,0,0,PDN
ST264,,2016,1983,,1032298,31647368,6663501,,1032298,31647368,6663501,,0,0,0,PDN
ST264,,2017,1983,,1032298,31647368,6663501,,1032298,31647368,6663501,,0,0,0,PDN
ST264,,2017,1983,,1032298,31647368,6663501,,1032298,31647368,6663501,,0,0,0,PDN
ST265,,1996,1988,,3354981,67864898,15430586,,817355,15181782,3518740,,2537626,52683116,11911846,PDN
ST265,,1997,1988,,5554710,105143390,24263498,,1781120,29929024,7106569,,3773590,75214366,17156929,PDN
ST265,,1998,1988,,5554710,105143390,24263498,,2233818,35558392,8560934,,3320892,69584998,15702564,PDN
ST265,,1999,1988,,3586614,62274733,14667527,,2264143,38283913,9076227,,1322471,23990820,5591300,PDN
ST265,,2000,1988,,4232578,63073214,15455570,,2281399,41577566,9679542,,1951179,21495648,5776028,PDN
ST265,,2001,1988,,3448536,63117476,14679404,,2385790,45694642,10516509,,1062746,17422834,4162895,PDN
ST265,,2002,1988,,3448536,63117476,14679404,,2458292,48494459,11087199,,990244,14623017,3592205,PDN
ST265,,2003,1988,,3564031,62280823,14646028,,2498614,50144126,11421056,,1065417,12136697,3224972,PDN
ST265,,2004,1988,,2569460,51526686,11737909,,2522068,50784018,11558370,,47392,742668,179539,PDN
ST265,,2005,1988,,2569460,51526686,11737909,,2532576,50996356,11606661,,36884,530330,131248,PDN
ST265,,2006,1988,,2569460,51526746,11737920,,2538662,51059416,11623967,,30798,467330,113953,PDN
ST265,,2007,1988,,2569460,51820241,11790143,,2545500,51141546,11645419,,23960,678695,144724,PDN
ST265,,2008,1988,,2589375,52677613,11962616,,2559879,52079274,11826654,,29496,598339,135962,PDN
ST265,,2009,1988,,2561625,52798818,11956432,,2561624,52798812,11956430,,1,6,2,PDN
ST265,,2010,1988,,2561625,52798818,11956432,,2561625,52798818,11956432,,0,0,0,PDN
ST265,,2011,1988,,2561625,52798818,11956432,,2561625,52798818,11956432,,0,0,0,PDN
ST265,,2012,1988,,2561625,52798818,11956432,,2561625,52798818,11956432,,0,0,0,PDN
ST265,,2013,1988,,2561625,52798818,11956432,,2561625,52798818,11956432,,0,0,0,PDN
ST265,,2014,1988,,2561625,52798818,11956432,,2561625,52798818,11956432,,0,0,0,PDN
ST265,,2015,1988,,2561625,52798818,11956432,,2561625,52798818,11956432,,0,0,0,PDN
ST265,,2016,1988,,2561625,52798818,11956432,,2561625,52798818,11956432,,0,0,0,PDN
ST265,,2017,1988,,2561625,52798818,11956432,,2561625,52798818,11956432,,0,0,0,PDN
ST265,,2017,1988,,2561625,52798818,11956432,,2561625,52798818,11956432,,0,0,0,PDN
ST274,,2001,2001,,496156,9809248,2241574,,0,0,0,,496156,9809248,2241574,PDN
ST274,,2002,2001,,496156,9809248,2241574,,202167,6166674,1299440,,293989,3642574,942134,PDN
ST274,,2003,2001,,589447,21782003,4465248,,318134,10881937,2254422,,271313,10900066,2210826,PDN
ST274,,2004,2001,,589447,21782003,4465248,,356358,12285464,2542384,,233089,9496539,1922864,PDN
ST274,,2005,2001,,589447,21782003,4465248,,382780,13061243,2706845,,206667,8720760,1758403,PDN
ST274,,2006,2001,,589447,21782003,4465248,,402775,13601505,2822972,,186672,8180498,1642276,PDN
ST274,,2007,2001,,589447,21782003,4465248,,416413,13902672,2890198,,173034,7879331,1575050,PDN
ST274,,2008,2001,,589447,21782003,4465248,,421836,13959666,2905762,,167611,7822337,1559486,PDN
ST274,,2009,2001,,430272,14039549,2928412,,425756,14000672,2916979,,4516,38877,11434,PDN
ST274,,2010,2001,,430272,14039549,2928412,,430272,14039549,2928412,,0,0,0,PDN
ST274,,2011,2001,,430272,14039549,2928412,,430272,14039549,2928412,,0,0,0,PDN
ST274,,2012,2001,,430272,14039549,2928412,,430272,14039549,2928412,,0,0,0,PDN
ST274,,2013,2001,,430272,14039549,2928412,,430272,14039549,2928412,,0,0,0,PDN
ST274,,2014,2001,,430272,14039549,2928412,,430272,14039549,2928412,,0,0,0,PDN
ST274,,2015,2001,,430272,14039549,2928412,,430272,14039549,2928412,,0,0,0,PDN
ST274,,2016,2001,,430272,14039549,2928412,,430272,14039549,2928412,,0,0,0,PDN
ST274,,2017,2001,,430272,14039549,2928412,,430272,14039549,2928412,,0,0,0,PDN
ST274,,2017,2001,,430272,14039549,2928412,,430272,14039549,2928412,,0,0,0,PDN
ST277,,1994,1992,,517304,22244075,4475324,,1610,69264,13935,,515694,22174811,4461389,PDN
ST277,,1995,1992,,447532,22278139,4411614,,106362,5130626,1019285,,341170,17147513,3392329,PDN
ST277,,1996,1992,,447532,22278139,4411614,,135300,7701726,1505714,,312232,14576413,2905900,PDN
ST277,,1997,1992,,447532,22278139,4411614,,161578,9181498,1795297,,285954,13096641,2616317,PDN
ST277,,1998,1992,,447532,22278139,4411614,,179489,10247300,2002852,,268043,12030839,2408762,PDN
ST277,,1999,1992,,203513,11653180,2277033,,189450,10587316,2073314,,14063,1065864,203719,PDN
ST277,,2000,1992,,203513,11653180,2277033,,191946,10728575,2100945,,11567,924605,176088,PDN
ST277,,2001,1992,,203513,11653180,2277033,,201572,11091996,2175237,,1941,561184,101796,PDN
ST277,,2002,1992,,213124,11653180,2286644,,207063,11351317,2226870,,6061,301863,59774,PDN
ST277,,2003,1992,,213124,11653180,2286644,,210736,11512473,2259219,,2388,140707,27425,PDN
ST277,,2004,1992,,226454,12681402,2482931,,213985,11689317,2293935,,12469,992085,188996,PDN
ST277,,2005,1992,,226454,12681402,2482931,,218082,11859397,2328295,,8372,822005,154636,PDN
ST277,,2006,1992,,220069,12029824,2360607,,220069,12029824,2360607,,0,0,0,PDN
ST277,,2007,1992,,220069,12029824,2360607,,220069,12029824,2360607,,0,0,0,PDN
ST277,,2008,1992,,220069,12029824,2360607,,220069,12029824,2360607,,0,0,0,PDN
ST277,,2009,1992,,220069,12226850,2395665,,220069,12226850,2395665,,0,0,0,PDN
ST277,,2010,1992,,220069,12226850,2395665,,220069,12226850,2395665,,0,0,0,PDN
ST277,,2011,1992,,220069,12226850,2395665,,220069,12226850,2395665,,0,0,0,PDN
ST277,,2012,1992,,220069,12226850,2395665,,220069,12226850,2395665,,0,0,0,PDN
ST277,,2013,1992,,220069,12226850,2395665,,220069,12226850,2395665,,0,0,0,PDN
ST277,,2014,1992,,220069,12226850,2395665,,220069,12226850,2395665,,0,0,0,PDN
ST277,,2015,1992,,220069,12226850,2395665,,220069,12226850,2395665,,0,0,0,PDN
ST277,,2016,1992,,220069,12226850,2395665,,220069,12226850,2395665,,0,0,0,PDN
ST277,,2017,1992,,220069,12226850,2395665,,220069,12226850,2395665,,0,0,0,PDN
ST277,,2017,1992,,220069,12226850,2395665,,220069,12226850,2395665,,0,0,0,PDN
ST287,,1998,1985,,12793,3837770,695670,,0,0,0,,12793,3837770,695670,PDP
ST287,,1999,1985,,12793,3837770,695670,,0,0,0,,12793,3837770,695670,PDP
ST287,,2007,1985,,12596,3778827,684985,,0,0,0,,12596,3778827,684985,PDP
ST287,,2008,1985,,12596,3778827,684985,,0,0,0,,12596,3778827,684985,PDP
ST287,,2009,1985,,1892472,11765498,3985977,,303429,1799545,623633,,1589043,9965953,3362344,PDP
ST287,,2010,1985,,1892472,11765498,3985977,,551117,3385959,1153601,,1341355,8379539,2832376,PDP
ST287,,2011,1985,,1892472,11765498,3985977,,624704,3865068,1312439,,1267768,7900430,2673538,PDP
ST287,,2012,1985,,856187,5463329,1828310,,661697,4102506,1391680,,194490,1360823,436629,PDP
ST287,,2013,1985,,856187,5463329,1828310,,706956,4440703,1497117,,149231,1022626,331193,PDP
ST287,,2014,1985,,856187,5463329,1828310,,730736,4620638,1552914,,125451,842691,275396,PDP
ST287,,2015,1985,,856187,5463329,1828310,,753338,4817084,1610470,,102849,646245,217839,PDP
ST287,,2016,1985,,856187,5463329,1828310,,783176,5072335,1685727,,73011,390994,142583,PDP
ST287,,2017,1985,,856187,5463329,1828310,,794644,5194383,1718911,,61543,268946,109398,PDP
ST287,,2017,1985,,856187,5463329,1828310,,794644,5194383,1718911,,61543,268946,109398,PDP
ST288,,2006,2006,,37909,1412394,289225,,0,0,0,,37909,1412394,289225,PDN
ST288,,2007,2006,,43273,1630999,333486,,42708,1312317,276216,,565,318682,57270,PDN
ST288,,2008,2006,,43120,1437939,298981,,43078,1416659,295153,,42,21280,3828,PDN
ST288,,2009,2006,,43120,1437939,298981,,43120,1437939,298981,,0,0,0,PDN
ST288,,2010,2006,,43120,1437939,298981,,43120,1437939,298981,,0,0,0,PDN
ST288,,2011,2006,,43120,1437939,298981,,43120,1437939,298981,,0,0,0,PDN
ST288,,2012,2006,,43120,1437939,298981,,43120,1437939,298981,,0,0,0,PDN
ST288,,2013,2006,,43120,1437939,298981,,43120,1437939,298981,,0,0,0,PDN
ST288,,2014,2006,,43120,1437939,298981,,43120,1437939,298981,,0,0,0,PDN
ST288,,2015,2006,,43120,1437939,298981,,43120,1437939,298981,,0,0,0,PDN
ST288,,2016,2006,,43120,1437939,298981,,43120,1437939,298981,,0,0,0,PDN
ST288,,2017,2006,,43120,1437939,298981,,43120,1437939,298981,,0,0,0,PDN
ST288,,2017,2006,,43120,1437939,298981,,43120,1437939,298981,,0,0,0,PDN
ST290,,1993,1986,,969149,1410112,1220059,,0,0,0,,969149,1410112,1220059,PDN
ST290,,1997,1986,,8832,8832296,1580415,,0,0,0,,8832,8832296,1580415,PDN
ST290,,1998,1986,,8832,8832296,1580415,,0,0,0,,8832,8832296,1580415,PDN
ST290,,1999,1986,,378138,18393681,3651035,,90346,3917849,787472,,287792,14475832,2863563,PDN
ST290,,2000,1986,,423251,20261637,4028524,,135634,6632051,1315714,,287617,13629586,2712810,PDN
ST290,,2001,1986,,423251,20261637,4028524,,262697,11990958,2396319,,160554,8270679,1632205,PDN
ST290,,2002,1986,,590430,27183797,5427404,,320559,14822486,2958012,,269871,12361311,2469392,PDN
ST290,,2003,1986,,590430,27183797,5427404,,364443,17236630,3431459,,225987,9947167,1995945,PDN
ST290,,2004,1986,,590430,27183797,5427404,,390859,19191794,3805769,,199571,7992003,1621635,PDN
ST290,,2005,1986,,590430,27183797,5427404,,406157,21172286,4173468,,184273,6011511,1253936,PDN
ST290,,2006,1986,,590430,27183797,5427404,,416407,22069437,4343353,,174023,5114360,1084051,PDN
ST290,,2007,1986,,521497,27800881,5468273,,422238,22572787,4438748,,99259,5228094,1029525,PDN
ST290,,2008,1986,,521497,27800881,5468273,,424179,22703041,4463866,,97318,5097840,1004407,PDN
ST290,,2009,1986,,424422,22704343,4464340,,424422,22704343,4464340,,0,0,0,PDN
ST290,,2010,1986,,424422,22704343,4464340,,424422,22704343,4464340,,0,0,0,PDN
ST290,,2011,1986,,424422,22704343,4464340,,424422,22704343,4464340,,0,0,0,PDN
ST290,,2012,1986,,424422,22704343,4464340,,424422,22704343,4464340,,0,0,0,PDN
ST290,,2013,1986,,424422,22704343,4464340,,424422,22704343,4464340,,0,0,0,PDN
ST290,,2014,1986,,424422,22704343,4464340,,424422,22704343,4464340,,0,0,0,PDN
ST290,,2015,1986,,424422,22704343,4464340,,424422,22704343,4464340,,0,0,0,PDN
ST290,,2016,1986,,424422,22704343,4464340,,424422,22704343,4464340,,0,0,0,PDN
ST290,,2017,1986,,424422,22704343,4464340,,424422,22704343,4464340,,0,0,0,PDN
ST290,,2017,1986,,424422,22704343,4464340,,424422,22704343,4464340,,0,0,0,PDN
ST292,,1984,1982,,89780,5431681,1056271,,0,0,0,,89780,5431681,1056271,PDN
ST292,,1985,1982,,89780,5431681,1056271,,0,0,0,,89780,5431681,1056271,PDN
ST292,,1986,1982,,89780,5431681,1056271,,0,0,0,,89780,5431681,1056271,PDN
ST292,,1987,1982,,3892395,109981078,23461982,,609728,17743755,3766980,,3282667,92237323,19695002,PDN
ST292,,1988,1982,,3892395,109981078,23461982,,1662466,53951600,11262395,,2229929,56029478,12199587,PDN
ST292,,1989,1982,,4012231,125387590,26323190,,2405719,83376742,17241438,,1606512,42010848,9081752,PDN
ST292,,1990,1982,,4088682,149620130,30711481,,2624501,92482750,19080506,,1464181,57137380,11630975,PDN
ST292,,1991,1982,,4676622,170878394,35082030,,2974251,107405072,22085474,,1702371,63473322,12996556,PDN
ST292,,1992,1982,,4676622,170878394,35082030,,3050367,110506020,22713360,,1626255,60372374,12368670,PDN
ST292,,1993,1982,,4187539,120823240,25686336,,3083865,111905496,22995875,,1103674,8917744,2690461,PDN
ST292,,1994,1982,,4231988,122444409,26019249,,3095932,112441736,23103358,,1136056,10002673,2915891,PDN
ST292,,1995,1982,,3764160,120853896,25268412,,3107524,112838424,23185535,,656636,8015472,2082877,PDN
ST292,,1996,1982,,3764156,120832793,25264653,,3113354,113182354,23252563,,650802,7650439,2012090,PDN
ST292,,1997,1982,,3118525,113352868,23288074,,3118525,113352868,23288074,,0,0,0,PDN
ST292,,1998,1982,,3117236,113352868,23286785,,3117236,113352868,23286785,,0,0,0,PDN
ST292,,1999,1982,,3117236,113352868,23286785,,3117236,113352868,23286785,,0,0,0,PDN
ST292,,2000,1982,,3117236,113352868,23286785,,3117236,113352868,23286785,,0,0,0,PDN
ST292,,2001,1982,,3117236,113352868,23286785,,3117236,113352868,23286785,,0,0,0,PDN
ST292,,2002,1982,,3117236,113352868,23286785,,3117236,113352868,23286785,,0,0,0,PDN
ST292,,2003,1982,,3117236,113352868,23286785,,3117236,113352868,23286785,,0,0,0,PDN
ST292,,2004,1982,,3117236,113352868,23286785,,3117236,113352868,23286785,,0,0,0,PDN
ST292,,2005,1982,,3117236,113352868,23286785,,3117236,113352868,23286785,,0,0,0,PDN
ST292,,2006,1982,,3117236,113352868,23286785,,3117236,113352868,23286785,,0,0,0,PDN
ST292,,2007,1982,,3117236,113352868,23286785,,3117236,113352868,23286785,,0,0,0,PDN
ST292,,2008,1982,,3117236,113352868,23286785,,3117236,113352868,23286785,,0,0,0,PDN
ST292,,2009,1982,,3117236,115622995,23690722,,3117236,115622995,23690722,,0,0,0,PDN
ST292,,2010,1982,,3117236,115622995,23690722,,3117236,115622995,23690722,,0,0,0,PDN
ST292,,2011,1982,,3117236,115622995,23690722,,3117236,115622995,23690722,,0,0,0,PDN
ST292,,2012,1982,,3117236,115622995,23690722,,3117236,115622995,23690722,,0,0,0,PDN
ST292,,2013,1982,,3117236,115622995,23690722,,3117236,115622995,23690722,,0,0,0,PDN
ST292,,2014,1982,,3117236,115622995,23690722,,3117236,115622995,23690722,,0,0,0,PDN
ST292,,2015,1982,,3117236,115622995,23690722,,3117236,115622995,23690722,,0,0,0,PDN
ST292,,2016,1982,,3117236,115622995,23690722,,3117236,115622995,23690722,,0,0,0,PDN
ST292,,2017,1982,,3117236,115622995,23690722,,3117236,115622995,23690722,,0,0,0,PDN
ST292,,2017,1982,,3117236,115622995,23690722,,3117236,115622995,23690722,,0,0,0,PDN
ST295,,1986,1984,,4870,48698181,8670027,,0,0,0,,4870,48698181,8670027,PDP
ST295,,1987,1984,,4870,48698181,8670027,,0,0,0,,4870,48698181,8670027,PDP
ST295,,1988,1984,,4870,48698181,8670027,,0,0,0,,4870,48698181,8670027,PDP
ST295,,1989,1984,,35113357,73298898,48155866,,768474,1537530,1042056,,34344883,71761368,47113810,PDP
ST295,,1990,1984,,32673172,70298574,45181815,,2507139,5407286,3469290,,30166033,64891288,41712525,PDP
ST295,,1991,1984,,33438514,76481699,47047357,,3969959,8546911,5490762,,29468555,67934788,41556595,PDP
ST295,,1992,1984,,34056401,79436572,48191022,,4588213,9982427,6364446,,29468188,69454145,41826576,PDP
ST295,,1993,1984,,41395056,106228014,60296838,,9970783,24635470,14354319,,31424273,81592544,45942519,PDP
ST295,,1994,1984,,45169489,130927976,68466282,,14131133,35486736,20445499,,31038356,95441240,48020783,PDP
ST295,,1995,1984,,31442061,93961944,48161268,,17190103,44861168,25172517,,14251958,49100776,22988751,PDP
ST295,,1996,1984,,33155559,106140504,52041770,,19300111,51891008,28533386,,13855448,54249496,23508384,PDP
ST295,,1997,1984,,35718681,119000501,56893147,,20791941,56048648,30765010,,14926740,62951853,26128137,PDP
ST295,,1998,1984,,36007302,119542482,57278206,,22321693,60710813,33124329,,13685609,58831669,24153877,PDP
ST295,,1999,1984,,35200138,104044023,53713309,,24211512,67997581,36310726,,10988626,36046442,17402583,PDP
ST295,,2000,1984,,38737380,118893820,59892864,,26109840,76162472,39661881,,12627540,42731348,20230983,PDP
ST295,,2001,1984,,40476036,128360344,63315955,,27933108,82713102,42650742,,12542928,45647242,20665213,PDP
ST295,,2002,1984,,42918511,136026916,67122589,,29687291,88789248,45486090,,13231220,47237668,21636499,PDP
ST295,,2003,1984,,42898529,143152022,68370419,,31677147,98755887,49249369,,11221382,44396135,19121050,PDP
ST295,,2004,1984,,43561388,144681167,69305368,,33408732,107457168,52529225,,10152656,37223999,16776143,PDP
ST295,,2005,1984,,44406286,145656686,70323846,,34508836,111968076,54431981,,9897450,33688610,15891865,PDP
ST295,,2006,1984,,45513632,152470550,72643624,,35355623,115869944,55973051,,10158009,36600606,16670573,PDP
ST295,,2007,1984,,45284542,158747942,73531507,,36073341,118484255,57155949,,9211201,40263687,16375558,PDP
ST295,,2008,1984,,46492560,158862179,74759852,,36561630,120201678,57949829,,9930930,38660501,16810023,PDP
ST295,,2009,1984,,41554422,137460218,66013536,,37132222,122641115,58954486,,4422200,14819103,7059051,PDP
ST295,,2010,1984,,41554411,137460218,66013525,,37399615,123216958,59324343,,4154796,14243260,6689181,PDP
ST295,,2011,1984,,41483709,137820159,66006870,,37721081,123962743,59778513,,3762628,13857416,6228361,PDP
ST295,,2012,1984,,41990241,138600431,66652240,,38168221,124870259,60387130,,3822020,13730172,6265111,PDP
ST295,,2013,1984,,41893573,138436482,66526399,,38543014,125742337,60917098,,3350559,12694145,5609304,PDP
ST295,,2014,1984,,42227991,139004500,66961889,,38949289,126707811,61495168,,3278702,12296689,5466725,PDP
ST295,,2015,1984,,42560935,141263751,67696835,,39378748,128042457,62162105,,3182187,13221294,5534728,PDP
ST295,,2016,1984,,42422568,136821252,66767987,,39788795,129383119,62810706,,2633773,7438133,3957284,PDP
ST295,,2017,1984,,42424860,136825887,66771104,,40060969,130157236,63220620,,2363891,6668651,3550483,PDP
ST295,,2017,1984,,42424860,136825887,66771104,,40060969,130157236,63220620,,2363891,6668651,3550483,PDP
ST300,,1983,1978,,39780595,125820394,62168565,,475834,619289,586028,,39304761,125201105,61582537,PDN
ST300,,1984,1978,,40247972,129216823,63240289,,2337593,3232554,2912781,,37910379,125984269,60327508,PDN
ST300,,1985,1978,,40866991,83318529,55692352,,3391629,5269388,4329243,,37475362,78049141,51363109,PDN
ST300,,1986,1978,,37434766,105926850,56282960,,6520091,18307040,9777571,,30914675,87619810,46505389,PDN
ST300,,1987,1978,,37349644,119991509,58700446,,8343336,27670246,13266867,,29006308,92321263,45433579,PDN
ST300,,1988,1978,,29385413,95049501,46298136,,9439848,34449247,15569607,,19945565,60600254,30728529,PDN
ST300,,1989,1978,,13629132,73903808,26779276,,10209280,39116125,17169445,,3419852,34787683,9609831,PDN
ST300,,1990,1978,,13790602,76967262,27485844,,10746324,43064429,18409034,,3044278,33902833,9076810,PDN
ST300,,1991,1978,,14012724,76811801,27680304,,11338750,47631501,19814106,,2673974,29180300,7866198,PDN
ST300,,1992,1978,,13773955,72398893,26656320,,11812814,50550570,20807577,,1961141,21848323,5848743,PDN
ST300,,1993,1978,,13039962,60060373,23726861,,12375007,53710875,21932102,,664955,6349498,1794759,PDN
ST300,,1994,1978,,16976306,71546098,29706928,,13022478,57376443,23231809,,3953828,14169655,6475119,PDN
ST300,,1995,1978,,16516246,75294971,29913928,,13582858,59456398,24162288,,2933388,15838573,5751640,PDN
ST300,,1996,1978,,21439596,99286837,39106293,,13990467,61920507,25008351,,7449129,37366330,14097942,PDN
ST300,,1997,1978,,20011638,95707977,37041527,,14432579,63844097,25792739,,5579059,31863880,11248788,PDN
ST300,,1998,1978,,21156670,111787367,41047661,,15256598,71713699,28017043,,5900072,40073668,13030618,PDN
ST300,,1999,1978,,18013391,85475173,33222497,,15616022,74296296,28836003,,2397369,11178877,4386494,PDN
ST300,,2000,1978,,18491668,88099954,34167816,,15946640,76503551,29559371,,2545028,11596403,4608445,PDN
ST300,,2001,1978,,18468214,88724785,34255542,,16291387,78292761,30222483,,2176827,10432024,4033059,PDN
ST300,,2002,1978,,18468623,89210754,34342422,,16568005,79141239,30650076,,1900618,10069515,3692346,PDN
ST300,,2003,1978,,18758703,87125130,34261395,,16967163,80393016,31271970,,1791540,6732114,2989425,PDN
ST300,,2004,1978,,18768974,87228478,34290055,,17245083,81437859,31735805,,1523891,5790619,2554250,PDN
ST300,,2005,1978,,18768974,88841564,34577081,,17540735,82816053,32276687,,1228239,6025511,2300394,PDN
ST300,,2006,1978,,19085658,93953595,35803379,,17789123,83678262,32678493,,1296535,10275333,3124886,PDN
ST300,,2007,1978,,18585068,103956046,37082585,,18014068,85478137,33223701,,571000,18477909,3858884,PDN
ST300,,2008,1978,,19687258,104119127,38213793,,18198757,88921373,34021065,,1488501,15197754,4192728,PDN
ST300,,2009,1978,,18862063,99258421,36523706,,18416861,94800745,35285324,,445202,4457676,1238382,PDN
ST300,,2010,1978,,18862063,99258421,36523706,,18651799,96636863,35846973,,210264,2621558,676733,PDN
ST300,,2011,1978,,18865220,99258421,36526863,,18750164,96979611,36006325,,115056,2278810,520538,PDN
ST300,,2012,1978,,18865220,99258421,36526863,,18751009,96979611,36007170,,114211,2278810,519693,PDN
ST300,,2013,1978,,18865220,99258421,36526863,,18758187,97029731,36023266,,107033,2228690,503597,PDN
ST300,,2014,1978,,18764636,97064579,36035916,,18764636,97064579,36035916,,0,0,0,PDN
ST300,,2015,1978,,18764636,97064579,36035916,,18764636,97064579,36035916,,0,0,0,PDN
ST300,,2016,1978,,18765270,97064579,36036550,,18765270,97064579,36036550,,0,0,0,PDN
ST300,,2017,1978,,18765270,97064579,36036550,,18765270,97064579,36036550,,0,0,0,PDN
ST300,,2017,1978,,18765270,97064579,36036550,,18765270,97064579,36036550,,0,0,0,PDN
ST301,,1983,1978,,4928337,11779045,7024252,,0,0,0,,4928337,11779045,7024252,PDN
ST301,,1984,1978,,18482006,35734463,24840451,,418836,594868,524684,,18063170,35139595,24315767,PDN
ST301,,1985,1978,,21279593,48436731,29898228,,1845232,2623968,2312130,,19434361,45812763,27586098,PDN
ST301,,1986,1978,,23967344,76114286,37510811,,3693230,9918776,5458137,,20274114,66195510,32052674,PDN
ST301,,1987,1978,,25799299,89973467,41808813,,4918535,15582200,7691168,,20880764,74391267,34117645,PDN
ST301,,1988,1978,,22679276,73232872,35710036,,5730117,19956863,9281160,,16949159,53276009,26428876,PDN
ST301,,1989,1978,,10518988,36597522,17031003,,6151687,22008419,10067776,,4367301,14589103,6963227,PDN
ST301,,1990,1978,,10518988,36597522,17031003,,6454106,23031999,10552326,,4064882,13565523,6478677,PDN
ST301,,1991,1978,,10633062,36681818,17160076,,6784478,24302869,11108832,,3848584,12378949,6051244,PDN
ST301,,1992,1978,,13670214,42006502,21144681,,7191800,27001810,11996393,,6478414,15004692,9148288,PDN
ST301,,1993,1978,,12479446,44219092,20347612,,7464990,29268932,12672985,,5014456,14950160,7674627,PDN
ST301,,1994,1978,,12615689,45195672,20657624,,7685532,31060557,13212322,,4930157,14135115,7445302,PDN
ST301,,1995,1978,,9439004,38011785,16202667,,7903308,31964694,13590976,,1535696,6047091,2611691,PDN
ST301,,1996,1978,,9616962,38315367,16434643,,8037701,32564900,13832167,,1579261,5750467,2602476,PDN
ST301,,1997,1978,,10763004,50182041,19692193,,8221782,33369027,14159331,,2541222,16813014,5532862,PDN
ST301,,1998,1978,,10763004,50182041,19692193,,8514316,35755363,14876480,,2248688,14426678,4815713,PDN
ST301,,1999,1978,,10896585,50371108,19859416,,8737153,37639162,15434513,,2159432,12731946,4424903,PDN
ST301,,2000,1978,,10718750,49493991,19525510,,8925839,38986346,15862911,,1792911,10507645,3662599,PDN
ST301,,2001,1978,,11547720,61283522,22452261,,9076026,39560315,16115228,,2471694,21723207,6337033,PDN
ST301,,2002,1978,,11603594,61516839,22549651,,9200664,39876624,16296149,,2402930,21640215,6253502,PDN
ST301,,2003,1978,,10843446,60908153,21681196,,9792308,46534909,18072541,,1051138,14373244,3608655,PDN
ST301,,2004,1978,,10979546,60422204,21730828,,10129504,49420043,18923106,,850042,11002161,2807722,PDN
ST301,,2005,1978,,10979546,60422204,21730828,,10372422,51156170,19474943,,607124,9266034,2255885,PDN
ST301,,2006,1978,,11413523,57299410,21609148,,10556562,52242722,19852420,,856961,5056688,1756728,PDN
ST301,,2007,1978,,11413523,57299410,21609148,,10654691,52748813,20040601,,758832,4550597,1568547,PDN
ST301,,2008,1978,,11391520,55632766,21290589,,10654606,52747885,20040351,,736914,2884881,1250238,PDN
ST301,,2009,1978,,10785870,53956967,20386753,,10739524,53744285,20302564,,46346,212682,84189,PDN
ST301,,2010,1978,,10785870,53956967,20386753,,10785870,53956967,20386753,,0,0,0,PDN
ST301,,2011,1978,,10785870,53956967,20386753,,10785870,53956967,20386753,,0,0,0,PDN
ST301,,2012,1978,,10785870,53956967,20386753,,10785870,53956967,20386753,,0,0,0,PDN
ST301,,2013,1978,,10785870,53956967,20386753,,10785870,53956967,20386753,,0,0,0,PDN
ST301,,2014,1978,,10785870,53956967,20386753,,10785870,53956967,20386753,,0,0,0,PDN
ST301,,2015,1978,,10785870,53956967,20386753,,10785870,53956967,20386753,,0,0,0,PDN
ST301,,2016,1978,,10785775,53956967,20386658,,10785775,53956967,20386658,,0,0,0,PDN
ST301,,2017,1978,,10785775,53956967,20386658,,10785775,53956967,20386658,,0,0,0,PDN
ST301,,2017,1978,,10785775,53956967,20386658,,10785775,53956967,20386658,,0,0,0,PDN
ST311,,2015,2013,,3353856,31177441,8901443,,260864,2258205,662680,,3092992,28919236,8238764,PDP
ST311,,2016,2013,,3602289,33486881,9560809,,759344,6409670,1899855,,2842945,27077211,7660954,PDP
ST311,,2017,2013,,3602289,33486881,9560809,,1193457,9958704,2965468,,2408832,23528177,6595340,PDP
ST311,,2017,2013,,3602289,33486881,9560809,,1193457,9958704,2965468,,2408832,23528177,6595340,PDP
ST314,,2000,1976,,1837125,5060930,2737646,,0,0,0,,1837125,5060930,2737646,PDP
ST314,,2001,1976,,1837125,5060930,2737646,,0,0,0,,1837125,5060930,2737646,PDP
ST314,,2002,1976,,8263894,18081939,11481321,,0,0,0,,8263894,18081939,11481321,PDP
ST314,,2003,1976,,8217382,17880916,11399040,,1246709,2444817,1681730,,6970673,15436099,9717310,PDP
ST314,,2004,1976,,26198043,51040610,35280002,,8056041,15425143,10800728,,18142002,35615467,24479274,PDP
ST314,,2005,1976,,25052809,49551806,33869856,,11928125,22234678,15884473,,13124684,27317128,17985383,PDP
ST314,,2006,1976,,25052809,49551806,33869856,,13092939,24259267,17409535,,11959870,25292539,16460321,PDP
ST314,,2007,1976,,23896844,45589601,32008873,,13634811,25234414,18124920,,10262033,20355187,13883953,PDP
ST314,,2008,1976,,16911717,42620581,24495450,,13993695,25893680,18601111,,2918022,16726901,5894339,PDP
ST314,,2009,1976,,15940471,40864343,23211708,,14448178,28231124,19471509,,1492293,12633219,3740198,PDP
ST314,,2010,1976,,15940471,40864343,23211708,,14771092,31079195,20301196,,1169379,9785148,2910508,PDP
ST314,,2011,1976,,15940471,40864343,23211708,,14941714,33294723,20866041,,998757,7569620,2345666,PDP
ST314,,2012,1976,,15940471,40864343,23211708,,15152739,35536297,21475923,,787732,5328046,1735783,PDP
ST314,,2013,1976,,15940471,40864343,23211708,,15332762,37460662,21998360,,607709,3403681,1213347,PDP
ST314,,2014,1976,,15969300,40922477,23250881,,15462608,38634462,22337068,,506692,2288015,913812,PDP
ST314,,2015,1976,,16040686,40901407,23318518,,15591976,39796795,22673256,,448710,1104612,645260,PDP
ST314,,2016,1976,,16076795,40967410,23366371,,15707547,39911111,22809170,,369248,1056299,557201,PDP
ST314,,2017,1976,,16076795,41708649,23498264,,15792408,40422147,22984962,,284387,1286502,513301,PDP
ST314,,2017,1976,,16076795,41708649,23498264,,15792408,40422147,22984962,,284387,1286502,513301,PDP
TS000,,1975,1958,,55000788,2516286000,502738510,,19398885,1042653938,204924497,,35601903,1473632062,297814013,PDP
TS000,,1976,1958,,37369495,2996956263,570635734,,24108556,1232255402,243371083,,13260939,1764700861,327264651,PDP
TS000,,1977,1958,,54002453,3051878813,597041388,,38219162,1378383358,283483105,,15783291,1673495455,313558283,PDP
TS000,,1978,1958,,54074816,3059588333,598485551,,39221650,1528269728,311155765,,14853166,1531318605,287329786,PDP
TS000,,1979,1958,,41703791,3082653252,590218605,,27391738,1682951602,326849318,,14312053,1399701650,263369287,PDP
TS000,,1980,1958,,43984719,3218764121,616718548,,28160179,1809488428,350133209,,15824540,1409275693,266585339,PDP
TS000,,1981,1958,,53017700,3431033870,663521947,,28836243,1930413629,372326213,,24181457,1500620241,291195734,PDP
TS000,,1982,1958,,51444208,3432765099,662256503,,29290659,2054441835,394849704,,22153549,1378323264,267406799,PDP
TS000,,1983,1958,,52135481,3494198594,673879003,,29997717,2154268882,413319582,,22137764,1339929712,260559421,PDP
TS000,,1984,1958,,42799194,3743550087,708911309,,30667571,2275451505,435552180,,12131623,1468098582,273359129,PDP
TS000,,1985,1958,,42805454,3746434638,709430834,,31222692,2375029444,453825796,,11582762,1371405194,255605038,PDP
TS000,,1986,1958,,41552243,3727989083,704895496,,31516563,2420530332,462215910,,10035680,1307458751,242679586,PDP
TS000,,1987,1958,,35960213,3141529775,594951276,,31810387,2484617164,473913085,,4149826,656912611,121038191,PDP
TS000,,1988,1958,,35856614,3327253050,627894523,,32107208,2561264026,487848138,,3749406,765989024,140046385,PDP
TS000,,1989,1958,,35400504,3233683931,610789104,,32415315,2630629654,500498883,,2985189,603054277,110290221,PDP
TS000,,1990,1958,,35185332,3321032737,626116424,,32760543,2707188844,514466743,,2424789,613843893,111649681,PDP
TS000,,1991,1958,,35700728,3287845128,620726551,,33194980,2784863173,528722235,,2505748,502981955,92004316,PDP
TS000,,1992,1958,,36819006,3295250815,623162567,,33804749,2848648690,540681740,,3014257,446602125,82480827,PDP
TS000,,1993,1958,,37947982,3306487065,626290876,,34427033,2903715195,551102335,,3520949,402771870,75188541,PDP
TS000,,1994,1958,,37659261,3263762373,618399897,,34975418,2952593664,560347956,,2683843,311168709,58051941,PDP
TS000,,1995,1958,,37427988,3241896149,614277837,,35328313,3002652271,569608077,,2099675,239243878,44669760,PDP
TS000,,1996,1958,,36898899,3261865698,617302048,,35507996,3039935370,576421763,,1390903,221930328,40880285,PDP
TS000,,1997,1958,,36506335,3196798669,605331721,,35687872,3068250958,581640000,,818463,128547711,23691721,PDP
TS000,,1998,1958,,36380879,3180105157,602235889,,35897301,3090411001,585792497,,483578,89694156,16443392,PDP
TS000,,1999,1958,,37192421,3266504157,618420919,,36050250,3103804215,588328580,,1142171,162699942,30092339,PDP
TS000,,2000,1958,,37186791,3271729795,619345117,,36168734,3113597735,590189683,,1018057,158132060,29155434,PDP
TS000,,2001,1958,,37749295,3270234259,619641511,,36289958,3119970448,591444842,,1459337,150263811,28196669,PDP
TS000,,2002,1958,,37798938,3272307088,620059985,,36418914,3125067326,592480716,,1380024,147239762,27579269,PDP
TS000,,2003,1958,,37796080,3268777081,619429012,,36538291,3128916153,593284937,,1257789,139860928,26144075,PDP
TS000,,2004,1958,,38677975,3275828436,621565597,,36638391,3131503631,593845443,,2039584,144324805,27720154,PDP
TS000,,2005,1958,,40804670,3332825011,633834031,,36945059,3139913746,595648573,,3859611,192911265,38185458,PDP
TS000,,2006,1958,,38786543,3287272672,623710506,,37454652,3154950723,598833784,,1331891,132321949,24876722,PDP
TS000,,2007,1958,,39783287,3361287661,637877177,,37695664,3161181943,600183554,,2087623,200105718,37693623,PDP
TS000,,2008,1958,,45034870,3626490479,690317874,,37977584,3181689056,604114427,,7057286,444801423,86203447,PDP
TS000,,2009,1958,,45281268,3660079262,696540919,,38981183,3294769489,625239097,,6300085,365309773,71301823,PDP
TS000,,2010,1958,,45284555,3660880897,696686846,,40134559,3354435578,637009213,,5149996,306445319,59677633,PDP
TS000,,2011,1958,,45267457,3660784311,696652562,,40859619,3395462806,645034494,,4407838,265321505,51618071,PDP
TS000,,2012,1958,,44880103,3623231447,689583205,,42754672,3492896993,664266591,,2125431,130334454,25316614,PDP
TS000,,2013,1958,,45367550,3623644318,690144116,,43201870,3517607345,669110649,,2165680,106036973,21033469,PDP
TS000,,2014,1958,,47274776,3731091520,711170061,,43703798,3543507534,674221151,,3570978,187583986,36948912,PDP
TS000,,2015,1958,,47201668,3727806339,710512402,,44455284,3581044402,681651795,,2746384,146761937,28860607,PDP
TS000,,2016,1958,,47201668,3727806339,710512402,,45023428,3613245017,687949584,,2178240,114561322,22562817,PDP
TS000,,2017,1958,,46816717,3724984370,709625322,,45332654,3633952095,691943346,,1484063,91032275,17681978,PDP
TS000,,2017,1958,,46816717,3724984370,709625322,,45332654,3633952095,691943346,,1484063,91032275,17681978,PDP
VK020,,2005,2005,,134,1343074,239115,,0,11851,2109,,134,1331223,237006,PDN
VK020,,2006,2005,,134,1343074,239115,,0,472269,84034,,134,870805,155081,PDN
VK020,,2007,2005,,134,1343074,239115,,0,797154,141842,,134,545920,97273,PDN
VK020,,2008,2005,,134,1343074,239115,,0,978502,174111,,134,364572,65004,PDN
VK020,,2009,2005,,0,1171987,208539,,0,1041027,185236,,0,130960,23302,PDN
VK020,,2010,2005,,0,1171987,208539,,0,1078320,191872,,0,93667,16667,PDN
VK020,,2011,2005,,0,1171987,208539,,0,1101772,196045,,0,70215,12494,PDN
VK020,,2012,2005,,0,1116028,198581,,0,1116028,198581,,0,0,0,PDN
VK020,,2013,2005,,0,1116028,198581,,0,1116028,198581,,0,0,0,PDN
VK020,,2014,2005,,0,1116028,198581,,0,1116028,198581,,0,0,0,PDN
VK020,,2015,2005,,0,1116028,198581,,0,1116028,198581,,0,0,0,PDN
VK020,,2016,2005,,0,1116028,198581,,0,1116028,198581,,0,0,0,PDN
VK020,,2017,2005,,0,1116028,198581,,0,1116028,198581,,0,0,0,PDN
VK020,,2017,2005,,0,1116028,198581,,0,1116028,198581,,0,0,0,PDN
VK024,,1992,1988,,1159,11587871,2063058,,0,2452856,436451,,1159,9135015,1626607,PDN
VK024,,1993,1988,,1159,11587871,2063058,,0,4004217,712494,,1159,7583654,1350564,PDN
VK024,,1994,1988,,1154,11543043,2055076,,0,4665087,830087,,1154,6877956,1224989,PDN
VK024,,1995,1988,,1154,11543043,2055076,,0,5038992,896618,,1154,6504051,1158458,PDN
VK024,,1996,1988,,1115,11151508,1985369,,0,5371989,955870,,1115,5779519,1029499,PDN
VK024,,1997,1988,,1115,11151508,1985369,,0,6064115,1079024,,1115,5087393,906345,PDN
VK024,,1998,1988,,1115,11151508,1985369,,0,6343449,1128728,,1115,4808059,856641,PDN
VK024,,1999,1988,,743,7434339,1323579,,0,6675567,1187823,,743,758772,135756,PDN
VK024,,2000,1988,,743,7434339,1323579,,0,6899473,1227664,,743,534866,95915,PDN
VK024,,2001,1988,,743,7434339,1323579,,0,7165187,1274944,,743,269152,48635,PDN
VK024,,2002,1988,,0,7260574,1291917,,0,7260574,1291917,,0,0,0,PDN
VK024,,2003,1988,,0,7260574,1291917,,0,7260574,1291917,,0,0,0,PDN
VK024,,2004,1988,,0,7260574,1291917,,0,7260574,1291917,,0,0,0,PDN
VK024,,2005,1988,,0,7260574,1291917,,0,7260574,1291917,,0,0,0,PDN
VK024,,2006,1988,,0,7260574,1291917,,0,7260574,1291917,,0,0,0,PDN
VK024,,2007,1988,,0,7260574,1291917,,0,7260574,1291917,,0,0,0,PDN
VK024,,2008,1988,,0,7260574,1291917,,0,7260574,1291917,,0,0,0,PDN
VK024,,2009,1988,,0,7386248,1314279,,0,7386248,1314279,,0,0,0,PDN
VK024,,2010,1988,,0,7386248,1314279,,0,7386248,1314279,,0,0,0,PDN
VK024,,2011,1988,,0,7386248,1314279,,0,7386248,1314279,,0,0,0,PDN
VK024,,2012,1988,,0,7386248,1314279,,0,7386248,1314279,,0,0,0,PDN
VK024,,2013,1988,,0,7386248,1314279,,0,7386248,1314279,,0,0,0,PDN
VK024,,2014,1988,,0,7386248,1314279,,0,7386248,1314279,,0,0,0,PDN
VK024,,2015,1988,,0,7386248,1314279,,0,7386248,1314279,,0,0,0,PDN
VK024,,2016,1988,,0,7386248,1314279,,0,7386248,1314279,,0,0,0,PDN
VK024,,2017,1988,,0,7386248,1314279,,0,7386248,1314279,,0,0,0,PDN
VK024,,2017,1988,,0,7386248,1314279,,0,7386248,1314279,,0,0,0,PDN
VK026,,2007,2007,,105,1049257,186806,,0,92937,16537,,105,956320,170269,PDN
VK026,,2008,2007,,105,1049257,186806,,0,306231,54490,,105,743026,132316,PDN
VK026,,2009,2007,,0,474227,84382,,0,399400,71068,,0,74827,13314,PDN
VK026,,2010,2007,,0,439107,78133,,0,439107,78133,,0,0,0,PDN
VK026,,2011,2007,,0,439107,78133,,0,439107,78133,,0,0,0,PDN
VK026,,2012,2007,,0,439107,78133,,0,439107,78133,,0,0,0,PDN
VK026,,2013,2007,,0,439107,78133,,0,439107,78133,,0,0,0,PDN
VK026,,2014,2007,,0,439107,78133,,0,439107,78133,,0,0,0,PDN
VK026,,2015,2007,,0,439107,78133,,0,439107,78133,,0,0,0,PDN
VK026,,2016,2007,,0,439107,78133,,0,439107,78133,,0,0,0,PDN
VK026,,2017,2007,,0,439107,78133,,0,439107,78133,,0,0,0,PDN
VK026,,2017,2007,,0,439107,78133,,0,439107,78133,,0,0,0,PDN
VK027,,1990,1990,,709,7089667,1262216,,0,0,0,,709,7089667,1262216,PDN
VK027,,1991,1990,,709,7089667,1262216,,0,61852,11006,,709,7027815,1251210,PDN
VK027,,1992,1990,,709,7089667,1262216,,0,841263,149691,,709,6248404,1112525,PDN
VK027,,1993,1990,,709,7089667,1262216,,0,1613748,287144,,709,5475919,975072,PDN
VK027,,1994,1990,,703,7031372,1251837,,0,2385554,424476,,703,4645818,827361,PDN
VK027,,1995,1990,,703,7031372,1251837,,0,3275488,582827,,703,3755884,669010,PDN
VK027,,1996,1990,,689,6889468,1226573,,0,4288894,763148,,689,2600574,463425,PDN
VK027,,1997,1990,,689,6889468,1226573,,0,4875390,867507,,689,2014078,359066,PDN
VK027,,1998,1990,,689,6889468,1226573,,0,5494118,977601,,689,1395350,248972,PDN
VK027,,1999,1990,,0,7212411,1283347,,0,6295183,1120139,,0,917228,163208,PDN
VK027,,2000,1990,,0,7212411,1283347,,0,6542440,1164135,,0,669971,119212,PDN
VK027,,2001,1990,,0,7212411,1283347,,0,7032503,1251335,,0,179908,32012,PDN
VK027,,2002,1990,,0,7388881,1314748,,0,7388881,1314748,,0,0,0,PDN
VK027,,2003,1990,,0,7388881,1314748,,0,7388881,1314748,,0,0,0,PDN
VK027,,2004,1990,,0,7388881,1314748,,0,7388881,1314748,,0,0,0,PDN
VK027,,2005,1990,,0,7388881,1314748,,0,7388881,1314748,,0,0,0,PDN
VK027,,2006,1990,,0,7388881,1314748,,0,7388881,1314748,,0,0,0,PDN
VK027,,2007,1990,,0,7388881,1314748,,0,7388881,1314748,,0,0,0,PDN
VK027,,2008,1990,,0,7388881,1314748,,0,7388881,1314748,,0,0,0,PDN
VK027,,2009,1990,,0,7495726,1333759,,0,7495726,1333759,,0,0,0,PDN
VK027,,2010,1990,,0,7495726,1333759,,0,7495726,1333759,,0,0,0,PDN
VK027,,2011,1990,,0,7495726,1333759,,0,7495726,1333759,,0,0,0,PDN
VK027,,2012,1990,,0,7495726,1333759,,0,7495726,1333759,,0,0,0,PDN
VK027,,2013,1990,,0,7495726,1333759,,0,7495726,1333759,,0,0,0,PDN
VK027,,2014,1990,,0,7495726,1333759,,0,7495726,1333759,,0,0,0,PDN
VK027,,2015,1990,,0,7495726,1333759,,0,7495726,1333759,,0,0,0,PDN
VK027,,2016,1990,,0,7495726,1333759,,0,7495726,1333759,,0,0,0,PDN
VK027,,2017,1990,,0,7495726,1333759,,0,7495726,1333759,,0,0,0,PDN
VK027,,2017,1990,,0,7495726,1333759,,0,7495726,1333759,,0,0,0,PDN
VK031,,1991,1987,,399,3994005,711076,,0,0,0,,399,3994005,711076,PDN
VK031,,1992,1987,,399,3994005,711076,,0,0,0,,399,3994005,711076,PDN
VK031,,1993,1987,,399,3994005,711076,,0,0,0,,399,3994005,711076,PDN
VK031,,1994,1987,,398,3975706,707819,,0,406488,72329,,398,3569218,635490,PDN
VK031,,1995,1987,,397,3971154,707008,,0,1055708,187848,,397,2915446,519160,PDN
VK031,,1996,1987,,393,3931329,699918,,0,1422581,253128,,393,2508748,446790,PDN
VK031,,1997,1987,,393,3931329,699918,,0,1687867,300332,,393,2243462,399586,PDN
VK031,,1998,1987,,393,3931329,699918,,0,1894541,337107,,393,2036788,362811,PDN
VK031,,1999,1987,,393,3931329,699918,,0,2076301,369449,,393,1855028,330469,PDN
VK031,,2000,1987,,393,3931329,699918,,0,2245246,399510,,393,1686083,300408,PDN
VK031,,2001,1987,,393,3931329,699918,,0,2376320,422833,,393,1555009,277085,PDN
VK031,,2002,1987,,393,3931329,699918,,0,2522340,448815,,393,1408989,251103,PDN
VK031,,2003,1987,,393,3931329,699918,,0,2670152,475116,,393,1261177,224802,PDN
VK031,,2004,1987,,0,3491180,621206,,0,2782201,495054,,0,708979,126152,PDN
VK031,,2005,1987,,0,3491180,621206,,0,2906295,517134,,0,584885,104072,PDN
VK031,,2006,1987,,0,3491180,621206,,0,3011379,535833,,0,479801,85373,PDN
VK031,,2007,1987,,0,3491180,621206,,0,3097273,551116,,0,393907,70090,PDN
VK031,,2008,1987,,0,3491180,621206,,0,3164473,563073,,0,326707,58133,PDN
VK031,,2009,1987,,0,3213165,571738,,0,3213165,571738,,0,0,0,PDN
VK031,,2010,1987,,0,3213165,571738,,0,3213165,571738,,0,0,0,PDN
VK031,,2011,1987,,0,3213165,571738,,0,3213165,571738,,0,0,0,PDN
VK031,,2012,1987,,0,3213165,571738,,0,3213165,571738,,0,0,0,PDN
VK031,,2013,1987,,0,3213165,571738,,0,3213165,571738,,0,0,0,PDN
VK031,,2014,1987,,0,3213165,571738,,0,3213165,571738,,0,0,0,PDN
VK031,,2015,1987,,0,3213165,571738,,0,3213165,571738,,0,0,0,PDN
VK031,,2016,1987,,0,3213165,571738,,0,3213165,571738,,0,0,0,PDN
VK031,,2017,1987,,0,3213165,571738,,0,3213165,571738,,0,0,0,PDN
VK031,,2017,1987,,0,3213165,571738,,0,3213165,571738,,0,0,0,PDN
VK032,,1988,1987,,708,7080170,1260525,,0,0,0,,708,7080170,1260525,PDN
VK032,,1989,1987,,708,7080170,1260525,,0,0,0,,708,7080170,1260525,PDN
VK032,,1990,1987,,708,7080170,1260525,,0,0,0,,708,7080170,1260525,PDN
VK032,,1991,1987,,708,7080170,1260525,,0,0,0,,708,7080170,1260525,PDN
VK032,,1992,1987,,1801,18011036,3206612,,0,0,0,,1801,18011036,3206612,PDN
VK032,,1993,1987,,1801,18011036,3206612,,0,0,0,,1801,18011036,3206612,PDN
VK032,,1994,1987,,1792,17917858,3190023,,0,550964,98036,,1792,17366894,3091987,PDN
VK032,,1995,1987,,1792,17917858,3190023,,0,3569899,635213,,1792,14347959,2554810,PDN
VK032,,1996,1987,,1792,17917858,3190023,,0,4967976,883981,,1792,12949882,2306042,PDN
VK032,,1997,1987,,1792,17917858,3190023,,0,5966242,1061609,,1792,11951616,2128414,PDN
VK032,,1998,1987,,1792,17917858,3190023,,0,6720283,1195780,,1792,11197575,1994243,PDN
VK032,,1999,1987,,0,9433460,1678552,,0,7377321,1312691,,0,2056139,365861,PDN
VK032,,2000,1987,,0,9433460,1678552,,0,7843344,1395613,,0,1590116,282939,PDN
VK032,,2001,1987,,0,9428466,1677663,,0,8076700,1437135,,0,1351766,240528,PDN
VK032,,2002,1987,,0,9399581,1672523,,0,8239540,1466110,,0,1160041,206413,PDN
VK032,,2003,1987,,0,8321665,1480723,,0,8310966,1478820,,0,10699,1903,PDN
VK032,,2004,1987,,0,8320795,1480569,,0,8320795,1480569,,0,0,0,PDN
VK032,,2005,1987,,0,8360432,1487621,,0,8360432,1487621,,0,0,0,PDN
VK032,,2006,1987,,0,8360432,1487621,,0,8360432,1487621,,0,0,0,PDN
VK032,,2007,1987,,0,8360432,1487621,,0,8360432,1487621,,0,0,0,PDN
VK032,,2008,1987,,0,8360432,1487621,,0,8360432,1487621,,0,0,0,PDN
VK032,,2009,1987,,0,8490571,1510778,,0,8490571,1510778,,0,0,0,PDN
VK032,,2010,1987,,0,8490571,1510778,,0,8490571,1510778,,0,0,0,PDN
VK032,,2011,1987,,0,8490571,1510778,,0,8490571,1510778,,0,0,0,PDN
VK032,,2012,1987,,0,8490571,1510778,,0,8490571,1510778,,0,0,0,PDN
VK032,,2013,1987,,0,8490571,1510778,,0,8490571,1510778,,0,0,0,PDN
VK032,,2014,1987,,0,8490571,1510778,,0,8490571,1510778,,0,0,0,PDN
VK032,,2015,1987,,0,8490571,1510778,,0,8490571,1510778,,0,0,0,PDN
VK032,,2016,1987,,0,8490571,1510778,,0,8490571,1510778,,0,0,0,PDN
VK032,,2017,1987,,0,8490571,1510778,,0,8490571,1510778,,0,0,0,PDN
VK032,,2017,1987,,0,8490571,1510778,,0,8490571,1510778,,0,0,0,PDN
VK033,,1997,1996,,182,1816747,323447,,0,214872,38233,,182,1601875,285214,PDN
VK033,,1998,1996,,182,1816747,323447,,0,1202368,213944,,182,614379,109503,PDN
VK033,,1999,1996,,0,2369744,421663,,0,2074297,369092,,0,295447,52571,PDN
VK033,,2000,1996,,0,2355277,419088,,0,2355277,419088,,0,0,0,PDN
VK033,,2001,1996,,0,2366567,421097,,0,2366567,421097,,0,0,0,PDN
VK033,,2002,1996,,0,2366567,421097,,0,2366567,421097,,0,0,0,PDN
VK033,,2003,1996,,0,2366567,421097,,0,2366567,421097,,0,0,0,PDN
VK033,,2004,1996,,0,2366567,421097,,0,2366567,421097,,0,0,0,PDN
VK033,,2005,1996,,0,2366567,421097,,0,2366567,421097,,0,0,0,PDN
VK033,,2006,1996,,0,2366567,421097,,0,2366567,421097,,0,0,0,PDN
VK033,,2007,1996,,0,2366567,421097,,0,2366567,421097,,0,0,0,PDN
VK033,,2008,1996,,0,2366567,421097,,0,2366567,421097,,0,0,0,PDN
VK033,,2009,1996,,0,2386878,424711,,0,2386878,424711,,0,0,0,PDN
VK033,,2010,1996,,0,2386878,424711,,0,2386878,424711,,0,0,0,PDN
VK033,,2011,1996,,0,2386878,424711,,0,2386878,424711,,0,0,0,PDN
VK033,,2012,1996,,0,2386878,424711,,0,2386878,424711,,0,0,0,PDN
VK033,,2013,1996,,0,2386878,424711,,0,2386878,424711,,0,0,0,PDN
VK033,,2014,1996,,0,2386878,424711,,0,2386878,424711,,0,0,0,PDN
VK033,,2015,1996,,0,2386878,424711,,0,2386878,424711,,0,0,0,PDN
VK033,,2016,1996,,0,2386878,424711,,0,2386878,424711,,0,0,0,PDN
VK033,,2017,1996,,0,2386878,424711,,0,2386878,424711,,0,0,0,PDN
VK033,,2017,1996,,0,2386878,424711,,0,2386878,424711,,0,0,0,PDN
VK035,,1997,1997,,155,1548197,275635,,0,552622,98331,,155,995575,177304,PDN
VK035,,1998,1997,,155,1548197,275635,,0,674240,119972,,155,873957,155663,PDN
VK035,,1999,1997,,0,675502,120196,,0,675502,120196,,0,0,0,PDN
VK035,,2000,1997,,0,675502,120196,,0,675502,120196,,0,0,0,PDN
VK035,,2001,1997,,0,675502,120196,,0,675502,120196,,0,0,0,PDN
VK035,,2002,1997,,0,675502,120196,,0,675502,120196,,0,0,0,PDN
VK035,,2003,1997,,0,675502,120196,,0,675502,120196,,0,0,0,PDN
VK035,,2004,1997,,0,675502,120196,,0,675502,120196,,0,0,0,PDN
VK035,,2005,1997,,0,675502,120196,,0,675502,120196,,0,0,0,PDN
VK035,,2006,1997,,0,675502,120196,,0,675502,120196,,0,0,0,PDN
VK035,,2007,1997,,0,675502,120196,,0,675502,120196,,0,0,0,PDN
VK035,,2008,1997,,0,675502,120196,,0,675502,120196,,0,0,0,PDN
VK035,,2009,1997,,0,688982,122595,,0,688982,122595,,0,0,0,PDN
VK035,,2010,1997,,0,688982,122595,,0,688982,122595,,0,0,0,PDN
VK035,,2011,1997,,0,688982,122595,,0,688982,122595,,0,0,0,PDN
VK035,,2012,1997,,0,688982,122595,,0,688982,122595,,0,0,0,PDN
VK035,,2013,1997,,0,688982,122595,,0,688982,122595,,0,0,0,PDN
VK035,,2014,1997,,0,688982,122595,,0,688982,122595,,0,0,0,PDN
VK035,,2015,1997,,0,688982,122595,,0,688982,122595,,0,0,0,PDN
VK035,,2016,1997,,0,688982,122595,,0,688982,122595,,0,0,0,PDN
VK035,,2017,1997,,0,688982,122595,,0,688982,122595,,0,0,0,PDN
VK035,,2017,1997,,0,688982,122595,,0,688982,122595,,0,0,0,PDN
VK069,,1991,1990,,3007,2747975,491971,,0,120976,21526,,3007,2626999,470445,PDP
VK069,,1992,1990,,4295,3925677,702814,,0,3554156,632412,,4295,371521,70402,PDP
VK069,,1993,1990,,13676,12500000,2237875,,0,7034700,1251726,,13676,5465300,986149,PDP
VK069,,1994,1990,,13676,12500000,2237875,,0,8753617,1557583,,13676,3746383,680292,PDP
VK069,,1995,1990,,13676,12500000,2237875,,0,8982963,1598392,,13676,3517037,639483,PDP
VK069,,1996,1990,,13676,12500000,2237875,,0,9116664,1622182,,13676,3383336,615693,PDP
VK069,,1997,1990,,439,13592389,2419014,,0,9182570,1633909,,439,4409819,785105,PDP
VK069,,1998,1990,,858,17778630,3164315,,0,12129572,2158287,,858,5649058,1006028,PDP
VK069,,1999,1990,,0,38914248,6924243,,0,17916258,3187946,,0,20997990,3736297,PDP
VK069,,2000,1990,,77,76360780,13587404,,0,23710020,4218865,,77,52650760,9368539,PDP
VK069,,2001,1990,,54,71389488,12702810,,0,29060444,5170898,,54,42329044,7531912,PDP
VK069,,2002,1990,,54,71389488,12702810,,0,46532518,8279807,,54,24856970,4423003,PDP
VK069,,2003,1990,,36,71198333,12668779,,0,55431974,9863341,,36,15766359,2805438,PDP
VK069,,2004,1990,,36,71198333,12668779,,0,58914126,10482941,,36,12284207,2185838,PDP
VK069,,2005,1990,,36,71198333,12668779,,0,61881593,11010960,,36,9316740,1657819,PDP
VK069,,2006,1990,,36,71198333,12668779,,0,65294816,11618295,,36,5903517,1050484,PDP
VK069,,2007,1990,,0,70833887,12603894,,0,68450464,12179798,,0,2383423,424096,PDP
VK069,,2008,1990,,0,80160654,14263462,,0,71084247,12648443,,0,9076407,1615019,PDP
VK069,,2009,1990,,0,80344681,14296206,,0,73607009,13097332,,0,6737672,1198874,PDP
VK069,,2010,1990,,0,84981350,15121236,,0,75611325,13453972,,0,9370025,1667264,PDP
VK069,,2011,1990,,0,83372670,14834994,,0,77447831,13780752,,0,5924839,1054242,PDP
VK069,,2012,1990,,0,83372670,14834994,,0,79024027,14061214,,0,4348643,773780,PDP
VK069,,2013,1990,,0,83372670,14834994,,0,80171642,14265416,,0,3201028,569578,PDP
VK069,,2014,1990,,0,80906963,14396256,,0,80906963,14396256,,0,0,0,PDP
VK069,,2015,1990,,0,80906963,14396256,,0,80906963,14396256,,0,0,0,PDP
VK069,,2016,1990,,0,83372670,14834994,,0,81556942,14511911,,0,1815728,323083,PDP
VK069,,2017,1990,,0,83372670,14834994,,0,82596280,14696847,,0,776390,138148,PDP
VK069,,2017,1990,,0,83372670,14834994,,0,82596280,14696847,,0,776390,138148,PDP
VK074,,1988,1986,,915,9149702,1628976,,0,0,0,,915,9149702,1628976,PDN
VK074,,1989,1986,,915,9149702,1628976,,0,0,0,,915,9149702,1628976,PDN
VK074,,1990,1986,,915,9149702,1628976,,0,0,0,,915,9149702,1628976,PDN
VK074,,1991,1986,,915,9149702,1628976,,0,0,0,,915,9149702,1628976,PDN
VK074,,1992,1986,,1115,11148490,1984832,,0,0,0,,1115,11148490,1984832,PDN
VK074,,1993,1986,,1115,11148490,1984832,,0,0,0,,1115,11148490,1984832,PDN
VK074,,1994,1986,,1110,11100887,1976357,,0,113087,20122,,1110,10987800,1956235,PDN
VK074,,1995,1986,,1718,17186706,3059851,,0,1195396,212704,,1718,15991310,2847147,PDN
VK074,,1996,1986,,1718,17186706,3059851,,0,1765730,314187,,1718,15420976,2745664,PDN
VK074,,1997,1986,,565,5704284,1015562,,0,1937027,344667,,565,3767257,670895,PDN
VK074,,1998,1986,,565,5704284,1015562,,0,2043787,363663,,565,3660497,651899,PDN
VK074,,1999,1986,,43,2795674,497494,,0,2146608,381959,,43,649066,115535,PDN
VK074,,2000,1986,,2099,23352587,4157364,,0,2231199,397010,,2099,21121388,3760354,PDN
VK074,,2001,1986,,2099,23352587,4157364,,0,2280621,405804,,2099,21071966,3751560,PDN
VK074,,2002,1986,,2099,23352587,4157364,,0,2318121,412477,,2099,21034466,3744887,PDN
VK074,,2003,1986,,43,2870253,510764,,0,2348431,417870,,43,521822,92894,PDN
VK074,,2004,1986,,0,2441141,434367,,0,2375616,422707,,0,65525,11660,PDN
VK074,,2005,1986,,0,2441141,434367,,0,2405609,428044,,0,35532,6323,PDN
VK074,,2006,1986,,0,2437636,433743,,0,2433737,433049,,0,3899,694,PDN
VK074,,2007,1986,,0,2490363,443125,,0,2468620,439256,,0,21743,3869,PDN
VK074,,2008,1986,,0,2491456,443320,,0,2491456,443320,,0,0,0,PDN
VK074,,2009,1986,,0,2531656,450473,,0,2531656,450473,,0,0,0,PDN
VK074,,2010,1986,,0,2531656,450473,,0,2531656,450473,,0,0,0,PDN
VK074,,2011,1986,,0,2531656,450473,,0,2531656,450473,,0,0,0,PDN
VK074,,2012,1986,,0,2531656,450473,,0,2531656,450473,,0,0,0,PDN
VK074,,2013,1986,,0,2531656,450473,,0,2531656,450473,,0,0,0,PDN
VK074,,2014,1986,,0,2531656,450473,,0,2531656,450473,,0,0,0,PDN
VK074,,2015,1986,,0,2531656,450473,,0,2531656,450473,,0,0,0,PDN
VK074,,2016,1986,,0,2531656,450473,,0,2531656,450473,,0,0,0,PDN
VK074,,2017,1986,,0,2531656,450473,,0,2531656,450473,,0,0,0,PDN
VK074,,2017,1986,,0,2531656,450473,,0,2531656,450473,,0,0,0,PDN
VK076,,1994,1988,,1358,13579966,2417722,,0,62808,11176,,1358,13517158,2406546,PDN
VK076,,1995,1988,,1358,13579966,2417722,,0,1494728,265966,,1358,12085238,2151756,PDN
VK076,,1996,1988,,1356,13556798,2413598,,0,2851279,507345,,1356,10705519,1906253,PDN
VK076,,1997,1988,,1356,13556798,2413598,,0,4024430,716091,,1356,9532368,1697507,PDN
VK076,,1998,1988,,1356,13556798,2413598,,0,5064602,901175,,1356,8492196,1512423,PDN
VK076,,1999,1988,,1356,13556798,2413598,,0,6021756,1071487,,1356,7535042,1342111,PDN
VK076,,2000,1988,,1358,13579583,2417654,,0,7216881,1284143,,1358,6362702,1133511,PDN
VK076,,2001,1988,,1358,13579583,2417654,,0,8317268,1479941,,1358,5262315,937713,PDN
VK076,,2002,1988,,1358,13579583,2417654,,0,9114144,1621734,,1358,4465439,795920,PDN
VK076,,2003,1988,,1358,13579583,2417654,,0,9692738,1724686,,1358,3886845,692968,PDN
VK076,,2004,1988,,2,12462985,2217615,,0,10043885,1787168,,2,2419100,430447,PDN
VK076,,2005,1988,,2,12462985,2217615,,0,10382217,1847370,,2,2080768,370245,PDN
VK076,,2006,1988,,2,12462985,2217615,,0,10697526,1903474,,2,1765459,314141,PDN
VK076,,2007,1988,,2,12462985,2217615,,0,10929978,1944836,,2,1533007,272779,PDN
VK076,,2008,1988,,2,12463020,2217621,,0,10969278,1951829,,2,1493742,265792,PDN
VK076,,2009,1988,,0,11094770,1974159,,0,11094770,1974159,,0,0,0,PDN
VK076,,2010,1988,,0,11094770,1974159,,0,11094770,1974159,,0,0,0,PDN
VK076,,2011,1988,,0,11094770,1974159,,0,11094770,1974159,,0,0,0,PDN
VK076,,2012,1988,,0,11094770,1974159,,0,11094770,1974159,,0,0,0,PDN
VK076,,2013,1988,,0,11094770,1974159,,0,11094770,1974159,,0,0,0,PDN
VK076,,2014,1988,,0,11094770,1974159,,0,11094770,1974159,,0,0,0,PDN
VK076,,2015,1988,,0,11094770,1974159,,0,11094770,1974159,,0,0,0,PDN
VK076,,2016,1988,,0,11094770,1974159,,0,11094770,1974159,,0,0,0,PDN
VK076,,2017,1988,,0,11094770,1974159,,0,11094770,1974159,,0,0,0,PDN
VK076,,2017,1988,,0,11094770,1974159,,0,11094770,1974159,,0,0,0,PDN
VK077,,2005,2005,,51,510356,90862,,0,0,0,,51,510356,90862,PDN
VK077,,2006,2005,,0,697988,124197,,0,120325,21410,,0,577663,102787,PDN
VK077,,2007,2005,,0,697988,124197,,0,581449,103461,,0,116539,20736,PDN
VK077,,2008,2005,,0,788619,140324,,0,729185,129748,,0,59434,10576,PDN
VK077,,2009,2005,,0,788619,140324,,0,788619,140324,,0,0,0,PDN
VK077,,2010,2005,,0,788619,140324,,0,788619,140324,,0,0,0,PDN
VK077,,2011,2005,,0,788619,140324,,0,788619,140324,,0,0,0,PDN
VK077,,2012,2005,,0,788619,140324,,0,788619,140324,,0,0,0,PDN
VK077,,2013,2005,,0,788619,140324,,0,788619,140324,,0,0,0,PDN
VK077,,2014,2005,,0,788619,140324,,0,788619,140324,,0,0,0,PDN
VK077,,2015,2005,,0,788619,140324,,0,788619,140324,,0,0,0,PDN
VK077,,2016,2005,,0,788619,140324,,0,788619,140324,,0,0,0,PDN
VK077,,2017,2005,,0,788619,140324,,0,788619,140324,,0,0,0,PDN
VK077,,2017,2005,,0,788619,140324,,0,788619,140324,,0,0,0,PDN
VK1003,,2005,2007,,4922009,24386789,9261295,,0,0,0,,4922009,24386789,9261295,PDN
VK1003,,2006,2007,,5610615,34231828,11701688,,0,0,0,,5610615,34231828,11701688,PDN
VK1003,,2007,2007,,5610615,34228328,11701065,,0,0,0,,5610615,34228328,11701065,PDN
VK1003,,2008,2007,,5610615,34228328,11701065,,0,0,0,,5610615,34228328,11701065,PDN
VK1003,,2009,2007,,4820507,29780251,10119484,,174176,1936210,518697,,4646331,27844041,9600787,PDN
VK1003,,2010,2007,,3195713,25888980,7802293,,890202,12962864,3196761,,2305511,12926116,4605532,PDN
VK1003,,2011,2007,,3059523,27711312,7990361,,1038915,17027358,4068694,,2020608,10683954,3921667,PDN
VK1003,,2012,2007,,3059523,27711312,7990361,,1101890,18095402,4321712,,1957633,9615910,3668649,PDN
VK1003,,2013,2007,,3059523,27711312,7990361,,1187759,21450793,5004626,,1871764,6260519,2985735,PDN
VK1003,,2014,2007,,1200290,21912518,5099315,,1200290,21912518,5099315,,0,0,0,PDN
VK1003,,2015,2007,,1200290,21912518,5099315,,1200290,21912518,5099315,,0,0,0,PDN
VK1003,,2016,2007,,1200290,21912518,5099315,,1200290,21912518,5099315,,0,0,0,PDN
VK1003,,2017,2007,,1200290,21912518,5099315,,1200290,21912518,5099315,,0,0,0,PDN
VK1003,,2017,2007,,1200290,21912518,5099315,,1200290,21912518,5099315,,0,0,0,PDN
VK114,,1998,1997,,2032,20317050,3617165,,0,0,0,,2032,20317050,3617165,PDN
VK114,,1999,1997,,0,86648581,15417897,,0,5267814,937333,,0,81380767,14480564,PDN
VK114,,2000,1997,,0,86648581,15417897,,0,25408417,4521071,,0,61240164,10896826,PDN
VK114,,2001,1997,,0,62760322,11167317,,0,44659135,7946465,,0,18101187,3220852,PDN
VK114,,2002,1997,,0,62760322,11167317,,0,53693084,9553930,,0,9067238,1613387,PDN
VK114,,2003,1997,,50,65875336,11721640,,0,58520533,10412906,,50,7354803,1308734,PDN
VK114,,2004,1997,,0,65542584,11662381,,0,60712786,10802987,,0,4829798,859394,PDN
VK114,,2005,1997,,0,60747106,10809094,,0,60747106,10809094,,0,0,0,PDN
VK114,,2006,1997,,0,60755197,10810533,,0,60755197,10810533,,0,0,0,PDN
VK114,,2007,1997,,0,60755197,10810533,,0,60755197,10810533,,0,0,0,PDN
VK114,,2008,1997,,0,60755197,10810533,,0,60755197,10810533,,0,0,0,PDN
VK114,,2009,1997,,0,60755197,10810533,,0,60755197,10810533,,0,0,0,PDN
VK114,,2010,1997,,0,60755197,10810533,,0,60755197,10810533,,0,0,0,PDN
VK114,,2011,1997,,0,60755197,10810533,,0,60755197,10810533,,0,0,0,PDN
VK114,,2012,1997,,0,60755197,10810533,,0,60755197,10810533,,0,0,0,PDN
VK114,,2013,1997,,0,60755197,10810533,,0,60755197,10810533,,0,0,0,PDN
VK114,,2014,1997,,0,60755197,10810533,,0,60755197,10810533,,0,0,0,PDN
VK114,,2015,1997,,0,60755197,10810533,,0,60755197,10810533,,0,0,0,PDN
VK114,,2016,1997,,0,60755197,10810533,,0,60755197,10810533,,0,0,0,PDN
VK114,,2017,1997,,0,60755197,10810533,,0,60755197,10810533,,0,0,0,PDN
VK114,,2017,1997,,0,60755197,10810533,,0,60755197,10810533,,0,0,0,PDN
VK121,,1997,1996,,83,825882,147037,,0,255743,45506,,83,570139,101531,PDN
VK121,,1998,1996,,83,825882,147037,,0,795067,141471,,83,30815,5566,PDN
VK121,,1999,1996,,0,985266,175314,,0,873861,155491,,0,111405,19823,PDN
VK121,,2000,1996,,0,885965,157645,,0,885965,157645,,0,0,0,PDN
VK121,,2001,1996,,0,888781,158146,,0,888781,158146,,0,0,0,PDN
VK121,,2002,1996,,0,888781,158146,,0,888781,158146,,0,0,0,PDN
VK121,,2003,1996,,0,888781,158146,,0,888781,158146,,0,0,0,PDN
VK121,,2004,1996,,0,888781,158146,,0,888781,158146,,0,0,0,PDN
VK121,,2005,1996,,0,888781,158146,,0,888781,158146,,0,0,0,PDN
VK121,,2006,1996,,0,888781,158146,,0,888781,158146,,0,0,0,PDN
VK121,,2007,1996,,0,888781,158146,,0,888781,158146,,0,0,0,PDN
VK121,,2008,1996,,0,888781,158146,,0,888781,158146,,0,0,0,PDN
VK121,,2009,1996,,0,903438,160754,,0,903438,160754,,0,0,0,PDN
VK121,,2010,1996,,0,903438,160754,,0,903438,160754,,0,0,0,PDN
VK121,,2011,1996,,0,903438,160754,,0,903438,160754,,0,0,0,PDN
VK121,,2012,1996,,0,903438,160754,,0,903438,160754,,0,0,0,PDN
VK121,,2013,1996,,0,903438,160754,,0,903438,160754,,0,0,0,PDN
VK121,,2014,1996,,0,903438,160754,,0,903438,160754,,0,0,0,PDN
VK121,,2015,1996,,0,903438,160754,,0,903438,160754,,0,0,0,PDN
VK121,,2016,1996,,0,903438,160754,,0,903438,160754,,0,0,0,PDN
VK121,,2017,1996,,0,903438,160754,,0,903438,160754,,0,0,0,PDN
VK121,,2017,1996,,0,903438,160754,,0,903438,160754,,0,0,0,PDN
VK122,,1997,1996,,56,558402,99416,,0,48821,8687,,56,509581,90729,PDN
VK122,,1998,1996,,56,558402,99416,,0,102969,18322,,56,455433,81094,PDN
VK122,,1999,1996,,56,558402,99416,,0,162473,28910,,56,395929,70506,PDN
VK122,,2000,1996,,0,170460,30331,,0,170460,30331,,0,0,0,PDN
VK122,,2001,1996,,0,170460,30331,,0,170460,30331,,0,0,0,PDN
VK122,,2002,1996,,0,170460,30331,,0,170460,30331,,0,0,0,PDN
VK122,,2003,1996,,0,170460,30331,,0,170460,30331,,0,0,0,PDN
VK122,,2004,1996,,0,170460,30331,,0,170460,30331,,0,0,0,PDN
VK122,,2005,1996,,0,170460,30331,,0,170460,30331,,0,0,0,PDN
VK122,,2006,1996,,0,170460,30331,,0,170460,30331,,0,0,0,PDN
VK122,,2007,1996,,0,170460,30331,,0,170460,30331,,0,0,0,PDN
VK122,,2008,1996,,0,170460,30331,,0,170460,30331,,0,0,0,PDN
VK122,,2009,1996,,0,172403,30677,,0,172403,30677,,0,0,0,PDN
VK122,,2010,1996,,0,172403,30677,,0,172403,30677,,0,0,0,PDN
VK122,,2011,1996,,0,172403,30677,,0,172403,30677,,0,0,0,PDN
VK122,,2012,1996,,0,172403,30677,,0,172403,30677,,0,0,0,PDN
VK122,,2013,1996,,0,172403,30677,,0,172403,30677,,0,0,0,PDN
VK122,,2014,1996,,0,172403,30677,,0,172403,30677,,0,0,0,PDN
VK122,,2015,1996,,0,172403,30677,,0,172403,30677,,0,0,0,PDN
VK122,,2016,1996,,0,172403,30677,,0,172403,30677,,0,0,0,PDN
VK122,,2017,1996,,0,172403,30677,,0,172403,30677,,0,0,0,PDN
VK122,,2017,1996,,0,172403,30677,,0,172403,30677,,0,0,0,PDN
VK123,,1997,1996,,249,2494925,444186,,0,263968,46969,,249,2230957,397217,PDN
VK123,,1998,1996,,249,2494925,444186,,0,446499,79448,,249,2048426,364738,PDN
VK123,,1999,1996,,0,508766,90528,,0,508766,90528,,0,0,0,PDN
VK123,,2000,1996,,0,547761,97466,,0,547761,97466,,0,0,0,PDN
VK123,,2001,1996,,0,557890,99269,,0,557890,99269,,0,0,0,PDN
VK123,,2002,1996,,0,557890,99269,,0,557890,99269,,0,0,0,PDN
VK123,,2003,1996,,0,557890,99269,,0,557890,99269,,0,0,0,PDN
VK123,,2004,1996,,0,557890,99269,,0,557890,99269,,0,0,0,PDN
VK123,,2005,1996,,0,557890,99269,,0,557890,99269,,0,0,0,PDN
VK123,,2006,1996,,0,557890,99269,,0,557890,99269,,0,0,0,PDN
VK123,,2007,1996,,0,557890,99269,,0,557890,99269,,0,0,0,PDN
VK123,,2008,1996,,0,557890,99269,,0,557890,99269,,0,0,0,PDN
VK123,,2009,1996,,0,566428,100788,,0,566428,100788,,0,0,0,PDN
VK123,,2010,1996,,0,566428,100788,,0,566428,100788,,0,0,0,PDN
VK123,,2011,1996,,0,566428,100788,,0,566428,100788,,0,0,0,PDN
VK123,,2012,1996,,0,566428,100788,,0,566428,100788,,0,0,0,PDN
VK123,,2013,1996,,0,566428,100788,,0,566428,100788,,0,0,0,PDN
VK123,,2014,1996,,0,566428,100788,,0,566428,100788,,0,0,0,PDN
VK123,,2015,1996,,0,566428,100788,,0,566428,100788,,0,0,0,PDN
VK123,,2016,1996,,0,566428,100788,,0,566428,100788,,0,0,0,PDN
VK123,,2017,1996,,0,566428,100788,,0,566428,100788,,0,0,0,PDN
VK123,,2017,1996,,0,566428,100788,,0,566428,100788,,0,0,0,PDN
VK124,,1995,1989,,8539,8538984,1527931,,0,0,0,,8539,8538984,1527931,PDN
VK124,,1996,1989,,8539,8538984,1527931,,0,0,0,,8539,8538984,1527931,PDN
VK124,,1997,1989,,447,4474162,796561,,0,1480485,263431,,447,2993677,533130,PDN
VK124,,1998,1989,,447,4474162,796561,,0,3475497,618416,,447,998665,178145,PDN
VK124,,1999,1989,,0,11475937,2041982,,0,5499780,978609,,0,5976157,1063373,PDN
VK124,,2000,1989,,0,11475937,2041982,,0,7513416,1336907,,0,3962521,705075,PDN
VK124,,2001,1989,,0,11499047,2046094,,0,9672456,1721078,,0,1826591,325016,PDN
VK124,,2002,1989,,0,11499047,2046094,,0,10697773,1903518,,0,801274,142576,PDN
VK124,,2003,1989,,0,11499047,2046094,,0,10958201,1949858,,0,540846,96236,PDN
VK124,,2004,1989,,0,11499047,2046094,,0,11170063,1987556,,0,328984,58538,PDN
VK124,,2005,1989,,0,11499047,2046094,,0,11307385,2011990,,0,191662,34104,PDN
VK124,,2006,1989,,0,11499047,2046094,,0,11428088,2033468,,0,70959,12626,PDN
VK124,,2007,1989,,0,11590445,2062357,,0,11543247,2053959,,0,47198,8398,PDN
VK124,,2008,1989,,0,11590445,2062357,,0,11590364,2062342,,0,81,15,PDN
VK124,,2009,1989,,0,11650128,2072977,,0,11650128,2072977,,0,0,0,PDN
VK124,,2010,1989,,0,11650128,2072977,,0,11650128,2072977,,0,0,0,PDN
VK124,,2011,1989,,0,11650128,2072977,,0,11650128,2072977,,0,0,0,PDN
VK124,,2012,1989,,0,11650128,2072977,,0,11650128,2072977,,0,0,0,PDN
VK124,,2013,1989,,0,11650128,2072977,,0,11650128,2072977,,0,0,0,PDN
VK124,,2014,1989,,0,11650128,2072977,,0,11650128,2072977,,0,0,0,PDN
VK124,,2015,1989,,0,11650128,2072977,,0,11650128,2072977,,0,0,0,PDN
VK124,,2016,1989,,0,11650128,2072977,,0,11650128,2072977,,0,0,0,PDN
VK124,,2017,1989,,0,11650128,2072977,,0,11650128,2072977,,0,0,0,PDN
VK124,,2017,1989,,0,11650128,2072977,,0,11650128,2072977,,0,0,0,PDN
VK155,,1995,1995,,944,1416315,252957,,0,0,0,,944,1416315,252957,PDN
VK155,,1996,1995,,1020,1530327,273320,,0,0,0,,1020,1530327,273320,PDN
VK155,,1997,1995,,1020,1530327,273320,,0,586723,104399,,1020,943604,168921,PDN
VK155,,1998,1995,,1020,1530327,273320,,0,693254,123355,,1020,837073,149965,PDN
VK155,,1999,1995,,0,693254,123355,,0,693254,123355,,0,0,0,PDN
VK155,,2000,1995,,0,693254,123355,,0,693254,123355,,0,0,0,PDN
VK155,,2001,1995,,0,693254,123355,,0,693254,123355,,0,0,0,PDN
VK155,,2002,1995,,0,693254,123355,,0,693254,123355,,0,0,0,PDN
VK155,,2003,1995,,0,693254,123355,,0,693254,123355,,0,0,0,PDN
VK155,,2004,1995,,0,693254,123355,,0,693254,123355,,0,0,0,PDN
VK155,,2005,1995,,0,693254,123355,,0,693254,123355,,0,0,0,PDN
VK155,,2006,1995,,0,693254,123355,,0,693254,123355,,0,0,0,PDN
VK155,,2007,1995,,0,693254,123355,,0,693254,123355,,0,0,0,PDN
VK155,,2008,1995,,0,693254,123355,,0,693254,123355,,0,0,0,PDN
VK155,,2009,1995,,0,706796,125764,,0,706796,125764,,0,0,0,PDN
VK155,,2010,1995,,0,706796,125764,,0,706796,125764,,0,0,0,PDN
VK155,,2011,1995,,0,706796,125764,,0,706796,125764,,0,0,0,PDN
VK155,,2012,1995,,0,706796,125764,,0,706796,125764,,0,0,0,PDN
VK155,,2013,1995,,0,706796,125764,,0,706796,125764,,0,0,0,PDN
VK155,,2014,1995,,0,706796,125764,,0,706796,125764,,0,0,0,PDN
VK155,,2015,1995,,0,706796,125764,,0,706796,125764,,0,0,0,PDN
VK155,,2016,1995,,0,706796,125764,,0,706796,125764,,0,0,0,PDN
VK155,,2017,1995,,0,706796,125764,,0,706796,125764,,0,0,0,PDN
VK155,,2017,1995,,0,706796,125764,,0,706796,125764,,0,0,0,PDN
VK156,,1990,1989,,1543,15433063,2747640,,0,0,0,,1543,15433063,2747640,PDN
VK156,,1991,1989,,1543,15433063,2747640,,7,451499,80345,,1536,14981564,2667295,PDN
VK156,,1992,1989,,1543,15433063,2747640,,7,1632598,290505,,1536,13800465,2457135,PDN
VK156,,1993,1989,,1543,15433063,2747640,,7,2960012,526700,,1536,12473051,2220940,PDN
VK156,,1994,1989,,1532,15324701,2728347,,7,3745292,666429,,1525,11579409,2061918,PDN
VK156,,1995,1989,,1531,15306167,2725048,,7,4024671,716141,,1524,11281496,2008907,PDN
VK156,,1996,1989,,100,5070787,902375,,7,4126986,734346,,93,943801,168029,PDN
VK156,,1997,1989,,7,4163703,740879,,7,4163703,740879,,0,0,0,PDN
VK156,,1998,1989,,7,4163703,740879,,7,4163703,740879,,0,0,0,PDN
VK156,,1999,1989,,7,4163703,740879,,7,4163703,740879,,0,0,0,PDN
VK156,,2000,1989,,7,4163703,740879,,7,4163703,740879,,0,0,0,PDN
VK156,,2001,1989,,7,4163703,740879,,7,4163703,740879,,0,0,0,PDN
VK156,,2002,1989,,7,4163703,740879,,7,4163703,740879,,0,0,0,PDN
VK156,,2003,1989,,7,4163703,740879,,7,4163703,740879,,0,0,0,PDN
VK156,,2004,1989,,7,4163703,740879,,7,4163703,740879,,0,0,0,PDN
VK156,,2005,1989,,7,4163703,740879,,7,4163703,740879,,0,0,0,PDN
VK156,,2006,1989,,7,4163703,740879,,7,4163703,740879,,0,0,0,PDN
VK156,,2007,1989,,7,4163703,740879,,7,4163703,740879,,0,0,0,PDN
VK156,,2008,1989,,7,4163703,740879,,7,4163703,740879,,0,0,0,PDN
VK156,,2009,1989,,7,4247094,755718,,7,4247094,755718,,0,0,0,PDN
VK156,,2010,1989,,7,4247094,755718,,7,4247094,755718,,0,0,0,PDN
VK156,,2011,1989,,7,4247094,755718,,7,4247094,755718,,0,0,0,PDN
VK156,,2012,1989,,7,4247094,755718,,7,4247094,755718,,0,0,0,PDN
VK156,,2013,1989,,7,4247094,755718,,7,4247094,755718,,0,0,0,PDN
VK156,,2014,1989,,7,4247094,755718,,7,4247094,755718,,0,0,0,PDN
VK156,,2015,1989,,7,4247094,755718,,7,4247094,755718,,0,0,0,PDN
VK156,,2016,1989,,7,4247094,755718,,7,4247094,755718,,0,0,0,PDN
VK156,,2017,1989,,7,4247094,755718,,7,4247094,755718,,0,0,0,PDN
VK156,,2017,1989,,7,4247094,755718,,7,4247094,755718,,0,0,0,PDN
VK161,,1995,1989,,1333,13331072,2373410,,0,0,0,,1333,13331072,2373410,PDN
VK161,,1996,1989,,1333,13331072,2373410,,0,0,0,,1333,13331072,2373410,PDN
VK161,,1997,1989,,1333,13331072,2373410,,0,822497,146352,,1333,12508575,2227058,PDN
VK161,,1998,1989,,1333,13331072,2373410,,0,1263213,224771,,1333,12067859,2148639,PDN
VK161,,1999,1989,,0,1692835,301216,,0,1384336,246323,,0,308499,54893,PDN
VK161,,2000,1989,,0,1692835,301216,,0,1495961,266185,,0,196874,35031,PDN
VK161,,2001,1989,,0,1625570,289247,,0,1625570,289247,,0,0,0,PDN
VK161,,2002,1989,,0,1625570,289247,,0,1625570,289247,,0,0,0,PDN
VK161,,2003,1989,,0,1625570,289247,,0,1625570,289247,,0,0,0,PDN
VK161,,2004,1989,,0,1625570,289247,,0,1625570,289247,,0,0,0,PDN
VK161,,2005,1989,,0,1625570,289247,,0,1625570,289247,,0,0,0,PDN
VK161,,2006,1989,,0,1625570,289247,,0,1625570,289247,,0,0,0,PDN
VK161,,2007,1989,,0,1625570,289247,,0,1625570,289247,,0,0,0,PDN
VK161,,2008,1989,,0,1625570,289247,,0,1625570,289247,,0,0,0,PDN
VK161,,2009,1989,,0,1648925,293403,,0,1648925,293403,,0,0,0,PDN
VK161,,2010,1989,,0,1648925,293403,,0,1648925,293403,,0,0,0,PDN
VK161,,2011,1989,,0,1648925,293403,,0,1648925,293403,,0,0,0,PDN
VK161,,2012,1989,,0,1648925,293403,,0,1648925,293403,,0,0,0,PDN
VK161,,2013,1989,,0,1648925,293403,,0,1648925,293403,,0,0,0,PDN
VK161,,2014,1989,,0,1648925,293403,,0,1648925,293403,,0,0,0,PDN
VK161,,2015,1989,,0,1648925,293403,,0,1648925,293403,,0,0,0,PDN
VK161,,2016,1989,,0,1648925,293403,,0,1648925,293403,,0,0,0,PDN
VK161,,2017,1989,,0,1648925,293403,,0,1648925,293403,,0,0,0,PDN
VK161,,2017,1989,,0,1648925,293403,,0,1648925,293403,,0,0,0,PDN
VK204,,1985,1982,,1,4649941,827393,,0,0,0,,1,4649941,827393,PDP
VK204,,1986,1982,,1,4649941,827393,,0,0,0,,1,4649941,827393,PDP
VK204,,1987,1982,,1,4649941,827393,,0,0,0,,1,4649941,827393,PDP
VK204,,1993,1982,,7260,69494396,12372811,,305,4116981,732864,,6955,65377415,11639947,PDP
VK204,,1994,1982,,7331,69936038,12451466,,1306,14496089,2580681,,6025,55439949,9870785,PDP
VK204,,1995,1982,,7571,72609982,12927497,,2583,23591193,4200304,,4988,49018789,8727193,PDP
VK204,,1996,1982,,7143,74317250,13230853,,3441,29275566,5212616,,3702,45041684,8018237,PDP
VK204,,1997,1982,,7060,74052341,13183633,,4170,34408301,6126643,,2890,39644040,7056990,PDP
VK204,,1998,1982,,6960,76858626,13682872,,4725,39185862,6977298,,2235,37672764,6705574,PDP
VK204,,1999,1982,,7451,58930804,10493360,,5216,43673127,7776235,,2235,15257677,2717125,PDP
VK204,,2000,1982,,7476,59254590,10550997,,5610,46954623,8360525,,1866,12299967,2190472,PDP
VK204,,2001,1982,,7490,59393202,10575675,,5841,48972354,8719783,,1649,10420848,1855892,PDP
VK204,,2002,1982,,7490,60143832,10709239,,6052,51351677,9143361,,1438,8792155,1565878,PDP
VK204,,2003,1982,,6525,57648902,10264337,,6238,52741101,9390776,,287,4907801,873561,PDP
VK204,,2004,1982,,6525,57648902,10264337,,6278,53774238,9574648,,247,3874664,689689,PDP
VK204,,2005,1982,,6525,57648902,10264337,,6278,54736089,9745796,,247,2912813,518541,PDP
VK204,,2006,1982,,6318,64121384,11415817,,6278,56640233,10084611,,40,7481151,1331206,PDP
VK204,,2007,1982,,6318,64121384,11415817,,6278,57896137,10308082,,40,6225247,1107735,PDP
VK204,,2008,1982,,6318,64851964,11545814,,6278,58913388,10489087,,40,5938576,1056727,PDP
VK204,,2009,1982,,6686,64781752,11533689,,6278,60565685,10783091,,408,4216067,750598,PDP
VK204,,2010,1982,,6304,62796153,11179997,,6278,61327392,10918626,,26,1468761,261372,PDP
VK204,,2011,1982,,6304,65589133,11676968,,6278,61854072,11012341,,26,3735061,664628,PDP
VK204,,2012,1982,,6304,65589133,11676968,,6278,62242976,11081541,,26,3346157,595428,PDP
VK204,,2013,1982,,6304,65589133,11676968,,6278,62924616,11202829,,26,2664517,474140,PDP
VK204,,2014,1982,,6304,65589133,11676968,,6278,63456422,11297456,,26,2132711,379512,PDP
VK204,,2015,1982,,6304,65589133,11676968,,6278,63974112,11389572,,26,1615021,287397,PDP
VK204,,2016,1982,,6638,65589133,11677302,,6278,64296312,11446903,,360,1292821,230400,PDP
VK204,,2017,1982,,6638,65502913,11661961,,6278,64803601,11537168,,360,699312,124793,PDP
VK204,,2017,1982,,6638,65502913,11661961,,6278,64803601,11537168,,360,699312,124793,PDP
VK209,,1994,1988,,124,1242767,221257,,0,0,0,,124,1242767,221257,PDN
VK209,,1995,1988,,124,1242767,221257,,0,0,0,,124,1242767,221257,PDN
VK209,,1996,1988,,123,1229259,218852,,0,0,0,,123,1229259,218852,PDN
VK209,,1997,1988,,783,7824851,1393105,,0,420720,74861,,783,7404131,1318244,PDN
VK209,,1998,1988,,783,7824851,1393105,,0,2320611,412920,,783,5504240,980185,PDN
VK209,,1999,1988,,783,7824851,1393105,,0,3679982,654801,,783,4144869,738304,PDN
VK209,,2000,1988,,783,7824851,1393105,,0,4470657,795491,,783,3354194,597614,PDN
VK209,,2001,1988,,0,4677271,832255,,0,4677271,832255,,0,0,0,PDN
VK209,,2002,1988,,0,4677271,832255,,0,4677271,832255,,0,0,0,PDN
VK209,,2003,1988,,0,4677271,832255,,0,4677271,832255,,0,0,0,PDN
VK209,,2004,1988,,0,4677271,832255,,0,4677271,832255,,0,0,0,PDN
VK209,,2005,1988,,0,4677271,832255,,0,4677271,832255,,0,0,0,PDN
VK209,,2006,1988,,0,4677271,832255,,0,4677271,832255,,0,0,0,PDN
VK209,,2007,1988,,0,4677271,832255,,0,4677271,832255,,0,0,0,PDN
VK209,,2008,1988,,0,4677271,832255,,0,4677271,832255,,0,0,0,PDN
VK209,,2009,1988,,0,4710327,838136,,0,4710327,838136,,0,0,0,PDN
VK209,,2010,1988,,0,4710327,838136,,0,4710327,838136,,0,0,0,PDN
VK209,,2011,1988,,0,4710327,838136,,0,4710327,838136,,0,0,0,PDN
VK209,,2012,1988,,0,4710327,838136,,0,4710327,838136,,0,0,0,PDN
VK209,,2013,1988,,0,4710327,838136,,0,4710327,838136,,0,0,0,PDN
VK209,,2014,1988,,0,4710327,838136,,0,4710327,838136,,0,0,0,PDN
VK209,,2015,1988,,0,4710327,838136,,0,4710327,838136,,0,0,0,PDN
VK209,,2016,1988,,0,4710327,838136,,0,4710327,838136,,0,0,0,PDN
VK209,,2017,1988,,0,4710327,838136,,0,4710327,838136,,0,0,0,PDN
VK209,,2017,1988,,0,4710327,838136,,0,4710327,838136,,0,0,0,PDN
VK213,,1994,1990,,983,3053234,544263,,0,0,0,,983,3053234,544263,PDN
VK213,,1995,1990,,983,3053234,544263,,0,0,0,,983,3053234,544263,PDN
VK213,,2003,1990,,924,9231099,1643468,,0,0,0,,924,9231099,1643468,PDN
VK213,,2004,1990,,924,9231099,1643468,,0,1059830,188582,,924,8171269,1454886,PDN
VK213,,2005,1990,,0,1456683,259196,,0,1339412,238330,,0,117271,20866,PDN
VK213,,2006,1990,,0,1456683,259196,,0,1456683,259196,,0,0,0,PDN
VK213,,2007,1990,,0,1456683,259196,,0,1456683,259196,,0,0,0,PDN
VK213,,2008,1990,,0,1544215,274771,,0,1544215,274771,,0,0,0,PDN
VK213,,2009,1990,,0,1544215,274771,,0,1544215,274771,,0,0,0,PDN
VK213,,2010,1990,,0,1544215,274771,,0,1544215,274771,,0,0,0,PDN
VK213,,2011,1990,,0,1544215,274771,,0,1544215,274771,,0,0,0,PDN
VK213,,2012,1990,,0,1544215,274771,,0,1544215,274771,,0,0,0,PDN
VK213,,2013,1990,,0,1544215,274771,,0,1544215,274771,,0,0,0,PDN
VK213,,2014,1990,,0,1544215,274771,,0,1544215,274771,,0,0,0,PDN
VK213,,2015,1990,,0,1544215,274771,,0,1544215,274771,,0,0,0,PDN
VK213,,2016,1990,,0,1544215,274771,,0,1544215,274771,,0,0,0,PDN
VK213,,2017,1990,,0,1544215,274771,,0,1544215,274771,,0,0,0,PDN
VK213,,2017,1990,,0,1544215,274771,,0,1544215,274771,,0,0,0,PDN
VK251,,1999,1997,,3151,31507158,5609407,,0,0,0,,3151,31507158,5609407,PDP
VK251,,2000,1997,,0,36951312,6574967,,0,2679284,476741,,0,34272028,6098226,PDP
VK251,,2001,1997,,0,95728627,17033564,,0,18014915,3205501,,0,77713712,13828063,PDP
VK251,,2002,1997,,3684,78449071,13962593,,0,28503249,5071752,,3684,49945822,8890841,PDP
VK251,,2003,1997,,0,79452998,14137544,,0,39512686,7030727,,0,39940312,7106817,PDP
VK251,,2004,1997,,0,75423805,13420606,,0,48461940,8623121,,0,26961865,4797485,PDP
VK251,,2005,1997,,0,70630077,12567629,,0,53810793,9574874,,0,16819284,2992755,PDP
VK251,,2006,1997,,0,70630077,12567629,,0,57097138,10159633,,0,13532939,2407996,PDP
VK251,,2007,1997,,1900,85831580,15274423,,348,59430482,10575167,,1552,26401098,4699256,PDP
VK251,,2008,1997,,1900,85831580,15274423,,1707,61665397,10974198,,193,24166183,4300225,PDP
VK251,,2009,1997,,7444,86488965,15396940,,2210,63652620,11328298,,5234,22836345,4068640,PDP
VK251,,2010,1997,,7635,85130931,15155488,,2593,65374551,11635075,,5042,19756380,3520411,PDP
VK251,,2011,1997,,7748,85930636,15297897,,5256,66962420,11920277,,2492,18968216,3377618,PDP
VK251,,2012,1997,,7748,85930636,15297897,,5956,68377886,12172839,,1792,17552750,3125056,PDP
VK251,,2013,1997,,7267,85930636,15297416,,6058,69525934,12377220,,1209,16404702,2920194,PDP
VK251,,2014,1997,,8155,82478850,14684106,,6349,70683699,12583519,,1806,11795151,2100587,PDP
VK251,,2015,1997,,8294,82478850,14684245,,6575,71731807,12770241,,1719,10747043,1914004,PDP
VK251,,2016,1997,,7327,80055053,14251998,,6634,72663697,12936117,,693,7391356,1315881,PDP
VK251,,2017,1997,,7327,80055053,14251998,,6683,73523070,13089079,,644,6531983,1162918,PDP
VK251,,2017,1997,,7327,80055053,14251998,,6683,73523070,13089079,,644,6531983,1162918,PDP
VK252,,1994,1994,,900322,150353693,27653648,,0,0,0,,900322,150353693,27653648,PDN
VK252,,1995,1994,,900322,150353693,27653648,,0,0,0,,900322,150353693,27653648,PDN
VK252,,1996,1994,,900322,150353693,27653648,,0,0,0,,900322,150353693,27653648,PDN
VK252,,1997,1994,,900322,150353693,27653648,,0,0,0,,900322,150353693,27653648,PDN
VK252,,1998,1994,,1659,16592774,2954110,,0,0,0,,1659,16592774,2954110,PDN
VK252,,1999,1994,,2951,29510321,5253898,,0,0,0,,2951,29510321,5253898,PDN
VK252,,2000,1994,,44,2225365,396017,,0,1781572,317006,,44,443793,79011,PDN
VK252,,2001,1994,,39,7137436,1270046,,0,6745854,1200330,,39,391582,69716,PDN
VK252,,2002,1994,,39,7137436,1270046,,0,6745854,1200330,,39,391582,69716,PDN
VK252,,2003,1994,,39,7137436,1270046,,0,6745854,1200330,,39,391582,69716,PDN
VK252,,2004,1994,,39,7137436,1270046,,0,6745854,1200330,,39,391582,69716,PDN
VK252,,2005,1994,,39,7137436,1270046,,0,6745854,1200330,,39,391582,69716,PDN
VK252,,2006,1994,,39,7137436,1270046,,0,6745854,1200330,,39,391582,69716,PDN
VK252,,2007,1994,,39,7137436,1270046,,0,6745854,1200330,,39,391582,69716,PDN
VK252,,2008,1994,,39,7137436,1270046,,0,6745854,1200330,,39,391582,69716,PDN
VK252,,2009,1994,,40,7145312,1271448,,0,6745854,1200330,,40,399458,71118,PDN
VK252,,2010,1994,,40,7145312,1271448,,0,6745854,1200330,,40,399458,71118,PDN
VK252,,2011,1994,,40,7145312,1271448,,0,6745854,1200330,,40,399458,71118,PDN
VK252,,2012,1994,,40,7145312,1271448,,0,6745854,1200330,,40,399458,71118,PDN
VK252,,2013,1994,,40,7145312,1271448,,0,6745854,1200330,,40,399458,71118,PDN
VK252,,2014,1994,,40,7145312,1271448,,0,6745854,1200330,,40,399458,71118,PDN
VK252,,2015,1994,,40,7145312,1271448,,0,6745854,1200330,,40,399458,71118,PDN
VK252,,2016,1994,,0,6745854,1200330,,0,6745854,1200330,,0,0,0,PDN
VK252,,2017,1994,,0,6745854,1200330,,0,6745854,1200330,,0,0,0,PDN
VK252,,2017,1994,,0,6745854,1200330,,0,6745854,1200330,,0,0,0,PDN
VK294,,1992,1988,,849,8490523,1511618,,0,0,0,,849,8490523,1511618,PDN
VK294,,1993,1988,,849,8490523,1511618,,0,0,0,,849,8490523,1511618,PDN
VK294,,1994,1988,,844,8434036,1501562,,0,500727,89097,,844,7933309,1412465,PDN
VK294,,1995,1988,,844,8434036,1501562,,0,1436950,255685,,844,6997086,1245877,PDN
VK294,,1996,1988,,84,3901363,694277,,0,2193786,390353,,84,1707577,303924,PDN
VK294,,1997,1988,,84,3901363,694277,,0,2710149,482233,,84,1191214,212044,PDN
VK294,,1998,1988,,84,3901363,694277,,0,3247111,577778,,84,654252,116499,PDN
VK294,,1999,1988,,84,4431466,788601,,0,3670138,653049,,84,761328,135552,PDN
VK294,,2000,1988,,84,4431466,788601,,0,3809594,677864,,84,621872,110737,PDN
VK294,,2001,1988,,0,3809594,677864,,0,3809594,677864,,0,0,0,PDN
VK294,,2002,1988,,0,3809594,677864,,0,3809594,677864,,0,0,0,PDN
VK294,,2003,1988,,0,3809594,677864,,0,3809594,677864,,0,0,0,PDN
VK294,,2004,1988,,0,3809594,677864,,0,3809594,677864,,0,0,0,PDN
VK294,,2005,1988,,0,3809594,677864,,0,3809594,677864,,0,0,0,PDN
VK294,,2006,1988,,0,3809594,677864,,0,3809594,677864,,0,0,0,PDN
VK294,,2007,1988,,0,3809594,677864,,0,3809594,677864,,0,0,0,PDN
VK294,,2008,1988,,0,3809594,677864,,0,3809594,677864,,0,0,0,PDN
VK294,,2009,1988,,0,3871767,688927,,0,3871767,688927,,0,0,0,PDN
VK294,,2010,1988,,0,3871767,688927,,0,3871767,688927,,0,0,0,PDN
VK294,,2011,1988,,0,3871767,688927,,0,3871767,688927,,0,0,0,PDN
VK294,,2012,1988,,0,3871767,688927,,0,3871767,688927,,0,0,0,PDN
VK294,,2013,1988,,0,3871767,688927,,0,3871767,688927,,0,0,0,PDN
VK294,,2014,1988,,0,3871767,688927,,0,3871767,688927,,0,0,0,PDN
VK294,,2015,1988,,0,3871767,688927,,0,3871767,688927,,0,0,0,PDN
VK294,,2016,1988,,0,3871767,688927,,0,3871767,688927,,0,0,0,PDN
VK294,,2017,1988,,0,3871767,688927,,0,3871767,688927,,0,0,0,PDN
VK294,,2017,1988,,0,3871767,688927,,0,3871767,688927,,0,0,0,PDN
VK340,,2000,2001,,1835,18353683,3267615,,0,0,0,,1835,18353683,3267615,PDP
VK340,,2001,2001,,892,31451101,5597173,,0,38905,6923,,892,31412196,5590250,PDP
VK340,,2002,2001,,892,31444868,5596064,,0,8752179,1557327,,892,22692689,4038737,PDP
VK340,,2003,2001,,892,44363822,7894810,,0,15586059,2773320,,892,28777763,5121490,PDP
VK340,,2004,2001,,892,44363822,7894810,,0,21433398,3813772,,892,22930424,4081038,PDP
VK340,,2005,2001,,892,44363822,7894810,,0,26598351,4732803,,892,17765471,3162007,PDP
VK340,,2006,2001,,892,44363822,7894810,,0,31206518,5552761,,892,13157304,2342049,PDP
VK340,,2007,2001,,1992,64044731,11397852,,422,35159436,6256549,,1570,28885295,5141303,PDP
VK340,,2008,2001,,1992,64044731,11397852,,1437,38768260,6899704,,555,25276471,4498148,PDP
VK340,,2009,2001,,2402,64143338,11415808,,1467,41999206,7474635,,935,22144132,3941172,PDP
VK340,,2010,2001,,1970,68871436,12256674,,1468,45034979,8014809,,502,23836457,4241865,PDP
VK340,,2011,2001,,2198,71532045,12730320,,1601,47750008,8498044,,597,23782037,4232276,PDP
VK340,,2012,2001,,2218,71532045,12730340,,1686,50225756,8938653,,532,21306289,3791687,PDP
VK340,,2013,2001,,2218,71532045,12730340,,1711,52429405,9330787,,507,19102640,3399553,PDP
VK340,,2014,2001,,2218,71532045,12730340,,1716,54508382,9700716,,502,17023663,3029624,PDP
VK340,,2015,2001,,2334,71532045,12730456,,1823,56349785,10028475,,511,15182260,2701981,PDP
VK340,,2016,2001,,2431,66532045,11840873,,1873,58001954,10322505,,558,8530091,1518368,PDP
VK340,,2017,2001,,2666,66532045,11841108,,2009,59496793,10588627,,657,7035252,1252481,PDP
VK340,,2017,2001,,2666,66532045,11841108,,2009,59496793,10588627,,657,7035252,1252481,PDP
VK384,,1999,2000,,2275,22745677,4049548,,0,0,0,,2275,22745677,4049548,PDN
VK384,,2000,2000,,2275,22745677,4049548,,0,0,0,,2275,22745677,4049548,PDN
VK384,,2001,2000,,27702,16759972,3009903,,0,0,0,,27702,16759972,3009903,PDN
VK384,,2002,2000,,27702,16759972,3009903,,0,1520407,270535,,27702,15239565,2739368,PDN
VK384,,2003,2000,,0,19133680,3404569,,0,8399496,1494572,,0,10734184,1909997,PDN
VK384,,2004,2000,,0,19133680,3404569,,0,11829128,2104827,,0,7304552,1299742,PDN
VK384,,2005,2000,,0,19133680,3404569,,0,14241553,2534084,,0,4892127,870485,PDN
VK384,,2006,2000,,0,22638300,4028167,,0,17039635,3031964,,0,5598665,996203,PDN
VK384,,2007,2000,,0,22638300,4028167,,0,19013820,3383242,,0,3624480,644925,PDN
VK384,,2008,2000,,0,22638300,4028167,,0,20682858,3680224,,0,1955442,347943,PDN
VK384,,2009,2000,,16,23364837,4157460,,16,22021315,3918399,,0,1343522,239061,PDN
VK384,,2010,2000,,16,23364837,4157460,,16,23123303,4114483,,0,241534,42978,PDN
VK384,,2011,2000,,17,23890704,4251032,,16,23476284,4177291,,1,414420,73741,PDN
VK384,,2012,2000,,16,23890704,4251031,,16,23847137,4243279,,0,43567,7752,PDN
VK384,,2013,2000,,16,23890704,4251031,,16,23890704,4251031,,0,0,0,PDN
VK384,,2014,2000,,16,23890704,4251031,,16,23890704,4251031,,0,0,0,PDN
VK384,,2015,2000,,16,23890704,4251031,,16,23890704,4251031,,0,0,0,PDN
VK384,,2016,2000,,16,23890704,4251031,,16,23890704,4251031,,0,0,0,PDN
VK384,,2017,2000,,16,23890704,4251031,,16,23890704,4251031,,0,0,0,PDN
VK384,,2017,2000,,16,23890704,4251031,,16,23890704,4251031,,0,0,0,PDN
VK385,,1999,1999,,31363,37635381,6728050,,0,0,0,,31363,37635381,6728050,PDN
VK385,,2000,1999,,55297,37635381,6751984,,5754,4387487,786446,,49543,33247894,5965538,PDN
VK385,,2001,1999,,72614,43931443,7889597,,20317,13226296,2373750,,52297,30705147,5515847,PDN
VK385,,2002,1999,,72614,43931443,7889597,,31041,18574159,3336051,,41573,25357284,4553546,PDN
VK385,,2003,1999,,72614,43931443,7889597,,38939,22947403,4122107,,33675,20984040,3767490,PDN
VK385,,2004,1999,,72614,43931443,7889597,,44702,26277678,4720445,,27912,17653765,3169152,PDN
VK385,,2005,1999,,67459,37655522,6767730,,48506,28432449,5107661,,18953,9223073,1660069,PDN
VK385,,2006,1999,,67459,37655522,6767730,,52034,30465040,5472860,,15425,7190482,1294870,PDN
VK385,,2007,1999,,67459,37655522,6767730,,54845,32143560,5774340,,12614,5511962,993390,PDN
VK385,,2008,1999,,67459,37655522,6767730,,56808,33272698,5977217,,10651,4382824,790513,PDN
VK385,,2009,1999,,68818,38413942,6904039,,59048,34384413,6177271,,9770,4029529,726768,PDN
VK385,,2010,1999,,60409,35212780,6326028,,60364,35186342,6321279,,45,26438,4749,PDN
VK385,,2011,1999,,61472,35726152,6418439,,61272,35693143,6412365,,200,33009,6073,PDN
VK385,,2012,1999,,61472,35726152,6418439,,61472,35726152,6418439,,0,0,0,PDN
VK385,,2013,1999,,61472,35726152,6418439,,61472,35726152,6418439,,0,0,0,PDN
VK385,,2014,1999,,61472,35726152,6418439,,61472,35726152,6418439,,0,0,0,PDN
VK385,,2015,1999,,61472,35726152,6418439,,61472,35726152,6418439,,0,0,0,PDN
VK385,,2016,1999,,61472,35726152,6418439,,61472,35726152,6418439,,0,0,0,PDN
VK385,,2017,1999,,61472,35726152,6418439,,61472,35726152,6418439,,0,0,0,PDN
VK385,,2017,1999,,61472,35726152,6418439,,61472,35726152,6418439,,0,0,0,PDN
VK432,,2005,2005,,27,267658,47653,,0,0,0,,27,267658,47653,PDN
VK432,,2006,2005,,27,267968,47708,,0,86724,15431,,27,181244,32277,PDN
VK432,,2007,2005,,27,267968,47708,,0,180118,32049,,27,87850,15659,PDN
VK432,,2008,2005,,27,267968,47708,,0,189894,33789,,27,78074,13919,PDN
VK432,,2009,2005,,0,189894,33789,,0,189894,33789,,0,0,0,PDN
VK432,,2010,2005,,0,189894,33789,,0,189894,33789,,0,0,0,PDN
VK432,,2011,2005,,0,189894,33789,,0,189894,33789,,0,0,0,PDN
VK432,,2012,2005,,0,189894,33789,,0,189894,33789,,0,0,0,PDN
VK432,,2013,2005,,0,189894,33789,,0,189894,33789,,0,0,0,PDN
VK432,,2014,2005,,0,189894,33789,,0,189894,33789,,0,0,0,PDN
VK432,,2015,2005,,0,189894,33789,,0,189894,33789,,0,0,0,PDN
VK432,,2016,2005,,0,189894,33789,,0,189894,33789,,0,0,0,PDN
VK432,,2017,2005,,0,189894,33789,,0,189894,33789,,0,0,0,PDN
VK432,,2017,2005,,0,189894,33789,,0,189894,33789,,0,0,0,PDN
VK734,,1998,1997,,10270486,21475586,14091765,,0,0,0,,10270486,21475586,14091765,PDP
VK734,,1999,1997,,10270486,15919253,13103093,,448568,678195,569243,,9821918,15241058,12533850,PDP
VK734,,2000,1997,,10270486,15919253,13103093,,3298542,5275285,4237205,,6971944,10643968,8865888,PDP
VK734,,2001,1997,,8017002,13901481,10490575,,5570967,9314096,7228279,,2446035,4587385,3262296,PDP
VK734,,2002,1997,,12081677,23906745,16335546,,7311040,12407354,9518754,,4770637,11499391,6816792,PDP
VK734,,2003,1997,,12081033,23957659,16343962,,8927207,17243542,11995453,,3153826,6714117,4348509,PDP
VK734,,2004,1997,,11264297,22256225,15224479,,10273321,20295896,13884690,,990976,1960329,1339789,PDP
VK734,,2005,1997,,11853192,23237517,15987982,,10723445,21192595,14494369,,1129747,2044922,1493613,PDP
VK734,,2006,1997,,11853201,23296249,15998441,,11011112,21762036,14883360,,842089,1534213,1115081,PDP
VK734,,2007,1997,,11853201,23413539,16019311,,11208101,22153394,15149986,,645100,1260145,869325,PDP
VK734,,2008,1997,,11371641,22448358,15366011,,11337655,22381311,15320095,,33986,67047,45916,PDP
VK734,,2009,1997,,11895935,24575741,16268843,,11371447,22437382,15363864,,524488,2138359,904979,PDP
VK734,,2010,1997,,12067224,26759684,16828734,,11581953,24142582,15877786,,485271,2617102,950948,PDP
VK734,,2011,1997,,12089707,26906791,16877392,,11780824,25405702,16301411,,308883,1501089,575981,PDP
VK734,,2012,1997,,12089707,26895063,16875305,,11961291,26288085,16638886,,128416,606978,236419,PDP
VK734,,2013,1997,,12131611,27304027,16989979,,12075451,26950489,16870911,,56160,353538,119067,PDP
VK734,,2014,1997,,12161602,27511314,17056854,,12140618,27473262,17029099,,20984,38052,27755,PDP
VK734,,2015,1997,,12267084,28563336,17349529,,12197711,27899083,17161960,,69373,664253,187567,PDP
VK734,,2016,1997,,14904182,33446567,20855528,,14831047,33083900,20717862,,73135,362667,137667,PDP
VK734,,2017,1997,,14904182,33605700,20883844,,14880790,33424803,20828264,,23392,180897,55580,PDP
VK734,,2017,1997,,14904182,33605700,20883844,,14880790,33424803,20828264,,23392,180897,55580,PDP
VK738,,2000,2000,,2570702,5489930,3547558,,0,0,0,,2570702,5489930,3547558,PDN
VK738,,2001,2000,,2570702,4073507,3295525,,76160,66148,87930,,2494542,4007359,3207595,PDN
VK738,,2002,2000,,4659183,7738828,6036199,,530191,658473,647357,,4128992,7080355,5388842,PDN
VK738,,2003,2000,,2570702,4536222,3377859,,1793216,2704400,2274426,,777486,1831822,1103433,PDN
VK738,,2004,2000,,2888274,5027566,3782859,,2379852,3655073,3030221,,508422,1372493,752638,PDN
VK738,,2005,2000,,3200042,5437683,4167601,,2592188,3968979,3298412,,607854,1468704,869189,PDN
VK738,,2006,2000,,3200042,5332084,4148811,,2747578,4162835,3488296,,452464,1169249,660515,PDN
VK738,,2007,2000,,3200042,5424883,4165324,,2904821,4443995,3695567,,295221,980888,469757,PDN
VK738,,2008,2000,,3040729,5288341,3981715,,3040589,4682389,3873754,,140,605952,107961,PDN
VK738,,2009,2000,,3203081,5573290,4194769,,3147202,4854939,4011070,,55879,718351,183699,PDN
VK738,,2010,2000,,3203081,5573290,4194769,,3203019,4955380,4084759,,62,617910,110010,PDN
VK738,,2011,2000,,3203019,4955380,4084759,,3203019,4955380,4084759,,0,0,0,PDN
VK738,,2012,2000,,3203019,4955380,4084759,,3203019,4955380,4084759,,0,0,0,PDN
VK738,,2013,2000,,3203019,4955380,4084759,,3203019,4955380,4084759,,0,0,0,PDN
VK738,,2014,2000,,3203019,4955380,4084759,,3203019,4955380,4084759,,0,0,0,PDN
VK738,,2015,2000,,3203019,4955380,4084759,,3203019,4955380,4084759,,0,0,0,PDN
VK738,,2016,2000,,3203019,4955380,4084759,,3203019,4955380,4084759,,0,0,0,PDN
VK738,,2017,2000,,3203019,4955380,4084759,,3203019,4955380,4084759,,0,0,0,PDN
VK738,,2017,2000,,3203019,4955380,4084759,,3203019,4955380,4084759,,0,0,0,PDN
VK739,,2000,2000,,86641,175493,117868,,0,0,0,,86641,175493,117868,PDN
VK739,,2001,2000,,86662,175493,117889,,86662,175493,117889,,0,0,0,PDN
VK739,,2002,2000,,86662,175493,117889,,86662,175493,117889,,0,0,0,PDN
VK739,,2003,2000,,86662,175493,117889,,86662,175493,117889,,0,0,0,PDN
VK739,,2004,2000,,86662,175493,117889,,86662,175493,117889,,0,0,0,PDN
VK739,,2005,2000,,86662,175493,117889,,86662,175493,117889,,0,0,0,PDN
VK739,,2006,2000,,86662,175493,117889,,86662,175493,117889,,0,0,0,PDN
VK739,,2007,2000,,86662,175493,117889,,86662,175493,117889,,0,0,0,PDN
VK739,,2008,2000,,86662,175493,117889,,86662,175493,117889,,0,0,0,PDN
VK739,,2009,2000,,86662,175493,117889,,86662,175493,117889,,0,0,0,PDN
VK739,,2010,2000,,86662,175493,117889,,86662,175493,117889,,0,0,0,PDN
VK739,,2011,2000,,86662,175493,117889,,86662,175493,117889,,0,0,0,PDN
VK739,,2012,2000,,86662,175493,117889,,86662,175493,117889,,0,0,0,PDN
VK739,,2013,2000,,86662,175493,117889,,86662,175493,117889,,0,0,0,PDN
VK739,,2014,2000,,86662,175493,117889,,86662,175493,117889,,0,0,0,PDN
VK739,,2015,2000,,86662,175493,117889,,86662,175493,117889,,0,0,0,PDN
VK739,,2016,2000,,86662,175493,117889,,86662,175493,117889,,0,0,0,PDN
VK739,,2017,2000,,86662,175493,117889,,86662,175493,117889,,0,0,0,PDN
VK739,,2017,2000,,86662,175493,117889,,86662,175493,117889,,0,0,0,PDN
VK742,,1997,1997,,1247,12473432,2220719,,0,0,0,,1247,12473432,2220719,PDP
VK742,,1998,1997,,1247,12473432,2220719,,0,0,0,,1247,12473432,2220719,PDP
VK742,,1999,1997,,1247,12473432,2220719,,0,0,0,,1247,12473432,2220719,PDP
VK742,,2000,1997,,1247,12473432,2220719,,0,0,0,,1247,12473432,2220719,PDP
VK742,,2001,1997,,1251,12514404,2228013,,0,0,0,,1251,12514404,2228013,PDP
VK742,,2002,1997,,519263,35872262,6902228,,125570,7464173,1453715,,393693,28408089,5448513,PDP
VK742,,2003,1997,,466917,35872262,6849882,,235950,15934604,3071289,,230967,19937658,3778593,PDP
VK742,,2004,1997,,470987,35872262,6853952,,269102,20671876,3947372,,201885,15200386,2906580,PDP
VK742,,2005,1997,,435791,34299834,6538964,,335140,24814938,4750609,,100651,9484896,1788355,PDP
VK742,,2006,1997,,448414,36500873,6943231,,363901,28641686,5460286,,84513,7859187,1482945,PDP
VK742,,2007,1997,,422674,36500873,6917491,,384751,31429839,5977249,,37923,5071034,940242,PDP
VK742,,2008,1997,,426168,36500873,6920985,,398829,33223750,6310528,,27339,3277123,610457,PDP
VK742,,2009,1997,,511410,37231156,7136171,,422939,34411239,6545935,,88471,2819917,590236,PDP
VK742,,2010,1997,,608870,37231156,7233631,,459377,35146820,6713260,,149493,2084336,520371,PDP
VK742,,2011,1997,,623993,37231156,7248754,,487904,35508013,6806056,,136089,1723143,442698,PDP
VK742,,2012,1997,,740503,36893884,7305251,,571603,36157385,7005301,,168900,736499,299950,PDP
VK742,,2013,1997,,742227,36893884,7306975,,701013,36715990,7234107,,41214,177894,72868,PDP
VK742,,2014,1997,,858801,37399618,7513537,,828022,37271612,7459981,,30779,128006,53556,PDP
VK742,,2015,1997,,1023104,39421224,8037557,,954259,37855875,7690180,,68845,1565349,347377,PDP
VK742,,2016,1997,,1082317,39421224,8096770,,1072210,38479160,7919036,,10107,942064,177734,PDP
VK742,,2017,1997,,1222563,39421224,8237016,,1161159,39023733,8104884,,61404,397491,132132,PDP
VK742,,2017,1997,,1222563,39421224,8237016,,1161159,39023733,8104884,,61404,397491,132132,PDP
VK780,,1993,1986,,1989,19843682,3532893,,0,0,0,,1989,19843682,3532893,PDN
VK780,,1994,1986,,1989,19843682,3532893,,0,0,0,,1989,19843682,3532893,PDN
VK780,,1995,1986,,1989,19843682,3532893,,0,0,0,,1989,19843682,3532893,PDN
VK780,,1996,1986,,2423,24166433,4302500,,0,0,0,,2423,24166433,4302500,PDN
VK780,,1997,1986,,363478,36227449,6809643,,0,0,0,,363478,36227449,6809643,PDN
VK780,,1998,1986,,2819938,108197647,22072188,,127612,4620956,949846,,2692326,103576691,21122342,PDN
VK780,,1999,1986,,7152121,215886786,45566140,,1459671,55058301,11256522,,5692450,160828485,34309618,PDN
VK780,,2000,1986,,6465178,214472185,44627489,,2297726,105741709,21112977,,4167452,108730476,23514512,PDN
VK780,,2001,1986,,5137584,231312539,46296399,,2710428,135412302,26805144,,2427156,95900237,19491255,PDN
VK780,,2002,1986,,5003465,233586859,46566963,,2980410,158813932,31239117,,2023055,74772927,15327846,PDN
VK780,,2003,1986,,5172641,231629153,46387793,,3193734,173659271,34093960,,1978907,57969882,12293833,PDN
VK780,,2004,1986,,4721055,221539237,44140848,,3343626,182778669,35866521,,1377429,38760568,8274327,PDN
VK780,,2005,1986,,4954571,226406479,45240422,,3465401,189126361,37117778,,1489170,37280118,8122644,PDN
VK780,,2006,1986,,4850315,225411895,44959193,,3580148,194310238,38154923,,1270167,31101657,6804270,PDN
VK780,,2007,1986,,4867737,226677598,45201830,,3669318,197915070,38885523,,1198419,28762528,6316307,PDN
VK780,,2008,1986,,4864530,227120061,45277353,,3719902,200589384,39411963,,1144628,26530677,5865390,PDN
VK780,,2009,1986,,4376644,226729459,44719967,,3752422,202226720,39735824,,624222,24502739,4984142,PDN
VK780,,2010,1986,,4401724,225077456,44451096,,3778943,203355936,39963275,,622781,21721520,4487822,PDN
VK780,,2011,1986,,4281163,223092883,43977409,,3799329,204104503,40116856,,481834,18988380,3860551,PDN
VK780,,2012,1986,,4281163,223093156,43977457,,3814970,204604160,40221405,,466193,18488996,3756052,PDN
VK780,,2013,1986,,3821273,204773462,40257834,,3821273,204773462,40257834,,0,0,0,PDN
VK780,,2014,1986,,3821273,204773462,40257834,,3821273,204773462,40257834,,0,0,0,PDN
VK780,,2015,1986,,3821273,204773462,40257834,,3821273,204773462,40257834,,0,0,0,PDN
VK780,,2016,1986,,3821273,204773462,40257834,,3821273,204773462,40257834,,0,0,0,PDN
VK780,,2017,1986,,3821273,204773462,40257834,,3821273,204773462,40257834,,0,0,0,PDN
VK780,,2017,1986,,3821273,204773462,40257834,,3821273,204773462,40257834,,0,0,0,PDN
VK783,,1986,1984,,7299077,11226278,9296635,,0,0,0,,7299077,11226278,9296635,PDP
VK783,,1987,1984,,7299077,11226278,9296635,,0,0,0,,7299077,11226278,9296635,PDP
VK783,,1993,1984,,6624374,38687433,13508259,,0,0,0,,6624374,38687433,13508259,PDP
VK783,,1994,1984,,80045996,416563518,154167618,,198665,5219138,1127337,,79847331,411344380,153040281,PDP
VK783,,1995,1984,,80045996,416563518,154167618,,466108,13126715,2801822,,79579888,403436803,151365796,PDP
VK783,,1996,1984,,50794118,311855582,106284435,,783770,27811829,5732494,,50010348,284043753,100551941,PDP
VK783,,1997,1984,,23368016,534409515,118458677,,1971835,68361622,14135825,,21396181,466047893,104322852,PDP
VK783,,1998,1984,,19997563,546750573,117284142,,3437239,123157331,25351355,,16560324,423593242,91932787,PDP
VK783,,1999,1984,,9695660,343354045,70790686,,4685178,182944599,37237598,,5010482,160409446,33553088,PDP
VK783,,2000,1984,,17733167,372652827,84041499,,5705294,231400303,46879725,,12027873,141252524,37161774,PDP
VK783,,2001,1984,,18917477,458257224,100457908,,6428872,265568052,53682974,,12488605,192689172,46774934,PDP
VK783,,2002,1984,,18917531,458295491,100464771,,7185935,299427698,60464885,,11731596,158867793,39999886,PDP
VK783,,2003,1984,,18978311,457946931,100463530,,7866203,331385441,66831584,,11112108,126561490,33631946,PDP
VK783,,2004,1984,,19040379,457819511,100502925,,8296333,352237956,70972126,,10744046,105581555,29530799,PDP
VK783,,2005,1984,,17350604,444317339,96410629,,8582029,367305065,73938802,,8768575,77012274,22471827,PDP
VK783,,2006,1984,,17313369,444317339,96373394,,8726769,378821965,76132813,,8586600,65495374,20240581,PDP
VK783,,2007,1984,,18008445,499235610,106840404,,8884085,389507619,78191491,,9124360,109727991,28648913,PDP
VK783,,2008,1984,,17986900,499235610,106818859,,9160218,410411465,82187169,,8826682,88824145,24631690,PDP
VK783,,2009,1984,,10682157,498684358,99416029,,9422985,432744076,86423711,,1259172,65940282,12992318,PDP
VK783,,2010,1984,,10722595,539625655,106741395,,9679072,452941172,90273587,,1043523,86684483,16467808,PDP
VK783,,2011,1984,,10785695,552598132,109112765,,9890430,471055984,93708221,,895265,81542148,15404544,PDP
VK783,,2012,1984,,10785695,552598132,109112765,,10076821,489045079,97095519,,708874,63553053,12017246,PDP
VK783,,2013,1984,,10572078,552598132,108899148,,10235296,504879795,100071558,,336782,47718337,8827589,PDP
VK783,,2014,1984,,10549838,548604118,108166230,,10360242,517786870,102493137,,189596,30817248,5673092,PDP
VK783,,2015,1984,,10840498,580278565,114092912,,10458480,529087640,104602188,,382018,51190925,9490724,PDP
VK783,,2016,1984,,10774964,570093158,112215028,,10538642,538875843,106424024,,236322,31217315,5791004,PDP
VK783,,2017,1984,,10774964,576504038,113355754,,10601809,546556673,107853887,,173155,29947365,5501867,PDP
VK783,,2017,1984,,10774964,576504038,113355754,,10601809,546556673,107853887,,173155,29947365,5501867,PDP
VK786,,1996,1995,,53419016,180804402,85590618,,0,0,0,,53419016,180804402,85590618,PDP
VK786,,1997,1995,,50942316,171893500,81528348,,0,0,0,,50942316,171893500,81528348,PDP
VK786,,1998,1995,,52328508,182600900,84819771,,0,0,0,,52328508,182600900,84819771,PDP
VK786,,1999,1995,,77924542,72815775,90881086,,0,0,0,,77924542,72815775,90881086,PDP
VK786,,2000,1995,,85749362,82774988,100478008,,3587600,2856233,4095827,,82161762,79918755,96382181,PDP
VK786,,2001,1995,,87836078,111243012,107630208,,21016607,22742270,25063274,,66819471,88500742,82566934,PDP
VK786,,2002,1995,,93856455,128055574,116642144,,38824080,42179309,46329295,,55032375,85876265,70312849,PDP
VK786,,2003,1995,,93930894,123697142,115941062,,58123384,68868415,70377550,,35807510,54828727,45563512,PDP
VK786,,2004,1995,,113823819,153603281,141155364,,69627764,85672799,84872034,,44196055,67930482,56283330,PDP
VK786,,2005,1995,,130098968,164863803,159434164,,81778833,99982507,99569315,,48320135,64881296,59864849,PDP
VK786,,2006,1995,,136332770,171875377,166915577,,98776905,116926062,119582254,,37555865,54949315,47333323,PDP
VK786,,2007,1995,,143500343,176314249,174872985,,109964742,128337937,132800674,,33535601,47976312,42072311,PDP
VK786,,2008,1995,,143500343,177770560,175132115,,118034550,136435351,142311303,,25465793,41335209,32820812,PDP
VK786,,2009,1995,,154864121,182434849,187325839,,126511763,144686013,152256605,,28352358,37748836,35069232,PDP
VK786,,2010,1995,,155256278,182975242,187814151,,132651678,151198939,159555404,,22604600,31776303,28258746,PDP
VK786,,2011,1995,,156824909,184881925,189722050,,138176870,157116488,166133540,,18648039,27765437,23588508,PDP
VK786,,2012,1995,,157185526,184991684,190102196,,142791187,162744018,171749198,,14394339,22247666,18352999,PDP
VK786,,2013,1995,,157185526,184991684,190102196,,147019199,168685370,177034390,,10166327,16306314,13067806,PDP
VK786,,2014,1995,,159728373,198185197,194992643,,150718320,177596552,182319132,,9010053,20588645,12673513,PDP
VK786,,2015,1995,,162302935,200243634,197933475,,153503476,183758196,186200665,,8799459,16485438,11732810,PDP
VK786,,2016,1995,,162226856,198925716,197622892,,155945356,188447578,189476954,,6281500,10478138,8145937,PDP
VK786,,2017,1995,,162226856,198925716,197622892,,157879520,192468955,192126667,,4347336,6456761,5496225,PDP
VK786,,2017,1995,,162226856,198925716,197622892,,157879520,192468955,192126667,,4347336,6456761,5496225,PDP
VK817,,1995,1982,,45798721,76340166,59382380,,0,668153,118888,,45798721,75672013,59263492,PDP
VK817,,1996,1982,,82322,59440888,10658992,,6099,25020853,4458208,,76223,34420035,6200784,PDP
VK817,,1997,1982,,107807,90615789,16231613,,107807,55368633,9959877,,0,35247156,6271736,PDP
VK817,,1998,1982,,113330,99575509,17831392,,112488,70174308,12599020,,842,29401201,5232372,PDP
VK817,,1999,1982,,238021,106517486,19191310,,112488,83772368,15018603,,125533,22745118,4172707,PDP
VK817,,2000,1982,,259133,102793517,18549794,,154082,90703070,16293418,,105051,12090447,2256376,PDP
VK817,,2001,1982,,2984693,118346085,24042716,,210076,94625297,17047317,,2774617,23720788,6995399,PDP
VK817,,2002,1982,,3062991,118164157,24088642,,258344,97070449,17530666,,2804647,21093708,6557976,PDP
VK817,,2003,1982,,3141225,117842247,24109597,,302706,98524599,17833773,,2838519,19317648,6275824,PDP
VK817,,2004,1982,,3141237,118149537,24164287,,333025,99708378,18074729,,2808212,18441159,6089558,PDP
VK817,,2005,1982,,3091347,120406558,24516002,,350993,103038403,18685228,,2740354,17368155,5830774,PDP
VK817,,2006,1982,,3165410,120491210,24605127,,397608,104463087,18985346,,2767802,16028123,5619781,PDP
VK817,,2007,1982,,3171355,121863486,24855249,,437482,105349500,19182945,,2733873,16513986,5672304,PDP
VK817,,2008,1982,,3165411,121877271,24851758,,459959,105955426,19313238,,2705452,15921845,5538520,PDP
VK817,,2009,1982,,532339,118766839,21665227,,479703,108281675,19746904,,52636,10485164,1918324,PDP
VK817,,2010,1982,,538649,119133804,21736834,,498941,108544001,19812820,,39708,10589803,1924014,PDP
VK817,,2011,1982,,634106,119219320,21847507,,518639,108603440,19843094,,115467,10615880,2004414,PDP
VK817,,2012,1982,,622421,119314241,21852712,,529125,108690561,19869081,,93296,10623680,1983630,PDP
VK817,,2013,1982,,568722,119299001,21796301,,543302,108870276,19915236,,25420,10428725,1881065,PDP
VK817,,2014,1982,,608335,119698005,21906911,,566399,109030912,19966916,,41936,10667093,1939996,PDP
VK817,,2015,1982,,608448,119867658,21937211,,579774,109114236,19995118,,28674,10753422,1942094,PDP
VK817,,2016,1982,,634233,119867658,21962996,,589426,109175723,20015710,,44807,10691935,1947286,PDP
VK817,,2017,1982,,626919,109349523,20084128,,593467,109228098,20029071,,33452,121425,55057,PDP
VK817,,2017,1982,,634233,119867658,21962996,,593467,109228098,20029071,,40766,10639560,1933925,PDP
VK821,,2008,2008,,502725,5159333,1420756,,242,0,242,,502483,5159333,1420514,PDN
VK821,,2009,2008,,404490,2683978,882066,,31968,249944,76442,,372522,2434034,805624,PDN
VK821,,2010,2008,,500517,3502581,1123752,,77398,599490,184069,,423119,2903091,939683,PDN
VK821,,2011,2008,,575901,4120216,1309035,,143977,1157778,349987,,431924,2962438,959048,PDN
VK821,,2012,2008,,598030,4323157,1367275,,227840,1863786,559475,,370190,2459371,807800,PDN
VK821,,2013,2008,,599511,4345370,1372708,,306657,2524626,755879,,292854,1820744,616829,PDN
VK821,,2014,2008,,608327,4408037,1392675,,346333,2859673,855172,,261994,1548364,537503,PDN
VK821,,2015,2008,,346333,2859673,855172,,346333,2859673,855172,,0,0,0,PDN
VK821,,2016,2008,,346333,2859673,855172,,346333,2859673,855172,,0,0,0,PDN
VK821,,2017,2008,,346333,2859673,855172,,346333,2859673,855172,,0,0,0,PDN
VK821,,2017,2008,,346333,2859673,855172,,346333,2859673,855172,,0,0,0,PDN
VK823,,1997,1993,,2079073,33192806,7985266,,0,0,0,,2079073,33192806,7985266,PDP
VK823,,1998,1993,,2079006,33191959,7985049,,0,0,0,,2079006,33191959,7985049,PDP
VK823,,1999,1993,,1283254,45599396,9397026,,31481,406011,103725,,1251773,45193385,9293301,PDP
VK823,,2000,1993,,4983346,90707904,21123542,,717773,15885943,3544453,,4265573,74821961,17579089,PDP
VK823,,2001,1993,,5392128,112886509,25478695,,1417885,36359893,7887617,,3974243,76526616,17591078,PDP
VK823,,2002,1993,,4456368,103772572,22921238,,1900368,54418818,11583432,,2556000,49353754,11337806,PDP
VK823,,2003,1993,,4586030,109652794,24097203,,2210425,68544336,14406926,,2375605,41108458,9690277,PDP
VK823,,2004,1993,,4525651,109005512,23921650,,2353389,74905909,15681843,,2172262,34099603,8239807,PDP
VK823,,2005,1993,,4309292,102126633,22481291,,2416694,77202005,16153706,,1892598,24924628,6327585,PDP
VK823,,2006,1993,,4438642,106274937,23348773,,2532950,81424261,17021253,,1905692,24850676,6327520,PDP
VK823,,2007,1993,,4624720,112668296,24672460,,2661339,86125117,17986093,,1963381,26543179,6686367,PDP
VK823,,2008,1993,,4660398,112708954,24715372,,2782168,89717707,18746173,,1878230,22991247,5969199,PDP
VK823,,2009,1993,,4966463,121838567,26645924,,2868146,92499289,19327093,,2098317,29339278,7318830,PDP
VK823,,2010,1993,,5105717,131380147,28482968,,2957557,95417425,19935746,,2148160,35962722,8547222,PDP
VK823,,2011,1993,,5041452,123172752,26958312,,3089835,99177198,20737021,,1951617,23995554,6221288,PDP
VK823,,2012,1993,,5317263,126759841,27872395,,3177236,102698858,21451053,,2140027,24060983,6421341,PDP
VK823,,2013,1993,,5370239,132332984,28917034,,3325774,106589137,22291814,,2044465,25743847,6625223,PDP
VK823,,2014,1993,,5139787,128911578,28077791,,3445540,110399924,23089656,,1694247,18511654,4988136,PDP
VK823,,2015,1993,,5145846,129712335,28226333,,3528427,113141822,23660424,,1617419,16570513,4565909,PDP
VK823,,2016,1993,,5372311,131654410,28798364,,3643209,116102829,24302076,,1729102,15551581,4496287,PDP
VK823,,2017,1993,,5498329,135789824,29660221,,3780190,120259693,25178712,,1718139,15530131,4481508,PDP
VK823,,2017,1993,,5498329,135789824,29660221,,3780190,120259693,25178712,,1718139,15530131,4481508,PDP
VK825,,1993,1987,,47086091,173059921,77879671,,0,0,0,,47086091,173059921,77879671,PDP
VK825,,1994,1987,,47095608,173085262,77893697,,0,0,0,,47095608,173085262,77893697,PDP
VK825,,1995,1987,,43843130,167872004,73713593,,0,0,0,,43843130,167872004,73713593,PDP
VK825,,1996,1987,,43341439,134852575,67336559,,0,0,0,,43341439,134852575,67336559,PDP
VK825,,1997,1987,,79366405,162826391,108339072,,5334656,4406252,6118687,,74031749,158420139,102220385,PDP
VK825,,1998,1987,,79557390,163798139,108702967,,13087409,10802510,15009564,,66469981,152995629,93693403,PDP
VK825,,1999,1987,,79135548,172074116,109753718,,22363021,21000932,26099842,,56772527,151073184,83653876,PDP
VK825,,2000,1987,,57930603,157788674,86006880,,28856757,30161362,34223547,,29073846,127627312,51783333,PDP
VK825,,2001,1987,,57522346,160816000,86137293,,33434159,41749641,40862921,,24088187,119066359,45274372,PDP
VK825,,2002,1987,,64860641,183351527,97485468,,39156596,50835761,48202105,,25704045,132515766,49283363,PDP
VK825,,2003,1987,,64859580,178324788,96589969,,44049039,60487677,54811971,,20810541,117837111,41777998,PDP
VK825,,2004,1987,,66243479,118661421,87357611,,47852254,74661487,61137216,,18391225,43999934,26220395,PDP
VK825,,2005,1987,,66613313,130754262,89879196,,49887085,82231908,64519097,,16726228,48522354,25360099,PDP
VK825,,2006,1987,,67213013,137564373,91690659,,52192885,91947642,68553675,,15020128,45616731,23136984,PDP
VK825,,2007,1987,,69199868,141272540,94337330,,53971462,98422095,71484290,,15228406,42850445,22853040,PDP
VK825,,2008,1987,,71843974,146626312,97934065,,55442705,102827186,73739357,,16401269,43799126,24194708,PDP
VK825,,2009,1987,,71185005,133301149,94904070,,56694739,106577636,75658730,,14490266,26723513,19245340,PDP
VK825,,2010,1987,,69534442,131018062,92847264,,57806809,109281220,77251866,,11727633,21736842,15595399,PDP
VK825,,2011,1987,,69411906,130952002,92712974,,58650262,111594791,78506987,,10761644,19357211,14205988,PDP
VK825,,2012,1987,,69411906,130932003,92709416,,59061889,113087720,79184260,,10350017,17844283,13525156,PDP
VK825,,2013,1987,,69418261,130932003,92715771,,59080947,113428468,79263949,,10337314,17503535,13451822,PDP
VK825,,2014,1987,,67090573,124276123,89203763,,59086241,113502295,79282379,,8004332,10773828,9921383,PDP
VK825,,2015,1987,,67083292,124276123,89196482,,59086250,113569738,79294389,,7997042,10706385,9902093,PDP
VK825,,2016,1987,,67084544,124038237,89155405,,59086678,113623622,79304405,,7997866,10414615,9851001,PDP
VK825,,2017,1987,,67084544,124038237,89155405,,59086881,113652814,79309802,,7997663,10385423,9845603,PDP
VK825,,2017,1987,,67084544,124038237,89155405,,59086881,113652814,79309802,,7997663,10385423,9845603,PDP
VK862,,1980,1976,,11244000,7699000,12613929,,0,0,0,,11244000,7699000,12613929,PDP
VK862,,1981,1976,,13381600,13668200,15813664,,0,0,0,,13381600,13668200,15813664,PDP
VK862,,1982,1976,,13381600,13668200,15813664,,0,0,0,,13381600,13668200,15813664,PDP
VK862,,1983,1976,,13381600,13668200,15813664,,0,0,0,,13381600,13668200,15813664,PDP
VK862,,1984,1976,,13381600,13668200,15813664,,0,0,0,,13381600,13668200,15813664,PDP
VK862,,1985,1976,,13381600,13668200,15813664,,0,0,0,,13381600,13668200,15813664,PDP
VK862,,1986,1976,,13381600,13668200,15813664,,0,0,0,,13381600,13668200,15813664,PDP
VK862,,1987,1976,,13381600,13668200,15813664,,0,0,0,,13381600,13668200,15813664,PDP
VK862,,1993,1976,,2536197,2536197,2987478,,0,0,0,,2536197,2536197,2987478,PDP
VK862,,1995,1976,,3923593,2040268,4286630,,59869,31091,65401,,3863724,2009177,4221229,PDP
VK862,,1996,1976,,3894648,2025217,4255007,,969067,765959,1105359,,2925581,1259258,3149648,PDP
VK862,,1997,1976,,3709189,5563784,4699186,,1806276,2190181,2195988,,1902913,3373603,2503198,PDP
VK862,,1998,1976,,3709189,5563784,4699186,,2372243,3460806,2988045,,1336946,2102978,1711141,PDP
VK862,,1999,1976,,3709189,5563784,4699186,,3042057,4496799,3842199,,667132,1066985,856987,PDP
VK862,,2000,1976,,5318077,7838846,6712889,,3784356,5579461,4777143,,1533721,2259385,1935746,PDP
VK862,,2001,1976,,16956370,19175328,20368351,,4536862,6608532,5712757,,12419508,12566796,14655594,PDP
VK862,,2002,1976,,20833077,23750830,25059204,,5289168,7477419,6619670,,15543909,16273411,18439534,PDP
VK862,,2003,1976,,20833077,23750830,25059204,,6009008,8266644,7479941,,14824069,15484186,17579263,PDP
VK862,,2004,1976,,16233061,17023306,19262120,,6551637,8763743,8111022,,9681424,8259563,11151098,PDP
VK862,,2005,1976,,20603076,20324968,24219619,,6890926,9019743,8495862,,13712150,11305225,15723757,PDP
VK862,,2006,1976,,15268803,16568235,18216887,,7418004,9432457,9096377,,7850799,7135778,9120510,PDP
VK862,,2007,1976,,15268803,16658607,18232968,,8039629,9936559,9807700,,7229174,6722048,8425268,PDP
VK862,,2008,1976,,13728369,14617476,16329343,,8501045,10285349,10331178,,5227324,4332127,5998165,PDP
VK862,,2009,1976,,16722335,18792954,20066278,,9536923,11234462,11535937,,7185412,7558492,8530341,PDP
VK862,,2010,1976,,13641467,15467157,16393631,,10576499,12376264,12778682,,3064968,3090893,3614949,PDP
VK862,,2011,1976,,17672148,18864449,21028812,,11787361,13315890,14156737,,5884787,5548559,6872076,PDP
VK862,,2012,1976,,17672148,18864449,21028812,,12632455,14020359,15127180,,5039693,4844090,5901632,PDP
VK862,,2013,1976,,17672148,18348854,20937069,,13571716,14659306,16180134,,4100432,3689548,4756936,PDP
VK862,,2014,1976,,18251450,18706723,21580049,,14318081,15170831,17017517,,3933369,3535892,4562531,PDP
VK862,,2015,1976,,17647387,17948676,20841102,,15087823,15650974,17872694,,2559564,2297702,2968408,PDP
VK862,,2016,1976,,17923831,17786428,21088676,,15825888,16082208,18687491,,2097943,1704220,2401185,PDP
VK862,,2017,1976,,17252384,17276438,20326483,,16285336,16336552,19192196,,967048,939886,1134287,PDP
VK862,,2017,1976,,17923646,17947700,21117187,,16285336,16336552,19192196,,1638310,1611148,1924991,PDP
VK873,,2000,1988,,1743,17423449,3102001,,0,0,0,,1743,17423449,3102001,PDN
VK873,,2001,1988,,24207,38731231,6915885,,0,45421,8082,,24207,38685810,6907803,PDN
VK873,,2002,1988,,24207,38731231,6915885,,7349,12418969,2217130,,16858,26312262,4698755,PDN
VK873,,2003,1988,,25616,38730378,6917142,,14043,22800182,4071015,,11573,15930196,2846127,PDN
VK873,,2004,1988,,22677,33673912,6014476,,17905,27071782,4834948,,4772,6602130,1179528,PDN
VK873,,2005,1988,,24019,33673912,6015818,,19524,28950621,5170880,,4495,4723291,844938,PDN
VK873,,2006,1988,,24019,33673912,6015818,,21874,31028963,5543042,,2145,2644949,472776,PDN
VK873,,2007,1988,,22830,31975348,5712394,,22830,31975348,5712394,,0,0,0,PDN
VK873,,2008,1988,,22830,31975348,5712394,,22830,31975348,5712394,,0,0,0,PDN
VK873,,2009,1988,,22830,31975348,5712394,,22830,31975348,5712394,,0,0,0,PDN
VK873,,2010,1988,,22830,31975348,5712394,,22830,31975348,5712394,,0,0,0,PDN
VK873,,2011,1988,,22830,31975348,5712394,,22830,31975348,5712394,,0,0,0,PDN
VK873,,2012,1988,,22830,31975348,5712394,,22830,31975348,5712394,,0,0,0,PDN
VK873,,2013,1988,,22830,31975348,5712394,,22830,31975348,5712394,,0,0,0,PDN
VK873,,2014,1988,,22830,31975348,5712394,,22830,31975348,5712394,,0,0,0,PDN
VK873,,2015,1988,,22830,31975348,5712394,,22830,31975348,5712394,,0,0,0,PDN
VK873,,2016,1988,,22830,31975348,5712394,,22830,31975348,5712394,,0,0,0,PDN
VK873,,2017,1988,,22830,31975348,5712394,,22830,31975348,5712394,,0,0,0,PDN
VK873,,2017,1988,,22830,31975348,5712394,,22830,31975348,5712394,,0,0,0,PDN
VK914,,1997,1997,,17336,173342388,30861177,,0,0,0,,17336,173342388,30861177,PDN
VK914,,1998,1997,,19515,195135393,34741115,,0,0,0,,19515,195135393,34741115,PDN
VK914,,1999,1997,,19515,195135393,34741115,,0,0,0,,19515,195135393,34741115,PDN
VK914,,2000,1997,,225527,146592797,26309654,,0,0,0,,225527,146592797,26309654,PDN
VK914,,2001,1997,,6758898,146617495,32847420,,1348504,16148247,4221858,,5410394,130469248,28625562,PDN
VK914,,2002,1997,,6758898,146617495,32847420,,2097793,32579383,7894836,,4661105,114038112,24952584,PDN
VK914,,2003,1997,,3193939,94529919,20014209,,2556716,49348279,11337549,,637223,45181640,8676660,PDN
VK914,,2004,1997,,2958255,94529919,19778525,,2729924,59229111,13268912,,228331,35300808,6509613,PDN
VK914,,2005,1997,,3126443,111892444,23036130,,2835060,66288281,14630128,,291383,45604163,8406002,PDN
VK914,,2006,1997,,3216027,104758583,21856344,,2935960,71646737,15684490,,280067,33111846,6171854,PDN
VK914,,2007,1997,,3154436,102974213,21477250,,3064274,74916803,16394666,,90162,28057410,5082584,PDN
VK914,,2008,1997,,3199714,103405098,21599198,,3137791,76154965,16688497,,61923,27250133,4910701,PDN
VK914,,2009,1997,,3130963,76175642,16685348,,3130963,76175642,16685348,,0,0,0,PDN
VK914,,2010,1997,,3130963,76175642,16685348,,3130963,76175642,16685348,,0,0,0,PDN
VK914,,2011,1997,,3130963,76175642,16685348,,3130963,76175642,16685348,,0,0,0,PDN
VK914,,2012,1997,,3130963,76175642,16685348,,3130963,76175642,16685348,,0,0,0,PDN
VK914,,2013,1997,,3130963,76175642,16685348,,3130963,76175642,16685348,,0,0,0,PDN
VK914,,2014,1997,,3130963,76175642,16685348,,3130963,76175642,16685348,,0,0,0,PDN
VK914,,2015,1997,,3130963,76175642,16685348,,3130963,76175642,16685348,,0,0,0,PDN
VK914,,2016,1997,,3130963,76175642,16685348,,3130963,76175642,16685348,,0,0,0,PDN
VK914,,2017,1997,,3130963,76175642,16685348,,3130963,76175642,16685348,,0,0,0,PDN
VK914,,2017,1997,,3130963,76175642,16685348,,3130963,76175642,16685348,,0,0,0,PDN
VK915,,1994,1993,,11946403,120469122,33382190,,0,0,0,,11946403,120469122,33382190,PDP
VK915,,1995,1993,,11946403,120469122,33382190,,0,0,0,,11946403,120469122,33382190,PDP
VK915,,1996,1993,,13376976,142446474,38723324,,0,0,0,,13376976,142446474,38723324,PDP
VK915,,1997,1993,,14231522,211532191,51870702,,0,0,0,,14231522,211532191,51870702,PDP
VK915,,1998,1993,,14242579,211296313,51839788,,0,0,0,,14242579,211296313,51839788,PDP
VK915,,1999,1993,,14242579,211296313,51839788,,18138,256412,63763,,14224441,211039901,51776025,PDP
VK915,,2000,1993,,18064063,211286091,55659452,,198653,2062013,565559,,17865410,209224078,55093893,PDP
VK915,,2001,1993,,18750901,295433882,71319208,,5680898,54761224,15424888,,13070003,240672658,55894320,PDP
VK915,,2002,1993,,56544445,410332366,129557322,,10444672,164313710,39681987,,46099773,246018656,89875335,PDP
VK915,,2003,1993,,58334029,406225599,130616164,,13340913,214155497,51446873,,44993116,192070102,79169291,PDP
VK915,,2004,1993,,60157775,397086853,130813798,,15095360,200071394,50695252,,45062415,197015459,80118546,PDP
VK915,,2005,1993,,60031824,376741439,127067667,,17459141,245193020,61087792,,42572683,131548419,65979875,PDP
VK915,,2006,1993,,59974176,319044784,116743710,,19259034,241438503,62219622,,40715142,77606281,54524088,PDP
VK915,,2007,1993,,61902596,311853626,117392565,,21009990,249308121,65370866,,40892606,62545505,52021699,PDP
VK915,,2008,1993,,62664023,301514778,116314340,,22945780,254657099,68258431,,39718243,46857679,48055909,PDP
VK915,,2009,1993,,72194760,335087662,131818899,,29918221,265218711,77110162,,42276539,69868951,54708737,PDP
VK915,,2010,1993,,76347493,337511362,136402895,,37126976,279116634,86791857,,39220517,58394728,49611039,PDP
VK915,,2011,1993,,62913347,316669393,119260214,,42668524,288893194,94073007,,20244823,27776199,25187208,PDP
VK915,,2012,1993,,63002718,316878057,119386714,,47459032,295690027,100072916,,15543686,21188030,19313798,PDP
VK915,,2013,1993,,63122443,316659723,119467590,,51628434,301736363,105318177,,11494009,14923360,14149412,PDP
VK915,,2014,1993,,75826235,331760393,134858334,,55899151,307101787,110543597,,19927084,24658606,24314736,PDP
VK915,,2015,1993,,71481370,326896740,129648050,,60411945,313292227,116157893,,11069425,13604513,13490156,PDP
VK915,,2016,1993,,71253434,327950274,129607575,,64286400,319247854,121092068,,6967034,8702420,8515506,PDP
VK915,,2017,1993,,68641816,326382091,126716921,,66888607,322429069,124260327,,1753209,3953022,2456594,PDP
VK915,,2017,1993,,68641816,326382091,126716921,,66888607,322429069,124260327,,1753209,3953022,2456594,PDP
VK917,,2000,2001,,2080788,8859855,3657275,,0,0,0,,2080788,8859855,3657275,PDP
VK917,,2001,2001,,2098856,9058858,3710752,,0,0,0,,2098856,9058858,3710752,PDP
VK917,,2002,2001,,2098856,9058858,3710752,,0,0,0,,2098856,9058858,3710752,PDP
VK917,,2003,2001,,2098415,9054002,3709447,,0,0,0,,2098415,9054002,3709447,PDP
VK917,,2004,2001,,2098415,9054002,3709447,,0,0,0,,2098415,9054002,3709447,PDP
VK917,,2005,2001,,2098415,9054002,3709447,,0,0,0,,2098415,9054002,3709447,PDP
VK917,,2006,2001,,2816260,31577073,8434956,,7406,129097,30377,,2808854,31447976,8404579,PDP
VK917,,2007,2001,,3161137,35227109,9429306,,131697,2525648,581101,,3029440,32701461,8848205,PDP
VK917,,2008,2001,,2463912,25189511,6946031,,850651,19040318,4238608,,1613261,6149193,2707423,PDP
VK917,,2009,2001,,2359288,25183997,6840426,,949971,23719717,5170561,,1409317,1464280,1669865,PDP
VK917,,2010,2001,,4950260,27724006,9883357,,1980345,24725722,6379939,,2969915,2998284,3503417,PDP
VK917,,2011,2001,,7537188,30399155,12946290,,3419396,26163407,8074806,,4117792,4235748,4871484,PDP
VK917,,2012,2001,,7537188,30399155,12946290,,4648832,27457745,9534552,,2888356,2941410,3411739,PDP
VK917,,2013,2001,,7537188,30399155,12946290,,5821781,28717018,10931570,,1715407,1682137,2014720,PDP
VK917,,2014,2001,,10508077,33326606,16438078,,6993355,29869415,12308197,,3514722,3457191,4129881,PDP
VK917,,2015,2001,,10508077,33326606,16438078,,8339545,31283857,13906067,,2168532,2042749,2532010,PDP
VK917,,2016,2001,,12333143,35455767,18641998,,9639789,32715934,15461129,,2693354,2739833,3180869,PDP
VK917,,2017,2001,,12333143,35455767,18641998,,10754346,34064994,16815733,,1578797,1390773,1826266,PDP
VK917,,2017,2001,,12333143,35455767,18641998,,10754346,34064994,16815733,,1578797,1390773,1826266,PDP
VK944,,1998,1997,,0,6761199,1203060,,0,2074927,369204,,0,4686272,833856,PDN
VK944,,1999,1997,,0,6761199,1203060,,0,3716711,661336,,0,3044488,541724,PDN
VK944,,2000,1997,,0,8724032,1552319,,0,4285899,762615,,0,4438133,789704,PDN
VK944,,2001,1997,,0,6581288,1171048,,0,4909207,873524,,0,1672081,297524,PDN
VK944,,2002,1997,,0,6581288,1171048,,0,5448011,969397,,0,1133277,201651,PDN
VK944,,2003,1997,,0,6581288,1171048,,0,6112486,1087631,,0,468802,83417,PDN
VK944,,2004,1997,,0,6581288,1171048,,0,6390967,1137183,,0,190321,33865,PDN
VK944,,2005,1997,,0,6405568,1139781,,0,6405568,1139781,,0,0,0,PDN
VK944,,2006,1997,,0,6405568,1139781,,0,6405568,1139781,,0,0,0,PDN
VK944,,2007,1997,,0,6405568,1139781,,0,6405568,1139781,,0,0,0,PDN
VK944,,2008,1997,,0,6405568,1139781,,0,6405568,1139781,,0,0,0,PDN
VK944,,2009,1997,,0,6412009,1140927,,0,6412009,1140927,,0,0,0,PDN
VK944,,2010,1997,,0,6412009,1140927,,0,6412009,1140927,,0,0,0,PDN
VK944,,2011,1997,,0,6412009,1140927,,0,6412009,1140927,,0,0,0,PDN
VK944,,2012,1997,,0,6412009,1140927,,0,6412009,1140927,,0,0,0,PDN
VK944,,2013,1997,,0,6412009,1140927,,0,6412009,1140927,,0,0,0,PDN
VK944,,2014,1997,,0,6412009,1140927,,0,6412009,1140927,,0,0,0,PDN
VK944,,2015,1997,,0,6412009,1140927,,0,6412009,1140927,,0,0,0,PDN
VK944,,2016,1997,,0,6412009,1140927,,0,6412009,1140927,,0,0,0,PDN
VK944,,2017,1997,,0,6412009,1140927,,0,6412009,1140927,,0,0,0,PDN
VK944,,2017,1997,,0,6412009,1140927,,0,6412009,1140927,,0,0,0,PDN
VK956,,1987,1985,,4685,46841772,8339520,,0,0,0,,4685,46841772,8339520,PDP
VK956,,1990,1985,,84308639,674758046,204372348,,0,0,0,,84308639,674758046,204372348,PDP
VK956,,1991,1985,,51011662,405281300,123125772,,0,0,0,,51011662,405281300,123125772,PDP
VK956,,1992,1985,,51011662,405281300,123125772,,0,0,0,,51011662,405281300,123125772,PDP
VK956,,1993,1985,,50642953,395667644,121046448,,0,0,0,,50642953,395667644,121046448,PDP
VK956,,1994,1985,,143080333,718136952,270862709,,0,0,0,,143080333,718136952,270862709,PDP
VK956,,1995,1985,,140726761,716075894,268142401,,0,0,0,,140726761,716075894,268142401,PDP
VK956,,1996,1985,,112441969,785923751,252286053,,0,0,0,,112441969,785923751,252286053,PDP
VK956,,1997,1985,,123287178,851032251,274716404,,907787,7491295,2240758,,122379391,843540956,272475646,PDP
VK956,,1998,1985,,74960937,757564041,209758809,,17401957,81208402,31851851,,57558980,676355639,177906958,PDP
VK956,,1999,1985,,185657647,1080086654,377843884,,34278780,185153631,67224266,,151378867,894933023,310619618,PDP
VK956,,2000,1985,,146368559,993195133,323093672,,45108972,288564917,96455043,,101259587,704630216,226638629,PDP
VK956,,2001,1985,,139161445,987062256,314795298,,52982597,380272504,120646744,,86178848,606789752,194148554,PDP
VK956,,2002,1985,,139507299,989892918,315644829,,60844352,461802495,143015614,,78662947,528090423,172629215,PDP
VK956,,2003,1985,,134180235,992615473,310802206,,67194980,536348723,162630696,,66985255,456266750,148171510,PDP
VK956,,2004,1985,,134717867,842652116,284655966,,72765615,602299466,179936338,,61952252,240352650,104719628,PDP
VK956,,2005,1985,,98970727,862664181,252469691,,77254568,680070180,198263497,,21716159,182594001,54206194,PDP
VK956,,2006,1985,,99878542,865181728,253825468,,81570576,759433250,216701048,,18307966,105748478,37124420,PDP
VK956,,2007,1985,,100638535,860590221,253768467,,84705650,818277532,230306634,,15932885,42312689,23461833,PDP
VK956,,2008,1985,,103153970,870599712,258064951,,86485649,829941403,234162055,,16668321,40658309,23902896,PDP
VK956,,2009,1985,,92263821,866438494,246434370,,87824267,836989996,236754871,,4439554,29448498,9679499,PDP
VK956,,2010,1985,,94920476,891500031,253550374,,89350296,850297167,240648724,,5570180,41202864,12901650,PDP
VK956,,2011,1985,,102352395,904594968,263312354,,90821112,862434552,244279217,,11531283,42160416,19033136,PDP
VK956,,2012,1985,,102371568,902114891,262890232,,92139615,873021264,247481477,,10231953,29093627,15408755,PDP
VK956,,2013,1985,,97295695,884512044,254682180,,93467545,875476119,249246214,,3828150,9035925,5435966,PDP
VK956,,2014,1985,,99027344,896765157,258594098,,95040450,881175190,251833190,,3986894,15589967,6760909,PDP
VK956,,2015,1985,,98874118,893726808,257900241,,96714054,890622257,255187764,,2160064,3104551,2712475,PDP
VK956,,2016,1985,,100136566,910848138,262209188,,97729172,896800996,257302302,,2407394,14047142,4906885,PDP
VK956,,2017,1985,,100136955,912601680,262521596,,99067295,905000650,260099438,,1069660,7601030,2422157,PDP
VK956,,2017,1985,,100136955,912601680,262521596,,99067295,905000650,260099438,,1069660,7601030,2422157,PDP
VK959,,2016,2015,,5220922,6453059,6369153,,0,0,0,,5220922,6453059,6369153,PU
VK959,,2017,2015,,3480615,3480615,4099941,,0,0,0,,3480615,3480615,4099941,PU
VK962,,2000,2001,,1256593,1976621,1608305,,0,0,0,,1256593,1976621,1608305,PDP
VK962,,2001,2001,,1256593,1976621,1608305,,0,0,0,,1256593,1976621,1608305,PDP
VK962,,2002,2001,,1256593,1976621,1608305,,0,0,0,,1256593,1976621,1608305,PDP
VK962,,2003,2001,,1093701,1720392,1399821,,0,0,0,,1093701,1720392,1399821,PDP
VK962,,2004,2001,,1245051,6086842,2328119,,0,0,0,,1245051,6086842,2328119,PDP
VK962,,2005,2001,,18990487,79206772,33084219,,340700,2458308,778121,,18649787,76748464,32306098,PDP
VK962,,2006,2001,,25819806,64012149,37209868,,4026074,18462220,7311167,,21793732,45549929,29898701,PDP
VK962,,2007,2001,,26013622,75242866,39402032,,7817425,35138839,14069887,,18196197,40104027,25332145,PDP
VK962,,2008,2001,,17106959,63918943,28480436,,11019032,40972115,18309444,,6087927,22946828,10170992,PDP
VK962,,2009,2001,,23107126,76759697,36765435,,14333588,54085612,23957362,,8773538,22674085,12808073,PDP
VK962,,2010,2001,,21254087,74693558,34544756,,16562018,64732410,28080241,,4692069,9961148,6464515,PDP
VK962,,2011,2001,,21254087,74958543,34591906,,18153579,70035820,30615469,,3100508,4922723,3976437,PDP
VK962,,2012,2001,,21254087,74958543,34591906,,19342309,71968896,32148163,,1911778,2989647,2443744,PDP
VK962,,2013,2001,,21254087,75406979,34671699,,20366594,73814199,33500793,,887493,1592780,1170906,PDP
VK962,,2014,2001,,21717347,75936948,35229260,,21333153,75391531,34748016,,384194,545417,481243,PDP
VK962,,2015,2001,,25101452,80895614,39495690,,22075949,76589765,35704021,,3025503,4305849,3791668,PDP
VK962,,2016,2001,,25101452,80919845,39500001,,22492785,77238706,36236327,,2608667,3681139,3263674,PDP
VK962,,2017,2001,,22944653,77885735,36803325,,22645846,77473752,36431211,,298807,411983,372114,PDP
VK962,,2017,2001,,22944653,77885735,36803325,,22645846,77473752,36431211,,298807,411983,372114,PDP
VK986,,1993,1988,,3274,32745093,5829803,,0,0,0,,3274,32745093,5829803,PDN
VK986,,1997,1988,,0,22105519,3933366,,0,6993443,1244385,,0,15112076,2688981,PDN
VK986,,1998,1988,,0,22105519,3933366,,0,8889572,1581774,,0,13215947,2351592,PDN
VK986,,1999,1988,,0,22105519,3933366,,0,11537761,2052982,,0,10567758,1880384,PDN
VK986,,2000,1988,,1481,34365461,6116332,,0,14282224,2541321,,1481,20083237,3575011,PDN
VK986,,2001,1988,,2560,42082997,7490638,,0,15972127,2842015,,2560,26110870,4648623,PDN
VK986,,2002,1988,,2148,37956829,6756032,,0,16637383,2960388,,2148,21319446,3795644,PDN
VK986,,2003,1988,,3450,50974155,9073585,,0,19228839,3421502,,3450,31745316,5652083,PDN
VK986,,2004,1988,,3450,50974155,9073585,,0,20645244,3673531,,3450,30328911,5400054,PDN
VK986,,2005,1988,,2783,48795163,8685196,,0,20968851,3731112,,2783,27826312,4954084,PDN
VK986,,2006,1988,,2783,48795163,8685196,,0,20968851,3731112,,2783,27826312,4954084,PDN
VK986,,2007,1988,,982,34610562,6159445,,0,22802455,4057376,,982,11808107,2102069,PDN
VK986,,2008,1988,,982,35225376,6268842,,0,24127142,4293086,,982,11098234,1975756,PDN
VK986,,2009,1988,,1002,36248748,6450957,,0,25200644,4484100,,1002,11048104,1966857,PDN
VK986,,2010,1988,,1002,36640781,6520713,,0,26029627,4631605,,1002,10611154,1889108,PDN
VK986,,2011,1988,,1002,36814568,6551636,,0,26285194,4677080,,1002,10529374,1874556,PDN
VK986,,2012,1988,,1002,36816237,6551934,,0,26552225,4724594,,1002,10264012,1827338,PDN
VK986,,2013,1988,,1002,36816237,6551934,,0,26786486,4766278,,1002,10029751,1785655,PDN
VK986,,2014,1988,,0,26798219,4768366,,0,26798219,4768366,,0,0,0,PDN
VK986,,2015,1988,,0,26801126,4768884,,0,26801126,4768884,,0,0,0,PDN
VK986,,2016,1988,,0,26801126,4768884,,0,26801126,4768884,,0,0,0,PDN
VK986,,2017,1988,,0,26801126,4768884,,0,26801126,4768884,,0,0,0,PDN
VK986,,2017,1988,,0,26801126,4768884,,0,26801126,4768884,,0,0,0,PDN
VK990,,1983,1981,,831547,16630900,3790782,,0,0,0,,831547,16630900,3790782,PDP
VK990,,1984,1981,,831547,16630900,3790782,,0,0,0,,831547,16630900,3790782,PDP
VK990,,1987,1981,,3066398,3066398,3612020,,0,0,0,,3066398,3066398,3612020,PDP
VK990,,1992,1981,,137474581,98707409,155038177,,0,0,0,,137474581,98707409,155038177,PDP
VK990,,1993,1981,,137474581,98707409,155038177,,0,0,0,,137474581,98707409,155038177,PDP
VK990,,1994,1981,,140316601,101545863,158385260,,757563,354074,820565,,139559038,101191789,157564695,PDP
VK990,,1995,1981,,129892884,110829248,149613391,,7706638,5831425,8744258,,122186246,104997823,140869133,PDP
VK990,,1996,1981,,158910769,189907391,192702120,,21158914,20533339,24812533,,137751855,169374052,167889587,PDP
VK990,,1997,1981,,160182590,203434206,196380847,,37086922,39875835,44182266,,123095668,163558371,152198581,PDP
VK990,,1998,1981,,159855217,239883421,202539100,,54906781,63761288,66252206,,104948436,176122133,136286894,PDP
VK990,,1999,1981,,129293868,187471665,162651816,,69977213,87312494,85513244,,59316655,100159171,77138572,PDP
VK990,,2000,1981,,129796301,192537880,164055710,,82904585,110814011,102622381,,46891716,81723869,61433329,PDP
VK990,,2001,1981,,141496417,320056341,198445944,,93161397,132533457,116743863,,48335020,187522884,81702081,PDP
VK990,,2002,1981,,145064412,241582842,188050683,,103604584,170557605,133952912,,41459828,71025237,54097771,PDP
VK990,,2003,1981,,142787115,238878990,185292273,,111123018,191071389,145121486,,31664097,47807601,40170787,PDP
VK990,,2004,1981,,141886965,237827247,184204980,,115603590,201095950,151385788,,26283375,36731297,32819192,PDP
VK990,,2005,1981,,149864002,249306057,194224510,,118699981,207195966,155567591,,31164021,42110091,38656919,PDP
VK990,,2006,1981,,150078688,247043012,194036519,,122367744,214379944,160513642,,27710944,32663068,33522877,PDP
VK990,,2007,1981,,150117707,246902581,194050551,,125867489,220970116,165186015,,24250218,25932465,28864536,PDP
VK990,,2008,1981,,150787923,251202633,195485900,,128995527,226000749,169209183,,21792396,25201884,26276717,PDP
VK990,,2009,1981,,153462728,262383847,200150246,,131610160,232929503,173056692,,21852568,29454344,27093556,PDP
VK990,,2010,1981,,154811659,270547842,202951845,,133867569,237453497,176119081,,20944090,33094345,26832763,PDP
VK990,,2011,1981,,154739425,275064184,203683230,,134536804,241480819,177504921,,20202621,33583365,26178309,PDP
VK990,,2012,1981,,155968408,278417905,205508959,,137125512,250162306,181638377,,18842896,28255599,23870583,PDP
VK990,,2013,1981,,156096226,279904399,205901277,,138714459,256697021,184390085,,17381767,23207378,21511195,PDP
VK990,,2014,1981,,155848848,279565152,205593537,,139993608,262709382,186739050,,15855240,16855770,18854489,PDP
VK990,,2015,1981,,156608650,281885625,206766235,,141465155,264824453,188586944,,15143495,17061172,18179292,PDP
VK990,,2016,1981,,158277325,283942966,208800986,,142900067,266952220,190400460,,15377258,16990746,18400523,PDP
VK990,,2017,1981,,158478777,285040130,209197662,,144475593,269375652,192407204,,14003184,15664478,16790458,PDP
VK990,,2017,1981,,158478777,285040130,209197662,,144475593,269375652,192407204,,14003184,15664478,16790458,PDP
VR014,,1975,1956,,47500455,2354550000,466459530,,23219015,1250242426,245682080,,24281440,1104307574,220777450,PDN
VR014,,1976,1956,,47500455,2354550000,466459530,,24073885,1325835230,259987627,,23426570,1028714770,206471903,PDN
VR014,,1977,1956,,38386749,2006215760,395364642,,28960829,1488036396,293735988,,9425920,518179364,101628654,PDN
VR014,,1978,1956,,38386749,2006215760,395364642,,29691096,1538088097,303372252,,8695653,468127663,91992390,PDN
VR014,,1979,1956,,41311880,2445891760,476523937,,26367621,1535322312,299556644,,14944259,910569448,176967293,PDN
VR014,,1980,1956,,40273240,2384524460,464565849,,28217445,1649231951,321675088,,12055795,735292509,142890761,PDN
VR014,,1981,1956,,58715848,2915591468,577504365,,32349300,1879471914,366774907,,26366548,1036119554,210729458,PDN
VR014,,1982,1956,,59286657,2925002609,579749755,,35362985,2063994183,402621736,,23923672,861008426,177128019,PDN
VR014,,1983,1956,,61082199,2951495628,586259357,,36640969,2159254210,420849903,,24441230,792241418,165409454,PDN
VR014,,1984,1956,,61183979,2960804148,588017457,,37512155,2250110161,437887628,,23671824,710693987,150129829,PDN
VR014,,1985,1956,,62251937,3058498105,606468682,,38547409,2338162793,454590611,,23704528,720335312,151878071,PDN
VR014,,1986,1956,,58768153,2959630842,585392858,,39318866,2403467712,466982160,,19449287,556163130,118410698,PDN
VR014,,1987,1956,,58799945,3004319710,593376406,,40153383,2467978144,479295402,,18646562,536341566,114081004,PDN
VR014,,1988,1956,,53377764,3189489545,620902594,,41045881,2525080566,490348473,,12331883,664408979,130554121,PDN
VR014,,1989,1956,,47732675,2980791931,578122698,,41812985,2576304420,500230142,,5919690,404487511,77892556,PDN
VR014,,1990,1956,,47980240,3002692466,582267156,,42533698,2627342205,510032311,,5446542,375350261,72234845,PDN
VR014,,1991,1956,,48299487,3022885700,586179505,,43303705,2683778885,520844432,,4995782,339106815,65335073,PDN
VR014,,1992,1956,,48836870,3055338299,592491372,,43972955,2732307896,530148737,,4863915,323030403,62342635,PDN
VR014,,1993,1956,,48837120,3056300760,592662878,,44600854,2774520575,538287789,,4236266,281780185,54375089,PDN
VR014,,1994,1956,,49378128,3084262445,598179275,,45301031,2820808440,547224241,,4077097,263454005,50955034,PDN
VR014,,1995,1956,,48908978,3094610419,599551401,,45971487,2865529777,555852230,,2937491,229080642,43699171,PDN
VR014,,1996,1956,,49451934,3120019921,604615621,,46593320,2904706689,563445044,,2858614,215313232,41170577,PDN
VR014,,1997,1956,,48099994,3035769555,588272513,,46917221,2934072658,568994206,,1182773,101696897,19278307,PDN
VR014,,1998,1956,,48012461,3036805264,588369270,,47158462,2956963100,573308480,,853999,79842164,15060790,PDN
VR014,,1999,1956,,49244647,3131568362,606463217,,47437517,2981772189,578001963,,1807130,149796173,28461254,PDN
VR014,,2000,1956,,48357570,3104324103,600728407,,47589714,3000528884,581491651,,767856,103795219,19236756,PDN
VR014,,2001,1956,,48291818,3136790489,606439592,,47682279,3017851506,584666533,,609539,118938983,21773059,PDN
VR014,,2002,1956,,48182559,3103020448,600321429,,47714498,3030672914,586980141,,468061,72347534,13341288,PDN
VR014,,2003,1956,,48147202,3088773599,597751046,,47739002,3037572116,588232261,,408200,51201483,9518785,PDN
VR014,,2004,1956,,48252719,3087398002,597611795,,47764470,3044210062,589438858,,488249,43187940,8172937,PDN
VR014,,2005,1956,,48182319,3104469987,600579114,,47835544,3051069030,590730389,,346775,53400957,9848725,PDN
VR014,,2006,1956,,48235109,3093373030,598657356,,47859214,3055744309,591585959,,375895,37628721,7071397,PDN
VR014,,2007,1956,,48193510,3091819965,598339411,,47872216,3058854615,592152397,,321294,32965350,6187014,PDN
VR014,,2008,1956,,48196321,3093589236,598657039,,47880137,3060666521,592482721,,316184,32922715,6174318,PDN
VR014,,2009,1956,,48091985,3142587066,607271178,,47888769,3121816175,603372076,,203216,20770891,3899105,PDN
VR014,,2010,1956,,48091985,3142587066,607271178,,47895370,3123783199,603728681,,196615,18803867,3542501,PDN
VR014,,2011,1956,,48028490,3137815982,606358736,,47908080,3125304277,604012046,,120410,12511705,2346692,PDN
VR014,,2012,1956,,47911603,3126491873,604226884,,47909669,3126350465,604199788,,1934,141408,27096,PDN
VR014,,2013,1956,,47911603,3126491873,604226884,,47911603,3126491873,604226884,,0,0,0,PDN
VR014,,2014,1956,,47911603,3126491873,604226884,,47911603,3126491873,604226884,,0,0,0,PDN
VR014,,2015,1956,,47911603,3126491873,604226884,,47911603,3126491873,604226884,,0,0,0,PDN
VR014,,2016,1956,,47911603,3126491873,604226884,,47911603,3126491873,604226884,,0,0,0,PDN
VR014,,2017,1956,,47911603,3126491873,604226884,,47911603,3126491873,604226884,,0,0,0,PDN
VR014,,2017,1956,,47911603,3126491873,604226884,,47911603,3126491873,604226884,,0,0,0,PDN
VR024,,1984,1982,,6456864,181365844,38728366,,580214,22526540,4588495,,5876650,158839304,34139871,PDN
VR024,,1985,1982,,6458180,194522866,41070790,,1354310,56694085,11442225,,5103870,137828781,29628565,PDN
VR024,,1986,1982,,8454858,300391087,61905229,,2601737,95405722,19577844,,5853121,204985365,42327385,PDN
VR024,,1987,1982,,8630847,305142794,62926718,,3411033,128165167,26216223,,5219814,176977627,36710495,PDN
VR024,,1988,1982,,11217876,339816810,71683501,,3934458,153131072,31181980,,7283418,186685738,40501521,PDN
VR024,,1989,1982,,10734461,329013742,69277831,,4896782,172566288,35602527,,5837679,156447454,33675304,PDN
VR024,,1990,1982,,10928532,304430205,65097608,,6550135,202653285,42609438,,4378397,101776920,22488170,PDN
VR024,,1991,1982,,11089087,303409240,65076496,,8013382,230118605,48959753,,3075705,73290635,16116743,PDN
VR024,,1992,1982,,13363191,356467972,76791656,,8855852,254336204,54111404,,4507339,102131768,22680252,PDN
VR024,,1993,1982,,13363191,356469407,76791911,,9427778,270283619,57520949,,3935413,86185788,19270962,PDN
VR024,,1994,1982,,13363191,356469407,76791911,,9964223,281404649,60036225,,3398968,75064758,16755686,PDN
VR024,,1995,1982,,12578689,339094708,72915826,,10247429,288872883,61648298,,2331260,50221825,11267528,PDN
VR024,,1996,1982,,11321884,321608210,68547544,,10439819,294559549,62852550,,882065,27048661,5694994,PDN
VR024,,1997,1982,,12007061,334102809,71455959,,10658554,301235017,64259091,,1348507,32867792,7196868,PDN
VR024,,1998,1982,,12014014,334937170,71611375,,10817347,308529213,65715783,,1196667,26407957,5895592,PDN
VR024,,1999,1982,,11575734,339360090,71960092,,10919649,313016320,66616503,,656085,26343770,5343589,PDN
VR024,,2000,1982,,11413043,336089000,71215356,,10987824,316230902,67256668,,425219,19858098,3958688,PDN
VR024,,2001,1982,,11247011,330323784,70023485,,11055059,318999434,67816524,,191952,11324350,2206961,PDN
VR024,,2002,1982,,11190382,323998887,68841430,,11081780,319974462,68016738,,108602,4024425,824692,PDN
VR024,,2003,1982,,11190382,323998887,68841430,,11100918,320847872,68191287,,89464,3151015,650143,PDN
VR024,,2004,1982,,11365096,329869743,70060780,,11133318,321924447,68415248,,231778,7945296,1645532,PDN
VR024,,2005,1982,,11541952,339755605,71996686,,11176052,323709419,68775593,,365900,16046186,3221093,PDN
VR024,,2006,1982,,11445237,337640105,71523547,,11219431,325695449,69172358,,225806,11944656,2351189,PDN
VR024,,2007,1982,,11445237,337640105,71523547,,11260913,327706910,69571751,,184324,9933195,1951796,PDN
VR024,,2008,1982,,11445237,337640105,71523547,,11287442,329433686,69905536,,157795,8206419,1618011,PDN
VR024,,2009,1982,,11368623,339878864,71845288,,11311807,337150099,71302927,,56816,2728765,542362,PDN
VR024,,2010,1982,,11407352,343041393,72446745,,11328643,338290141,71522618,,78709,4751252,924127,PDN
VR024,,2011,1982,,11410454,343041471,72449861,,11331413,338474056,71558112,,79041,4567415,891749,PDN
VR024,,2012,1982,,11410454,343041471,72449861,,11333373,338701674,71600575,,77081,4339797,849287,PDN
VR024,,2013,1982,,11378125,342577906,72335047,,11341552,339389081,71731068,,36573,3188825,603980,PDN
VR024,,2014,1982,,11378450,341400977,72125954,,11348981,339888375,71827339,,29469,1512602,298615,PDN
VR024,,2015,1982,,11349855,339906319,71831406,,11349855,339906319,71831406,,0,0,0,PDN
VR024,,2016,1982,,11349855,339906319,71831406,,11349855,339906319,71831406,,0,0,0,PDN
VR024,,2017,1982,,11349855,339906319,71831406,,11349855,339906319,71831406,,0,0,0,PDN
VR024,,2017,1982,,11349855,339906319,71831406,,11349855,339906319,71831406,,0,0,0,PDN
VR039,,1975,1948,,5582943,1299370575,236787672,,4825956,979145369,179051111,,756987,320225206,57736561,PDP
VR039,,1976,1948,,5582943,1299370575,236787672,,4916892,1003778621,183525188,,666051,295591954,53262484,PDP
VR039,,1977,1948,,15225720,1613931137,302402079,,11382054,1163135913,218345740,,3843666,450795224,84056339,PDP
VR039,,1978,1948,,16298980,1727961545,323765447,,13144996,1368845510,256711813,,3153984,359116035,67053634,PDP
VR039,,1979,1948,,18568469,1914721045,359266164,,10801437,1671371108,308198431,,7767032,243349937,51067733,PDP
VR039,,1980,1948,,23915398,2471176743,463626562,,12311970,1832696291,338414513,,11603428,638480452,125212049,PDP
VR039,,1981,1948,,24152649,2499267743,468862212,,13592782,1906002383,352739113,,10559867,593265360,116123099,PDP
VR039,,1982,1948,,30999304,2715636673,514208676,,14861201,1998242082,370420290,,16138103,717394591,143788386,PDP
VR039,,1983,1948,,24817412,2314919338,436724768,,16347341,2051140107,381318890,,8470071,263779231,55405878,PDP
VR039,,1984,1948,,20588660,2325017291,434292804,,17478141,2103594402,391783195,,3110519,221422889,42509609,PDP
VR039,,1985,1948,,21797216,2330663639,436506049,,18196734,2136456265,398349094,,3600482,194207374,38156955,PDP
VR039,,1986,1948,,23484461,2352445270,442069029,,18990691,2160308580,403387235,,4493770,192136690,38681794,PDP
VR039,,1987,1948,,25691096,2386119624,450267542,,19897773,2181869591,408130796,,5793323,204250033,42136746,PDP
VR039,,1988,1948,,26711394,2393639015,452625809,,20917419,2199237932,412240894,,5793975,194401083,40384915,PDP
VR039,,1989,1948,,29626317,2405708068,457688251,,22027141,2217967402,416683262,,7599176,187740666,41004989,PDP
VR039,,1990,1948,,30224800,2350231967,448415541,,22946782,2235997844,420811167,,7278018,114234123,27604374,PDP
VR039,,1991,1948,,30937935,2358705801,450636476,,23910551,2256224053,425373906,,7027384,102481748,25262570,PDP
VR039,,1992,1948,,31104512,2361288115,451262540,,25012346,2279370244,430594240,,6092166,81917871,20668300,PDP
VR039,,1993,1948,,30036968,2396809132,456515461,,26253771,2301356323,435747779,,3783197,95452809,20767682,PDP
VR039,,1994,1948,,30201922,2398006411,456893454,,27427519,2320061079,440249775,,2774403,77945332,16643679,PDP
VR039,,1995,1948,,30369552,2399566473,457338675,,28293652,2335924031,443938497,,2075900,63642442,13400178,PDP
VR039,,1996,1948,,32256103,2466682291,471167543,,28983382,2352785079,447628414,,3272721,113897212,23539129,PDP
VR039,,1997,1948,,32333609,2501527143,477445200,,29416704,2381830297,453229924,,2916905,119696846,24215276,PDP
VR039,,1998,1948,,30916146,2489850710,473950080,,29741877,2407545160,458130696,,1174269,82305550,15819384,PDP
VR039,,1999,1948,,31271460,2571812483,488889340,,30020056,2433604564,463045779,,1251404,138207919,25843561,PDP
VR039,,2000,1948,,31714280,2632175931,500072987,,30279302,2472499129,470225766,,1434978,159676802,29847221,PDP
VR039,,2001,1948,,32242877,2643937570,502694402,,30452604,2497676561,474879038,,1790273,146261009,27815364,PDP
VR039,,2002,1948,,32161163,2609356650,496459499,,30617228,2513854941,477922378,,1543935,95501709,18537121,PDP
VR039,,2003,1948,,32198826,2610154162,496639069,,30777148,2527133239,480444984,,1421678,83020923,16194085,PDP
VR039,,2004,1948,,32015081,2621591819,498490494,,30961108,2535032464,482034500,,1053973,86559355,16455994,PDP
VR039,,2005,1948,,32111078,2616577498,497694263,,31078860,2539594090,482963929,,1032218,76983408,14730334,PDP
VR039,,2006,1948,,32081704,2610763411,496630354,,31168481,2542869119,483636296,,913223,67894292,12994058,PDP
VR039,,2007,1948,,32000861,2590661554,492972668,,31252059,2544546460,484018333,,748802,46115094,8954335,PDP
VR039,,2008,1948,,32275979,2598747306,494686532,,31335766,2545792724,484323795,,940213,52954582,10362737,PDP
VR039,,2009,1948,,32200932,2613934110,497313761,,31452507,2596886236,493531905,,748425,17047874,3781854,PDP
VR039,,2010,1948,,32271480,2626846148,499681824,,31558417,2600221265,494231239,,713063,26624883,5450586,PDP
VR039,,2011,1948,,32268621,2624181745,499204873,,31653193,2602208006,494679526,,615428,21973739,4525347,PDP
VR039,,2012,1948,,32470692,2622109494,499038215,,31734414,2602918140,494887107,,736278,19191354,4151109,PDP
VR039,,2013,1948,,32470692,2622109674,499038247,,31826653,2603190163,495027748,,644039,18919511,4010500,PDP
VR039,,2014,1948,,32348588,2607470486,496311306,,31920094,2603433972,495164572,,428494,4036514,1146735,PDP
VR039,,2015,1948,,32348588,2607470486,496311306,,32008861,2603604547,495283689,,339727,3865939,1027615,PDP
VR039,,2016,1948,,32603268,2606905558,496465465,,32092970,2603725174,495389263,,510298,3180384,1076202,PDP
VR039,,2017,1948,,32603268,2606905558,496465465,,32162999,2603818027,495475813,,440269,3087531,989651,PDP
VR039,,2017,1948,,32603268,2606905558,496465465,,32162999,2603818027,495475813,,440269,3087531,989651,PDP
VR041,,1993,1991,,9179,3671407,662454,,310,165434,29747,,8869,3505973,632707,PDN
VR041,,1994,1991,,9179,3671407,662454,,312,491697,87803,,8867,3179710,574651,PDN
VR041,,1995,1991,,9179,3671407,662454,,925,746680,133786,,8254,2924727,528668,PDN
VR041,,1996,1991,,925,781853,140045,,925,781853,140045,,0,0,0,PDN
VR041,,1997,1991,,925,781853,140045,,925,781853,140045,,0,0,0,PDN
VR041,,1998,1991,,925,781853,140045,,925,781853,140045,,0,0,0,PDN
VR041,,1999,1991,,925,781853,140045,,925,781853,140045,,0,0,0,PDN
VR041,,2000,1991,,925,781853,140045,,925,781853,140045,,0,0,0,PDN
VR041,,2001,1991,,925,781853,140045,,925,781853,140045,,0,0,0,PDN
VR041,,2002,1991,,925,781853,140045,,925,781853,140045,,0,0,0,PDN
VR041,,2003,1991,,925,781853,140045,,925,781853,140045,,0,0,0,PDN
VR041,,2004,1991,,925,781853,140045,,925,781853,140045,,0,0,0,PDN
VR041,,2005,1991,,925,781853,140045,,925,781853,140045,,0,0,0,PDN
VR041,,2006,1991,,925,781853,140045,,925,781853,140045,,0,0,0,PDN
VR041,,2007,1991,,925,781853,140045,,925,781853,140045,,0,0,0,PDN
VR041,,2008,1991,,925,781853,140045,,925,781853,140045,,0,0,0,PDN
VR041,,2009,1991,,8675,1727520,316063,,925,797511,142831,,7750,930009,173232,PDN
VR041,,2010,1991,,6737,1495018,272755,,925,797511,142831,,5812,697507,129924,PDN
VR041,,2011,1991,,925,797511,142831,,925,797511,142831,,0,0,0,PDN
VR041,,2012,1991,,925,797511,142831,,925,797511,142831,,0,0,0,PDN
VR041,,2013,1991,,925,797511,142831,,925,797511,142831,,0,0,0,PDN
VR041,,2014,1991,,925,797511,142831,,925,797511,142831,,0,0,0,PDN
VR041,,2015,1991,,925,797511,142831,,925,797511,142831,,0,0,0,PDN
VR041,,2016,1991,,925,797511,142831,,925,797511,142831,,0,0,0,PDN
VR041,,2017,1991,,925,797511,142831,,925,797511,142831,,0,0,0,PDN
VR041,,2017,1991,,925,797511,142831,,925,797511,142831,,0,0,0,PDN
VR046,,1975,1956,,2762616,178097570,34452575,,1497529,116279421,22187817,,1265087,61818149,12264758,PDP
VR046,,1976,1956,,2762616,178097570,34452575,,1538982,121323698,23126829,,1223634,56773872,11325746,PDP
VR046,,1977,1956,,2791785,186300360,35941315,,1577386,126266059,24044656,,1214399,60034301,11896659,PDP
VR046,,1978,1956,,2077018,166146700,31640488,,1587121,129436304,24618492,,489897,36710396,7021996,PDP
VR046,,1979,1956,,2077018,166146700,31640488,,1608175,134053255,25461067,,468843,32093445,6179421,PDP
VR046,,1980,1956,,2071624,170456700,32401998,,1629282,138506989,26274654,,442342,31949711,6127344,PDP
VR046,,1981,1956,,2082404,188757000,35669059,,1631681,146430295,27686894,,450723,42326705,7982165,PDP
VR046,,1982,1956,,2098772,196858197,37126921,,1674705,152664025,28839122,,424067,44194172,8287799,PDP
VR046,,1983,1956,,2118187,204047640,38425596,,1700717,155980215,29455204,,417470,48067425,8970392,PDP
VR046,,1984,1956,,2161645,212633161,39996727,,1742499,159872140,30189499,,419146,52761021,9807228,PDP
VR046,,1985,1956,,2161645,212633161,39996727,,1769565,162083546,30610054,,392080,50549615,9386673,PDP
VR046,,1986,1956,,2161645,212633161,39996727,,1863010,167080526,31592641,,298635,45552635,8404086,PDP
VR046,,1987,1956,,2167195,212743161,40021850,,1956100,171805451,32526465,,211095,40937710,7495385,PDP
VR046,,1988,1956,,2353463,219339741,41381887,,2046261,176449338,33442940,,307202,42890403,7938947,PDP
VR046,,1989,1956,,2388215,225444541,42502902,,2115620,180734313,34274750,,272595,44710228,8228152,PDP
VR046,,1990,1956,,2367130,224187250,42258100,,2161755,183025392,34728551,,205375,41161858,7529549,PDP
VR046,,1991,1956,,2496284,201028283,38266441,,2224625,185506285,35232861,,271659,15521998,3033580,PDP
VR046,,1992,1956,,2473489,196368258,37414460,,2275844,187466552,35632882,,197645,8901706,1781578,PDP
VR046,,1993,1956,,2486712,196595057,37468039,,2324904,189144211,35980458,,161808,7450846,1487581,PDP
VR046,,1994,1956,,2483523,202880684,38583289,,2372521,193608150,36822370,,111002,9272534,1760919,PDP
VR046,,1995,1956,,2515297,207671035,39467438,,2413231,199059240,37833025,,102066,8611795,1634413,PDP
VR046,,1996,1956,,2515996,208738775,39658127,,2447874,202048454,38399556,,68122,6690321,1258571,PDP
VR046,,1997,1956,,2602822,215938853,41026105,,2492012,206334353,39206310,,110810,9604500,1819795,PDP
VR046,,1998,1956,,3020774,227777881,43550646,,2610248,213041642,40518013,,410526,14736239,3032633,PDP
VR046,,1999,1956,,2880544,260561921,49243875,,2738448,218936475,41695116,,142096,41625446,7548759,PDP
VR046,,2000,1956,,2952976,262491280,49659610,,2769298,223047526,42457470,,183678,39443754,7202140,PDP
VR046,,2001,1956,,2924933,278297016,52443975,,2791617,226832495,43153271,,133316,51464521,9290704,PDP
VR046,,2002,1956,,2926106,291142865,54730886,,2803088,231487515,43993037,,123018,59655350,10737849,PDP
VR046,,2003,1956,,2932376,291968965,54884149,,2812380,238700955,45285860,,119996,53268010,9598289,PDP
VR046,,2004,1956,,2884103,276375904,52061310,,2823111,244016416,46242402,,60992,32359488,5818908,PDP
VR046,,2005,1956,,2894160,278229893,52401258,,2829746,246787565,46742124,,64414,31442328,5659134,PDP
VR046,,2006,1956,,2923538,285682352,53756696,,2830819,247558823,46880432,,92719,38123529,6876264,PDP
VR046,,2007,1956,,2923538,285682352,53756696,,2836692,249738345,47274120,,86846,35944007,6482576,PDP
VR046,,2008,1956,,2939659,287551961,54105488,,2847000,253108023,47884015,,92659,34443938,6221473,PDP
VR046,,2009,1956,,2880601,267768152,50526178,,2855761,260253027,49164128,,24840,7515125,1362050,PDP
VR046,,2010,1956,,2880601,267767617,50526083,,2857132,261015018,49301084,,23469,6752599,1224999,PDP
VR046,,2011,1956,,2866216,265601331,50126237,,2859580,262385355,49547363,,6636,3215976,578874,PDP
VR046,,2012,1956,,2869629,267397261,50449210,,2863051,263889912,49818550,,6578,3507349,630662,PDP
VR046,,2013,1956,,2869629,267397261,50449210,,2865965,265453602,50099700,,3664,1943659,349510,PDP
VR046,,2014,1956,,2888544,272709519,51413368,,2870278,267176436,50410567,,18266,5533083,1002800,PDP
VR046,,2015,1956,,2888544,272709519,51413368,,2872383,268899094,50719195,,16161,3810425,694172,PDP
VR046,,2016,1956,,2887385,278816111,52498791,,2874805,270468454,51000863,,12580,8347657,1497928,PDP
VR046,,2017,1956,,2887385,278816111,52498791,,2875709,271079544,51110501,,11676,7736567,1388289,PDP
VR046,,2017,1956,,2887385,278816111,52498791,,2875709,271079544,51110501,,11676,7736567,1388289,PDP
VR050,,1978,1974,,2034472,96150520,19143105,,135729,6044579,1211277,,1898743,90105941,17931828,PDP
VR050,,1979,1974,,2073564,108176520,21322055,,331752,16137136,3203129,,1741812,92039384,18118926,PDP
VR050,,1980,1974,,2390567,122812820,24243382,,514187,23904840,4767717,,1876380,98907980,19475665,PDP
VR050,,1981,1974,,2390567,122812820,24243382,,655444,28005901,5638700,,1735123,94806919,18604682,PDP
VR050,,1982,1974,,2155949,99806607,19915132,,874474,32150138,6595139,,1281475,67656469,13319993,PDP
VR050,,1983,1974,,5016846,132960341,28675270,,1761110,43842129,9562201,,3255736,89118212,19113069,PDP
VR050,,1984,1974,,8983371,177545043,40575016,,3033699,64115814,14442207,,5949672,113429229,26132809,PDP
VR050,,1985,1974,,12941295,197803992,48137735,,5166098,101941379,23305133,,7775197,95862613,24832602,PDP
VR050,,1986,1974,,13194914,223529198,52968793,,6709044,133097295,30391837,,6485870,90431903,22576956,PDP
VR050,,1987,1974,,13916923,258397816,59895182,,7957524,162833286,36931418,,5959399,95564530,22963764,PDP
VR050,,1988,1974,,16990867,312123536,72528863,,8989006,194219347,43547609,,8001861,117904189,28981254,PDP
VR050,,1989,1974,,15151199,359284128,79080759,,9834718,217946866,48615299,,5316481,141337262,30465460,PDP
VR050,,1990,1974,,14969907,360462326,79109111,,10746287,240570692,53552460,,4223620,119891634,25556651,PDP
VR050,,1991,1974,,16623199,377947035,83873561,,11704485,263789952,58642199,,4918714,114157083,25231362,PDP
VR050,,1992,1974,,16792025,380156644,84435556,,12290027,280409151,62184894,,4501998,99747493,22250662,PDP
VR050,,1993,1974,,16828329,383787215,85117869,,12803779,291756097,64717675,,4024550,92031118,20400194,PDP
VR050,,1994,1974,,16828335,383787647,85117952,,13276340,302567248,67113929,,3551995,81220399,18004023,PDP
VR050,,1995,1974,,15889980,366752947,81148511,,13705506,312305777,69275929,,2184474,54447170,11872582,PDP
VR050,,1996,1974,,15961509,380024100,83581456,,14062355,322357827,71421399,,1899154,57666273,12160057,PDP
VR050,,1997,1974,,15436262,372638131,81741979,,14404280,333650728,73772737,,1031982,38987403,7969242,PDP
VR050,,1998,1974,,15368546,372569833,81662111,,14677136,343988024,75884969,,691410,28581809,5777142,PDP
VR050,,1999,1974,,15997033,408594009,88700593,,14936482,354827680,78073080,,1060551,53766329,10627513,PDP
VR050,,2000,1974,,16270421,410170025,89254411,,15113834,361183403,79381343,,1156587,48986622,9873068,PDP
VR050,,2001,1974,,16171962,401425629,87600010,,15253743,366151397,80405237,,918219,35274232,7194773,PDP
VR050,,2002,1974,,16185935,406418426,88502381,,15325212,369260658,81029955,,860723,37157768,7472426,PDP
VR050,,2003,1974,,16304986,404040931,88198390,,15413990,371947529,81596824,,890996,32093402,6601566,PDP
VR050,,2004,1974,,16219113,393372753,86214265,,15459700,372927741,81816949,,759413,20445012,4397316,PDP
VR050,,2005,1974,,16241871,393968837,86343088,,15486685,373992577,82033407,,755186,19976260,4309681,PDP
VR050,,2006,1974,,16277899,395016034,86565450,,15526354,375074961,82265671,,751545,19941073,4299779,PDP
VR050,,2007,1974,,16333470,390783122,85867833,,15559259,375786178,82425127,,774211,14996944,3442706,PDP
VR050,,2008,1974,,16273652,387220369,85174073,,15590789,376193540,82529141,,682863,11026829,2644932,PDP
VR050,,2009,1974,,15843990,388082858,84897878,,15644975,384065299,83983996,,199015,4017559,913884,PDP
VR050,,2010,1974,,15843990,388082858,84897878,,15668097,384337773,84055601,,175893,3745085,842279,PDP
VR050,,2011,1974,,15778569,385882653,84440962,,15691466,384564083,84119238,,87103,1318570,321724,PDP
VR050,,2012,1974,,15768532,384839016,84245224,,15714515,384675720,84162152,,54017,163296,83074,PDP
VR050,,2013,1974,,15768532,384839016,84245224,,15720939,384695843,84172156,,47593,143173,73069,PDP
VR050,,2014,1974,,15768532,384839016,84245224,,15720939,384695843,84172156,,47593,143173,73069,PDP
VR050,,2015,1974,,15768532,384839016,84245224,,15742063,384709166,84195650,,26469,129850,49574,PDP
VR050,,2016,1974,,15768532,384839016,84245224,,15750555,384712779,84204785,,17977,126237,40439,PDP
VR050,,2017,1974,,15768532,384839016,84245224,,15766430,384746932,84226737,,2102,92084,18487,PDP
VR050,,2017,1974,,15768532,384839016,84245224,,15766430,384746932,84226737,,2102,92084,18487,PDP
VR051,,2004,1982,,196920,38775555,7096485,,0,0,0,,196920,38775555,7096485,PDN
VR051,,2005,1982,,169968,38775555,7069533,,22508,7376624,1335075,,147460,31398931,5734458,PDN
VR051,,2006,1982,,80404,28033116,5068503,,32940,11155582,2017919,,47464,16877534,3050584,PDN
VR051,,2007,1982,,80404,28033116,5068503,,35709,13647099,2464018,,44695,14386017,2604485,PDN
VR051,,2008,1982,,80404,28033116,5068503,,37615,15655834,2823351,,42789,12377282,2245152,PDN
VR051,,2009,1982,,54289,22263678,4015798,,38799,16966256,3057706,,15490,5297422,958091,PDN
VR051,,2010,1982,,54289,22263678,4015798,,41815,18406520,3316997,,12474,3857158,698801,PDN
VR051,,2011,1982,,54289,22263678,4015798,,45431,19697187,3550269,,8858,2566491,465528,PDN
VR051,,2012,1982,,73795,29185195,5266891,,51740,21411433,3861604,,22055,7773762,1405287,PDN
VR051,,2013,1982,,73795,29185195,5266891,,56638,23368405,4214718,,17157,5816790,1052173,PDN
VR051,,2014,1982,,73795,29185195,5266891,,58914,24454815,4410306,,14881,4730380,856585,PDN
VR051,,2015,1982,,67613,27185587,4904907,,59683,24618881,4440268,,7930,2566706,464639,PDN
VR051,,2016,1982,,67613,27185587,4904907,,59906,24645515,4445230,,7707,2540072,459677,PDN
VR051,,2017,1982,,59907,24648592,4445778,,59907,24648592,4445778,,0,0,0,PDN
VR051,,2017,1982,,59907,24648592,4445778,,59907,24648592,4445778,,0,0,0,PDN
VR054,,1975,1963,,139992,1110000,337501,,140000,1110000,337509,,-8,0,-8,PDN
VR054,,1976,1963,,139992,1110000,337501,,140000,1110000,337509,,-8,0,-8,PDN
VR054,,1977,1963,,139992,1110000,337501,,139992,1110000,337501,,0,0,0,PDN
VR054,,1978,1963,,139992,1110000,337501,,139992,1110000,337501,,0,0,0,PDN
VR054,,1979,1963,,139992,1110000,337501,,139992,1110000,337501,,0,0,0,PDN
VR054,,1980,1963,,383859,102358,402072,,383859,102358,402072,,0,0,0,PDN
VR054,,1981,1963,,383859,102358,402072,,383859,102358,402072,,0,0,0,PDN
VR054,,1982,1963,,383859,1023582,565991,,383859,1023582,565991,,0,0,0,PDN
VR054,,1983,1963,,383859,1023582,565991,,383859,1023582,565991,,0,0,0,PDN
VR054,,1984,1963,,383859,1023582,565991,,383859,1023582,565991,,0,0,0,PDN
VR054,,1985,1963,,383859,1023582,565991,,383859,1023582,565991,,0,0,0,PDN
VR054,,1986,1963,,383859,1023582,565991,,383859,1023582,565991,,0,0,0,PDN
VR054,,1987,1963,,383859,1023582,565991,,383859,1023582,565991,,0,0,0,PDN
VR054,,1988,1963,,383859,1023582,565991,,383859,1023582,565991,,0,0,0,PDN
VR054,,1989,1963,,383859,1023582,565991,,383859,1023582,565991,,0,0,0,PDN
VR054,,1990,1963,,421788,3908023,1117166,,383859,1023582,565991,,37929,2884441,551175,PDN
VR054,,1991,1963,,383859,1023582,565991,,383859,1023582,565991,,0,0,0,PDN
VR054,,1992,1963,,383859,1023582,565991,,383859,1023582,565991,,0,0,0,PDN
VR054,,1993,1963,,383859,1023582,565991,,383859,1023582,565991,,0,0,0,PDN
VR054,,1994,1963,,383859,1023582,565991,,383859,1023582,565991,,0,0,0,PDN
VR054,,1995,1963,,383859,1023582,565991,,383859,1023582,565991,,0,0,0,PDN
VR054,,1996,1963,,383859,1023582,565991,,383859,1023582,565991,,0,0,0,PDN
VR054,,1997,1963,,383859,1023582,565991,,383859,1023582,565991,,0,0,0,PDN
VR054,,1998,1963,,383859,1023582,565991,,383859,1023582,565991,,0,0,0,PDN
VR054,,1999,1963,,383859,1023582,565991,,383859,1023582,565991,,0,0,0,PDN
VR054,,2000,1963,,383859,1023582,565991,,383859,1023582,565991,,0,0,0,PDN
VR054,,2001,1963,,383859,1023582,565991,,383859,1023582,565991,,0,0,0,PDN
VR054,,2002,1963,,530624,24020264,4804692,,384009,1044271,569822,,146615,22975993,4234870,PDN
VR054,,2003,1963,,530624,24020264,4804692,,408386,4800606,1262586,,122238,19219658,3542106,PDN
VR054,,2004,1963,,455862,13915288,2931892,,431653,8751746,1988903,,24209,5163542,942989,PDN
VR054,,2005,1963,,456208,13915288,2932238,,441191,10684984,2342434,,15017,3230304,589804,PDN
VR054,,2006,1963,,452112,12095517,2604339,,441618,10906269,2382235,,10494,1189248,222104,PDN
VR054,,2007,1963,,452112,12095517,2604339,,441618,10906269,2382235,,10494,1189248,222104,PDN
VR054,,2008,1963,,441618,10906269,2382235,,441618,10906269,2382235,,0,0,0,PDN
VR054,,2009,1963,,441618,10926769,2385883,,441618,10926769,2385883,,0,0,0,PDN
VR054,,2010,1963,,441618,10926769,2385883,,441618,10926769,2385883,,0,0,0,PDN
VR054,,2011,1963,,441618,10926769,2385883,,441618,10926769,2385883,,0,0,0,PDN
VR054,,2012,1963,,441618,10926769,2385883,,441618,10926769,2385883,,0,0,0,PDN
VR054,,2013,1963,,441618,10926769,2385883,,441618,10926769,2385883,,0,0,0,PDN
VR054,,2014,1963,,441618,10926769,2385883,,441618,10926769,2385883,,0,0,0,PDN
VR054,,2015,1963,,441618,10926769,2385883,,441618,10926769,2385883,,0,0,0,PDN
VR054,,2016,1963,,441618,10926769,2385883,,441618,10926769,2385883,,0,0,0,PDN
VR054,,2017,1963,,441618,10926769,2385883,,441618,10926769,2385883,,0,0,0,PDN
VR054,,2017,1963,,441618,10926769,2385883,,441618,10926769,2385883,,0,0,0,PDN
VR060,,1976,1975,,68220,46055349,8263122,,1460,702208,126408,,66760,45353141,8136714,PDN
VR060,,1977,1975,,68220,46055349,8263122,,12650,5932637,1068279,,55570,40122712,7194843,PDN
VR060,,1978,1975,,97675,47796308,8602356,,21707,11511161,2069956,,75968,36285147,6532400,PDN
VR060,,1979,1975,,97675,47796308,8602356,,36491,18765294,3375511,,61184,29031014,5226845,PDN
VR060,,1980,1975,,129670,55591501,10021396,,49083,25372514,4563765,,80587,30218987,5457631,PDN
VR060,,1981,1975,,129670,55591501,10021396,,53702,30178276,5423502,,75968,25413225,4597894,PDN
VR060,,1982,1975,,139911,71609588,12881831,,57641,35178683,6317193,,82270,36430905,6564638,PDN
VR060,,1983,1975,,139911,71609588,12881831,,60897,39276356,7049572,,79014,32333232,5832259,PDN
VR060,,1984,1975,,144326,73902994,13294325,,65291,44211427,7932093,,79035,29691567,5362232,PDN
VR060,,1985,1975,,146303,75049696,13500341,,67448,49423573,8861678,,78855,25626123,4638663,PDN
VR060,,1986,1975,,141675,78717326,14148317,,69947,55096885,9873663,,71728,23620441,4274654,PDN
VR060,,1987,1975,,132895,84706541,15205233,,71766,60404635,10819922,,61129,24301906,4385311,PDN
VR060,,1988,1975,,132300,87867104,15767016,,74171,64766493,11598458,,58129,23100611,4168558,PDN
VR060,,1989,1975,,132546,90513713,16238189,,74776,68290312,12226077,,57770,22223401,4012112,PDN
VR060,,1990,1975,,132502,92513713,16594017,,75424,70689342,12653599,,57078,21824371,3940418,PDN
VR060,,1991,1975,,86397,85992879,15387621,,77776,73910830,13229169,,8621,12082049,2158452,PDN
VR060,,1992,1975,,86922,87995219,15744434,,79227,76465468,13685182,,7695,11529751,2059252,PDN
VR060,,1993,1975,,87525,89422512,15999004,,79680,78488670,14045636,,7845,10933842,1953368,PDN
VR060,,1994,1975,,94694,91214737,16325074,,79694,80273214,14363184,,15000,10941523,1961890,PDN
VR060,,1995,1975,,91986,89884004,16085581,,79694,82017736,14673597,,12292,7866268,1411984,PDN
VR060,,1996,1975,,82093,88126116,15762897,,79694,83531913,14943024,,2399,4594203,819873,PDN
VR060,,1997,1975,,79768,91131174,16295279,,79694,84666401,15144890,,74,6464773,1150389,PDN
VR060,,1998,1975,,79694,87905483,15721239,,79694,85601332,15311248,,0,2304151,409991,PDN
VR060,,1999,1975,,79694,101134383,18075136,,79694,87363186,15624745,,0,13771197,2450391,PDN
VR060,,2000,1975,,79694,101134383,18075136,,79694,90223075,16133622,,0,10911308,1941514,PDN
VR060,,2001,1975,,79694,101134383,18075136,,79694,91447186,16351435,,0,9687197,1723701,PDN
VR060,,2002,1975,,446660,106296308,19360594,,79694,91885988,16429514,,366966,14410320,2931080,PDN
VR060,,2003,1975,,446463,105761810,19265291,,79694,92003139,16450359,,366769,13758671,2814932,PDN
VR060,,2004,1975,,122425,96184957,17237186,,120831,95031649,17030377,,1594,1153308,206809,PDN
VR060,,2005,1975,,140830,100388384,18003532,,122189,95734848,17156859,,18641,4653536,846673,PDN
VR060,,2006,1975,,163583,110132388,19760093,,126844,96892847,17367564,,36739,13239541,2392529,PDN
VR060,,2007,1975,,161471,105477599,18929727,,135763,100055850,17939295,,25708,5421749,990432,PDN
VR060,,2008,1975,,161522,105668212,18963695,,139981,101073965,18124672,,21541,4594247,839023,PDN
VR060,,2009,1975,,142593,111188340,19926994,,140988,104759345,18781439,,1605,6428995,1145555,PDN
VR060,,2010,1975,,142842,111557356,19992904,,141497,106802862,19145564,,1345,4754494,847341,PDN
VR060,,2011,1975,,142623,110082477,19730251,,141960,108144277,19384712,,663,1938200,345539,PDN
VR060,,2012,1975,,142623,110082477,19730251,,142045,108914905,19521920,,578,1167572,208331,PDN
VR060,,2013,1975,,145262,114227924,20470514,,142582,109566157,19638338,,2680,4661767,832177,PDN
VR060,,2014,1975,,145262,114227924,20470514,,142953,110351117,19778381,,2309,3876807,692133,PDN
VR060,,2015,1975,,145666,114227924,20470918,,142995,110521427,19808728,,2671,3706497,662191,PDN
VR060,,2016,1975,,142995,110521427,19808728,,142995,110521427,19808728,,0,0,0,PDN
VR060,,2017,1975,,142995,110521427,19808728,,142995,110521427,19808728,,0,0,0,PDN
VR060,,2017,1975,,142995,110521427,19808728,,142995,110521427,19808728,,0,0,0,PDN
VR063,,2000,2000,,31592,4718648,871209,,0,0,0,,31592,4718648,871209,PDN
VR063,,2001,2000,,6582,1999759,362411,,6582,1983385,359497,,0,16374,2914,PDN
VR063,,2002,2000,,6585,2329327,421056,,6585,2329327,421056,,0,0,0,PDN
VR063,,2003,2000,,6585,2329327,421056,,6585,2329327,421056,,0,0,0,PDN
VR063,,2004,2000,,6585,2329327,421056,,6585,2329327,421056,,0,0,0,PDN
VR063,,2005,2000,,6587,2400881,433790,,6587,2400881,433790,,0,0,0,PDN
VR063,,2006,2000,,6587,2400881,433790,,6587,2400881,433790,,0,0,0,PDN
VR063,,2007,2000,,6587,2400881,433790,,6587,2400881,433790,,0,0,0,PDN
VR063,,2008,2000,,6587,2400881,433790,,6587,2400881,433790,,0,0,0,PDN
VR063,,2009,2000,,6587,2400881,433791,,6587,2400881,433791,,0,0,0,PDN
VR063,,2010,2000,,6587,2400881,433791,,6587,2400881,433791,,0,0,0,PDN
VR063,,2011,2000,,6587,2400881,433791,,6587,2400881,433791,,0,0,0,PDN
VR063,,2012,2000,,6587,2400881,433791,,6587,2400881,433791,,0,0,0,PDN
VR063,,2013,2000,,6587,2400881,433791,,6587,2400881,433791,,0,0,0,PDN
VR063,,2014,2000,,6587,2400881,433791,,6587,2400881,433791,,0,0,0,PDN
VR063,,2015,2000,,6587,2400881,433791,,6587,2400881,433791,,0,0,0,PDN
VR063,,2016,2000,,6587,2400881,433791,,6587,2400881,433791,,0,0,0,PDN
VR063,,2017,2000,,6587,2400881,433791,,6587,2400881,433791,,0,0,0,PDN
VR063,,2017,2000,,6587,2400881,433791,,6587,2400881,433791,,0,0,0,PDN
VR064,,1976,1975,,0,3200000,569395,,0,0,0,,0,3200000,569395,PDN
VR064,,1977,1975,,54564,10912780,1996340,,7932,919983,171630,,46632,9992797,1824710,PDN
VR064,,1978,1975,,103788,10912780,2045564,,26011,2737537,513117,,77777,8175243,1532447,PDN
VR064,,1979,1975,,103788,10912780,2045564,,53174,4973199,938085,,50614,5939581,1107479,PDN
VR064,,1980,1975,,176000,13230000,2530093,,87191,7341631,1393531,,88809,5888369,1136562,PDN
VR064,,1981,1975,,191890,29120000,5373385,,146337,14547091,2734787,,45553,14572909,2638598,PDN
VR064,,1982,1975,,326291,36890000,6890348,,149445,15175248,2849667,,176846,21714752,4040681,PDN
VR064,,1983,1975,,326291,36890000,6890348,,167548,19606811,3656304,,158743,17283189,3234044,PDN
VR064,,1984,1975,,326291,36890000,6890348,,169079,20276601,3777015,,157212,16613399,3113333,PDN
VR064,,1985,1975,,169079,20276601,3777015,,169079,20276601,3777015,,0,0,0,PDN
VR064,,1986,1975,,169079,20276601,3777015,,169079,20276601,3777015,,0,0,0,PDN
VR064,,1987,1975,,169079,20276601,3777015,,169079,20276601,3777015,,0,0,0,PDN
VR064,,1988,1975,,169079,20276601,3777015,,169079,20276601,3777015,,0,0,0,PDN
VR064,,1989,1975,,169079,20276601,3777015,,169079,20276601,3777015,,0,0,0,PDN
VR064,,1990,1975,,169079,20276601,3777015,,169079,20276601,3777015,,0,0,0,PDN
VR064,,1991,1975,,169079,20276601,3777015,,169079,20276601,3777015,,0,0,0,PDN
VR064,,1992,1975,,169079,20276601,3777015,,169079,20276601,3777015,,0,0,0,PDN
VR064,,1993,1975,,169079,20276601,3777015,,169079,20276601,3777015,,0,0,0,PDN
VR064,,1994,1975,,169079,20276601,3777015,,169079,20276601,3777015,,0,0,0,PDN
VR064,,1995,1975,,169079,20276601,3777015,,169079,20276601,3777015,,0,0,0,PDN
VR064,,1996,1975,,169079,20276601,3777015,,169079,20276601,3777015,,0,0,0,PDN
VR064,,1997,1975,,169079,20276601,3777015,,169079,20276601,3777015,,0,0,0,PDN
VR064,,1998,1975,,169079,20276601,3777015,,169079,20276601,3777015,,0,0,0,PDN
VR064,,1999,1975,,169079,20276601,3777015,,169079,20276601,3777015,,0,0,0,PDN
VR064,,2000,1975,,169079,20276601,3777015,,169079,20276601,3777015,,0,0,0,PDN
VR064,,2001,1975,,169079,20276601,3777015,,169079,20276601,3777015,,0,0,0,PDN
VR064,,2002,1975,,169079,20276601,3777015,,169079,20276601,3777015,,0,0,0,PDN
VR064,,2003,1975,,169079,20276601,3777015,,169079,20276601,3777015,,0,0,0,PDN
VR064,,2004,1975,,234080,21287951,4021972,,172907,20352373,3794326,,61173,935578,227646,PDN
VR064,,2005,1975,,251863,21516541,4080429,,215340,20946951,3942555,,36523,569590,137874,PDN
VR064,,2006,1975,,225576,21142479,3987583,,225036,21080918,3976089,,540,61561,11494,PDN
VR064,,2007,1975,,225576,21143083,3987690,,225453,21135780,3986268,,123,7303,1422,PDN
VR064,,2008,1975,,225577,21153767,3989592,,225577,21153767,3989592,,0,0,0,PDN
VR064,,2009,1975,,225577,21559849,4061849,,225577,21559849,4061849,,0,0,0,PDN
VR064,,2010,1975,,225577,21559849,4061849,,225577,21559849,4061849,,0,0,0,PDN
VR064,,2011,1975,,225577,21559849,4061849,,225577,21559849,4061849,,0,0,0,PDN
VR064,,2012,1975,,225577,21559849,4061849,,225577,21559849,4061849,,0,0,0,PDN
VR064,,2013,1975,,225577,21559849,4061849,,225577,21559849,4061849,,0,0,0,PDN
VR064,,2014,1975,,225577,21559849,4061849,,225577,21559849,4061849,,0,0,0,PDN
VR064,,2015,1975,,225577,21559849,4061849,,225577,21559849,4061849,,0,0,0,PDN
VR064,,2016,1975,,225577,21559849,4061849,,225577,21559849,4061849,,0,0,0,PDN
VR064,,2017,1975,,225577,21559849,4061849,,225577,21559849,4061849,,0,0,0,PDN
VR064,,2017,1975,,225577,21559849,4061849,,225577,21559849,4061849,,0,0,0,PDN
VR069,,1986,1984,,294,2941505,523693,,0,13407,2386,,294,2928098,521307,PDN
VR069,,1987,1984,,387,3866704,688413,,1,2442377,434588,,386,1424327,253825,PDN
VR069,,1988,1984,,1137,11376730,2025466,,1,4511429,802746,,1136,6865301,1222720,PDN
VR069,,1989,1984,,1137,11376730,2025466,,1,6364176,1132417,,1136,5012554,893049,PDN
VR069,,1990,1984,,488,13574882,2415947,,1,8868459,1578019,,487,4706423,837928,PDN
VR069,,1991,1984,,488,15382611,2737607,,1,9820762,1747468,,487,5561849,990139,PDN
VR069,,1992,1984,,1,9820906,1747493,,1,9820906,1747493,,0,0,0,PDN
VR069,,1993,1984,,1,9820906,1747493,,1,9820906,1747493,,0,0,0,PDN
VR069,,1994,1984,,1,9820906,1747493,,1,9820906,1747493,,0,0,0,PDN
VR069,,1995,1984,,1,9820906,1747493,,1,9820906,1747493,,0,0,0,PDN
VR069,,1996,1984,,1,9820906,1747493,,1,9820906,1747493,,0,0,0,PDN
VR069,,1997,1984,,1,9820906,1747493,,1,9820906,1747493,,0,0,0,PDN
VR069,,1998,1984,,1,9820906,1747493,,1,9820906,1747493,,0,0,0,PDN
VR069,,1999,1984,,1,9820906,1747493,,1,9820906,1747493,,0,0,0,PDN
VR069,,2000,1984,,1,9820906,1747493,,1,9820906,1747493,,0,0,0,PDN
VR069,,2001,1984,,1,9820906,1747493,,1,9820906,1747493,,0,0,0,PDN
VR069,,2002,1984,,1,9820906,1747493,,1,9820906,1747493,,0,0,0,PDN
VR069,,2003,1984,,1,9820906,1747493,,1,9820906,1747493,,0,0,0,PDN
VR069,,2004,1984,,1,9820906,1747493,,1,9820906,1747493,,0,0,0,PDN
VR069,,2005,1984,,104,11361450,2021714,,1,10107455,1798481,,103,1253995,223233,PDN
VR069,,2006,1984,,248,12807207,2279110,,1,10570556,1880883,,247,2236651,398227,PDN
VR069,,2007,1984,,248,12787414,2275589,,1,11112250,1977270,,247,1675164,298319,PDN
VR069,,2008,1984,,273,13039967,2320552,,1,11504973,2047149,,272,1534994,273403,PDN
VR069,,2009,1984,,1,11875044,2112998,,1,11850656,2108658,,0,24388,4340,PDN
VR069,,2010,1984,,1,11875044,2112998,,1,11875044,2112998,,0,0,0,PDN
VR069,,2011,1984,,1,11875044,2112998,,1,11875044,2112998,,0,0,0,PDN
VR069,,2012,1984,,1,11875044,2112998,,1,11875044,2112998,,0,0,0,PDN
VR069,,2013,1984,,1,11875044,2112998,,1,11875044,2112998,,0,0,0,PDN
VR069,,2014,1984,,1,11875044,2112998,,1,11875044,2112998,,0,0,0,PDN
VR069,,2015,1984,,1,11875044,2112998,,1,11875044,2112998,,0,0,0,PDN
VR069,,2016,1984,,1,11875044,2112998,,1,11875044,2112998,,0,0,0,PDN
VR069,,2017,1984,,1,11875044,2112998,,1,11875044,2112998,,0,0,0,PDN
VR069,,2017,1984,,1,11875044,2112998,,1,11875044,2112998,,0,0,0,PDN
VR071,,1975,1947,,1114371,138387460,25738474,,814760,105000818,19498180,,299611,33386642,6240294,PDP
VR071,,1976,1947,,1114371,138387460,25738474,,830095,109544165,20321939,,284276,28843295,5416535,PDP
VR071,,1977,1947,,1114371,138387460,25738474,,845484,114046082,21138381,,268887,24341378,4600093,PDP
VR071,,1978,1947,,1122938,139647460,25971240,,854304,117287908,21724039,,268634,22359552,4247201,PDP
VR071,,1979,1947,,572938,139647460,25421240,,514449,121912936,22207142,,58489,17734524,3214098,PDP
VR071,,1980,1947,,588708,139647460,25437010,,524374,124754908,22722756,,64334,14892552,2714254,PDP
VR071,,1981,1947,,588708,139647460,25437010,,531399,126715747,23078685,,57309,12931713,2358325,PDP
VR071,,1982,1947,,601172,143715103,26173254,,523373,127303402,23175224,,77799,16411701,2998030,PDP
VR071,,1983,1947,,601172,143715103,26173254,,523373,127431451,23198008,,77799,16283652,2975246,PDP
VR071,,1984,1947,,664039,151028023,27537353,,528323,127636148,23239381,,135716,23391875,4297972,PDP
VR071,,1985,1947,,672646,155392888,28322626,,531116,130629271,23774759,,141530,24763617,4547867,PDP
VR071,,1986,1947,,678286,161245370,29369633,,536357,135057327,24567910,,141929,26188043,4801723,PDP
VR071,,1987,1947,,678629,164233660,29901700,,538765,139130776,25295131,,139864,25102884,4606569,PDP
VR071,,1988,1947,,663019,166273935,30249128,,539370,141491536,25715800,,123649,24782399,4533328,PDP
VR071,,1989,1947,,663019,166273935,30249128,,539378,141686840,25750559,,123641,24587095,4498569,PDP
VR071,,1990,1947,,663467,166273935,30249576,,540049,142117184,25827804,,123418,24156751,4421772,PDP
VR071,,1991,1947,,941392,147872418,27253210,,540049,142120940,25828472,,401343,5751478,1424738,PDP
VR071,,1992,1947,,887618,155810260,28611864,,550640,147913217,26869718,,336978,7897043,1742146,PDP
VR071,,1993,1947,,907758,170321779,31214124,,559630,154048362,27970371,,348128,16273417,3243753,PDP
VR071,,1994,1947,,923578,178129897,32619289,,647795,158355086,28824857,,275783,19774811,3794432,PDP
VR071,,1995,1947,,938648,176806465,32398873,,695328,162560017,29620598,,243320,14246448,2778275,PDP
VR071,,1996,1947,,968877,174452099,32010176,,730293,165410877,30162833,,238584,9041222,1847343,PDP
VR071,,1997,1947,,947141,181402093,33225093,,767467,169853067,30990433,,179674,11549026,2234660,PDP
VR071,,1998,1947,,801853,183633591,33476869,,778190,174564010,31839402,,23663,9069581,1637467,PDP
VR071,,1999,1947,,800413,183335585,33422403,,778707,176236740,32137558,,21706,7098845,1284845,PDP
VR071,,2000,1947,,779264,179653336,32746050,,778854,177188491,32307055,,410,2464845,438995,PDP
VR071,,2001,1947,,781644,180743961,32942491,,779255,177899740,32434013,,2389,2844221,508478,PDP
VR071,,2002,1947,,783298,185120076,33722813,,780677,178813976,32598110,,2621,6306100,1124703,PDP
VR071,,2003,1947,,782768,184539763,33619025,,781003,179662168,32749360,,1765,4877595,869665,PDP
VR071,,2004,1947,,790016,183601223,33459273,,781236,180302900,32863603,,8780,3298323,595670,PDP
VR071,,2005,1947,,945476,220663660,40209473,,781255,180725310,32938783,,164221,39938350,7270690,PDP
VR071,,2006,1947,,875688,207477878,37793460,,788011,182632079,33284822,,87677,24845799,4508638,PDP
VR071,,2007,1947,,887232,214086874,38980982,,837475,193529471,35273324,,49757,20557403,3707658,PDP
VR071,,2008,1947,,884699,224682502,40863792,,847428,198249218,36123090,,37271,26433284,4740702,PDP
VR071,,2009,1947,,860288,226399172,41144839,,855762,206478393,37595690,,4526,19920779,3549149,PDP
VR071,,2010,1947,,860288,226399172,41144839,,856733,210038003,38230044,,3555,16361169,2914796,PDP
VR071,,2011,1947,,858229,220471765,40088082,,857062,213787998,38897631,,1167,6683767,1190451,PDP
VR071,,2012,1947,,858229,220471765,40088082,,857681,215992720,39290550,,548,4479045,797533,PDP
VR071,,2013,1947,,897444,228048335,41475441,,858101,216641933,39406487,,39343,11406402,2068951,PDP
VR071,,2014,1947,,875384,227923918,41431242,,872379,219062390,39851451,,3005,8861528,1579789,PDP
VR071,,2015,1947,,1009769,227788094,41541460,,883197,220139023,40053841,,126572,7649071,1487617,PDP
VR071,,2016,1947,,1031571,231897320,42294441,,887989,223001456,40567963,,143582,8895864,1726476,PDP
VR071,,2017,1947,,906553,234149095,42570093,,891879,226520023,41197933,,14674,7629072,1372159,PDP
VR071,,2017,1947,,906553,234149095,42570093,,891879,226520023,41197933,,14674,7629072,1372159,PDP
VR075,,1988,1981,,909668,41987443,8380743,,407952,23482909,4586406,,501716,18504534,3794337,PDN
VR075,,1989,1981,,401835,17655536,3543389,,401751,17165343,3456082,,84,490193,87307,PDN
VR075,,1990,1981,,401751,17165343,3456082,,401751,17165343,3456082,,0,0,0,PDN
VR075,,1991,1981,,401751,17165343,3456082,,401751,17165343,3456082,,0,0,0,PDN
VR075,,1992,1981,,694760,33827507,6713889,,401751,17165343,3456082,,293009,16662164,3257807,PDN
VR075,,1993,1981,,773965,41748011,8202437,,415971,18314564,3674790,,357994,23433447,4527647,PDN
VR075,,1994,1981,,830114,45263203,8884065,,518422,26975470,5318328,,311692,18287733,3565737,PDN
VR075,,1995,1981,,864795,57509335,11097773,,611789,36109020,7036882,,253006,21400315,4060891,PDN
VR075,,1996,1981,,927113,63703535,12262262,,688889,43352667,8402887,,238224,20350868,3859375,PDN
VR075,,1997,1981,,927113,63703535,12262262,,737442,48125161,9300638,,189671,15578374,2961624,PDN
VR075,,1998,1981,,927113,63703535,12262262,,750059,49734029,9599530,,177054,13969506,2662732,PDN
VR075,,1999,1981,,776823,54503246,10474909,,755289,50770422,9789172,,21534,3732824,685737,PDN
VR075,,2000,1981,,776823,54503246,10474909,,758087,51477481,9917781,,18736,3025765,557128,PDN
VR075,,2001,1981,,758670,51623673,9944377,,758670,51623673,9944377,,0,0,0,PDN
VR075,,2002,1981,,758670,51623673,9944377,,758670,51623673,9944377,,0,0,0,PDN
VR075,,2003,1981,,758670,51623673,9944377,,758670,51623673,9944377,,0,0,0,PDN
VR075,,2004,1981,,758670,51623673,9944377,,758670,51623673,9944377,,0,0,0,PDN
VR075,,2005,1981,,758670,51623673,9944377,,758670,51623673,9944377,,0,0,0,PDN
VR075,,2006,1981,,935524,58949516,11424762,,758670,51623673,9944377,,176854,7325843,1480385,PDN
VR075,,2007,1981,,935524,58949516,11424762,,770048,51995735,10021958,,165476,6953781,1402804,PDN
VR075,,2008,1981,,935524,58949516,11424762,,794709,53161474,10254046,,140815,5788042,1170716,PDN
VR075,,2009,1981,,794709,54149926,10429927,,794709,54149926,10429927,,0,0,0,PDN
VR075,,2010,1981,,794709,54149926,10429927,,794709,54149926,10429927,,0,0,0,PDN
VR075,,2011,1981,,794709,54149926,10429927,,794709,54149926,10429927,,0,0,0,PDN
VR075,,2012,1981,,794709,54149926,10429927,,794709,54149926,10429927,,0,0,0,PDN
VR075,,2013,1981,,794709,54149926,10429927,,794709,54149926,10429927,,0,0,0,PDN
VR075,,2014,1981,,794709,54149926,10429927,,794709,54149926,10429927,,0,0,0,PDN
VR075,,2015,1981,,794709,54149926,10429927,,794709,54149926,10429927,,0,0,0,PDN
VR075,,2016,1981,,794709,54149926,10429927,,794709,54149926,10429927,,0,0,0,PDN
VR075,,2017,1981,,794709,54149926,10429927,,794709,54149926,10429927,,0,0,0,PDN
VR075,,2017,1981,,794709,54149926,10429927,,794709,54149926,10429927,,0,0,0,PDN
VR076,,1975,1949,,2846169,776987281,141100134,,1587700,543452994,98287521,,1258469,233534287,42812613,PDP
VR076,,1976,1949,,2846169,776987281,141100134,,1667680,592914563,107168492,,1178489,184072718,33931642,PDP
VR076,,1977,1949,,3112590,793091370,144232051,,1765238,606205130,109630919,,1347352,186886240,34601132,PDP
VR076,,1978,1949,,3121298,793091646,144240808,,1892605,620269266,112260802,,1228693,172822380,31980006,PDP
VR076,,1979,1949,,1651298,793091646,142770808,,1378682,640781878,115396810,,272616,152309768,27373998,PDP
VR076,,1980,1949,,2251267,873100032,157607145,,1509730,658506638,118681730,,741537,214593394,38925415,PDP
VR076,,1981,1949,,2251267,873100032,157607145,,1655642,677850662,122269639,,595625,195249370,35337506,PDP
VR076,,1982,1949,,2594782,878135077,158846575,,2063345,734422495,132743504,,531437,143712582,26103071,PDP
VR076,,1983,1949,,3774313,1154165089,209141767,,2522007,793641158,143739295,,1252306,360523931,65402472,PDP
VR076,,1984,1949,,4388292,1185482921,215328314,,2784522,839875314,152228528,,1603770,345607607,63099786,PDP
VR076,,1985,1949,,75230447,1157251734,281147126,,3022312,876689972,159016969,,72208135,280561762,122130157,PDP
VR076,,1986,1949,,6380832,1158060614,212441439,,3222544,907298354,164663532,,3158288,250762260,47777907,PDP
VR076,,1987,1949,,6386841,1171538212,214845598,,3373921,933469548,169471705,,3012920,238068664,45373893,PDP
VR076,,1988,1949,,5271841,1136032448,207412846,,3218788,933273357,169281663,,2053053,202759091,38131183,PDP
VR076,,1989,1949,,5346704,1132866085,206924299,,3429238,957553898,173812494,,1917466,175312187,33111805,PDP
VR076,,1990,1949,,5403987,1124594461,205509763,,3551083,970393229,176218917,,1852904,154201232,29290846,PDP
VR076,,1991,1949,,4951955,1098005436,200326588,,3693444,982588071,178531179,,1258511,115417365,21795409,PDP
VR076,,1992,1949,,4939092,1117503383,203783110,,3784532,994738300,180784230,,1154560,122765083,22998880,PDP
VR076,,1993,1949,,4978145,1123702146,204925146,,3896561,1003310821,182421618,,1081584,120391325,22503528,PDP
VR076,,1994,1949,,5046730,1128643008,205872888,,4011813,1013563040,184361108,,1034917,115079968,21511780,PDP
VR076,,1995,1949,,5278067,1128058355,206000194,,4160045,1025212785,186582249,,1118022,102845570,19417945,PDP
VR076,,1996,1949,,5533962,1151173941,210369183,,4295860,1036225193,188677567,,1238102,114948748,21691616,PDP
VR076,,1997,1949,,5765323,1186285921,216848227,,4518640,1056537572,192514649,,1246683,129748349,24333578,PDP
VR076,,1998,1949,,5561101,1163613509,212609768,,4682874,1075197308,195999121,,878227,88416201,16610647,PDP
VR076,,1999,1949,,6801278,1181931445,217109364,,4857922,1088354715,198515345,,1943356,93576730,18594019,PDP
VR076,,2000,1949,,7202012,1222362160,224704176,,5062139,1100842722,200941627,,2139873,121519438,23762549,PDP
VR076,,2001,1949,,7471826,1267535185,233011895,,5423957,1111707169,203236621,,2047869,155828016,29775274,PDP
VR076,,2002,1949,,8413630,1260637514,232726354,,5855978,1120689340,205266893,,2557652,139948174,27459461,PDP
VR076,,2003,1949,,10264417,1279316620,237900827,,6195342,1134767091,208111194,,4069075,144549529,29789633,PDP
VR076,,2004,1949,,8331039,1203703928,222513232,,6614799,1142176642,209849077,,1716240,61527286,12664155,PDP
VR076,,2005,1949,,9546232,1269958544,235517503,,7007309,1155268583,212571114,,2538923,114689961,22946389,PDP
VR076,,2006,1949,,8868156,1250109400,231307551,,7390556,1168838970,215369020,,1477600,81270430,15938531,PDP
VR076,,2007,1949,,8778441,1242977883,229948882,,7633506,1178807160,217385670,,1144935,64170723,12563212,PDP
VR076,,2008,1949,,8909959,1260283911,233159766,,7807972,1186186189,218873130,,1101987,74097722,14286636,PDP
VR076,,2009,1949,,8743506,1252677984,231639945,,7989784,1213120472,223847520,,753722,39557512,7792426,PDP
VR076,,2010,1949,,8941074,1255804502,232393833,,8179193,1219366945,225148401,,761881,36437557,7245432,PDP
VR076,,2011,1949,,8941074,1255804502,232393833,,8404871,1224604166,226305968,,536203,31200336,6087865,PDP
VR076,,2012,1949,,9840392,1259097969,233879177,,8589011,1228082609,227109047,,1251381,31015360,6770128,PDP
VR076,,2013,1949,,9830429,1258560623,233773601,,8762974,1231209125,227839330,,1067455,27351498,5934269,PDP
VR076,,2014,1949,,9819295,1261786432,234336454,,8936312,1234980393,228683714,,882983,26806039,5652740,PDP
VR076,,2015,1949,,9608081,1266827916,235022301,,9107173,1241269576,229973647,,500908,25558340,5048654,PDP
VR076,,2016,1949,,10257249,1278815911,237804565,,9246896,1245295517,230829728,,1010353,33520394,6974833,PDP
VR076,,2017,1949,,10257249,1278815911,237804565,,9462554,1249268319,231752291,,794695,29547592,6052273,PDP
VR076,,2017,1949,,10257249,1278815911,237804565,,9462554,1249268319,231752291,,794695,29547592,6052273,PDP
VR083,,1999,1999,,2985,21560233,3839325,,184,878343,156473,,2801,20681890,3682852,PDN
VR083,,2000,1999,,3103,21776654,3877952,,785,6937174,1235158,,2318,14839480,2642794,PDN
VR083,,2001,1999,,3423,21776654,3878272,,1380,10420082,1855487,,2043,11356572,2022785,PDN
VR083,,2002,1999,,2580,20455238,3642302,,1485,13144398,2340346,,1095,7310840,1301956,PDN
VR083,,2003,1999,,2580,20455238,3642302,,1659,14338181,2552937,,921,6117057,1089365,PDN
VR083,,2004,1999,,1930,14378595,2560399,,1930,14378595,2560399,,0,0,0,PDN
VR083,,2005,1999,,1930,14378595,2560399,,1930,14378595,2560399,,0,0,0,PDN
VR083,,2006,1999,,1930,14378595,2560399,,1930,14378595,2560399,,0,0,0,PDN
VR083,,2007,1999,,1930,14378595,2560399,,1930,14378595,2560399,,0,0,0,PDN
VR083,,2008,1999,,1930,14378595,2560399,,1930,14378595,2560399,,0,0,0,PDN
VR083,,2009,1999,,1930,14378595,2560398,,1930,14378595,2560398,,0,0,0,PDN
VR083,,2010,1999,,1930,14378595,2560398,,1930,14378595,2560398,,0,0,0,PDN
VR083,,2011,1999,,1930,14378595,2560398,,1930,14378595,2560398,,0,0,0,PDN
VR083,,2012,1999,,1930,14378595,2560398,,1930,14378595,2560398,,0,0,0,PDN
VR083,,2013,1999,,1930,14378595,2560398,,1930,14378595,2560398,,0,0,0,PDN
VR083,,2014,1999,,1930,14378595,2560398,,1930,14378595,2560398,,0,0,0,PDN
VR083,,2015,1999,,1930,14378595,2560398,,1930,14378595,2560398,,0,0,0,PDN
VR083,,2016,1999,,1930,14378595,2560398,,1930,14378595,2560398,,0,0,0,PDN
VR083,,2017,1999,,1930,14378595,2560398,,1930,14378595,2560398,,0,0,0,PDN
VR083,,2017,1999,,1930,14378595,2560398,,1930,14378595,2560398,,0,0,0,PDN
VR084,,1978,1977,,32760,55920000,9982938,,8,195660,34823,,32752,55724340,9948115,PDN
VR084,,1979,1977,,32760,55920000,9982938,,416,7569477,1347298,,32344,48350523,8635640,PDN
VR084,,1980,1977,,32760,55920000,9982938,,1400,14506433,2582616,,31360,41413567,7400322,PDN
VR084,,1981,1977,,32760,55920000,9982938,,1569,21051017,3747302,,31191,34868983,6235636,PDN
VR084,,1982,1977,,35409,59250000,10578114,,1633,25306451,4504560,,33776,33943549,6073554,PDN
VR084,,1983,1977,,35409,59250000,10578114,,1633,28233833,5025447,,33776,31016167,5552667,PDN
VR084,,1984,1977,,1976,39663579,7059552,,1634,29778137,5300235,,342,9885442,1759317,PDN
VR084,,1985,1977,,1976,39663579,7059552,,1634,30690028,5462493,,342,8973551,1597059,PDN
VR084,,1986,1977,,1976,39663579,7059552,,1634,31166798,5547328,,342,8496781,1512224,PDN
VR084,,1987,1977,,1766,33822419,6019990,,1634,31398780,5588606,,132,2423639,431384,PDN
VR084,,1988,1977,,1976,35776954,6367982,,1634,34144328,6077137,,342,1632626,290845,PDN
VR084,,1989,1977,,2064,37986526,6761232,,1634,36602397,6514516,,430,1384129,246716,PDN
VR084,,1990,1977,,1884,43595114,7759022,,1634,38807931,6906960,,250,4787183,852062,PDN
VR084,,1991,1977,,1884,48602287,8649978,,1634,41667304,7415745,,250,6934983,1234233,PDN
VR084,,1992,1977,,1884,48602287,8649978,,1634,44265624,7878080,,250,4336663,771898,PDN
VR084,,1993,1977,,3290,51338639,9138279,,1634,46973217,8359858,,1656,4365422,778421,PDN
VR084,,1994,1977,,3407,52511357,9347065,,1634,49527974,8814441,,1773,2983383,532624,PDN
VR084,,1995,1977,,4015,56748886,10101682,,1634,51874131,9231906,,2381,4874755,869776,PDN
VR084,,1996,1977,,4015,56748886,10101682,,1634,52569952,9355718,,2381,4178934,745964,PDN
VR084,,1997,1977,,4015,56748886,10101682,,1634,53111907,9452151,,2381,3636979,649531,PDN
VR084,,1998,1977,,4015,56748886,10101682,,1634,53396110,9502721,,2381,3352776,598961,PDN
VR084,,1999,1977,,4015,56748886,10101682,,1634,53751357,9565932,,2381,2997529,535750,PDN
VR084,,2000,1977,,1044354,83995338,15990144,,212285,59030457,10715925,,832069,24964881,5274219,PDN
VR084,,2001,1977,,969764,79287668,15077890,,343292,63814559,11698196,,626472,15473109,3379694,PDN
VR084,,2002,1977,,418748,71999924,13230122,,372444,64585178,11864469,,46304,7414746,1365653,PDN
VR084,,2003,1977,,418748,71999924,13230122,,414721,66172342,12189159,,4027,5827582,1040963,PDN
VR084,,2004,1977,,906060,79709031,15089162,,474130,67933693,12561976,,431930,11775338,2527186,PDN
VR084,,2005,1977,,699907,74652824,13983328,,574964,70551524,13128616,,124943,4101300,854712,PDN
VR084,,2006,1977,,655920,73390241,13714682,,612439,71723091,13374555,,43481,1667150,340127,PDN
VR084,,2007,1977,,655920,73390241,13714682,,625562,72152077,13464010,,30358,1238164,250672,PDN
VR084,,2008,1977,,626672,72165178,13467451,,626672,72165178,13467451,,0,0,0,PDN
VR084,,2009,1977,,626672,73231950,13657269,,626672,73231950,13657269,,0,0,0,PDN
VR084,,2010,1977,,626672,73231950,13657269,,626672,73231950,13657269,,0,0,0,PDN
VR084,,2011,1977,,626672,73231950,13657269,,626672,73231950,13657269,,0,0,0,PDN
VR084,,2012,1977,,626672,73231950,13657269,,626672,73231950,13657269,,0,0,0,PDN
VR084,,2013,1977,,626672,73231950,13657269,,626672,73231950,13657269,,0,0,0,PDN
VR084,,2014,1977,,626672,73231950,13657269,,626672,73231950,13657269,,0,0,0,PDN
VR084,,2015,1977,,626672,73231950,13657269,,626672,73231950,13657269,,0,0,0,PDN
VR084,,2016,1977,,626672,73231950,13657269,,626672,73231950,13657269,,0,0,0,PDN
VR084,,2017,1977,,626672,73231950,13657269,,626672,73231950,13657269,,0,0,0,PDN
VR084,,2017,1977,,626672,73231950,13657269,,626672,73231950,13657269,,0,0,0,PDN
VR086,,1975,1957,,2398903,87750000,18012782,,1796160,66919300,13703509,,602743,20830700,4309273,PDN
VR086,,1976,1957,,2398903,87750000,18012782,,1854848,70259683,14356571,,544055,17490317,3656211,PDN
VR086,,1977,1957,,2398903,87750000,18012782,,1977088,78325334,15913980,,421815,9424666,2098802,PDN
VR086,,1978,1957,,3079974,109350000,22537269,,2081065,86193662,17418016,,998909,23156338,5119253,PDN
VR086,,1979,1957,,2519370,123350000,24467769,,1744115,96357370,18889555,,775255,26992630,5578214,PDN
VR086,,1980,1957,,2519370,123350000,24467769,,1808653,102878076,20114360,,710717,20471924,4353409,PDN
VR086,,1981,1957,,2519370,123350000,24467769,,1867584,108204077,21120978,,651786,15145923,3346791,PDN
VR086,,1982,1957,,2519370,123350000,24467769,,1917272,114586838,22306389,,602098,8763162,2161380,PDN
VR086,,1983,1957,,2520754,129275309,25523478,,1950257,118353510,23009600,,570497,10921799,2513878,PDN
VR086,,1984,1957,,2180103,136025309,26383895,,1983596,121252307,23558740,,196507,14773002,2825155,PDN
VR086,,1985,1957,,2180273,137724372,26686389,,1997582,122650912,23821588,,182691,15073460,2864801,PDN
VR086,,1986,1957,,2180273,137724372,26686389,,2006297,123756915,24027100,,173976,13967457,2659289,PDN
VR086,,1987,1957,,2387151,155421922,30042297,,2041085,130128082,25195548,,346066,25293840,4846749,PDN
VR086,,1988,1957,,2321314,175457334,33541480,,2063289,137316712,26496868,,258025,38140622,7044612,PDN
VR086,,1989,1957,,2321314,175457334,33541480,,2080586,141925049,27334153,,240728,33532285,6207327,PDN
VR086,,1990,1957,,2317062,159821998,30755140,,2091948,144474297,27799118,,225114,15347701,2956022,PDN
VR086,,1991,1957,,2145177,154222608,29586922,,2098779,145957923,28069940,,46398,8264685,1516982,PDN
VR086,,1992,1957,,2145177,154222608,29586922,,2103081,147059545,28270260,,42096,7163063,1316662,PDN
VR086,,1993,1957,,2103081,147069230,28271983,,2103081,147069230,28271983,,0,0,0,PDN
VR086,,1994,1957,,2103081,147068602,28271871,,2103081,147068602,28271871,,0,0,0,PDN
VR086,,1995,1957,,2103081,147068602,28271871,,2103081,147068602,28271871,,0,0,0,PDN
VR086,,1996,1957,,2103081,147068602,28271871,,2103081,147068602,28271871,,0,0,0,PDN
VR086,,1997,1957,,2103081,147068602,28271871,,2103081,147068602,28271871,,0,0,0,PDN
VR086,,1998,1957,,2103081,147068602,28271871,,2103081,147068602,28271871,,0,0,0,PDN
VR086,,1999,1957,,2103081,147068602,28271871,,2103081,147068602,28271871,,0,0,0,PDN
VR086,,2000,1957,,2103081,147068602,28271871,,2103081,147068602,28271871,,0,0,0,PDN
VR086,,2001,1957,,2103081,147068602,28271871,,2103081,147068602,28271871,,0,0,0,PDN
VR086,,2002,1957,,2103081,147068602,28271871,,2103081,147068602,28271871,,0,0,0,PDN
VR086,,2003,1957,,2223779,159217562,30554306,,2127636,149454480,28720960,,96143,9763082,1833346,PDN
VR086,,2004,1957,,2228533,159534290,30615417,,2145407,151739277,29145278,,83126,7795013,1470139,PDN
VR086,,2005,1957,,2222905,161386117,30939296,,2153809,153499439,29466876,,69096,7886678,1472420,PDN
VR086,,2006,1957,,2198426,160865329,30822150,,2170287,155086044,29765668,,28139,5779285,1056482,PDN
VR086,,2007,1957,,2198426,160865329,30822150,,2175939,156365392,29998962,,22487,4499937,823188,PDN
VR086,,2008,1957,,2196333,164051002,31386902,,2177893,157029794,30119137,,18440,7021208,1267765,PDN
VR086,,2009,1957,,2217474,168910125,32272656,,2178228,160334140,30707434,,39246,8575985,1565222,PDN
VR086,,2010,1957,,2222304,166727396,31889100,,2179415,161569585,30928451,,42889,5157811,960649,PDN
VR086,,2011,1957,,2206001,165409291,31638259,,2184725,162889514,31168623,,21276,2519777,469635,PDN
VR086,,2012,1957,,2206001,165409291,31638259,,2188492,163640804,31306072,,17509,1768487,332187,PDN
VR086,,2013,1957,,2206001,165409291,31638259,,2189212,164148757,31397175,,16789,1260534,241083,PDN
VR086,,2014,1957,,2189285,165010364,31550559,,2189212,164435129,31448131,,73,575235,102428,PDN
VR086,,2015,1957,,2189285,165010364,31550559,,2189212,164556663,31469756,,73,453701,80803,PDN
VR086,,2016,1957,,2189212,164557987,31469992,,2189212,164557987,31469992,,0,0,0,PDN
VR086,,2017,1957,,2189212,164557987,31469992,,2189212,164557987,31469992,,0,0,0,PDN
VR086,,2017,1957,,2189212,164557987,31469992,,2189212,164557987,31469992,,0,0,0,PDN
VR087,,1998,1998,,8306,5525204,991438,,0,28839,5131,,8306,5496365,986307,PDN
VR087,,1999,1998,,8306,5525204,991438,,1892,1149006,206341,,6414,4376198,785097,PDN
VR087,,2000,1998,,22853,9176446,1655673,,5144,2182637,393514,,17709,6993809,1262159,PDN
VR087,,2001,1998,,22853,9176446,1655673,,8173,3244407,585470,,14680,5932039,1070203,PDN
VR087,,2002,1998,,22853,9176446,1655673,,10047,4095916,738858,,12806,5080530,916815,PDN
VR087,,2003,1998,,15409,7491709,1348453,,11066,4632289,835317,,4343,2859420,513136,PDN
VR087,,2004,1998,,15279,7417608,1335138,,11558,4899118,883287,,3721,2518490,451851,PDN
VR087,,2005,1998,,15279,7417608,1335138,,12462,5321111,959279,,2817,2096497,375859,PDN
VR087,,2006,1998,,12659,7442955,1337028,,12647,5445416,981582,,12,1997539,355446,PDN
VR087,,2007,1998,,12659,7442955,1337028,,12651,5927766,1067414,,8,1515189,269614,PDN
VR087,,2008,1998,,12659,7442955,1337028,,12652,6405298,1152385,,7,1037657,184643,PDN
VR087,,2009,1998,,12659,7442955,1337029,,12653,6588955,1185066,,6,854000,151963,PDN
VR087,,2010,1998,,12659,7442955,1337029,,12653,6675563,1200476,,6,767392,136553,PDN
VR087,,2011,1998,,12653,6675563,1200476,,12653,6675563,1200476,,0,0,0,PDN
VR087,,2012,1998,,12653,6675563,1200476,,12653,6675563,1200476,,0,0,0,PDN
VR087,,2013,1998,,12653,6675563,1200476,,12653,6675563,1200476,,0,0,0,PDN
VR087,,2014,1998,,12653,6675563,1200476,,12653,6675563,1200476,,0,0,0,PDN
VR087,,2015,1998,,12653,6675563,1200476,,12653,6675563,1200476,,0,0,0,PDN
VR087,,2016,1998,,12653,6675563,1200476,,12653,6675563,1200476,,0,0,0,PDN
VR087,,2017,1998,,12653,6675563,1200476,,12653,6675563,1200476,,0,0,0,PDN
VR087,,2017,1998,,12653,6675563,1200476,,12653,6675563,1200476,,0,0,0,PDN
VR088,,1985,1983,,13562,4082067,739908,,7606,2122378,385253,,5956,1959689,354655,PDN
VR088,,1986,1983,,103667,30167152,5471488,,25023,8525341,1541988,,78644,21641811,3929500,PDN
VR088,,1987,1983,,103667,30167152,5471488,,31420,12809525,2310695,,72247,17357627,3160793,PDN
VR088,,1988,1983,,31746,12950933,2336182,,31746,12950933,2336182,,0,0,0,PDN
VR088,,1989,1983,,31746,12950933,2336182,,31746,12950933,2336182,,0,0,0,PDN
VR088,,1990,1983,,31746,12950933,2336182,,31746,12950933,2336182,,0,0,0,PDN
VR088,,1991,1983,,31746,12950933,2336182,,31746,12950933,2336182,,0,0,0,PDN
VR088,,1992,1983,,31746,12950933,2336182,,31746,12950933,2336182,,0,0,0,PDN
VR088,,1993,1983,,31746,12950933,2336182,,31746,12950933,2336182,,0,0,0,PDN
VR088,,1994,1983,,31746,12950933,2336182,,31746,12950933,2336182,,0,0,0,PDN
VR088,,1995,1983,,31746,12950933,2336182,,31746,12950933,2336182,,0,0,0,PDN
VR088,,1996,1983,,31746,12950933,2336182,,31746,12950933,2336182,,0,0,0,PDN
VR088,,1997,1983,,31746,12950933,2336182,,31746,12950933,2336182,,0,0,0,PDN
VR088,,1998,1983,,31746,12950933,2336182,,31746,12950933,2336182,,0,0,0,PDN
VR088,,1999,1983,,31746,12950933,2336182,,31746,12950933,2336182,,0,0,0,PDN
VR088,,2000,1983,,31746,12950933,2336182,,31746,12950933,2336182,,0,0,0,PDN
VR088,,2001,1983,,31746,12950933,2336182,,31746,12950933,2336182,,0,0,0,PDN
VR088,,2002,1983,,31746,12950933,2336182,,31746,12950933,2336182,,0,0,0,PDN
VR088,,2003,1983,,31746,12950933,2336182,,31746,12950933,2336182,,0,0,0,PDN
VR088,,2004,1983,,31957,15184139,2733761,,31868,13618909,2455161,,89,1565230,278600,PDN
VR088,,2005,1983,,31957,15184139,2733761,,31957,15184139,2733761,,0,0,0,PDN
VR088,,2006,1983,,31957,15184139,2733761,,31957,15184139,2733761,,0,0,0,PDN
VR088,,2007,1983,,31957,15184139,2733761,,31957,15184139,2733761,,0,0,0,PDN
VR088,,2008,1983,,31957,15184139,2733761,,31957,15184139,2733761,,0,0,0,PDN
VR088,,2009,1983,,31957,15443508,2779913,,31957,15443508,2779913,,0,0,0,PDN
VR088,,2010,1983,,31957,15443508,2779913,,31957,15443508,2779913,,0,0,0,PDN
VR088,,2011,1983,,31957,15443508,2779913,,31957,15443508,2779913,,0,0,0,PDN
VR088,,2012,1983,,31957,15443508,2779913,,31957,15443508,2779913,,0,0,0,PDN
VR088,,2013,1983,,31957,15443508,2779913,,31957,15443508,2779913,,0,0,0,PDN
VR088,,2014,1983,,31957,15443508,2779913,,31957,15443508,2779913,,0,0,0,PDN
VR088,,2015,1983,,31957,15443508,2779913,,31957,15443508,2779913,,0,0,0,PDN
VR088,,2016,1983,,31957,15443508,2779913,,31957,15443508,2779913,,0,0,0,PDN
VR088,,2017,1983,,31957,15443508,2779913,,31957,15443508,2779913,,0,0,0,PDN
VR088,,2017,1983,,31957,15443508,2779913,,31957,15443508,2779913,,0,0,0,PDN
VR095,,1988,1988,,136,1356443,241496,,0,8016,1426,,136,1348427,240070,PDN
VR095,,1989,1988,,385,2500000,445225,,383,1631966,290768,,2,868034,154457,PDN
VR095,,1990,1988,,1364,4500000,802076,,1010,3060644,545609,,354,1439356,256467,PDN
VR095,,1991,1988,,2543,6000000,1070159,,2111,5013838,894253,,432,986162,175906,PDN
VR095,,1992,1988,,10008,15980843,2853574,,3176,6724475,1199702,,6832,9256368,1653872,PDN
VR095,,1993,1988,,10008,15980843,2853574,,3221,8508100,1517118,,6787,7472743,1336456,PDN
VR095,,1994,1988,,10008,15980843,2853574,,3254,10586056,1886894,,6754,5394787,966680,PDN
VR095,,1995,1988,,10269,16389401,2926533,,3255,11530230,2054897,,7014,4859171,871636,PDN
VR095,,1996,1988,,10269,16389401,2926533,,3255,11581683,2064053,,7014,4807718,862480,PDN
VR095,,1997,1988,,3876,13274157,2365826,,3255,11996548,2137872,,621,1277609,227954,PDN
VR095,,1998,1988,,3255,11997069,2137965,,3255,11997069,2137965,,0,0,0,PDN
VR095,,1999,1988,,3255,11997069,2137965,,3255,11997069,2137965,,0,0,0,PDN
VR095,,2000,1988,,3255,11997069,2137965,,3255,11997069,2137965,,0,0,0,PDN
VR095,,2001,1988,,3255,11997069,2137965,,3255,11997069,2137965,,0,0,0,PDN
VR095,,2002,1988,,3255,11997069,2137965,,3255,11997069,2137965,,0,0,0,PDN
VR095,,2003,1988,,3255,11997069,2137965,,3255,11997069,2137965,,0,0,0,PDN
VR095,,2004,1988,,3255,11997069,2137965,,3255,11997069,2137965,,0,0,0,PDN
VR095,,2005,1988,,3255,11997069,2137965,,3255,11997069,2137965,,0,0,0,PDN
VR095,,2006,1988,,3255,11997069,2137965,,3255,11997069,2137965,,0,0,0,PDN
VR095,,2007,1988,,3255,11997069,2137965,,3255,11997069,2137965,,0,0,0,PDN
VR095,,2008,1988,,3255,11997069,2137965,,3255,11997069,2137965,,0,0,0,PDN
VR095,,2009,1988,,3255,12237332,2180716,,3255,12237332,2180716,,0,0,0,PDN
VR095,,2010,1988,,3255,12237332,2180716,,3255,12237332,2180716,,0,0,0,PDN
VR095,,2011,1988,,3255,12237332,2180716,,3255,12237332,2180716,,0,0,0,PDN
VR095,,2012,1988,,3255,12237332,2180716,,3255,12237332,2180716,,0,0,0,PDN
VR095,,2013,1988,,3255,12237332,2180716,,3255,12237332,2180716,,0,0,0,PDN
VR095,,2014,1988,,3255,12237332,2180716,,3255,12237332,2180716,,0,0,0,PDN
VR095,,2015,1988,,3255,12237332,2180716,,3255,12237332,2180716,,0,0,0,PDN
VR095,,2016,1988,,3255,12237332,2180716,,3255,12237332,2180716,,0,0,0,PDN
VR095,,2017,1988,,3255,12237332,2180716,,3255,12237332,2180716,,0,0,0,PDN
VR095,,2017,1988,,3255,12237332,2180716,,3255,12237332,2180716,,0,0,0,PDN
VR100,,1996,1995,,124254,12425363,2335173,,9332,1476575,272068,,114922,10948788,2063105,PDN
VR100,,1997,1995,,124254,12425363,2335173,,9813,2730895,495737,,114441,9694468,1839436,PDN
VR100,,1998,1995,,15283,3739426,680661,,11384,2965788,539104,,3899,773638,141557,PDN
VR100,,1999,1995,,65628,9594542,1772842,,14408,3792777,689279,,51220,5801765,1083563,PDN
VR100,,2000,1995,,35944,9594542,1743158,,16238,4285593,778799,,19706,5308949,964359,PDN
VR100,,2001,1995,,16238,4318978,784739,,16238,4318978,784739,,0,0,0,PDN
VR100,,2002,1995,,16238,4318978,784739,,16238,4318978,784739,,0,0,0,PDN
VR100,,2003,1995,,28724,10331323,1867038,,21002,5953247,1080299,,7722,4378076,786739,PDN
VR100,,2004,1995,,45015,13285429,2408970,,23654,7642152,1383468,,21361,5643277,1025502,PDN
VR100,,2005,1995,,39695,12340512,2235515,,24770,8378814,1515662,,14925,3961698,719853,PDN
VR100,,2006,1995,,42923,14619819,2644314,,24952,8521941,1541312,,17971,6097878,1103002,PDN
VR100,,2007,1995,,42923,14619819,2644314,,26238,9215098,1665935,,16685,5404721,978379,PDN
VR100,,2008,1995,,29755,12644685,2279699,,26725,9706908,1753933,,3030,2937777,525766,PDN
VR100,,2009,1995,,27067,10107237,1825508,,26966,10013476,1808724,,101,93761,16784,PDN
VR100,,2010,1995,,27067,10107237,1825508,,27067,10107237,1825508,,0,0,0,PDN
VR100,,2011,1995,,27067,10107237,1825508,,27067,10107237,1825508,,0,0,0,PDN
VR100,,2012,1995,,27067,10107237,1825508,,27067,10107237,1825508,,0,0,0,PDN
VR100,,2013,1995,,27067,10107237,1825508,,27067,10107237,1825508,,0,0,0,PDN
VR100,,2014,1995,,27067,10107237,1825508,,27067,10107237,1825508,,0,0,0,PDN
VR100,,2015,1995,,27067,10107237,1825508,,27067,10107237,1825508,,0,0,0,PDN
VR100,,2016,1995,,27067,10107237,1825508,,27067,10107237,1825508,,0,0,0,PDN
VR100,,2017,1995,,27067,10107237,1825508,,27067,10107237,1825508,,0,0,0,PDN
VR100,,2017,1995,,27067,10107237,1825508,,27067,10107237,1825508,,0,0,0,PDN
VR102,,1975,1956,,2000000,50000000,10896797,,303256,15448944,3052178,,1696744,34551056,7844619,PDN
VR102,,1976,1956,,124889,21610886,3970242,,93737,15626380,2874232,,31152,5984506,1096010,PDN
VR102,,1977,1956,,124889,21610886,3970242,,93907,15887205,2920812,,30982,5723681,1049430,PDN
VR102,,1978,1956,,124889,21610886,3970242,,93907,16072714,2953821,,30982,5538172,1016421,PDN
VR102,,1979,1956,,189913,52610886,9551281,,102525,21530439,3933564,,87388,31080447,5617717,PDN
VR102,,1980,1956,,225889,65108886,11811100,,130428,28851031,5264063,,95461,36257855,6547037,PDN
VR102,,1981,1956,,225889,65108886,11811100,,159236,35190833,6420950,,66653,29918053,5390150,PDN
VR102,,1982,1956,,225295,67597100,12253249,,172348,40541104,7386068,,52947,27055996,4867181,PDN
VR102,,1983,1956,,256395,72536904,13163317,,180053,43332584,7890477,,76342,29204320,5272840,PDN
VR102,,1984,1956,,258847,73508753,13338696,,193579,45870227,8355541,,65268,27638526,4983155,PDN
VR102,,1985,1956,,276357,76000753,13799623,,197302,47535989,8655663,,79055,28464764,5143960,PDN
VR102,,1986,1956,,276357,76000753,13799623,,202041,48907507,8904444,,74316,27093246,4895179,PDN
VR102,,1987,1956,,216729,56747229,10314101,,203091,49570056,9023386,,13638,7177173,1290715,PDN
VR102,,1988,1956,,216729,56747229,10314101,,204532,50670222,9220586,,12197,6077007,1093515,PDN
VR102,,1989,1956,,216729,56747229,10314101,,204911,51321480,9336847,,11818,5425749,977254,PDN
VR102,,1990,1956,,901275,85408106,16098447,,243026,53587085,9778095,,658249,31821021,6320352,PDN
VR102,,1991,1956,,888044,89667952,16843196,,451824,65717604,12145348,,436220,23950348,4697848,PDN
VR102,,1992,1956,,833761,84829877,15928045,,565802,73710471,13681544,,267959,11119406,2246501,PDN
VR102,,1993,1956,,1199405,115903650,21822830,,645810,79279897,14752553,,553595,36623753,7070277,PDN
VR102,,1994,1956,,1149463,106191367,20044724,,695259,83653194,15580169,,454204,22538173,4464555,PDN
VR102,,1995,1956,,1236334,110442183,20887968,,745349,87835820,16374498,,490985,22606363,4513470,PDN
VR102,,1996,1956,,969108,96983210,18225907,,751502,88723137,16538537,,217606,8260073,1687370,PDN
VR102,,1997,1956,,855237,94196634,17616204,,752792,88825391,16558022,,102445,5371243,1058182,PDN
VR102,,1998,1956,,855237,94196634,17616204,,792274,92674837,17282459,,62963,1521797,333745,PDN
VR102,,1999,1956,,842754,102494173,19080151,,809017,95938036,17879842,,33737,6556137,1200309,PDN
VR102,,2000,1956,,842754,102494173,19080151,,815568,96944551,18065488,,27186,5549622,1014663,PDN
VR102,,2001,1956,,828775,101685880,18922348,,818691,97333131,18137753,,10084,4352749,784595,PDN
VR102,,2002,1956,,892268,113371331,21065103,,818603,97333295,18137695,,73665,16038036,2927408,PDN
VR102,,2003,1956,,910291,121419257,22515141,,845324,101853793,18968775,,64967,19565464,3546366,PDN
VR102,,2004,1956,,913719,124453629,23058493,,858922,107722521,20026630,,54797,16731108,3031863,PDN
VR102,,2005,1956,,879560,123276501,22814881,,862382,109906233,20418651,,17178,13370268,2396230,PDN
VR102,,2006,1956,,1097054,134673439,25060300,,882536,114121322,21188821,,214518,20552117,3871479,PDN
VR102,,2007,1956,,1097054,134673439,25060300,,953223,118694313,22073208,,143831,15979126,2987092,PDN
VR102,,2008,1956,,1012768,136535128,25307275,,973727,121105780,22522798,,39041,15429348,2784477,PDN
VR102,,2009,1956,,987855,128810273,23907832,,980931,125285116,23273655,,6924,3525157,634176,PDN
VR102,,2010,1956,,997894,129827783,24098921,,990596,126959033,23581169,,7298,2868750,517752,PDN
VR102,,2011,1956,,991418,127264442,23636334,,991418,127105725,23608093,,0,158717,28241,PDN
VR102,,2012,1956,,991418,127264442,23636334,,991418,127264442,23636334,,0,0,0,PDN
VR102,,2013,1956,,991418,127264442,23636334,,991418,127264442,23636334,,0,0,0,PDN
VR102,,2014,1956,,991418,127264442,23636334,,991418,127264442,23636334,,0,0,0,PDN
VR102,,2015,1956,,991418,127264442,23636334,,991418,127264442,23636334,,0,0,0,PDN
VR102,,2016,1956,,991418,127264442,23636334,,991418,127264442,23636334,,0,0,0,PDN
VR102,,2017,1956,,991418,127263651,23636193,,991418,127263651,23636193,,0,0,0,PDN
VR102,,2017,1956,,991418,127263651,23636193,,991418,127263651,23636193,,0,0,0,PDN
VR107,,1987,1984,,320,3197287,569232,,0,0,0,,320,3197287,569232,PDP
VR107,,1988,1984,,91086,26127776,4740156,,0,0,0,,91086,26127776,4740156,PDP
VR107,,1989,1984,,91086,26127776,4740156,,13683,1273502,240285,,77403,24854274,4499871,PDP
VR107,,1990,1984,,91186,30638376,5542854,,34485,6048784,1110781,,56701,24589592,4432073,PDP
VR107,,1991,1984,,91186,30638376,5542854,,45635,9292630,1699128,,45551,21345746,3843726,PDP
VR107,,1992,1984,,91186,30805726,5572632,,50046,11079429,2021475,,41140,19726297,3551157,PDP
VR107,,1993,1984,,68614,27857057,5025386,,52326,12352335,2250250,,16288,15504722,2775136,PDP
VR107,,1994,1984,,83575,27817873,5033374,,52916,13628334,2477886,,30659,14189539,2555488,PDP
VR107,,1995,1984,,52916,19033789,3439711,,52916,14106087,2562896,,0,4927702,876815,PDP
VR107,,1996,1984,,52996,14405037,2616170,,52996,14405037,2616170,,0,0,0,PDP
VR107,,1997,1984,,52996,14405037,2616170,,52996,14405037,2616170,,0,0,0,PDP
VR107,,1998,1984,,52996,14405037,2616170,,52996,14405037,2616170,,0,0,0,PDP
VR107,,1999,1984,,52996,14405037,2616170,,52996,14405037,2616170,,0,0,0,PDP
VR107,,2000,1984,,53031,14755008,2678477,,52996,14405037,2616170,,35,349971,62307,PDP
VR107,,2001,1984,,58999,16247045,2949932,,52996,14405037,2616170,,6003,1842008,333762,PDP
VR107,,2002,1984,,58999,16247045,2949932,,52996,14405037,2616170,,6003,1842008,333762,PDP
VR107,,2003,1984,,89018,18116522,3312598,,73273,15379528,2809844,,15745,2736994,502754,PDP
VR107,,2004,1984,,83838,18091114,3302897,,83020,16275741,2979059,,818,1815373,323838,PDP
VR107,,2005,1984,,492256,19579275,3976113,,83020,16275741,2979059,,409236,3303534,997054,PDP
VR107,,2006,1984,,909733,18691586,4235638,,163085,16429863,3086548,,746648,2261723,1149090,PDP
VR107,,2007,1984,,909733,18691586,4235638,,296977,16500120,3232941,,612756,2191466,1002697,PDP
VR107,,2008,1984,,902659,21306566,4693863,,429613,16600072,3383362,,473046,4706494,1310501,PDP
VR107,,2009,1984,,903403,21687019,4762303,,490467,17959068,3686031,,412936,3727951,1076272,PDP
VR107,,2010,1984,,904559,21802645,4784033,,651673,19545850,4129582,,252886,2256795,654451,PDP
VR107,,2011,1984,,1104525,21929233,5006523,,781441,20694022,4463652,,323084,1235211,542872,PDP
VR107,,2012,1984,,1104525,21929233,5006523,,879251,20943201,4605799,,225274,986032,400724,PDP
VR107,,2013,1984,,1108890,21968865,5017940,,926245,21136272,4687147,,182645,832593,330793,PDP
VR107,,2014,1984,,1116926,21968865,5025976,,989191,21499961,4814806,,127735,468904,211170,PDP
VR107,,2015,1984,,1259077,21571276,5097382,,1046415,21556131,4882025,,212662,15145,215357,PDP
VR107,,2016,1984,,1259077,21706251,5121399,,1094381,21598339,4937502,,164696,107912,183897,PDP
VR107,,2017,1984,,1259077,21706251,5121399,,1132400,21628289,4980850,,126677,77962,140549,PDP
VR107,,2017,1984,,1259077,21706251,5121399,,1132400,21628289,4980850,,126677,77962,140549,PDP
VR112,,1993,1993,,338653,33865207,6364491,,0,0,0,,338653,33865207,6364491,PDN
VR112,,1994,1993,,338653,33865207,6364491,,6815,1497103,273203,,331838,32368104,6091288,PDN
VR112,,1995,1993,,255415,31855956,5923735,,16974,3571055,652393,,238441,28284901,5271342,PDN
VR112,,1996,1993,,255415,31855956,5923735,,24973,4506716,826880,,230442,27349240,5096855,PDN
VR112,,1997,1993,,119750,21346523,3918064,,28788,5026934,923260,,90962,16319589,2994804,PDN
VR112,,1998,1993,,119750,21346523,3918064,,30114,6217767,1136478,,89636,15128756,2781586,PDN
VR112,,1999,1993,,124982,22249353,4083942,,31455,7660364,1394509,,93527,14588989,2689433,PDN
VR112,,2000,1993,,124982,22249353,4083942,,32273,9087874,1649332,,92709,13161479,2434610,PDN
VR112,,2001,1993,,106668,18380854,3377283,,32379,10144518,1837453,,74289,8236336,1539830,PDN
VR112,,2002,1993,,106668,18380854,3377283,,32379,11938147,2156604,,74289,6442707,1220679,PDN
VR112,,2003,1993,,66485,15689527,2858216,,32379,13440853,2423990,,34106,2248674,434226,PDN
VR112,,2004,1993,,32379,20304490,3645278,,32379,14885506,2681046,,0,5418984,964232,PDN
VR112,,2005,1993,,32379,20304490,3645278,,32379,16004665,2880184,,0,4299825,765094,PDN
VR112,,2006,1993,,32379,16725471,3008441,,32379,16725471,3008441,,0,0,0,PDN
VR112,,2007,1993,,32379,16725471,3008441,,32379,16725471,3008441,,0,0,0,PDN
VR112,,2008,1993,,32379,16725471,3008441,,32379,16725471,3008441,,0,0,0,PDN
VR112,,2009,1993,,32379,16841853,3029149,,32379,16841853,3029149,,0,0,0,PDN
VR112,,2010,1993,,32379,16841853,3029149,,32379,16841853,3029149,,0,0,0,PDN
VR112,,2011,1993,,32379,16841853,3029149,,32379,16841853,3029149,,0,0,0,PDN
VR112,,2012,1993,,32379,16841853,3029149,,32379,16841853,3029149,,0,0,0,PDN
VR112,,2013,1993,,32379,16841853,3029149,,32379,16841853,3029149,,0,0,0,PDN
VR112,,2014,1993,,32379,16841853,3029149,,32379,16841853,3029149,,0,0,0,PDN
VR112,,2015,1993,,32379,16841853,3029149,,32379,16841853,3029149,,0,0,0,PDN
VR112,,2016,1993,,32379,16841853,3029149,,32379,16841853,3029149,,0,0,0,PDN
VR112,,2017,1993,,32379,16841853,3029149,,32379,16841853,3029149,,0,0,0,PDN
VR112,,2017,1993,,32379,16841853,3029149,,32379,16841853,3029149,,0,0,0,PDN
VR115,,1975,1961,,200000,7400000,1516726,,200000,7400000,1516726,,0,0,0,PDN
VR115,,1976,1961,,200000,7400000,1516726,,200000,7400000,1516726,,0,0,0,PDN
VR115,,1977,1961,,200000,7400000,1516726,,200000,7400000,1516726,,0,0,0,PDN
VR115,,1978,1961,,200000,7400000,1516726,,200000,7400000,1516726,,0,0,0,PDN
VR115,,1979,1961,,200000,7400000,1516726,,200000,7400000,1516726,,0,0,0,PDN
VR115,,1980,1961,,200000,7400000,1516726,,200000,7400000,1516726,,0,0,0,PDN
VR115,,1981,1961,,200000,7400000,1516726,,200000,7400000,1516726,,0,0,0,PDN
VR115,,1982,1961,,194625,7155653,1467873,,194625,7155653,1467873,,0,0,0,PDN
VR115,,1983,1961,,194625,7155653,1467873,,194625,7155653,1467873,,0,0,0,PDN
VR115,,1984,1961,,194625,7155653,1467873,,194625,7155653,1467873,,0,0,0,PDN
VR115,,1985,1961,,668034,42264124,8188341,,194625,7155653,1467873,,473409,35108471,6720468,PDN
VR115,,1986,1961,,956594,50047708,9861880,,308267,9886664,2067460,,648327,40161044,7794420,PDN
VR115,,1987,1961,,1067717,51170744,10172832,,536761,19384687,3985994,,530956,31786057,6186838,PDN
VR115,,1988,1961,,1875073,94831407,18748989,,663751,26168660,5320096,,1211322,68662747,13428893,PDN
VR115,,1989,1961,,2467412,110010162,22042174,,833729,40726736,8080479,,1633683,69283426,13961695,PDN
VR115,,1990,1961,,2275696,115941783,22905906,,1026176,53100210,10474612,,1249520,62841573,12431294,PDN
VR115,,1991,1961,,1679475,110845765,21402921,,1115405,63686179,12447465,,564070,47159586,8955456,PDN
VR115,,1992,1961,,1813100,109194847,21242788,,1247727,78393471,15196743,,565373,30801376,6046045,PDN
VR115,,1993,1961,,1956595,138631390,26624102,,1328673,87570752,16910657,,627922,51060638,9713445,PDN
VR115,,1994,1961,,1961034,136641881,26274536,,1355432,89828020,17339065,,605602,46813861,8935471,PDN
VR115,,1995,1961,,1633016,117973912,22624815,,1371639,91930660,17729408,,261377,26043252,4895407,PDN
VR115,,1996,1961,,1372870,92100251,17760815,,1372870,92100251,17760815,,0,0,0,PDN
VR115,,1997,1961,,1372870,92100251,17760815,,1372870,92100251,17760815,,0,0,0,PDN
VR115,,1998,1961,,1830287,111995190,21758257,,1456051,96113330,18558067,,374236,15881860,3200190,PDN
VR115,,1999,1961,,1830582,112002766,21759900,,1605247,105195459,20323300,,225335,6807307,1436600,PDN
VR115,,2000,1961,,1944910,123770345,23968103,,1664792,108835024,21030455,,280118,14935321,2937648,PDN
VR115,,2001,1961,,2322136,140504321,27322904,,1750181,111974869,21674535,,571955,28529452,5648369,PDN
VR115,,2002,1961,,2701411,159866596,31147425,,1876572,116581790,22620663,,824839,43284806,8526762,PDN
VR115,,2003,1961,,2819229,177138725,34338575,,2099431,127804755,24840491,,719798,49333970,9498084,PDN
VR115,,2004,1961,,4331858,170106153,34599857,,2259294,136204962,26495052,,2072564,33901191,8104805,PDN
VR115,,2005,1961,,4221541,178203949,35930429,,2692255,145563124,28593167,,1529286,32640825,7337262,PDN
VR115,,2006,1961,,3789919,171927291,34381964,,3110747,152899920,30317138,,679172,19027371,4064826,PDN
VR115,,2007,1961,,3783605,168992504,33853446,,3353280,159054019,31654707,,430325,9938485,2198739,PDN
VR115,,2008,1961,,3742700,167577659,33560789,,3424610,161110433,32091947,,318090,6467226,1468842,PDN
VR115,,2009,1961,,3447567,165785402,32946748,,3434581,163801974,32580839,,12986,1983428,365909,PDN
VR115,,2010,1961,,3447567,165785402,32946748,,3440151,164345284,32683083,,7416,1440118,263665,PDN
VR115,,2011,1961,,3444191,164794272,32767015,,3443307,164692563,32748033,,884,101709,18982,PDN
VR115,,2012,1961,,3444191,164794272,32767015,,3444191,164794272,32767015,,0,0,0,PDN
VR115,,2013,1961,,3444191,164794272,32767015,,3444191,164794272,32767015,,0,0,0,PDN
VR115,,2014,1961,,3444191,164794272,32767015,,3444191,164794272,32767015,,0,0,0,PDN
VR115,,2015,1961,,3444191,164794272,32767015,,3444191,164794272,32767015,,0,0,0,PDN
VR115,,2016,1961,,3444191,164794272,32767015,,3444191,164794272,32767015,,0,0,0,PDN
VR115,,2017,1961,,3444191,164796131,32767345,,3444191,164796131,32767345,,0,0,0,PDN
VR115,,2017,1961,,3444191,164796131,32767345,,3444191,164796131,32767345,,0,0,0,PDN
VR120,,1975,1957,,30000000,42972000,37646263,,16808174,18026953,20015817,,13191826,24945047,17630446,PDN
VR120,,1976,1957,,30000000,42972000,37646263,,18431740,20248958,22034757,,11568260,22723042,15611506,PDN
VR120,,1977,1957,,30000000,42972000,37646263,,19714496,22091493,23645367,,10285504,20880507,14000896,PDN
VR120,,1978,1957,,25410978,53488995,34928593,,21436280,24032291,25712488,,3974698,29456704,9216105,PDN
VR120,,1979,1957,,22984745,50039994,31888659,,22167995,25259084,26662494,,816750,24780910,5226165,PDN
VR120,,1980,1957,,25161604,51588298,34341016,,22539770,26223693,27205908,,2621834,25364605,7135108,PDN
VR120,,1981,1957,,25176822,59085479,35690252,,22810939,28126562,27815665,,2365883,30958917,7874587,PDN
VR120,,1982,1957,,25536556,63594123,36852236,,22802853,34919042,29016206,,2733703,28675081,7836030,PDN
VR120,,1983,1957,,27612328,69652606,40006030,,23467730,42027057,30945854,,4144598,27625549,9060176,PDN
VR120,,1984,1957,,29015595,81260132,43474693,,24195390,49964721,33085910,,4820205,31295411,10388783,PDN
VR120,,1985,1957,,31198975,88214369,46895482,,25221656,57055757,35373926,,5977319,31158612,11521556,PDN
VR120,,1986,1957,,34133884,101741910,52237427,,26245918,60604543,37029645,,7887966,41137367,15207782,PDN
VR120,,1987,1957,,34601240,110713919,54301226,,26825828,69185521,39136419,,7775412,41528398,15164807,PDN
VR120,,1988,1957,,35633181,122737023,57472509,,27216365,78673442,41215198,,8416816,44063581,16257311,PDN
VR120,,1989,1957,,35751840,147458958,61990089,,28082719,85671032,43326675,,7669121,61787926,18663414,PDN
VR120,,1990,1957,,34633116,149676342,61265917,,28986571,94246298,45756375,,5646545,55430044,15509542,PDN
VR120,,1991,1957,,49159380,160945156,77797308,,29781917,99682719,47519056,,19377463,61262437,30278252,PDN
VR120,,1992,1957,,49980648,175148636,81145886,,30388551,106495480,49337925,,19592097,68653156,31807961,PDN
VR120,,1993,1957,,33236910,141595825,58431897,,30942150,113404309,51120853,,2294760,28191516,7311044,PDN
VR120,,1994,1957,,33414120,147567122,59671615,,31339374,115612982,51911079,,2074746,31954140,7760536,PDN
VR120,,1995,1957,,32882304,136317763,57138134,,31611678,117404821,52502216,,1270626,18912942,4635918,PDN
VR120,,1996,1957,,36443082,160664587,65031087,,32110633,124098960,54192298,,4332449,36565627,10838789,PDN
VR120,,1997,1957,,36417068,194430222,71013193,,33424305,139601260,58264387,,2992763,54828962,12748806,PDN
VR120,,1998,1957,,35876610,202976812,71993480,,34020277,157287186,62007321,,1856333,45689626,9986159,PDN
VR120,,1999,1957,,36064298,198827429,71442844,,34444668,164269304,63674082,,1619630,34558125,7768762,PDN
VR120,,2000,1957,,36164823,190697927,70096839,,34771823,168794641,64806457,,1393000,21903286,5290382,PDN
VR120,,2001,1957,,37934814,190261254,71789130,,35339156,173043440,66129804,,2595658,17217814,5659326,PDN
VR120,,2002,1957,,37502307,183539197,70160527,,35806653,174373380,66833945,,1695654,9165817,3326582,PDN
VR120,,2003,1957,,37429604,183917462,70155132,,36059895,174999434,67198584,,1369709,8918028,2956548,PDN
VR120,,2004,1957,,37472055,183594945,70140195,,36207025,176084464,67538780,,1265030,7510481,2601415,PDN
VR120,,2005,1957,,37210743,186497471,70395346,,36283105,177112838,67797845,,927638,9384633,2597501,PDN
VR120,,2006,1957,,37272698,182075649,69670500,,36311356,177569939,67907431,,961342,4505710,1763069,PDN
VR120,,2007,1957,,37250344,183422318,69887767,,36353672,177986326,68023837,,896672,5435992,1863930,PDN
VR120,,2008,1957,,37127724,183311798,69745482,,36433402,178461505,68188118,,694322,4850293,1557364,PDN
VR120,,2009,1957,,37050033,184409686,69863143,,36465859,182081234,68864653,,584174,2328452,998490,PDN
VR120,,2010,1957,,38291387,186231980,71428748,,36503503,182473582,68972111,,1787884,3758398,2456639,PDN
VR120,,2011,1957,,38291165,186224102,71427124,,36572163,182774787,69094365,,1719002,3449315,2332761,PDN
VR120,,2012,1957,,37001132,184460642,69823309,,36634993,182988389,69195201,,366139,1472253,628108,PDN
VR120,,2013,1957,,37001132,184460642,69823309,,36699345,183210947,69299156,,301787,1249695,524155,PDN
VR120,,2014,1957,,36707226,183228226,69310110,,36707226,183228226,69310110,,0,0,0,PDN
VR120,,2015,1957,,36707226,183228226,69310110,,36707226,183228226,69310110,,0,0,0,PDN
VR120,,2016,1957,,36707226,183228226,69310110,,36707226,183228226,69310110,,0,0,0,PDN
VR120,,2017,1957,,36707226,183228226,69310110,,36707226,183228226,69310110,,0,0,0,PDN
VR120,,2017,1957,,36707226,183228226,69310110,,36707226,183228226,69310110,,0,0,0,PDN
VR122,,1983,1981,,952000,21085000,4703779,,60911,918395,224326,,891089,20166605,4479453,PDN
VR122,,1984,1981,,1292332,36328521,7756482,,301983,8539980,1821552,,990349,27788541,5934930,PDN
VR122,,1985,1981,,3625247,90359791,19703502,,456948,18645864,3774717,,3168299,71713927,15928785,PDN
VR122,,1986,1981,,3626639,91236287,19860854,,539015,22915440,4616495,,3087624,68320847,15244359,PDN
VR122,,1987,1981,,3626639,91236287,19860854,,555877,23615145,4757860,,3070762,67621142,15102994,PDN
VR122,,1988,1981,,3573200,89928530,19574718,,577195,24612872,4956710,,2996005,65315658,14618008,PDN
VR122,,1989,1981,,911548,35593843,7244972,,623372,26034061,5255767,,288176,9559782,1989205,PDN
VR122,,1990,1981,,911627,35600221,7246186,,651408,26714865,5404943,,260219,8885356,1841243,PDN
VR122,,1991,1981,,853601,34117019,6924245,,651408,26760711,5413100,,202193,7356308,1511145,PDN
VR122,,1992,1981,,853601,34117019,6924245,,651537,26773481,5415502,,202064,7343538,1508743,PDN
VR122,,1993,1981,,668479,27845588,5623210,,655783,26994960,5459157,,12696,850628,164053,PDN
VR122,,1994,1981,,685071,28402722,5738936,,662798,27164268,5496298,,22273,1238454,242638,PDN
VR122,,1995,1981,,662797,27166315,5496661,,662797,27166315,5496661,,0,0,0,PDN
VR122,,1996,1981,,800805,30986385,6314397,,698209,28146506,5706484,,102596,2839879,607913,PDN
VR122,,1997,1981,,1020484,41530686,8410286,,799480,32634755,6606376,,221004,8895931,1803910,PDN
VR122,,1998,1981,,1020131,41516501,8407409,,834645,35658416,7179559,,185486,5858085,1227850,PDN
VR122,,1999,1981,,1022240,41971860,8490543,,845353,37060835,7439808,,176887,4911025,1050735,PDN
VR122,,2000,1981,,892431,41940254,8355110,,858086,38313557,7675445,,34345,3626697,679665,PDN
VR122,,2001,1981,,892557,41948219,8356653,,866260,39152341,7832869,,26297,2795878,523784,PDN
VR122,,2002,1981,,892332,41934034,8353904,,870365,39697191,7933922,,21967,2236843,419982,PDN
VR122,,2003,1981,,892332,41934034,8353904,,874232,40086694,8007096,,18100,1847340,346808,PDN
VR122,,2004,1981,,1600057,62694639,12755687,,964544,42847814,8588710,,635513,19846825,4166977,PDN
VR122,,2005,1981,,2876697,121043665,24414716,,1028030,45862555,9188627,,1848667,75181110,15226089,PDN
VR122,,2006,1981,,1598223,82343322,16250060,,1312134,55530635,11193030,,286089,26812687,5057030,PDN
VR122,,2007,1981,,1491836,70603434,14054725,,1377821,60125717,12076347,,114015,10477717,1978378,PDN
VR122,,2008,1981,,1515631,67239178,13479897,,1407459,62710807,12565966,,108172,4528371,913931,PDN
VR122,,2009,1981,,1475547,65950308,13210476,,1409288,63712517,12746034,,66259,2237791,464443,PDN
VR122,,2010,1981,,1475547,65950308,13210476,,1458979,65554393,13123461,,16568,395915,87016,PDN
VR122,,2011,1981,,1460312,65625748,13137490,,1460312,65625748,13137490,,0,0,0,PDN
VR122,,2012,1981,,1460312,65625748,13137490,,1460312,65625748,13137490,,0,0,0,PDN
VR122,,2013,1981,,1460312,65625748,13137490,,1460312,65625748,13137490,,0,0,0,PDN
VR122,,2014,1981,,1460312,65625748,13137490,,1460312,65625748,13137490,,0,0,0,PDN
VR122,,2015,1981,,1460312,65625748,13137490,,1460312,65625748,13137490,,0,0,0,PDN
VR122,,2016,1981,,1460312,65625748,13137490,,1460312,65625748,13137490,,0,0,0,PDN
VR122,,2017,1981,,1460312,65625748,13137490,,1460312,65625748,13137490,,0,0,0,PDN
VR122,,2017,1981,,1460312,65625748,13137490,,1460312,65625748,13137490,,0,0,0,PDN
VR131,,1975,1960,,13174622,461249360,95247462,,7921297,275016010,56856530,,5253325,186233350,38390932,PDP
VR131,,1976,1960,,13174622,461249360,95247462,,8263443,293501939,60487987,,4911179,167747421,34759475,PDP
VR131,,1977,1960,,13789560,486720823,100394689,,9793543,318930685,66542775,,3996017,167790138,33851914,PDP
VR131,,1978,1960,,13807950,486720823,100413079,,10195665,336699701,70106644,,3612285,150021122,30306435,PDP
VR131,,1979,1960,,8682950,486720823,95288079,,6697782,356248489,70087193,,1985168,130472334,25200886,PDP
VR131,,1980,1960,,9153876,505312723,99067172,,6893307,369608870,72660010,,2260569,135703853,26407162,PDP
VR131,,1981,1960,,9248286,527307799,103075296,,7297751,394819368,77550308,,1950535,132488431,25524988,PDP
VR131,,1982,1960,,9375157,532174799,104068182,,7455175,404381934,79409256,,1919982,127792865,24658926,PDP
VR131,,1983,1960,,9633505,546027049,106791343,,7564178,410281985,80568090,,2069327,135745064,26223253,PDP
VR131,,1984,1960,,9773092,553380678,108239405,,7656731,414144855,81347986,,2116361,139235823,26891419,PDP
VR131,,1985,1960,,9781623,553740678,108311993,,7775945,424069628,83233174,,2005678,129671050,25078819,PDP
VR131,,1986,1960,,9892616,559649583,109474392,,7876113,433202605,84958427,,2016503,126446978,24515965,PDP
VR131,,1987,1960,,9979254,579273631,113052854,,7994974,443447227,86900175,,1984280,135826404,26152679,PDP
VR131,,1988,1960,,10115085,583494298,113939693,,8163154,454593289,89051640,,1951931,128901009,24888053,PDP
VR131,,1989,1960,,10158952,580532027,113456466,,8418871,467996082,91692195,,1740081,112535945,21764271,PDP
VR131,,1990,1960,,11261732,625983220,122646647,,8725061,485806208,95167447,,2536671,140177012,27479200,PDP
VR131,,1991,1960,,10383512,572030761,112168345,,9001664,493358727,96787914,,1381848,78672034,15380431,PDP
VR131,,1992,1960,,10436577,581903342,113978097,,9248128,514432813,100784216,,1188449,67470529,13193881,PDP
VR131,,1993,1960,,10538111,596726513,116717206,,9465796,534117296,104504461,,1072315,62609217,12212745,PDP
VR131,,1994,1960,,10518256,597862942,116899562,,9599624,547422843,107005824,,918632,50440099,9893738,PDP
VR131,,1995,1960,,10297127,606982983,118301217,,9677167,556002964,108610079,,619960,50980019,9691138,PDP
VR131,,1996,1960,,11066070,627780594,122770802,,9732370,563367407,109975681,,1333700,64413187,12795121,PDP
VR131,,1997,1960,,11019166,615297117,120502639,,9987383,573892244,112103441,,1031783,41404873,8399198,PDP
VR131,,1998,1960,,10836625,627257898,122448351,,10285626,586905940,114717288,,550999,40351958,7731063,PDP
VR131,,1999,1960,,10916814,619385318,121127725,,10360684,591839853,115670266,,556130,27545465,5457459,PDP
VR131,,2000,1960,,11217220,652363416,127296120,,10473876,600801935,117378135,,743344,51561481,9917985,PDP
VR131,,2001,1960,,11424095,658379046,128573391,,10595815,608671212,118900301,,828280,49707834,9673090,PDP
VR131,,2002,1960,,11321867,656266588,128095281,,10702872,615910916,120295562,,618995,40355672,7799719,PDP
VR131,,2003,1960,,11554280,667983165,130412494,,10771961,620784693,121231871,,782319,47198472,9180623,PDP
VR131,,2004,1960,,11430590,667516831,130205827,,10843040,625722953,122181644,,587550,41793878,8024183,PDP
VR131,,2005,1960,,11354690,664899439,129664199,,10901785,629955795,122993563,,452905,34943644,6670636,PDP
VR131,,2006,1960,,11354192,662430959,129224470,,10931959,632742550,123519601,,422233,29688409,5704869,PDP
VR131,,2007,1960,,11392994,661716967,129136227,,10957458,635221747,123986239,,435536,26495220,5149988,PDP
VR131,,2008,1960,,11393017,661717872,129136411,,10979368,636947270,124315181,,413649,24770602,4821230,PDP
VR131,,2009,1960,,11274722,664687801,129546575,,10998742,650244508,126700614,,275980,14443293,2845960,PDP
VR131,,2010,1960,,11274722,664687801,129546575,,11014070,651865243,127004330,,260652,12822558,2542245,PDP
VR131,,2011,1960,,11243575,663025857,129219708,,11048934,653665308,127359489,,194641,9360549,1860219,PDP
VR131,,2012,1960,,11371474,671665467,130884904,,11061055,654144319,127456844,,310419,17521148,3428060,PDP
VR131,,2013,1960,,11371474,671665467,130884904,,11091479,655623566,127750479,,279995,16041901,3134425,PDP
VR131,,2014,1960,,11371474,671665467,130884904,,11120713,656875348,128002450,,250761,14790119,2882454,PDP
VR131,,2015,1960,,11371474,671665467,130884904,,11144364,658029147,128231403,,227110,13636320,2653500,PDP
VR131,,2016,1960,,11371474,671665467,130884904,,11171389,659106839,128450188,,200085,12558628,2434716,PDP
VR131,,2017,1960,,11371334,671414979,130840193,,11210995,660246959,128692662,,160339,11168020,2147530,PDP
VR131,,2017,1960,,11371334,671414979,130840193,,11210995,660246959,128692662,,160339,11168020,2147530,PDP
VR147,,1975,1971,,515680,14865944,3160866,,0,1559796,277544,,515680,13306148,2883322,PDN
VR147,,1976,1971,,1315680,54865944,11078303,,328453,9004636,1930701,,987227,45861308,9147602,PDN
VR147,,1977,1971,,1792752,29541186,7049191,,417804,12322006,2610332,,1374948,17219180,4438859,PDN
VR147,,1978,1971,,1801449,29541186,7057888,,450429,13838102,2912725,,1351020,15703084,4145163,PDN
VR147,,1979,1971,,1801449,29541186,7057888,,478559,15545232,3244615,,1322890,13995954,3813273,PDN
VR147,,1980,1971,,1829545,32203186,7559649,,484083,15900096,3313282,,1345462,16303090,4246367,PDN
VR147,,1981,1971,,1832041,34699386,8006309,,489301,15976252,3332050,,1342740,18723134,4674259,PDN
VR147,,1982,1971,,2806757,38868170,9722801,,583264,14304314,3128516,,2223493,24563856,6594285,PDN
VR147,,1983,1971,,2807007,39246439,9790359,,801345,14482501,3378302,,2005662,24763938,6412057,PDN
VR147,,1984,1971,,13884007,63346439,25155615,,4131457,18199735,7369844,,9752550,45146704,17785771,PDN
VR147,,1985,1971,,13884007,63346439,25155615,,6632437,21596879,10475298,,7251570,41749560,14680317,PDN
VR147,,1986,1971,,14999745,46546502,23282041,,8428900,24048015,12707906,,6570845,22498487,10574135,PDN
VR147,,1987,1971,,18313329,41501938,25698015,,9597751,25782489,14185382,,8715578,15719449,11512633,PDN
VR147,,1988,1971,,18313329,41501938,25698015,,10286367,27066877,15102537,,8026962,14435061,10595478,PDN
VR147,,1989,1971,,17523677,41916113,24982060,,10707368,28396564,15760137,,6816309,13519549,9221923,PDN
VR147,,1990,1971,,17769948,43556486,25520212,,11235758,30538541,16669662,,6534190,13017945,8850550,PDN
VR147,,1991,1971,,18048968,43629384,25812204,,11631680,31914910,17310490,,6417288,11714474,8501714,PDN
VR147,,1992,1971,,13912067,41780286,21346282,,11943873,33021819,17819642,,1968194,8758467,3526640,PDN
VR147,,1993,1971,,14261649,47737065,22755789,,12449716,35061612,18688437,,1811933,12675453,4067352,PDN
VR147,,1994,1971,,14647696,50685648,23666495,,12983478,39695298,20046698,,1664218,10990350,3619797,PDN
VR147,,1995,1971,,15086437,54661042,24812601,,13448495,42093342,20938414,,1637942,12567700,3874187,PDN
VR147,,1996,1971,,15251459,55247719,25082014,,13814073,43761276,21600777,,1437386,11486443,3481237,PDN
VR147,,1997,1971,,15492659,52682184,24866713,,14113491,44565238,22043249,,1379168,8116946,2823464,PDN
VR147,,1998,1971,,15481736,49607800,24308747,,14429873,45323099,22494481,,1051863,4284701,1814266,PDN
VR147,,1999,1971,,15906730,53594766,25443166,,14684302,46132490,22892930,,1222428,7462276,2550236,PDN
VR147,,2000,1971,,15688865,50290461,24637346,,14880144,46579896,23168382,,808721,3710565,1468964,PDN
VR147,,2001,1971,,15287119,47487942,23736931,,14972450,46779918,23296279,,314669,708024,440652,PDN
VR147,,2002,1971,,15526626,49525673,24339023,,15054320,47185090,23450243,,472306,2340583,888780,PDN
VR147,,2003,1971,,15802797,49445922,24601004,,15143317,47662247,23624144,,659480,1783675,976860,PDN
VR147,,2004,1971,,15424634,50347333,24383234,,15195752,48213029,23774583,,228882,2134304,608651,PDN
VR147,,2005,1971,,15461118,49318485,24236649,,15226581,48883460,23924706,,234537,435025,311943,PDN
VR147,,2006,1971,,15432047,49351069,24213376,,15263032,49117396,24002782,,169015,233673,210594,PDN
VR147,,2007,1971,,15278684,49135937,24021733,,15278684,49135937,24021733,,0,0,0,PDN
VR147,,2008,1971,,15278684,49135937,24021733,,15278684,49135937,24021733,,0,0,0,PDN
VR147,,2009,1971,,15278684,50039811,24182563,,15278684,50039811,24182563,,0,0,0,PDN
VR147,,2010,1971,,15278684,50039811,24182563,,15278684,50039811,24182563,,0,0,0,PDN
VR147,,2011,1971,,15278684,50039811,24182563,,15278684,50039811,24182563,,0,0,0,PDN
VR147,,2012,1971,,15278684,50039811,24182563,,15278684,50039811,24182563,,0,0,0,PDN
VR147,,2013,1971,,15278684,50039811,24182563,,15278684,50039811,24182563,,0,0,0,PDN
VR147,,2014,1971,,15278684,50039811,24182563,,15278684,50039811,24182563,,0,0,0,PDN
VR147,,2015,1971,,15278684,50039811,24182563,,15278684,50039811,24182563,,0,0,0,PDN
VR147,,2016,1971,,15278684,50039811,24182563,,15278684,50039811,24182563,,0,0,0,PDN
VR147,,2017,1971,,15278684,50039811,24182563,,15278684,50039811,24182563,,0,0,0,PDN
VR147,,2017,1971,,15278684,50039811,24182563,,15278684,50039811,24182563,,0,0,0,PDN
VR153,,1989,1982,,342611,7106484,1607110,,0,0,0,,342611,7106484,1607110,PDP
VR153,,1990,1982,,342611,7106484,1607110,,0,0,0,,342611,7106484,1607110,PDP
VR153,,1991,1982,,342611,7106484,1607110,,0,0,0,,342611,7106484,1607110,PDP
VR153,,1992,1982,,342611,7106484,1607110,,0,0,0,,342611,7106484,1607110,PDP
VR153,,2011,1982,,1003251,27567335,5908471,,74187,2108939,449443,,929064,25458396,5459028,PDP
VR153,,2012,1982,,1003251,27567335,5908471,,239100,8227289,1703030,,764151,19340046,4205440,PDP
VR153,,2013,1982,,1003251,27567335,5908471,,294217,11331594,2310515,,709034,16235741,3597956,PDP
VR153,,2014,1982,,1003251,27567335,5908471,,348418,14959340,3010222,,654833,12607995,2898248,PDP
VR153,,2015,1982,,1003251,27567335,5908471,,381166,18441477,3662568,,622085,9125858,2245903,PDP
VR153,,2016,1982,,1003251,27567335,5908471,,405537,21162519,4171110,,597714,6404816,1737361,PDP
VR153,,2017,1982,,1003251,27567335,5908471,,420154,23214624,4550870,,583097,4352711,1357601,PDP
VR153,,2017,1982,,1003251,27567335,5908471,,420154,23214624,4550870,,583097,4352711,1357601,PDP
VR155,,1978,1975,,500000,5000000,1389680,,0,0,0,,500000,5000000,1389680,PDN
VR155,,1979,1975,,500000,5000000,1389680,,0,0,0,,500000,5000000,1389680,PDN
VR155,,1980,1975,,500000,5000000,1389680,,0,0,0,,500000,5000000,1389680,PDN
VR155,,1981,1975,,500000,5000000,1389680,,0,0,0,,500000,5000000,1389680,PDN
VR155,,1982,1975,,11082313,114027161,31371843,,178336,5098257,1085499,,10903977,108928904,30286344,PDN
VR155,,1983,1975,,11082313,114027161,31371843,,297453,9230188,1939835,,10784860,104796973,29432008,PDN
VR155,,1984,1975,,11082313,114027161,31371843,,369156,12227305,2544833,,10713157,101799856,28827010,PDN
VR155,,1985,1975,,11082313,114027161,31371843,,415263,14578063,3009224,,10667050,99449098,28362619,PDN
VR155,,1986,1975,,11082313,114027161,31371843,,458564,16948321,3474279,,10623749,97078840,27897564,PDN
VR155,,1987,1975,,2667431,77755145,16502866,,468815,17555180,3592513,,2198616,60199965,12910353,PDN
VR155,,1988,1975,,2626538,89556758,18561904,,504403,19551920,3983392,,2122135,70004838,14578512,PDN
VR155,,1989,1975,,2626538,89556758,18561904,,567746,22902103,4642853,,2058792,66654655,13919051,PDN
VR155,,1990,1975,,1208745,56074576,11186428,,660029,28261668,5688796,,548716,27812908,5497632,PDN
VR155,,1991,1975,,1208745,56074576,11186428,,749535,32814767,6588462,,459210,23259809,4597966,PDN
VR155,,1992,1975,,1208745,56074576,11186428,,802014,37009718,7387373,,406731,19064858,3799055,PDN
VR155,,1993,1975,,1335035,61867551,12343496,,916006,44414486,8818939,,419029,17453065,3524557,PDN
VR155,,1994,1975,,1426852,66458387,13252188,,994333,51149054,10095588,,432519,15309333,3156600,PDN
VR155,,1995,1975,,1451373,83555586,16318915,,1019748,54459049,10709970,,431625,29096537,5608945,PDN
VR155,,1996,1975,,1246193,69825545,13670667,,1032191,56675391,11116780,,214002,13150154,2553887,PDN
VR155,,1997,1975,,1245625,69809768,13667292,,1052815,58807495,11516782,,192810,11002273,2150510,PDN
VR155,,1998,1975,,1245625,69809768,13667292,,1059741,60104890,11754561,,185884,9704878,1912731,PDN
VR155,,1999,1975,,1092575,65356694,12721880,,1065249,61133104,11943026,,27326,4223590,778854,PDN
VR155,,2000,1975,,1092986,69463156,13452978,,1068929,61944184,12091026,,24057,7518972,1361952,PDN
VR155,,2001,1975,,1121368,72019986,13936312,,1075906,62744649,12240434,,45462,9275337,1695878,PDN
VR155,,2002,1975,,1207885,76368786,14796637,,1112300,65771565,12815425,,95585,10597221,1981212,PDN
VR155,,2003,1975,,1202439,73676908,14312209,,1139906,67654035,13177991,,62533,6022873,1134218,PDN
VR155,,2004,1975,,1146055,68208709,13282836,,1146055,68208709,13282836,,0,0,0,PDN
VR155,,2005,1975,,1181240,73496883,14258977,,1147163,68416950,13320998,,34077,5079933,937979,PDN
VR155,,2006,1975,,1167220,71678683,13921434,,1151793,69102650,13447638,,15427,2576033,473796,PDN
VR155,,2007,1975,,1167220,71678683,13921434,,1153148,69324848,13488530,,14072,2353835,432904,PDN
VR155,,2008,1975,,1167220,71678683,13921434,,1155081,69698170,13556891,,12139,1980513,364543,PDN
VR155,,2009,1975,,1155659,71104698,13807740,,1155659,71104698,13807740,,0,0,0,PDN
VR155,,2010,1975,,1155659,71104698,13807740,,1155659,71104698,13807740,,0,0,0,PDN
VR155,,2011,1975,,1155659,71104698,13807740,,1155659,71104698,13807740,,0,0,0,PDN
VR155,,2012,1975,,1155659,71104698,13807740,,1155659,71104698,13807740,,0,0,0,PDN
VR155,,2013,1975,,1155659,71104698,13807740,,1155659,71104698,13807740,,0,0,0,PDN
VR155,,2014,1975,,1155659,71104698,13807740,,1155659,71104698,13807740,,0,0,0,PDN
VR155,,2015,1975,,1155659,71104698,13807740,,1155659,71104698,13807740,,0,0,0,PDN
VR155,,2016,1975,,1155659,71104698,13807740,,1155659,71104698,13807740,,0,0,0,PDN
VR155,,2017,1975,,1155659,71104698,13807740,,1155659,71104698,13807740,,0,0,0,PDN
VR155,,2017,1975,,1155659,71104698,13807740,,1155659,71104698,13807740,,0,0,0,PDN
VR159,,1979,1976,,33000,33000000,5904886,,0,0,0,,33000,33000000,5904886,PDN
VR159,,1980,1976,,33000,33000000,5904886,,0,0,0,,33000,33000000,5904886,PDN
VR159,,1981,1976,,33000,33000000,5904886,,0,0,0,,33000,33000000,5904886,PDN
VR159,,1982,1976,,8403000,292458600,60441897,,108638,2087533,480085,,8294362,290371067,59961812,PDN
VR159,,1983,1976,,5752173,199686616,41283599,,414460,9373007,2082255,,5337713,190313609,39201344,PDN
VR159,,1984,1976,,8577540,203606118,44806387,,944035,23187234,5069877,,7633505,180418884,39736510,PDN
VR159,,1985,1976,,8577540,203606118,44806387,,1445855,38388082,8276475,,7131685,165218036,36529912,PDN
VR159,,1986,1976,,9148634,217883475,47917936,,1924661,53629566,11467288,,7223973,164253909,36450648,PDN
VR159,,1987,1976,,8577540,203606118,44806387,,2361356,70915377,14979750,,6216184,132690741,29826637,PDN
VR159,,1988,1976,,8577540,203606118,44806387,,2660760,84786500,17747326,,5916780,118819618,27059061,PDN
VR159,,1989,1976,,8577540,203606118,44806387,,2832128,94422763,19633331,,5745412,109183355,25173056,PDN
VR159,,1990,1976,,3641275,163935376,32811271,,3021078,104628100,21638178,,620197,59307276,11173093,PDN
VR159,,1991,1976,,3641275,163935376,32811271,,3094582,110493843,22755408,,546693,53441533,10055863,PDN
VR159,,1992,1976,,4044935,156882121,31959903,,3121596,112803577,23193407,,923339,44078544,8766496,PDN
VR159,,1993,1976,,4044935,156882121,31959903,,3187567,116398698,23899079,,857368,40483423,8060824,PDN
VR159,,1994,1976,,4009058,165226568,33408803,,3231157,119224180,24445424,,777901,46002388,8963379,PDN
VR159,,1995,1976,,4275078,171212170,34739877,,3514744,126144402,25960367,,760334,45067768,8779510,PDN
VR159,,1996,1976,,4378334,145770659,30316174,,3779525,132299937,27320439,,598809,13470722,2995735,PDN
VR159,,1997,1976,,5005405,172767810,35747008,,3975531,137701179,28477520,,1029874,35066631,7269488,PDN
VR159,,1998,1976,,5788604,208218447,42838150,,4369150,152475393,31500003,,1419454,55743054,11338147,PDN
VR159,,1999,1976,,8604283,293560225,60839198,,4637947,163561196,33741363,,3966336,129999029,27097835,PDN
VR159,,2000,1976,,8408578,289199727,59867604,,4764053,169298030,34888258,,3644525,119901697,24979346,PDN
VR159,,2001,1976,,8641184,285199573,59388439,,4906709,174088825,35883368,,3734475,111110748,23505071,PDN
VR159,,2002,1976,,8085034,273699198,56785959,,5039940,177970497,36707288,,3045094,95728701,20078671,PDN
VR159,,2003,1976,,8085034,273699198,56785958,,5134657,181359429,37405018,,2950377,92339769,19380940,PDN
VR159,,2004,1976,,6692098,240366689,49461972,,5175604,184435812,37993364,,1516494,55930877,11468608,PDN
VR159,,2005,1976,,6575575,236350092,48630751,,5190472,185655314,38225225,,1385103,50694778,10405526,PDN
VR159,,2006,1976,,6575575,236350092,48630751,,5194436,186012492,38292744,,1381139,50337600,10338007,PDN
VR159,,2007,1976,,5194436,186012492,38292744,,5194436,186012492,38292744,,0,0,0,PDN
VR159,,2008,1976,,5194436,186012492,38292744,,5194436,186012492,38292744,,0,0,0,PDN
VR159,,2009,1976,,5194437,188984621,38821597,,5194437,188984621,38821597,,0,0,0,PDN
VR159,,2010,1976,,5194437,188984621,38821597,,5194437,188984621,38821597,,0,0,0,PDN
VR159,,2011,1976,,5194437,188984621,38821597,,5194437,188984621,38821597,,0,0,0,PDN
VR159,,2012,1976,,5194437,188984621,38821597,,5194437,188984621,38821597,,0,0,0,PDN
VR159,,2013,1976,,5194437,188984621,38821597,,5194437,188984621,38821597,,0,0,0,PDN
VR159,,2014,1976,,5194437,188984621,38821597,,5194437,188984621,38821597,,0,0,0,PDN
VR159,,2015,1976,,5194437,188984621,38821597,,5194437,188984621,38821597,,0,0,0,PDN
VR159,,2016,1976,,5194437,188984621,38821597,,5194437,188984621,38821597,,0,0,0,PDN
VR159,,2017,1976,,5194437,188984621,38821597,,5194437,188984621,38821597,,0,0,0,PDN
VR159,,2017,1976,,5194437,188984621,38821597,,5194437,188984621,38821597,,0,0,0,PDN
VR162,,1975,1962,,224925,13576316,2640640,,137548,7987840,1558872,,87377,5588476,1081768,PDN
VR162,,1976,1962,,224925,13576316,2640640,,154926,9311155,1811715,,69999,4265161,828925,PDN
VR162,,1977,1962,,224925,13576316,2640640,,164848,10376943,2011279,,60077,3199373,629361,PDN
VR162,,1978,1962,,224925,13576316,2640640,,189973,11791762,2288151,,34952,1784554,352489,PDN
VR162,,1979,1962,,224925,13576316,2640640,,219959,13027860,2538084,,4966,548456,102556,PDN
VR162,,1980,1962,,420381,19093449,3817792,,260243,14351425,2813877,,160138,4742024,1003915,PDN
VR162,,1981,1962,,433652,20635048,4105369,,302452,15548965,3069172,,131200,5086083,1036197,PDN
VR162,,1982,1962,,433652,20635048,4105369,,319852,16010606,3168714,,113800,4624442,936655,PDN
VR162,,1983,1962,,563858,27691555,5491181,,347423,16764279,3330391,,216435,10927276,2160790,PDN
VR162,,1984,1962,,585419,27691555,5512742,,388570,17810019,3557613,,196849,9881536,1955129,PDN
VR162,,1985,1962,,714953,31441555,6309536,,411931,18539074,3710699,,303022,12902481,2598837,PDN
VR162,,1986,1962,,714953,31441555,6309536,,442195,19714586,3950128,,272758,11726969,2359408,PDN
VR162,,1987,1962,,714953,31441555,6309536,,481452,20831883,4188193,,233501,10609672,2121343,PDN
VR162,,1988,1962,,761316,34440312,6889485,,509178,21904676,4406807,,252138,12535636,2482678,PDN
VR162,,1989,1962,,885338,38390657,7716416,,512093,22035020,4432915,,373245,16355637,3283501,PDN
VR162,,1990,1962,,598897,28725456,5710188,,515919,22242441,4473649,,82978,6483015,1236539,PDN
VR162,,1991,1962,,621138,32917099,6478273,,544531,24780755,4953918,,76607,8136344,1524355,PDN
VR162,,1992,1962,,861275,56666634,10944306,,675611,29911516,5997945,,185664,26755118,4946361,PDN
VR162,,1993,1962,,2328655,96686912,19532732,,1051251,46398305,9307177,,1277404,50288607,10225555,PDN
VR162,,1994,1962,,1988450,94690104,18837223,,1181673,54008422,10791713,,806777,40681682,8045510,PDN
VR162,,1995,1962,,1899765,89608287,17844300,,1292865,60742686,12101172,,606900,28865601,5743128,PDN
VR162,,1996,1962,,1372463,67483543,13380211,,1338296,64285028,12776913,,34167,3198515,603298,PDN
VR162,,1997,1962,,1857798,81808842,16414531,,1383465,66055821,13137170,,474333,15753021,3277361,PDN
VR162,,1998,1962,,1555475,74209487,14760010,,1451284,68925874,13715674,,104191,5283613,1044336,PDN
VR162,,1999,1962,,2759871,107040782,21806273,,1752157,79621045,15919603,,1007714,27419737,5886670,PDN
VR162,,2000,1962,,2727582,116587472,23472684,,2000432,90052073,18023933,,727150,26535399,5448751,PDN
VR162,,2001,1962,,2870996,127772202,25606263,,2167340,97687721,19549497,,703656,30084481,6056766,PDN
VR162,,2002,1962,,2739517,130101377,25889228,,2203987,100733980,20128183,,535530,29367397,5761045,PDN
VR162,,2003,1962,,2621890,121227238,24192573,,2241877,102812280,20535877,,380013,18414958,3656696,PDN
VR162,,2004,1962,,2313719,107028870,21358002,,2263313,103924915,20755291,,50406,3103955,602711,PDN
VR162,,2005,1962,,2306223,108143452,21548830,,2269679,104538766,20870883,,36544,3604686,677947,PDN
VR162,,2006,1962,,2417054,110344729,22051347,,2277284,105149704,20987196,,139770,5195025,1064151,PDN
VR162,,2007,1962,,2490767,113029163,22602718,,2298366,106381322,21227427,,192401,6647841,1375291,PDN
VR162,,2008,1962,,2490767,113033805,22603544,,2339518,107273182,21427273,,151249,5760623,1176271,PDN
VR162,,2009,1962,,2480912,113262241,22634336,,2373764,110297859,21999717,,107148,2964382,634618,PDN
VR162,,2010,1962,,2480912,113262241,22634336,,2389293,110969892,22134825,,91619,2292349,499510,PDN
VR162,,2011,1962,,2391578,111156616,22170334,,2391578,111156616,22170334,,0,0,0,PDN
VR162,,2012,1962,,2391578,111156616,22170334,,2391578,111156616,22170334,,0,0,0,PDN
VR162,,2013,1962,,2391578,111156616,22170334,,2391578,111156616,22170334,,0,0,0,PDN
VR162,,2014,1962,,2391578,111156616,22170334,,2391578,111156616,22170334,,0,0,0,PDN
VR162,,2015,1962,,2391578,111156616,22170334,,2391578,111156616,22170334,,0,0,0,PDN
VR162,,2016,1962,,2391578,111156616,22170334,,2391578,111156616,22170334,,0,0,0,PDN
VR162,,2017,1962,,2391578,111156616,22170334,,2391578,111156616,22170334,,0,0,0,PDN
VR162,,2017,1962,,2391578,111156616,22170334,,2391578,111156616,22170334,,0,0,0,PDN
VR164,,1975,1957,,14500000,11991500,16633719,,6998453,4428930,7786519,,7501547,7562570,8847200,PDP
VR164,,1976,1957,,9373861,8051793,10806564,,8012000,4950190,8892817,,1361861,3101603,1913747,PDP
VR164,,1977,1957,,9373861,8051793,10806564,,8272356,5076104,9175577,,1101505,2975689,1630987,PDP
VR164,,1978,1957,,9373861,8051793,10806564,,8376751,5106698,9285416,,997110,2945095,1521148,PDP
VR164,,1979,1957,,9230961,8051793,10663664,,8356209,5116128,9266552,,874752,2935665,1397112,PDP
VR164,,1980,1957,,9230961,8051793,10663664,,8393903,5150183,9310306,,837058,2901610,1353358,PDP
VR164,,1981,1957,,9231661,8751793,10788920,,8428837,5358071,9382230,,802824,3393722,1406690,PDP
VR164,,1982,1957,,9231661,8751793,10788920,,8414617,5408382,9376963,,817044,3343411,1411957,PDP
VR164,,1983,1957,,9299245,8802116,10865458,,8436376,5428098,9402230,,862869,3374018,1463228,PDP
VR164,,1984,1957,,9348133,12419801,11558062,,8455074,5438824,9422836,,893059,6980977,2135226,PDP
VR164,,1985,1957,,8983642,10142085,10788283,,8466794,5446013,9435835,,516848,4696072,1352448,PDP
VR164,,1986,1957,,8983744,11166366,10970642,,8469878,5447355,9439158,,513866,5719011,1531484,PDP
VR164,,1987,1957,,9025403,12063080,11171859,,8492506,5941320,9549680,,532897,6121760,1622179,PDP
VR164,,1988,1957,,9031168,12340497,11226986,,8516015,6004393,9584412,,515153,6336104,1642574,PDP
VR164,,1989,1957,,8516015,6004393,9584412,,8516015,6004393,9584412,,0,0,0,PDP
VR164,,1990,1957,,8516015,6004393,9584412,,8516015,6004393,9584412,,0,0,0,PDP
VR164,,1991,1957,,8516015,6004393,9584412,,8516015,6004393,9584412,,0,0,0,PDP
VR164,,1992,1957,,10506355,16520725,13445986,,8524557,6009898,9593934,,1981798,10510827,3852052,PDP
VR164,,1993,1957,,10887824,15747475,13689866,,8969565,7575459,10317511,,1918259,8172016,3372355,PDP
VR164,,1994,1957,,10951338,35402556,17250725,,9537689,13194728,11885505,,1413649,22207828,5365220,PDP
VR164,,1995,1957,,12467875,117644679,33401092,,10483733,36240223,16932171,,1984142,81404456,16468921,PDP
VR164,,1996,1957,,13053070,109296735,32500888,,11335263,58809203,21799534,,1717807,50487532,10701354,PDP
VR164,,1997,1957,,13101250,99608601,30825200,,11860731,72406476,24744446,,1240519,27202125,6080754,PDP
VR164,,1998,1957,,13248066,103911996,31737745,,12212876,80901461,26608154,,1035190,23010535,5129591,PDP
VR164,,1999,1957,,14374380,110659951,34064763,,12595435,87650080,28191535,,1778945,23009871,5873228,PDP
VR164,,2000,1957,,14847801,121537090,36473618,,12971119,93869444,29673867,,1876682,27667646,6799751,PDP
VR164,,2001,1957,,15003076,114414818,35361585,,13358472,98573632,30898264,,1644604,15841186,4463321,PDP
VR164,,2002,1957,,15469616,113062205,35587446,,13664000,101577425,31738275,,1805616,11484780,3849171,PDP
VR164,,2003,1957,,15642128,115259443,36150926,,14119686,104205630,32661613,,1522442,11053813,3489313,PDP
VR164,,2004,1957,,19536291,131090829,42862062,,14840298,107788649,34019773,,4695993,23302180,8842289,PDP
VR164,,2005,1957,,18731564,160108238,47220575,,15260580,113752727,35501279,,3470984,46355511,11719296,PDP
VR164,,2006,1957,,20764213,154552358,48264633,,15997055,122258084,37751162,,4767158,32294274,10513471,PDP
VR164,,2007,1957,,20764213,154552358,48264633,,16684441,129916639,39801281,,4079772,24635719,8463352,PDP
VR164,,2008,1957,,20764213,154552187,48264602,,17432080,135038758,41460329,,3332133,19513429,6804273,PDP
VR164,,2009,1957,,21050217,161820108,49843834,,18194417,140062527,43116577,,2855800,21757581,6727255,PDP
VR164,,2010,1957,,21050217,161820108,49843834,,18940951,142616120,44317487,,2109266,19203988,5526345,PDP
VR164,,2011,1957,,21050217,161820108,49843834,,19301004,145091706,45118036,,1749213,16728402,4725795,PDP
VR164,,2012,1957,,21050217,161820108,49843834,,19449129,147435554,45683216,,1601088,14384554,4160617,PDP
VR164,,2013,1957,,20533761,161898567,49341337,,19564302,149312994,46132454,,969459,12585573,3208884,PDP
VR164,,2014,1957,,20533761,161898567,49341337,,19741158,152110955,46807167,,792603,9787612,2534171,PDP
VR164,,2015,1957,,20533761,161898567,49341337,,19871979,154807228,47417752,,661782,7091339,1923585,PDP
VR164,,2016,1957,,21461565,173261137,52290952,,20102816,156512020,47951933,,1358749,16749117,4339019,PDP
VR164,,2017,1957,,21461565,173261137,52290952,,20214386,157353487,48213230,,1247179,15907650,4077722,PDP
VR164,,2017,1957,,21461565,173261137,52290952,,20214386,157353487,48213230,,1247179,15907650,4077722,PDP
VR167,,1988,1986,,9209411,21031520,12951674,,323982,730673,453995,,8885429,20300847,12497679,PDN
VR167,,1989,1986,,9656062,21626146,13504131,,1529691,3198636,2098843,,8126371,18427510,11405288,PDN
VR167,,1990,1986,,9676448,21626146,13524517,,2393901,4742364,3237738,,7282547,16883782,10286779,PDN
VR167,,1991,1986,,9397879,24718275,13796149,,2873390,6380646,4008736,,6524489,18337629,9787413,PDN
VR167,,1992,1986,,9397879,24718275,13796149,,3148786,7261366,4440844,,6249093,17456909,9355305,PDN
VR167,,1993,1986,,7190675,22223946,11145114,,3559101,8662764,5100518,,3631574,13561182,6044596,PDN
VR167,,1994,1986,,7190495,22223399,11144836,,3986471,8805406,5553269,,3204024,13417993,5591567,PDN
VR167,,1995,1986,,7297999,19644022,10793377,,4404659,9352917,6068879,,2893340,10291105,4724498,PDN
VR167,,1996,1986,,7467580,20134214,11050180,,4734811,9753539,6470316,,2732769,10380675,4579864,PDN
VR167,,1997,1986,,6618345,13053355,8941006,,5011574,10079707,6805116,,1606771,2973648,2135890,PDN
VR167,,1998,1986,,6618345,13053355,8941006,,5217627,10324129,7054661,,1400718,2729226,1886345,PDN
VR167,,1999,1986,,7032991,16493174,9967719,,5292951,10424870,7147910,,1740040,6068304,2819809,PDN
VR167,,2000,1986,,6949083,16507683,9886393,,5492913,10790017,7412845,,1456170,5717666,2473548,PDN
VR167,,2001,1986,,6570123,16432745,9494099,,5597920,11149877,7581884,,972203,5282868,1912215,PDN
VR167,,2002,1986,,6161470,17421651,9261408,,5609244,11186830,7599783,,552226,6234821,1661625,PDN
VR167,,2003,1986,,6161470,17421651,9261408,,5638810,11457376,7677489,,522660,5964275,1583919,PDN
VR167,,2004,1986,,6043042,14961356,8705205,,5638810,11457376,7677489,,404232,3503980,1027716,PDN
VR167,,2005,1986,,5638810,11457376,7677489,,5638810,11457376,7677489,,0,0,0,PDN
VR167,,2006,1986,,5638810,11457376,7677489,,5638810,11457376,7677489,,0,0,0,PDN
VR167,,2007,1986,,5650093,11457376,7688772,,5650093,11457376,7688772,,0,0,0,PDN
VR167,,2008,1986,,5650093,11457376,7688772,,5650093,11457376,7688772,,0,0,0,PDN
VR167,,2009,1986,,5650093,11662706,7725308,,5650093,11662706,7725308,,0,0,0,PDN
VR167,,2010,1986,,5650093,11662706,7725308,,5650093,11662706,7725308,,0,0,0,PDN
VR167,,2011,1986,,5650093,11662706,7725308,,5650093,11662706,7725308,,0,0,0,PDN
VR167,,2012,1986,,5650093,11662706,7725308,,5650093,11662706,7725308,,0,0,0,PDN
VR167,,2013,1986,,5650093,11662706,7725308,,5650093,11662706,7725308,,0,0,0,PDN
VR167,,2014,1986,,5650093,11662706,7725308,,5650093,11662706,7725308,,0,0,0,PDN
VR167,,2015,1986,,5650093,11662706,7725308,,5650093,11662706,7725308,,0,0,0,PDN
VR167,,2016,1986,,5650093,11662706,7725308,,5650093,11662706,7725308,,0,0,0,PDN
VR167,,2017,1986,,5650093,11662706,7725308,,5650093,11662706,7725308,,0,0,0,PDN
VR167,,2017,1986,,5650093,11662706,7725308,,5650093,11662706,7725308,,0,0,0,PDN
VR171,,1975,1966,,4159997,45710000,12293449,,160000,3710000,820142,,3999997,42000000,11473307,PDN
VR171,,1976,1966,,4159997,45710000,12293449,,160000,3710000,820142,,3999997,42000000,11473307,PDN
VR171,,1977,1966,,3529181,33442080,9479729,,160000,3710000,820142,,3369181,29732080,8659587,PDN
VR171,,1978,1966,,3940778,33863245,9966266,,632098,4009125,1345465,,3308680,29854120,8620801,PDN
VR171,,1979,1966,,3940778,33863245,9966266,,775221,4204359,1523328,,3165557,29658886,8442938,PDN
VR171,,1980,1966,,3831024,33909179,9864686,,790489,4393663,1572280,,3040535,29515516,8292406,PDN
VR171,,1981,1966,,3831024,33909179,9864686,,861771,4453490,1654207,,2969253,29455689,8210479,PDN
VR171,,1982,1966,,3831024,33909179,9864686,,601604,4515835,1405133,,3229420,29393344,8459553,PDN
VR171,,1983,1966,,3831024,33909179,9864686,,619023,4520622,1423404,,3212001,29388557,8441282,PDN
VR171,,1984,1966,,3831024,33909179,9864686,,725249,4561407,1536887,,3105775,29347772,8327799,PDN
VR171,,1985,1966,,3831086,34528885,9975016,,791333,4589747,1608014,,3039753,29939138,8367002,PDN
VR171,,1986,1966,,3831086,34528885,9975016,,813697,4598939,1632014,,3017389,29929946,8343002,PDN
VR171,,1987,1966,,3854181,43162337,11534312,,831495,8524523,2348314,,3022686,34637814,9185998,PDN
VR171,,1988,1966,,3729427,65490484,15382538,,855307,16937090,3869024,,2874120,48553394,11513514,PDN
VR171,,1989,1966,,4068502,102197894,22253181,,954824,32911202,6810910,,3113678,69286692,15442271,PDN
VR171,,1990,1966,,2867267,110741177,22572103,,1043979,44233300,8914673,,1823288,66507877,13657430,PDN
VR171,,1991,1966,,1500069,102476122,19734254,,1136966,57113129,11299444,,363103,45362993,8434810,PDN
VR171,,1992,1966,,1522481,107368157,20627135,,1196451,67069796,13130578,,326030,40298361,7496557,PDN
VR171,,1993,1966,,2326961,124738639,24522448,,1298982,75801212,14786742,,1027979,48937427,9735706,PDN
VR171,,1994,1966,,2451948,127161727,25078590,,1442003,80570730,15778432,,1009945,46590997,9300158,PDN
VR171,,1995,1966,,1916632,90927172,18095844,,1494794,82422979,16160804,,421838,8504193,1935040,PDN
VR171,,1996,1966,,1553302,93443878,18180327,,1504115,85217152,16667309,,49187,8226726,1513018,PDN
VR171,,1997,1966,,2511163,101197651,20517862,,1510020,88212244,17206149,,1001143,12985407,3311713,PDN
VR171,,1998,1966,,2511163,101197651,20517862,,1873433,93806099,18564910,,637730,7391552,1952952,PDN
VR171,,1999,1966,,3203735,98143824,20667049,,2209398,95961588,19284414,,994337,2182236,1382635,PDN
VR171,,2000,1966,,3074292,115989657,23713021,,2364199,96982945,19620951,,710093,19006712,4092070,PDN
VR171,,2001,1966,,2741964,110665978,22433419,,2453146,97532859,19807747,,288818,13133119,2625672,PDN
VR171,,2002,1966,,2859208,119743867,24165946,,2521890,98391214,20029223,,337318,21352653,4136723,PDN
VR171,,2003,1966,,3015766,125212841,25295631,,2588622,99236921,20246437,,427144,25975920,5049194,PDN
VR171,,2004,1966,,4193850,138711660,28875640,,2645424,104079316,21164875,,1548426,34632344,7710765,PDN
VR171,,2005,1966,,4159882,131374885,27536196,,2988498,112583457,23021142,,1171384,18791428,4515054,PDN
VR171,,2006,1966,,4940602,134795342,28925538,,3325621,115794446,23929615,,1614981,19000896,4995923,PDN
VR171,,2007,1966,,4469092,133621207,28245107,,3626755,117741835,24577259,,842337,15879372,3667848,PDN
VR171,,2008,1966,,4332149,127050135,26938934,,3753559,118576460,24852573,,578590,8473675,2086361,PDN
VR171,,2009,1966,,4281758,125300258,26577180,,3902716,121737780,25564245,,379042,3562478,1012936,PDN
VR171,,2010,1966,,4281758,125400917,26595091,,4018326,122184117,25759274,,263432,3216800,835817,PDN
VR171,,2011,1966,,4465073,123889108,26509401,,4122727,122640934,25944957,,342346,1248174,564441,PDN
VR171,,2012,1966,,4465073,123889108,26509401,,4210615,122764737,26054875,,254458,1124371,454524,PDN
VR171,,2013,1966,,4465073,123889108,26509401,,4276758,122904750,26145931,,188315,984358,363467,PDN
VR171,,2014,1966,,4466174,124156234,26558034,,4321155,123026928,26212068,,145019,1129306,345963,PDN
VR171,,2015,1966,,4330541,123036297,26223122,,4330541,123036297,26223122,,0,0,0,PDN
VR171,,2016,1966,,4330541,123036297,26223122,,4330541,123036297,26223122,,0,0,0,PDN
VR171,,2017,1966,,4330541,123036297,26223122,,4330541,123036297,26223122,,0,0,0,PDN
VR171,,2017,1966,,4330541,123036297,26223122,,4330541,123036297,26223122,,0,0,0,PDN
VR175,,1991,1982,,57784,8089785,1497248,,0,21090,3753,,57784,8068695,1493495,PDN
VR175,,1992,1982,,57784,8089785,1497248,,28218,2962118,555285,,29566,5127667,941963,PDN
VR175,,1993,1982,,105224,11574615,2164764,,53389,5840596,1092641,,51835,5734019,1072123,PDN
VR175,,1994,1982,,105224,11574615,2164764,,76996,8226508,1540787,,28228,3348107,623977,PDN
VR175,,1995,1982,,106938,11763214,2200037,,90737,9853339,1844000,,16201,1909875,356037,PDN
VR175,,1996,1982,,142788,17085260,3182870,,101768,11318450,2115727,,41020,5766810,1067143,PDN
VR175,,1997,1982,,142788,17085260,3182870,,110825,12656642,2362897,,31963,4428618,819973,PDN
VR175,,1998,1982,,142788,17085260,3182870,,118855,13863768,2585718,,23933,3221492,597152,PDN
VR175,,1999,1982,,180286,23360200,4336905,,127111,15140043,2821069,,53175,8220157,1515836,PDN
VR175,,2000,1982,,180286,23360200,4336905,,132677,16316714,3036007,,47609,7043486,1300898,PDN
VR175,,2001,1982,,133851,22957305,4218781,,133732,17866134,3312759,,119,5091171,906022,PDN
VR175,,2002,1982,,133783,21659282,3987748,,133783,20843074,3842515,,0,816208,145233,PDN
VR175,,2003,1982,,133911,22245354,4092159,,133783,21933395,4036522,,128,311959,55637,PDN
VR175,,2004,1982,,223089,22268752,4185500,,136388,22245354,4094636,,86701,23398,90864,PDN
VR175,,2005,1982,,226971,22271819,4189928,,155352,22251159,4114633,,71619,20660,75295,PDN
VR175,,2006,1982,,318104,22269500,4280648,,181285,22258270,4141831,,136819,11230,138817,PDN
VR175,,2007,1982,,242500,24569072,4614221,,197036,22259253,4157757,,45464,2309819,456464,PDN
VR175,,2008,1982,,240952,24571163,4613045,,214437,22296762,4181832,,26515,2274401,431213,PDN
VR175,,2009,1982,,240808,23507373,4423613,,236424,23375036,4395681,,4384,132337,27932,PDN
VR175,,2010,1982,,240808,23507446,4423626,,240808,23507446,4423626,,0,0,0,PDN
VR175,,2011,1982,,240808,23507446,4423626,,240808,23507446,4423626,,0,0,0,PDN
VR175,,2012,1982,,240808,23507446,4423626,,240808,23507446,4423626,,0,0,0,PDN
VR175,,2013,1982,,240808,23507446,4423626,,240808,23507446,4423626,,0,0,0,PDN
VR175,,2014,1982,,240808,23507446,4423626,,240808,23507446,4423626,,0,0,0,PDN
VR175,,2015,1982,,240808,23507446,4423626,,240808,23507446,4423626,,0,0,0,PDN
VR175,,2016,1982,,240808,23507446,4423626,,240808,23507446,4423626,,0,0,0,PDN
VR175,,2017,1982,,240808,23507446,4423626,,240808,23507446,4423626,,0,0,0,PDN
VR175,,2017,1982,,240808,23507446,4423626,,240808,23507446,4423626,,0,0,0,PDN
VR182,,1975,1971,,12000000,24000000,16270463,,937713,1802107,1258373,,11062287,22197893,15012090,PDN
VR182,,1976,1971,,2409276,32218638,8142130,,717008,10284107,2546920,,1692268,21934531,5595210,PDN
VR182,,1977,1971,,2537366,46614118,10831693,,962348,18720586,4293413,,1575018,27893532,6538280,PDN
VR182,,1978,1971,,2545707,46614089,10840029,,1136702,25084050,5600056,,1409005,21530039,5239973,PDN
VR182,,1979,1971,,2451457,46614089,10745779,,1293131,30431537,6707995,,1158326,16182552,4037784,PDN
VR182,,1980,1971,,2569419,57925232,12876400,,1586166,37002345,8170213,,983253,20922887,4706187,PDN
VR182,,1981,1971,,2572709,61215232,13465099,,1961034,41689274,9379054,,611675,19525958,4086045,PDN
VR182,,1982,1971,,3126386,71138055,15784403,,2228303,43897725,10039286,,898083,27240330,5745117,PDN
VR182,,1983,1971,,4621449,85693959,19869484,,2516841,46711796,10828548,,2104608,38982163,9040936,PDN
VR182,,1984,1971,,4621202,86324795,19981486,,2785574,49784356,11644000,,1835628,36540439,8337486,PDN
VR182,,1985,1971,,5145522,88780677,20942795,,3027669,51051495,12111565,,2117853,37729182,8831230,PDN
VR182,,1986,1971,,5146130,94858310,22024833,,3197389,51760899,12407513,,1948741,43097411,9617320,PDN
VR182,,1987,1971,,4675974,61348905,15592149,,3310396,52028689,12568170,,1365578,9320216,3023979,PDN
VR182,,1988,1971,,4794193,60484031,15556476,,3445684,52543135,12794996,,1348509,7940896,2761480,PDN
VR182,,1989,1971,,4794193,60484031,15556476,,3552865,52998916,12983277,,1241328,7485115,2573199,PDN
VR182,,1990,1971,,4794193,60484031,15556476,,3620881,53550182,13149383,,1173312,6933849,2407093,PDN
VR182,,1991,1971,,3793260,55263724,13626663,,3649260,54006115,13258889,,144000,1257609,367774,PDN
VR182,,1992,1971,,3796336,55557227,13681964,,3696663,54647324,13420386,,99673,909903,261578,PDN
VR182,,1993,1971,,3865457,55653416,13768200,,3748512,54750462,13490587,,116945,902954,277613,PDN
VR182,,1994,1971,,3945840,75777618,17429402,,3796951,54930550,13571070,,148889,20847068,3858332,PDN
VR182,,1995,1971,,4725661,94731059,21581721,,3970761,66036549,15721037,,754900,28694510,5860684,PDN
VR182,,1996,1971,,4736992,93264410,21332083,,4080490,73694902,17193462,,656502,19569508,4138621,PDN
VR182,,1997,1971,,4269748,85302640,19448154,,4116245,74447250,17363087,,153503,10855390,2085067,PDN
VR182,,1998,1971,,4269748,85302641,19448154,,4172813,74793795,17481317,,96935,10508846,1966837,PDN
VR182,,1999,1971,,5151945,77462427,18935295,,4338723,75023690,17688134,,813222,2438737,1247161,PDN
VR182,,2000,1971,,5254365,83707133,20148873,,4608958,74538324,17872005,,645407,9168809,2276868,PDN
VR182,,2001,1971,,6349877,80292027,20636715,,5042194,77170316,18773567,,1307683,3121711,1863148,PDN
VR182,,2002,1971,,6161781,78612349,20149743,,5321940,77506211,19113081,,839841,1106138,1036662,PDN
VR182,,2003,1971,,5967010,79302527,20077780,,5529872,77805728,19374308,,437138,1496799,703472,PDN
VR182,,2004,1971,,6639451,80676082,20994626,,5668645,78238967,19590169,,970806,2437115,1404457,PDN
VR182,,2005,1971,,6639452,80676255,20994658,,5723580,78607963,19710762,,915872,2068292,1283896,PDN
VR182,,2006,1971,,6983967,80811871,21363304,,5796471,78849880,19826699,,1187496,1961991,1536605,PDN
VR182,,2007,1971,,6983967,80811871,21363304,,5890927,79019718,19951375,,1093040,1792153,1411929,PDN
VR182,,2008,1971,,6983967,80811871,21363304,,5949683,79120908,20028136,,1034284,1690963,1335168,PDN
VR182,,2009,1971,,6356312,81557212,20868274,,5994694,80732646,20359936,,361618,824566,508338,PDN
VR182,,2010,1971,,6356312,81557212,20868274,,6026875,80854620,20413820,,329437,702592,454453,PDN
VR182,,2011,1971,,6034273,80903177,20429858,,6034273,80903177,20429858,,0,0,0,PDN
VR182,,2012,1971,,6034273,80903177,20429858,,6034273,80903177,20429858,,0,0,0,PDN
VR182,,2013,1971,,6034273,80903177,20429858,,6034273,80903177,20429858,,0,0,0,PDN
VR182,,2014,1971,,6034273,80903177,20429858,,6034273,80903177,20429858,,0,0,0,PDN
VR182,,2015,1971,,6034273,80903177,20429858,,6034273,80903177,20429858,,0,0,0,PDN
VR182,,2016,1971,,6034273,80903177,20429858,,6034273,80903177,20429858,,0,0,0,PDN
VR182,,2017,1971,,6034273,80903177,20429858,,6034273,80903177,20429858,,0,0,0,PDN
VR182,,2017,1971,,6034273,80903177,20429858,,6034273,80903177,20429858,,0,0,0,PDN
VR187,,1989,1987,,946632,80390101,15250920,,7302,338247,67488,,939330,80051854,15183432,PDN
VR187,,1990,1987,,940950,56680299,11026412,,95047,5804736,1127918,,845903,50875563,9898494,PDN
VR187,,1991,1987,,557630,46665539,8861107,,134712,10566235,2014825,,422918,36099304,6846282,PDN
VR187,,1992,1987,,557640,46665539,8861117,,135514,13055934,2458634,,422126,33609605,6402483,PDN
VR187,,1993,1987,,557960,46665539,8861437,,135544,14280012,2676471,,422416,32385527,6184966,PDN
VR187,,1994,1987,,135658,35994965,6540456,,135544,14632664,2739221,,114,21362301,3801235,PDN
VR187,,1995,1987,,135658,35994965,6540456,,135544,14810533,2770870,,114,21184432,3769586,PDN
VR187,,1996,1987,,135544,14873629,2782097,,135544,14873629,2782097,,0,0,0,PDN
VR187,,1997,1987,,135544,14873629,2782097,,135544,14873629,2782097,,0,0,0,PDN
VR187,,1998,1987,,135544,14873629,2782097,,135544,14873629,2782097,,0,0,0,PDN
VR187,,1999,1987,,135544,14873629,2782097,,135544,14873629,2782097,,0,0,0,PDN
VR187,,2000,1987,,135544,14873629,2782097,,135544,14873629,2782097,,0,0,0,PDN
VR187,,2001,1987,,135544,14873629,2782097,,135544,14873629,2782097,,0,0,0,PDN
VR187,,2002,1987,,135544,14873629,2782097,,135544,14873629,2782097,,0,0,0,PDN
VR187,,2003,1987,,135544,14873629,2782097,,135544,14873629,2782097,,0,0,0,PDN
VR187,,2004,1987,,135544,14873629,2782097,,135544,14873629,2782097,,0,0,0,PDN
VR187,,2005,1987,,135544,14873629,2782097,,135544,14873629,2782097,,0,0,0,PDN
VR187,,2006,1987,,135544,14873629,2782097,,135544,14873629,2782097,,0,0,0,PDN
VR187,,2007,1987,,135544,14873629,2782097,,135544,14873629,2782097,,0,0,0,PDN
VR187,,2008,1987,,135544,14873629,2782097,,135544,14873629,2782097,,0,0,0,PDN
VR187,,2009,1987,,135544,15171505,2835101,,135544,15171505,2835101,,0,0,0,PDN
VR187,,2010,1987,,135544,15171505,2835101,,135544,15171505,2835101,,0,0,0,PDN
VR187,,2011,1987,,135544,15171505,2835101,,135544,15171505,2835101,,0,0,0,PDN
VR187,,2012,1987,,135544,15171505,2835101,,135544,15171505,2835101,,0,0,0,PDN
VR187,,2013,1987,,135544,15171505,2835101,,135544,15171505,2835101,,0,0,0,PDN
VR187,,2014,1987,,135544,15171505,2835101,,135544,15171505,2835101,,0,0,0,PDN
VR187,,2015,1987,,135544,15171505,2835101,,135544,15171505,2835101,,0,0,0,PDN
VR187,,2016,1987,,135544,15171505,2835101,,135544,15171505,2835101,,0,0,0,PDN
VR187,,2017,1987,,135544,15171505,2835101,,135544,15171505,2835101,,0,0,0,PDN
VR187,,2017,1987,,135544,15171505,2835101,,135544,15171505,2835101,,0,0,0,PDN
VR191,,1975,1963,,12000000,49992000,20895374,,2426591,24698115,6821273,,9573409,25293885,14074101,PDP
VR191,,1976,1963,,1646698,29000000,6806840,,1429291,25171936,5908283,,217407,3828064,898557,PDP
VR191,,1977,1963,,1646698,29000000,6806840,,1444218,25357469,5956223,,202480,3642531,850617,PDP
VR191,,1978,1963,,2983445,73095820,15989819,,1809163,27713085,6740317,,1174282,45382735,9249502,PDP
VR191,,1979,1963,,2443445,73095820,15449819,,1725962,31091533,7258263,,717483,42004287,8191556,PDP
VR191,,1980,1963,,2710209,73393500,15769551,,1860392,33734411,7862956,,849817,39659089,7906595,PDP
VR191,,1981,1963,,2710209,73393500,15769551,,1975996,36115129,8402176,,734213,37278371,7367375,PDP
VR191,,1982,1963,,3175137,83024644,17948205,,2179252,38190889,8974784,,995885,44833755,8973421,PDP
VR191,,1983,1963,,3229698,83276115,18047512,,2297069,39641509,9350718,,932629,43634606,8696794,PDP
VR191,,1984,1963,,3477711,89698044,19438217,,2393532,41467250,9772046,,1084179,48230794,9666171,PDP
VR191,,1985,1963,,3541410,91211028,19771130,,2491599,44259149,10366892,,1049811,46951879,9404238,PDP
VR191,,1986,1963,,3879601,99698203,21619495,,2631383,48034548,11178456,,1248218,51663655,10441039,PDP
VR191,,1987,1963,,3964254,99698203,21704148,,2842673,53143739,12298854,,1121581,46554464,9405294,PDP
VR191,,1988,1963,,3846339,107583885,22989379,,3045453,57444552,13266904,,800886,50139333,9722475,PDP
VR191,,1989,1963,,4244796,108355284,23525096,,3217890,61946221,14240349,,1026906,46409063,9284747,PDP
VR191,,1990,1963,,4231960,108982263,23623822,,3373800,65341422,15000388,,858160,43640841,8623434,PDP
VR191,,1991,1963,,3842202,78180564,17753334,,3455815,68128094,15578252,,386387,10052470,2175082,PDP
VR191,,1992,1963,,4225220,90455965,20320587,,3637388,72013049,16451098,,587832,18442916,3869489,PDP
VR191,,1993,1963,,4286050,96538990,21463806,,3791750,76955080,17484825,,494300,19583910,3978981,PDP
VR191,,1994,1963,,4540220,104050111,23054475,,4053620,85450561,19258346,,486600,18599550,3796129,PDP
VR191,,1995,1963,,4347428,99946227,22131454,,4226683,90544428,20337791,,120745,9401799,1793663,PDP
VR191,,1996,1963,,5509777,113609440,25724980,,4329356,94599778,21162057,,1180421,19009662,4562923,PDP
VR191,,1997,1963,,4577108,106068963,23450589,,4407383,97715810,21794538,,169725,8353153,1656051,PDP
VR191,,1998,1963,,4580681,106418167,23516298,,4449115,100023263,22246849,,131566,6394904,1269449,PDP
VR191,,1999,1963,,4933285,113527945,25133987,,4541001,102707199,22816303,,392284,10820746,2317684,PDP
VR191,,2000,1963,,5217654,128468662,28076847,,4633892,105717565,23444847,,583762,22751097,4632000,PDP
VR191,,2001,1963,,5196935,128258232,28018684,,4688027,107255764,23772683,,508908,21002468,4246001,PDP
VR191,,2002,1963,,5205997,128448369,28061579,,4713053,107905692,23913354,,492944,20542677,4148225,PDP
VR191,,2003,1963,,5059496,124519504,27215991,,4736371,108345013,24014843,,323125,16174491,3201148,PDP
VR191,,2004,1963,,6033163,124245196,28140849,,4773128,108588113,24094856,,1260035,15657083,4045993,PDP
VR191,,2005,1963,,7811634,144423932,33509842,,4872242,111151346,24650062,,2939392,33272586,8859780,PDP
VR191,,2006,1963,,7003475,143612044,32557219,,5338896,115556137,25900486,,1664579,28055907,6656733,PDP
VR191,,2007,1963,,6399301,135685349,30542602,,5626632,118282712,26673378,,772669,17402637,3869224,PDP
VR191,,2008,1963,,6479565,138098624,31052274,,5718303,118952222,26884179,,761262,19146402,4168095,PDP
VR191,,2009,1963,,6382855,132029786,29875696,,5781088,121437300,27389146,,601767,10592486,2486551,PDP
VR191,,2010,1963,,6382855,132029786,29875696,,5886445,122480512,27680129,,496410,9549274,2195570,PDP
VR191,,2011,1963,,7040122,136709852,31365717,,6122845,123763723,28144858,,917277,12946129,3220859,PDP
VR191,,2012,1963,,7040122,136709852,31365717,,6263136,124864523,28481021,,776986,11845329,2884696,PDP
VR191,,2013,1963,,7040122,136709852,31365717,,6358104,125676173,28720410,,682018,11033679,2645305,PDP
VR191,,2014,1963,,7040122,136709852,31365717,,6436130,126352894,28918849,,603992,10356958,2446867,PDP
VR191,,2015,1963,,7080195,136547075,31376826,,6492643,126930138,29078075,,587552,9616937,2298750,PDP
VR191,,2016,1963,,7172883,137749155,31683408,,6548911,127574719,29249038,,623972,10174436,2434370,PDP
VR191,,2017,1963,,7475407,144837692,33247237,,6637863,128575846,29516126,,837544,16261846,3731111,PDP
VR191,,2017,1963,,7475407,144837692,33247237,,6637863,128575846,29516126,,837544,16261846,3731111,PDP
VR193,,1975,1963,,809084,16819173,3801819,,524983,14723592,3144839,,284101,2095581,656980,PDN
VR193,,1976,1963,,860597,18894904,4222680,,580998,16946468,3596384,,279599,1948436,626296,PDN
VR193,,1977,1963,,2774107,21529521,6604983,,686865,15235235,3397761,,2087242,6294286,3207222,PDN
VR193,,1978,1963,,1679396,18993075,5058947,,705776,15258076,3420736,,973620,3734999,1638211,PDN
VR193,,1979,1963,,1679396,18993075,5058947,,705776,15258076,3420736,,973620,3734999,1638211,PDN
VR193,,1980,1963,,1686861,19449067,5147549,,718433,15629137,3499418,,968428,3819930,1648131,PDN
VR193,,1981,1963,,1946745,30083067,7299604,,730277,15820090,3545240,,1216468,14262977,3754364,PDN
VR193,,1982,1963,,2551396,31172513,8098106,,576594,17918102,3764868,,1974802,13254411,4333238,PDN
VR193,,1983,1963,,2584245,32898488,8438068,,581638,17992912,3783224,,2002607,14905576,4654844,PDN
VR193,,1984,1963,,3069520,42419716,10617512,,609171,18041788,3819454,,2460349,24377928,6798058,PDN
VR193,,1985,1963,,3287358,45931679,11460255,,680839,19052868,4071029,,2606519,26878811,7389226,PDN
VR193,,1986,1963,,4880567,54031170,14494654,,801903,19480419,4268170,,4078664,34550751,10226484,PDN
VR193,,1987,1963,,3669758,30499632,9096739,,827186,19899237,4367976,,2842572,10600395,4728763,PDN
VR193,,1988,1963,,2464838,28154028,7474452,,867268,20184376,4458794,,1597570,7969652,3015658,PDN
VR193,,1989,1963,,2380190,28443457,7441303,,888080,20441591,4525374,,1492110,8001866,2915929,PDN
VR193,,1990,1963,,2421801,30140790,7784931,,899950,20719298,4586658,,1521851,9421492,3198273,PDN
VR193,,1991,1963,,933451,22250744,4892658,,903975,20918821,4626185,,29476,1331923,266473,PDN
VR193,,1992,1963,,937884,22951228,5021732,,905716,21050648,4651383,,32168,1900580,370349,PDN
VR193,,1993,1963,,937884,22951228,5021732,,906131,21076600,4656416,,31753,1874628,365316,PDN
VR193,,1994,1963,,906131,21076600,4656416,,906131,21076600,4656416,,0,0,0,PDN
VR193,,1995,1963,,906131,21076600,4656416,,906131,21076600,4656416,,0,0,0,PDN
VR193,,1996,1963,,906131,21076600,4656416,,906131,21076600,4656416,,0,0,0,PDN
VR193,,1997,1963,,906131,21076600,4656416,,906131,21076600,4656416,,0,0,0,PDN
VR193,,1998,1963,,906131,21076600,4656416,,906131,21076600,4656416,,0,0,0,PDN
VR193,,1999,1963,,906129,21076600,4656414,,906129,21076600,4656414,,0,0,0,PDN
VR193,,2000,1963,,906129,21076600,4656414,,906129,21076600,4656414,,0,0,0,PDN
VR193,,2001,1963,,906129,21076600,4656414,,906129,21076600,4656414,,0,0,0,PDN
VR193,,2002,1963,,906129,21076600,4656414,,906129,21076600,4656414,,0,0,0,PDN
VR193,,2003,1963,,906129,21076600,4656414,,906129,21076600,4656414,,0,0,0,PDN
VR193,,2004,1963,,906129,21076600,4656414,,906129,21076600,4656414,,0,0,0,PDN
VR193,,2005,1963,,906129,21076600,4656414,,906129,21076600,4656414,,0,0,0,PDN
VR193,,2006,1963,,906129,21076600,4656414,,906129,21076600,4656414,,0,0,0,PDN
VR193,,2007,1963,,906129,21076600,4656414,,906129,21076600,4656414,,0,0,0,PDN
VR193,,2008,1963,,906129,21076600,4656414,,906129,21076600,4656414,,0,0,0,PDN
VR193,,2009,1963,,906129,21498705,4731520,,906129,21498705,4731520,,0,0,0,PDN
VR193,,2010,1963,,906129,21498705,4731520,,906129,21498705,4731520,,0,0,0,PDN
VR193,,2011,1963,,906129,21498705,4731520,,906129,21498705,4731520,,0,0,0,PDN
VR193,,2012,1963,,906129,21498705,4731520,,906129,21498705,4731520,,0,0,0,PDN
VR193,,2013,1963,,906129,21498705,4731520,,906129,21498705,4731520,,0,0,0,PDN
VR193,,2014,1963,,906129,21498705,4731520,,906129,21498705,4731520,,0,0,0,PDN
VR193,,2015,1963,,906129,21498705,4731520,,906129,21498705,4731520,,0,0,0,PDN
VR193,,2016,1963,,906129,21498705,4731520,,906129,21498705,4731520,,0,0,0,PDN
VR193,,2017,1963,,906129,21498705,4731520,,906129,21498705,4731520,,0,0,0,PDN
VR193,,2017,1963,,906129,21498705,4731520,,906129,21498705,4731520,,0,0,0,PDN
VR200,,1975,1969,,876941,3874493,1566353,,266330,831377,414262,,610611,3043116,1152091,PDN
VR200,,1976,1969,,876941,3874493,1566353,,293328,927901,458435,,583613,2946592,1107918,PDN
VR200,,1977,1969,,876941,3874493,1566353,,315956,1021508,497719,,560985,2852985,1068634,PDN
VR200,,1978,1969,,398892,3252960,977711,,326335,1064264,515706,,72557,2188696,462005,PDN
VR200,,1979,1969,,398892,3252960,977711,,326335,1064264,515706,,72557,2188696,462005,PDN
VR200,,1980,1969,,326335,1064264,515706,,326335,1064264,515706,,0,0,0,PDN
VR200,,1981,1969,,326335,1064264,515706,,326335,1064264,515706,,0,0,0,PDN
VR200,,1982,1969,,330182,1083072,522899,,330182,1083072,522899,,0,0,0,PDN
VR200,,1983,1969,,330182,1083072,522899,,330182,1083072,522899,,0,0,0,PDN
VR200,,1984,1969,,330182,1083072,522899,,330182,1083072,522899,,0,0,0,PDN
VR200,,1985,1969,,330182,1083072,522899,,330182,1083072,522899,,0,0,0,PDN
VR200,,1986,1969,,330182,1083072,522899,,330182,1083072,522899,,0,0,0,PDN
VR200,,1987,1969,,330182,1083072,522899,,330182,1083072,522899,,0,0,0,PDN
VR200,,1988,1969,,330182,1083072,522899,,330182,1083072,522899,,0,0,0,PDN
VR200,,1989,1969,,330182,1083072,522899,,330182,1083072,522899,,0,0,0,PDN
VR200,,1990,1969,,330182,1083072,522899,,330182,1083072,522899,,0,0,0,PDN
VR200,,1991,1969,,330182,1083072,522899,,330182,1083072,522899,,0,0,0,PDN
VR200,,1992,1969,,330182,1083072,522899,,330182,1083072,522899,,0,0,0,PDN
VR200,,1993,1969,,330182,1083072,522899,,330182,1083072,522899,,0,0,0,PDN
VR200,,1994,1969,,359775,8481308,1868905,,356401,1136958,558707,,3374,7344350,1310198,PDN
VR200,,1995,1969,,3774200,45591701,11886602,,879859,5238491,1811975,,2894341,40353210,10074627,PDN
VR200,,1996,1969,,3505420,54198202,13149228,,1064846,15437339,3811703,,2440574,38760863,9337525,PDN
VR200,,1997,1969,,1390000,39271955,8377892,,1190672,20586236,4853703,,199328,18685719,3524189,PDN
VR200,,1998,1969,,1354171,39359168,8357582,,1218086,23027962,5315588,,136085,16331206,3041994,PDN
VR200,,1999,1969,,1451512,44638766,9394352,,1258875,25214612,5745461,,192637,19424154,3648891,PDN
VR200,,2000,1969,,1399723,43805921,9194371,,1274672,27934386,6245203,,125051,15871535,2949168,PDN
VR200,,2001,1969,,1453999,42483302,9013305,,1318127,30688822,6778771,,135872,11794480,2234534,PDN
VR200,,2002,1969,,1405357,37488500,8075909,,1327547,31214919,6881803,,77810,6273581,1194106,PDN
VR200,,2003,1969,,1412417,34313597,7518039,,1331250,31543324,6943941,,81167,2770273,574098,PDN
VR200,,2004,1969,,1498918,34669289,7667830,,1370289,33189003,7275806,,128629,1480286,392024,PDN
VR200,,2005,1969,,1638730,35247612,7910547,,1398442,33457232,7351686,,240288,1790380,558861,PDN
VR200,,2006,1969,,1561956,35164753,7819029,,1439794,33551636,7409836,,122162,1613117,409193,PDN
VR200,,2007,1969,,1561956,35164753,7819029,,1465779,33682308,7459072,,96177,1482445,359957,PDN
VR200,,2008,1969,,1561956,35164753,7819029,,1476688,33764624,7484628,,85268,1400129,334401,PDN
VR200,,2009,1969,,1481634,34396874,7602074,,1477000,34256186,7572407,,4634,140688,29667,PDN
VR200,,2010,1969,,1481634,34396874,7602074,,1477322,34308798,7582090,,4312,88076,19984,PDN
VR200,,2011,1969,,1481634,34396874,7602074,,1481041,34393145,7600818,,593,3729,1257,PDN
VR200,,2012,1969,,1481634,34396874,7602074,,1481634,34396874,7602074,,0,0,0,PDN
VR200,,2013,1969,,1481634,34398312,7602330,,1481634,34398312,7602330,,0,0,0,PDN
VR200,,2014,1969,,1481634,34398312,7602330,,1481634,34398312,7602330,,0,0,0,PDN
VR200,,2015,1969,,1481634,34398312,7602330,,1481634,34398312,7602330,,0,0,0,PDN
VR200,,2016,1969,,1481634,34398312,7602330,,1481634,34398312,7602330,,0,0,0,PDN
VR200,,2017,1969,,1481634,34398312,7602330,,1481634,34398312,7602330,,0,0,0,PDN
VR200,,2017,1969,,1481634,34398312,7602330,,1481634,34398312,7602330,,0,0,0,PDN
VR202,,1993,1973,,59256,7801673,1447454,,0,0,0,,59256,7801673,1447454,PDN
VR202,,1994,1973,,96419,12694591,2355243,,0,0,0,,96419,12694591,2355243,PDN
VR202,,1995,1973,,42284,40474811,7244208,,16942,10773314,1933902,,25342,29701497,5310306,PDN
VR202,,1996,1973,,47650,22981262,4136843,,27358,16797473,3016232,,20292,6183789,1120611,PDN
VR202,,1997,1973,,33431,23749144,4259257,,28564,19111319,3429155,,4867,4637825,830102,PDN
VR202,,1998,1973,,33431,23749144,4259257,,28564,19613073,3518435,,4867,4136071,740822,PDN
VR202,,1999,1973,,32624,21642935,3883680,,28564,19613073,3518435,,4060,2029862,365245,PDN
VR202,,2000,1973,,32624,21642935,3883680,,28564,19613073,3518435,,4060,2029862,365245,PDN
VR202,,2001,1973,,32624,21642935,3883680,,28564,19613073,3518435,,4060,2029862,365245,PDN
VR202,,2002,1973,,32624,21642935,3883680,,28564,19613073,3518435,,4060,2029862,365245,PDN
VR202,,2003,1973,,32624,21642935,3883680,,28564,19613073,3518435,,4060,2029862,365245,PDN
VR202,,2004,1973,,32624,21642935,3883680,,28564,19613073,3518435,,4060,2029862,365245,PDN
VR202,,2005,1973,,28564,19613073,3518435,,28564,19613073,3518435,,0,0,0,PDN
VR202,,2006,1973,,28564,19613073,3518435,,28564,19613073,3518435,,0,0,0,PDN
VR202,,2007,1973,,28801,21978246,3939521,,28564,19613073,3518435,,237,2365173,421086,PDN
VR202,,2008,1973,,28801,21978246,3939521,,28564,19613073,3518435,,237,2365173,421086,PDN
VR202,,2009,1973,,29297,22476891,4028744,,28564,21682633,3886683,,733,794258,142060,PDN
VR202,,2010,1973,,28564,28340402,5071340,,28564,24721005,4427319,,0,3619397,644021,PDN
VR202,,2011,1973,,28564,28340402,5071340,,28564,25919674,4640605,,0,2420728,430734,PDN
VR202,,2012,1973,,28564,28340402,5071340,,28564,26812221,4799421,,0,1528181,271918,PDN
VR202,,2013,1973,,28564,26824096,4801534,,28564,26824096,4801534,,0,0,0,PDN
VR202,,2014,1973,,28564,26824096,4801534,,28564,26824096,4801534,,0,0,0,PDN
VR202,,2015,1973,,28564,26824096,4801534,,28564,26824096,4801534,,0,0,0,PDN
VR202,,2016,1973,,28564,26824096,4801534,,28564,26824096,4801534,,0,0,0,PDN
VR202,,2017,1973,,28564,26824096,4801534,,28564,26824096,4801534,,0,0,0,PDN
VR202,,2017,1973,,28564,26824096,4801534,,28564,26824096,4801534,,0,0,0,PDN
VR207,,2000,1991,,1840659,22087915,5770893,,0,0,0,,1840659,22087915,5770893,PDP
VR207,,2001,1991,,2988270,41049323,10292420,,214831,3319236,805442,,2773439,37730087,9486978,PDP
VR207,,2002,1991,,2987404,41035935,10289172,,310205,7733327,1686242,,2677199,33302608,8602930,PDP
VR207,,2003,1991,,4704234,50201904,13636957,,1010184,15264672,3726318,,3694050,34937232,9910639,PDP
VR207,,2004,1991,,3412275,35150611,9666832,,1868784,20508386,5517963,,1543491,14642225,4148869,PDP
VR207,,2005,1991,,3231354,34710148,9407537,,2337053,25086645,6800869,,894301,9623503,2606668,PDP
VR207,,2006,1991,,6229945,52885699,15640211,,2496282,26541364,7218945,,3733663,26344335,8421266,PDP
VR207,,2007,1991,,4328391,35094838,10573024,,2590026,26843225,7366401,,1738365,8251613,3206623,PDP
VR207,,2008,1991,,4328394,35074833,10569467,,2952907,27229522,7798018,,1375487,7845311,2771449,PDP
VR207,,2009,1991,,4394614,30097133,9749977,,3101582,27437795,7983752,,1293032,2659338,1766224,PDP
VR207,,2010,1991,,6222994,32291189,11968758,,3334529,27823327,8285298,,2888465,4467862,3683459,PDP
VR207,,2011,1991,,4808398,33081649,10694813,,3624518,29580168,8887893,,1183880,3501481,1806919,PDP
VR207,,2012,1991,,4808398,33081649,10694813,,3772746,31670999,9408155,,1035652,1410650,1286658,PDP
VR207,,2013,1991,,4808398,33081649,10694813,,4012993,31982935,9703906,,795405,1098714,990906,PDP
VR207,,2014,1991,,4808398,33081649,10694813,,4125234,32114518,9839561,,683164,967131,855251,PDP
VR207,,2015,1991,,4808398,33081649,10694813,,4177166,32176149,9902460,,631232,905500,792353,PDP
VR207,,2016,1991,,4808398,33081649,10694813,,4223117,32241162,9959979,,585281,840487,734834,PDP
VR207,,2017,1991,,4808398,33081649,10694813,,4258514,32278043,10001938,,549884,803606,692875,PDP
VR207,,2017,1991,,4808398,33081649,10694813,,4258514,32278043,10001938,,549884,803606,692875,PDP
VR214,,1975,1971,,11458290,27444634,16341677,,1222754,3530881,1851025,,10235536,23913753,14490652,PDP
VR214,,1976,1971,,11458290,27444634,16341677,,3432231,10814456,5356511,,8026059,16630178,10985166,PDP
VR214,,1977,1971,,16144412,62648393,27291813,,5526149,19036658,8913455,,10618263,43611735,18378358,PDP
VR214,,1978,1971,,17609813,83676091,32498797,,7749762,29950309,13078998,,9860051,53725782,19419799,PDP
VR214,,1979,1971,,17609813,83676091,32498797,,9512461,39290642,16503678,,8097352,44385449,15995119,PDP
VR214,,1980,1971,,19684528,87772027,35302326,,10923997,44727189,18882572,,8760531,43044838,16419754,PDP
VR214,,1981,1971,,19684528,87772027,35302326,,12201123,51416113,21349898,,7483405,36355914,13952428,PDP
VR214,,1982,1971,,22045176,97231418,39346140,,13384972,57083450,23542170,,8660204,40147968,15803970,PDP
VR214,,1983,1971,,22131466,104164922,40666150,,14196135,61861848,25203581,,7935331,42303074,15462569,PDP
VR214,,1984,1971,,23072924,109074189,42481143,,14846857,65743116,26544920,,8226067,43331073,15936223,PDP
VR214,,1985,1971,,24100116,112466974,44112033,,15452041,68882531,27708719,,8648075,43584443,16403314,PDP
VR214,,1986,1971,,24321897,115466932,44867614,,16008712,71656098,28758907,,8313185,43810834,16108707,PDP
VR214,,1987,1971,,25281897,114894772,45725807,,16641091,75188184,30019771,,8640806,39706588,15706036,PDP
VR214,,1988,1971,,24957091,121159171,46515662,,17176428,79567514,31334349,,7780663,41591657,15181313,PDP
VR214,,1989,1971,,21042278,132097818,44547228,,17573995,83155918,32370422,,3468283,48941900,12176806,PDP
VR214,,1990,1971,,21057982,132737353,44676728,,17841542,86519583,33236486,,3216440,46217770,11440242,PDP
VR214,,1991,1971,,21144597,134901513,45148425,,18226154,90239497,34283004,,2918443,44662016,10865421,PDP
VR214,,1992,1971,,20850502,126914304,43433118,,18617881,94570429,35445359,,2232621,32343875,7987759,PDP
VR214,,1993,1971,,20893255,130040337,44032105,,18968579,99026592,36588969,,1924676,31013745,7443136,PDP
VR214,,1994,1971,,20892731,130040090,44031537,,19223071,102530079,37466857,,1669660,27510011,6564680,PDP
VR214,,1995,1971,,21098949,138066427,45665929,,19442258,106270117,38351531,,1656691,31796310,7314398,PDP
VR214,,1996,1971,,25735143,156649834,53608779,,19695189,110966567,39440130,,6039954,45683267,14168649,PDP
VR214,,1997,1971,,25973064,151136323,52865648,,21020363,120607069,42480696,,4952701,30529254,10384952,PDP
VR214,,1998,1971,,26959171,164477761,56225677,,22806423,134581584,46753324,,4152748,29896177,9472353,PDP
VR214,,1999,1971,,28458728,178553252,60229769,,24013784,143328658,49517104,,4444944,35224594,10712665,PDP
VR214,,2000,1971,,28896010,183885564,61615861,,25502134,154933008,53070285,,3393876,28952556,8545576,PDP
VR214,,2001,1971,,32203620,179377096,64121252,,26673894,159322385,55023073,,5529726,20054711,9098179,PDP
VR214,,2002,1971,,31520084,177554231,63113363,,27192694,161751393,55974081,,4327390,15802838,7139282,PDP
VR214,,2003,1971,,30557929,182578363,63045182,,27630223,163994858,56810803,,2927706,18583505,6234379,PDP
VR214,,2004,1971,,29967046,177681164,61582912,,28157806,166780463,57834045,,1809240,10900701,3748867,PDP
VR214,,2005,1971,,30455362,179695703,62429687,,28445570,168479325,58424098,,2009792,11216378,4005589,PDP
VR214,,2006,1971,,30361333,182484529,62831890,,28751681,170326787,59058938,,1609652,12157742,3772952,PDP
VR214,,2007,1971,,30503931,182322189,62945602,,29056884,171854977,59636061,,1447047,10467212,3309541,PDP
VR214,,2008,1971,,31465939,197938222,66686264,,29272253,172979528,60051528,,2193686,24958694,6634736,PDP
VR214,,2009,1971,,31268307,196507978,66234138,,29714558,177839468,61358590,,1553749,18668510,4875547,PDP
VR214,,2010,1971,,31284064,196907581,66320999,,30130095,181497374,62425001,,1153969,15410207,3896000,PDP
VR214,,2011,1971,,31729922,205107277,68225878,,30413551,183734890,63106591,,1316371,21372387,5119285,PDP
VR214,,2012,1971,,31729922,205107277,68225878,,30493007,183826108,63202277,,1236915,21281169,5023598,PDP
VR214,,2013,1971,,32100135,208814155,69255677,,30783888,186834456,64028453,,1316247,21979699,5227225,PDP
VR214,,2014,1971,,32100135,208814155,69255677,,31097239,190644143,65019683,,1002896,18170012,4235993,PDP
VR214,,2015,1971,,32100135,208814155,69255677,,31392071,193094913,65750595,,708064,15719242,3505082,PDP
VR214,,2016,1971,,32627363,212215835,70388186,,31612421,195442343,66388638,,1014942,16773492,3999549,PDP
VR214,,2017,1971,,32737116,220225749,71923193,,31893285,199028009,67307522,,843831,21197740,4615670,PDP
VR214,,2017,1971,,32737116,220225749,71923193,,31893285,199028009,67307522,,843831,21197740,4615670,PDP
VR215,,1975,1963,,12000000,84996000,27123843,,5122040,50423431,14094181,,6877960,34572569,13029662,PDP
VR215,,1976,1963,,16557992,157873513,44649364,,5186824,59035628,15691384,,11371168,98837885,28957980,PDP
VR215,,1977,1963,,22109949,183518109,54764417,,5893631,64222823,17321180,,16216318,119295286,37443237,PDP
VR215,,1978,1963,,22732631,183518109,55387099,,6501805,78874293,20536377,,16230826,104643816,34850722,PDP
VR215,,1979,1963,,19387231,183518109,52041699,,6123959,90729441,22267988,,13263272,92788668,29773711,PDP
VR215,,1980,1963,,20417452,201094109,56199322,,6389080,98791990,23967726,,14028372,102302119,32231596,PDP
VR215,,1981,1963,,17046734,206281504,53751628,,7441128,102569046,25691848,,9605606,103712458,28059780,PDP
VR215,,1982,1963,,16524241,206679479,53299949,,7594366,104347800,26161590,,8929875,102331679,27138359,PDP
VR215,,1983,1963,,16642271,208032789,53658781,,7656873,106091240,26534318,,8985398,101941549,27124463,PDP
VR215,,1984,1963,,16687775,216112788,55142008,,7743217,109257606,27184072,,8944558,106855182,27957936,PDP
VR215,,1985,1963,,16693041,216349769,55189441,,7809920,111169150,27590908,,8883121,105180619,27598533,PDP
VR215,,1986,1963,,16705842,216925788,55304737,,7891916,112102735,27839022,,8813926,104823053,27465715,PDP
VR215,,1987,1963,,11035438,157284610,39022023,,8069106,114558278,28453141,,2966332,42726332,10568882,PDP
VR215,,1988,1963,,11035438,157284610,39022023,,8169395,116961953,28981130,,2866043,40322657,10040893,PDP
VR215,,1989,1963,,11035438,157284610,39022023,,8259837,119580928,29537582,,2775601,37703682,9484441,PDP
VR215,,1990,1963,,9860734,161459716,38590221,,8331621,122659922,30157230,,1529113,38799794,8432991,PDP
VR215,,1991,1963,,10129676,169145740,40226783,,8428310,125320966,30727414,,1701366,43824774,9499369,PDP
VR215,,1992,1963,,10574622,163629497,39690191,,8669502,126810049,31233568,,1905120,36819448,8456623,PDP
VR215,,1993,1963,,10134071,147936607,36457311,,8958734,130268292,32138145,,1175337,17668315,4319166,PDP
VR215,,1994,1963,,10284422,150325123,37032665,,9383626,136794367,33724261,,900796,13530756,3308404,PDP
VR215,,1995,1963,,10723650,154803885,38268825,,9755274,141487408,34930969,,968376,13316477,3337856,PDP
VR215,,1996,1963,,10666637,152629002,37824822,,10131470,144091788,35770578,,535167,8537214,2054244,PDP
VR215,,1997,1963,,13923768,179588888,45879086,,11539125,155925058,39283797,,2384643,23663830,6595289,PDP
VR215,,1998,1963,,15058621,176592857,46480838,,12540648,160494768,41098436,,2517973,16098089,5382402,PDP
VR215,,1999,1963,,14987734,167607028,44811049,,13063941,161933570,41877743,,1923793,5673458,2933306,PDP
VR215,,2000,1963,,15277744,176783859,46733947,,13382094,163496343,42473970,,1895650,13287516,4259977,PDP
VR215,,2001,1963,,15497956,168348934,45453283,,13997992,164292539,43231540,,1499964,4056395,2221743,PDP
VR215,,2002,1963,,16074377,171294162,46553766,,14451928,164878127,43789673,,1622449,6416035,2764093,PDP
VR215,,2003,1963,,16035500,172155193,46668097,,15014339,165386689,44442575,,1021161,6768504,2225522,PDP
VR215,,2004,1963,,17434697,171807779,48005476,,15490091,166073694,45040570,,1944606,5734085,2964906,PDP
VR215,,2005,1963,,17434697,172319413,48096514,,15765046,166281321,45352470,,1669651,6038092,2744044,PDP
VR215,,2006,1963,,18533850,174446335,49574123,,15790025,166308430,45382272,,2743825,8137905,4191851,PDP
VR215,,2007,1963,,17926396,172902681,48691997,,16208935,166987949,45922093,,1717461,5914732,2769904,PDP
VR215,,2008,1963,,17968926,174880911,49086526,,16454854,167455518,46251210,,1514072,7425393,2835316,PDP
VR215,,2009,1963,,17753481,180709561,49908213,,16714317,171860782,47294532,,1039164,8848779,2613680,PDP
VR215,,2010,1963,,17753481,180709561,49908213,,16908041,173209667,47728271,,845440,7499894,2179941,PDP
VR215,,2011,1963,,17753481,180709561,49908213,,17105242,174507079,48156328,,648239,6202482,1751884,PDP
VR215,,2012,1963,,17889005,180819083,50063224,,17272131,175709989,48537257,,616874,5109094,1525966,PDP
VR215,,2013,1963,,17889005,180819083,50063224,,17414433,176523666,48824342,,474572,4295417,1238881,PDP
VR215,,2014,1963,,17889005,180819083,50063224,,17521608,176940716,49005725,,367397,3878367,1057498,PDP
VR215,,2015,1963,,17889005,180819083,50063224,,17619570,177259311,49160376,,269435,3559772,902847,PDP
VR215,,2016,1963,,18203710,180768306,50368894,,17738426,177599981,49339851,,465284,3168325,1029043,PDP
VR215,,2017,1963,,18203710,180855137,50384344,,17854845,177967390,49521645,,348865,2887747,862700,PDP
VR215,,2017,1963,,18203710,180855137,50384344,,17854845,177967390,49521645,,348865,2887747,862700,PDP
VR218,,1975,1965,,2000000,40000000,9117438,,223619,12386953,2427703,,1776381,27613047,6689735,PDN
VR218,,1976,1965,,1000000,20000000,4558719,,242473,13666337,2674206,,757527,6333663,1884513,PDN
VR218,,1977,1965,,1000000,20000000,4558719,,256784,15311427,2981237,,743216,4688573,1577482,PDN
VR218,,1978,1965,,3073347,72786223,16024632,,272496,15399816,3012677,,2800851,57386407,13011955,PDN
VR218,,1979,1965,,3073347,72786223,16024632,,427384,17198109,3487546,,2645963,55588114,12537086,PDN
VR218,,1980,1965,,3348748,72957039,16330428,,584706,19626463,4076959,,2764042,53330576,12253469,PDN
VR218,,1981,1965,,3348748,72957039,16330428,,665148,20716583,4351373,,2683600,52240456,11979055,PDN
VR218,,1982,1965,,3435898,75373291,16847516,,700880,21258759,4483577,,2735018,54114532,12363939,PDN
VR218,,1983,1965,,3633820,89832825,19618308,,794100,23348287,4948599,,2839720,66484538,14669709,PDN
VR218,,1984,1965,,4272685,93456691,20901989,,1123313,39043428,8070542,,3149372,54413263,12831447,PDN
VR218,,1985,1965,,4506570,107636704,23659008,,1320653,53448058,10830984,,3185917,54188646,12828024,PDN
VR218,,1986,1965,,4508330,125324153,26808001,,1375642,57684061,11639710,,3132688,67640092,15168291,PDN
VR218,,1987,1965,,5585535,184919437,38489349,,1992809,104200188,20533768,,3592726,80719249,17955581,PDN
VR218,,1988,1965,,7008548,335030412,66622500,,2702248,170362994,33015948,,4306300,164667418,33606552,PDN
VR218,,1989,1965,,4757912,425519486,80473123,,3313962,236567141,45407759,,1443950,188952345,35065364,PDN
VR218,,1990,1965,,5629442,447442705,85245582,,3687742,293270587,55871120,,1941700,154172118,29374462,PDN
VR218,,1991,1965,,5587870,450931444,85824782,,3878469,335235364,63528890,,1709401,115696080,22295892,PDN
VR218,,1992,1965,,5786316,469548495,89335870,,4004201,359201424,67919045,,1782115,110347071,21416825,PDN
VR218,,1993,1965,,5174675,489250649,92229951,,4164756,384640932,72606203,,1009919,104609717,19623748,PDN
VR218,,1994,1965,,5480744,497512075,94006024,,4339300,400014523,75516261,,1141444,97497552,18489763,PDN
VR218,,1995,1965,,5410556,471993036,89395082,,4473338,415421486,78391752,,937218,56571550,11003330,PDN
VR218,,1996,1965,,6398555,526621559,100103459,,4976766,433033545,82028998,,1421789,93588014,18074461,PDN
VR218,,1997,1965,,6484961,478513017,91629626,,5515801,440999504,83985464,,969160,37513513,7644162,PDN
VR218,,1998,1965,,6482999,477367896,91423906,,6091769,444154846,85122880,,391230,33213050,6301026,PDN
VR218,,1999,1965,,7989116,463504886,90463295,,6357956,447135992,85919520,,1631160,16368894,4543775,PDN
VR218,,2000,1965,,10395859,474760795,94872869,,6640541,449469454,86617312,,3755318,25291341,8255557,PDN
VR218,,2001,1965,,9084581,477592625,94065476,,6739805,452469370,87250369,,2344776,25123255,6815107,PDN
VR218,,2002,1965,,9127919,482945586,95061298,,6776482,455157083,87765287,,2351437,27788503,7296011,PDN
VR218,,2003,1965,,9245165,493600835,97074496,,6825512,458911219,88482313,,2419653,34689616,8592183,PDN
VR218,,2004,1965,,7725278,490452667,94994436,,6864438,461837531,89041935,,860840,28615136,5952501,PDN
VR218,,2005,1965,,7580793,491831904,95095367,,6914575,466820144,89978658,,666218,25011760,5116709,PDN
VR218,,2006,1965,,7917261,527157767,101717575,,6923346,467704441,90144777,,993915,59453326,11572798,PDN
VR218,,2007,1965,,7687872,517336860,99740694,,6901609,465201954,89677757,,786263,52134906,10062937,PDN
VR218,,2008,1965,,7687874,517338274,99740948,,7002030,480281746,92461415,,685844,37056528,7279533,PDN
VR218,,2009,1965,,7043124,499831626,95981133,,7016089,491564134,94483014,,27035,8267492,1498118,PDN
VR218,,2010,1965,,7043124,499831626,95981133,,7020138,492576811,94667254,,22986,7254815,1313877,PDN
VR218,,2011,1965,,7045514,499625811,95946901,,7021243,492977778,94739706,,24271,6648033,1207194,PDN
VR218,,2012,1965,,7045514,499625811,95946901,,7022329,493438969,94822854,,23185,6186842,1124047,PDN
VR218,,2013,1965,,7045514,499625811,95946901,,7022542,493637454,94858385,,22972,5988357,1088517,PDN
VR218,,2014,1965,,7045514,499625811,95946901,,7022753,493798955,94887333,,22761,5826856,1059569,PDN
VR218,,2015,1965,,7022753,493799279,94887391,,7022753,493799279,94887391,,0,0,0,PDN
VR218,,2016,1965,,7022753,493799279,94887391,,7022753,493799279,94887391,,0,0,0,PDN
VR218,,2017,1965,,7022753,493799279,94887391,,7022753,493799279,94887391,,0,0,0,PDN
VR218,,2017,1965,,7022753,493799279,94887391,,7022753,493799279,94887391,,0,0,0,PDN
VR221,,1983,1981,,8522,85210343,15170505,,0,0,0,,8522,85210343,15170505,PDN
VR221,,1984,1981,,8522,85210343,15170505,,0,0,0,,8522,85210343,15170505,PDN
VR221,,1985,1981,,37646,85210343,15199629,,15496,16739406,2994038,,22150,68470937,12205591,PDN
VR221,,1986,1981,,71713,88773743,15867753,,38382,43430542,7766236,,33331,45343201,8101517,PDN
VR221,,1987,1981,,88547,111511822,19930508,,62099,74028807,13234485,,26448,37483015,6696023,PDN
VR221,,1988,1981,,142509,181254256,32394156,,85878,105921916,18933194,,56631,75332340,13460962,PDN
VR221,,1989,1981,,160172,211396066,37775130,,101576,133708718,23893163,,58596,77687348,13881967,PDN
VR221,,1990,1981,,160172,211396066,37775130,,110085,153150150,27361001,,50087,58245916,10414129,PDN
VR221,,1991,1981,,160172,211396066,37775130,,115089,166519916,29744967,,45083,44876150,8030163,PDN
VR221,,1992,1981,,133558,221776341,39595540,,118206,175993543,31433783,,15352,45782798,8161757,PDN
VR221,,1993,1981,,137151,221776341,39599133,,120941,184710142,32987514,,16210,37066199,6611619,PDN
VR221,,1994,1981,,170170,230031149,41100979,,134771,195066958,34844194,,35399,34964191,6256785,PDN
VR221,,1995,1981,,219682,240285960,42975191,,185844,212106031,37927131,,33838,28179929,5048060,PDN
VR221,,1996,1981,,211431,237558539,42481634,,202541,220400457,39419704,,8890,17158082,3061930,PDN
VR221,,1997,1981,,211064,247319131,44218027,,204289,225176023,40271197,,6775,22143108,3946830,PDN
VR221,,1998,1981,,211064,247319131,44218027,,205595,226610982,40527834,,5469,20708149,3690193,PDN
VR221,,1999,1981,,206538,235063095,42032711,,205682,228151555,40802044,,856,6911540,1230667,PDN
VR221,,2000,1981,,206469,235063095,42032642,,205693,228914895,40937881,,776,6148200,1094761,PDN
VR221,,2001,1981,,206010,236913538,42361444,,205693,229390561,41022519,,317,7522977,1338925,PDN
VR221,,2002,1981,,207392,234893738,42003431,,205939,230266568,41178638,,1453,4627170,824793,PDN
VR221,,2003,1981,,206657,232514388,41579324,,206096,231086659,41324719,,561,1427729,254605,PDN
VR221,,2004,1981,,206677,232957828,41658248,,206263,231677206,41429965,,414,1280622,228283,PDN
VR221,,2005,1981,,206268,231803814,41452498,,206268,231803814,41452498,,0,0,0,PDN
VR221,,2006,1981,,206268,231803814,41452498,,206268,231803814,41452498,,0,0,0,PDN
VR221,,2007,1981,,206268,231803814,41452498,,206268,231803814,41452498,,0,0,0,PDN
VR221,,2008,1981,,206268,231803814,41452498,,206268,231803814,41452498,,0,0,0,PDN
VR221,,2009,1981,,206268,236336812,42259081,,206268,236336812,42259081,,0,0,0,PDN
VR221,,2010,1981,,206268,236336812,42259081,,206268,236336812,42259081,,0,0,0,PDN
VR221,,2011,1981,,206268,236336812,42259081,,206268,236336812,42259081,,0,0,0,PDN
VR221,,2012,1981,,206268,236336812,42259081,,206268,236336812,42259081,,0,0,0,PDN
VR221,,2013,1981,,206268,236336812,42259081,,206268,236336812,42259081,,0,0,0,PDN
VR221,,2014,1981,,206268,236336812,42259081,,206268,236336812,42259081,,0,0,0,PDN
VR221,,2015,1981,,206268,236336812,42259081,,206268,236336812,42259081,,0,0,0,PDN
VR221,,2016,1981,,206268,236336812,42259081,,206268,236336812,42259081,,0,0,0,PDN
VR221,,2017,1981,,206268,236336812,42259081,,206268,236336812,42259081,,0,0,0,PDN
VR221,,2017,1981,,206268,236336812,42259081,,206268,236336812,42259081,,0,0,0,PDN
VR223,,1986,1984,,17394,5218285,945914,,0,0,0,,17394,5218285,945914,PDN
VR223,,1987,1984,,17394,5218285,945914,,0,0,0,,17394,5218285,945914,PDN
VR223,,1988,1984,,60719,18215568,3301923,,0,531832,94632,,60719,17683736,3207291,PDN
VR223,,1989,1984,,60719,18215568,3301923,,236,5148993,916427,,60483,13066575,2385496,PDN
VR223,,1990,1984,,60719,18215568,3301923,,617,7887516,1404090,,60102,10328052,1897833,PDN
VR223,,1991,1984,,633,7928579,1411412,,633,7928579,1411412,,0,0,0,PDN
VR223,,1992,1984,,633,7928579,1411412,,633,7928579,1411412,,0,0,0,PDN
VR223,,1993,1984,,633,7928579,1411412,,633,7928579,1411412,,0,0,0,PDN
VR223,,1994,1984,,633,7928579,1411412,,633,7928579,1411412,,0,0,0,PDN
VR223,,1995,1984,,633,7928579,1411412,,633,7928579,1411412,,0,0,0,PDN
VR223,,1996,1984,,633,7928579,1411412,,633,7928579,1411412,,0,0,0,PDN
VR223,,1997,1984,,633,7928579,1411412,,633,7928579,1411412,,0,0,0,PDN
VR223,,1998,1984,,633,7928579,1411412,,633,7928579,1411412,,0,0,0,PDN
VR223,,1999,1984,,633,7928579,1411412,,633,7928579,1411412,,0,0,0,PDN
VR223,,2000,1984,,633,7928579,1411412,,633,7928579,1411412,,0,0,0,PDN
VR223,,2001,1984,,633,7928579,1411412,,633,7928579,1411412,,0,0,0,PDN
VR223,,2002,1984,,633,7928579,1411412,,633,7928579,1411412,,0,0,0,PDN
VR223,,2003,1984,,633,7928579,1411412,,633,7928579,1411412,,0,0,0,PDN
VR223,,2004,1984,,633,7928579,1411412,,633,7928579,1411412,,0,0,0,PDN
VR223,,2005,1984,,633,7928579,1411412,,633,7928579,1411412,,0,0,0,PDN
VR223,,2006,1984,,633,7928579,1411412,,633,7928579,1411412,,0,0,0,PDN
VR223,,2007,1984,,633,7928579,1411412,,633,7928579,1411412,,0,0,0,PDN
VR223,,2008,1984,,633,7928579,1411412,,633,7928579,1411412,,0,0,0,PDN
VR223,,2009,1984,,633,8087366,1439666,,633,8087366,1439666,,0,0,0,PDN
VR223,,2010,1984,,633,8087366,1439666,,633,8087366,1439666,,0,0,0,PDN
VR223,,2011,1984,,633,8087366,1439666,,633,8087366,1439666,,0,0,0,PDN
VR223,,2012,1984,,633,8087366,1439666,,633,8087366,1439666,,0,0,0,PDN
VR223,,2013,1984,,633,8087366,1439666,,633,8087366,1439666,,0,0,0,PDN
VR223,,2014,1984,,633,8087366,1439666,,633,8087366,1439666,,0,0,0,PDN
VR223,,2015,1984,,633,8087366,1439666,,633,8087366,1439666,,0,0,0,PDN
VR223,,2016,1984,,633,8087366,1439666,,633,8087366,1439666,,0,0,0,PDN
VR223,,2017,1984,,633,8087366,1439666,,633,8087366,1439666,,0,0,0,PDN
VR223,,2017,1984,,633,8087366,1439666,,633,8087366,1439666,,0,0,0,PDN
VR245,,1975,1962,,36552921,288700745,87923160,,23651817,109434242,43124102,,12901104,179266503,44799058,PDP
VR245,,1976,1962,,36552921,288700745,87923160,,25489280,144747737,51245105,,11063641,143953008,36678055,PDP
VR245,,1977,1962,,40142700,334736438,99704344,,26996771,172145501,57627643,,13145929,162590937,42076701,PDP
VR245,,1978,1962,,42847736,335856432,102608667,,27976221,186669687,61191468,,14871515,149186745,41417199,PDP
VR245,,1979,1962,,42847736,335856432,102608667,,29023521,198335269,64314494,,13824215,137521163,38294173,PDP
VR245,,1980,1962,,47113829,372873796,113461480,,29965903,213114346,67886605,,17147926,159759450,45574875,PDP
VR245,,1981,1962,,47113829,372873796,113461480,,31182274,235877402,73153342,,15931555,136996394,40308138,PDP
VR245,,1982,1962,,51141759,400313076,122371844,,34209712,260079835,80487263,,16932047,140233241,41884581,PDP
VR245,,1983,1962,,57711865,444483804,136801510,,34906591,273817461,83628559,,22805274,170666343,53172951,PDP
VR245,,1984,1962,,58962163,449236234,138897436,,35747788,285038479,86466379,,23214375,164197755,52431057,PDP
VR245,,1985,1962,,59164910,451521898,139506885,,36357371,293269012,88540469,,22807539,158252886,50966416,PDP
VR245,,1986,1962,,58799464,465684515,141661477,,36836090,301959822,90565596,,21963374,163724693,51095881,PDP
VR245,,1987,1962,,59008658,472149515,143021027,,38025043,310801990,93327888,,20983615,161347525,49693139,PDP
VR245,,1988,1962,,59004080,475141264,143548789,,39335865,318337775,95979597,,19668215,156803489,47569192,PDP
VR245,,1989,1962,,44854439,411482717,118072004,,40308845,330868713,99182281,,4545594,80614004,18889723,PDP
VR245,,1990,1962,,44878659,422860805,120120795,,41131785,348525454,103146990,,3746874,74335351,16973805,PDP
VR245,,1991,1962,,45183435,438873828,123274863,,41807520,367050351,107118970,,3375915,71823477,16155893,PDP
VR245,,1992,1962,,46115737,453234370,126762422,,42459137,382484953,110516958,,3656600,70749417,16245464,PDP
VR245,,1993,1962,,46258083,455398281,127289806,,43030201,394226057,113177186,,3227882,61172224,14112620,PDP
VR245,,1994,1962,,46336878,463498726,128809961,,43543856,404758566,115564953,,2793022,58740160,13245008,PDP
VR245,,1995,1962,,46327741,465051417,129077103,,43904012,411090386,117051768,,2423729,53961031,12025335,PDP
VR245,,1996,1962,,52331913,531145371,146841765,,44241738,418000297,118619015,,8090175,113145074,28222750,PDP
VR245,,1997,1962,,45308381,462686922,127637015,,44531448,434002593,121756109,,776933,28684329,5880906,PDP
VR245,,1998,1962,,45390498,462803027,127739791,,44727755,441400523,123268773,,662743,21402504,4471018,PDP
VR245,,1999,1962,,45703802,461829825,127879927,,44974642,445285232,124206890,,729160,16544593,3673037,PDP
VR245,,2000,1962,,46030817,470887300,129818593,,45179637,450215629,125289180,,851180,20671671,4529413,PDP
VR245,,2001,1962,,46601258,468374134,129941852,,45440486,455348248,126463306,,1160772,13025886,3478546,PDP
VR245,,2002,1962,,46689848,472537600,130771272,,45669721,458454398,127245237,,1020127,14083202,3526035,PDP
VR245,,2003,1962,,46749352,486992077,133402746,,45790096,460196130,127675528,,959256,26795947,5727218,PDP
VR245,,2004,1962,,46449363,492797864,134135816,,45972243,464345421,128595983,,477120,28452443,5539833,PDP
VR245,,2005,1962,,46480237,506205057,136552311,,46079183,471865339,130040987,,401054,34339718,6511324,PDP
VR245,,2006,1962,,47189199,524803469,140570599,,46082448,478389453,131205126,,1106751,46414016,9365473,PDP
VR245,,2007,1962,,47153364,515341867,138851206,,46163208,485401569,132533594,,990156,29940298,6317612,PDP
VR245,,2008,1962,,47817699,509736515,138518147,,39906274,480026980,125320327,,7911425,29709535,13197820,PDP
VR245,,2009,1962,,47618582,523853701,140830983,,46590314,501682546,135857671,,1028268,22171155,4973313,PDP
VR245,,2010,1962,,48004756,539326123,143970257,,46776189,502573187,136202023,,1228567,36752936,7768236,PDP
VR245,,2011,1962,,48815814,528573583,142868055,,47040652,505406424,136970621,,1775162,23167159,5897428,PDP
VR245,,2012,1962,,49118924,536884588,144649991,,47550729,512783372,138793324,,1568195,24101216,5856664,PDP
VR245,,2013,1962,,49190346,548219129,146738234,,47889615,519271602,140286697,,1300731,28947527,6451534,PDP
VR245,,2014,1962,,48917662,555374253,147738704,,48088962,523726576,141278748,,828700,31647677,6459957,PDP
VR245,,2015,1962,,48964105,553638160,147476233,,48307919,527536386,142175606,,656186,26101774,5300628,PDP
VR245,,2016,1962,,49370429,556348247,148364779,,48508211,530927575,142979312,,862218,25420672,5385470,PDP
VR245,,2017,1962,,49290814,556280971,148273193,,48624935,532943741,143454784,,665879,23337230,4818409,PDP
VR245,,2017,1962,,49290814,556280971,148273193,,48624935,532943741,143454784,,665879,23337230,4818409,PDP
VR249,,1990,1988,,0,10967735,1951554,,0,420492,74821,,0,10547243,1876733,PDN
VR249,,1991,1988,,0,10967735,1951554,,0,2735898,486815,,0,8231837,1464739,PDN
VR249,,1992,1988,,0,10967735,1951554,,0,5014564,892271,,0,5953171,1059283,PDN
VR249,,1993,1988,,0,10967735,1951554,,0,7419070,1320119,,0,3548665,631435,PDN
VR249,,1994,1988,,0,11567390,2058254,,0,8574380,1525690,,0,2993010,532564,PDN
VR249,,1995,1988,,0,12335077,2194854,,0,8920011,1587191,,0,3415066,607663,PDN
VR249,,1996,1988,,0,12335077,2194854,,0,9181407,1633702,,0,3153670,561152,PDN
VR249,,1997,1988,,0,12335077,2194854,,0,9181805,1633773,,0,3153272,561081,PDN
VR249,,1998,1988,,0,12335077,2194854,,0,11042339,1964829,,0,1292738,230025,PDN
VR249,,1999,1988,,0,25184453,4481219,,0,14584299,2595071,,0,10600154,1886148,PDN
VR249,,2000,1988,,0,25184453,4481219,,0,17628448,3136735,,0,7556005,1344484,PDN
VR249,,2001,1988,,0,37462836,6665985,,0,25620947,4558887,,0,11841889,2107098,PDN
VR249,,2002,1988,,0,44550338,7927106,,0,32387173,5762842,,0,12163165,2164264,PDN
VR249,,2003,1988,,0,35447930,6307461,,0,34833669,6198162,,0,614261,109299,PDN
VR249,,2004,1988,,0,35447930,6307461,,0,35447930,6307461,,0,0,0,PDN
VR249,,2005,1988,,0,35447930,6307461,,0,35447930,6307461,,0,0,0,PDN
VR249,,2006,1988,,0,35447930,6307461,,0,35447930,6307461,,0,0,0,PDN
VR249,,2007,1988,,0,35447930,6307461,,0,35447930,6307461,,0,0,0,PDN
VR249,,2008,1988,,0,35447930,6307461,,0,35447930,6307461,,0,0,0,PDN
VR249,,2009,1988,,0,35650766,6343552,,0,35650766,6343552,,0,0,0,PDN
VR249,,2010,1988,,0,35650766,6343552,,0,35650766,6343552,,0,0,0,PDN
VR249,,2011,1988,,0,35650766,6343552,,0,35650766,6343552,,0,0,0,PDN
VR249,,2012,1988,,0,35650766,6343552,,0,35650766,6343552,,0,0,0,PDN
VR249,,2013,1988,,0,35650766,6343552,,0,35650766,6343552,,0,0,0,PDN
VR249,,2014,1988,,0,35650766,6343552,,0,35650766,6343552,,0,0,0,PDN
VR249,,2015,1988,,0,35650766,6343552,,0,35650766,6343552,,0,0,0,PDN
VR249,,2016,1988,,0,35650766,6343552,,0,35650766,6343552,,0,0,0,PDN
VR249,,2017,1988,,0,35650766,6343552,,0,35650766,6343552,,0,0,0,PDN
VR249,,2017,1988,,0,35650766,6343552,,0,35650766,6343552,,0,0,0,PDN
VR250,,1975,1963,,9454737,247823624,53551467,,5334107,129811027,28432155,,4120630,118012597,25119312,PDN
VR250,,1976,1963,,9454737,247823624,53551467,,6253973,162632507,35192142,,3200764,85191117,18359325,PDN
VR250,,1977,1963,,10820762,287064084,61899781,,6894927,187110708,40188647,,3925835,99953376,21711134,PDN
VR250,,1978,1963,,10820762,287064084,61899781,,7377378,206482218,44117986,,3443384,80581866,17781795,PDN
VR250,,1979,1963,,9635762,302064084,63383820,,7226611,220637825,46486010,,2409151,81426259,16897810,PDN
VR250,,1980,1963,,9634642,302055284,63381134,,7450516,230972259,48548783,,2184126,71083025,14832351,PDN
VR250,,1981,1963,,9634642,302055284,63381134,,7948002,246416318,51794322,,1686640,55638966,11586812,PDN
VR250,,1982,1963,,9961737,308443715,64844960,,8686580,268894187,56532521,,1275157,39549528,8312439,PDN
VR250,,1983,1963,,12871898,404248935,84802313,,9502114,299103991,62723465,,3369784,105144944,22078848,PDN
VR250,,1984,1963,,14980329,442061726,93638999,,10533703,335591186,70247437,,4446626,106470540,23391562,PDN
VR250,,1985,1963,,15500069,465195603,98275087,,11404427,361125730,75661674,,4095642,104069873,22613413,PDN
VR250,,1986,1963,,16660327,487077614,103328942,,12762853,399549675,83857101,,3897474,87527939,19471841,PDN
VR250,,1987,1963,,18369076,529796898,112638987,,13588309,430082336,90115415,,4780767,99714562,22523572,PDN
VR250,,1988,1963,,19822777,643806221,134379044,,14209486,457145763,95552148,,5613291,186660458,38826896,PDN
VR250,,1989,1963,,18345901,617368457,128197940,,14585492,476525533,99376512,,3760409,140842924,28821428,PDN
VR250,,1990,1963,,18345901,617368457,128197940,,14952163,494287951,102903756,,3393738,123080506,25294184,PDN
VR250,,1991,1963,,17490490,589811313,122439122,,15207796,505924183,105229893,,2282694,83887130,17209229,PDN
VR250,,1992,1963,,17490490,589811313,122439122,,15359606,514017858,106821858,,2130884,75793455,15617264,PDN
VR250,,1993,1963,,17111753,585265115,121251453,,15484221,520177706,108042532,,1627532,65087409,13208921,PDN
VR250,,1994,1963,,17299882,589149645,122130780,,15620920,524958469,109029900,,1678962,64191176,13100880,PDN
VR250,,1995,1963,,17215262,584305730,121184253,,15680464,526872733,109430061,,1534798,57432997,11754192,PDN
VR250,,1996,1963,,24776846,596910251,130988634,,16929902,528859763,111033063,,7846944,68050488,19955571,PDN
VR250,,1997,1963,,14135074,491218722,101540541,,14026158,489432837,101113851,,108916,1785885,426690,PDN
VR250,,1998,1963,,14135074,491219802,101540733,,14038158,489580618,101152147,,96916,1639184,388586,PDN
VR250,,1999,1963,,14140664,491347391,101569025,,14083201,489782898,101233183,,57463,1564493,335842,PDN
VR250,,2000,1963,,14091915,490315440,101336655,,14085563,489933159,101262282,,6352,382281,74373,PDN
VR250,,2001,1963,,14703498,507929467,105082407,,14138869,492213394,101721323,,564629,15716073,3361084,PDN
VR250,,2002,1963,,14275432,497317096,102766018,,14144232,492802284,101831471,,131200,4514812,934547,PDN
VR250,,2003,1963,,14190947,496069359,102459516,,14181891,493167976,101934200,,9056,2901383,525316,PDN
VR250,,2004,1963,,14219859,498813871,102976775,,14189756,493355815,101975488,,30103,5458056,1001287,PDN
VR250,,2005,1963,,14216023,498461006,102910152,,14189756,493355815,101975488,,26267,5105191,934664,PDN
VR250,,2006,1963,,14288568,523774393,107486859,,14190000,493717509,102040091,,98568,30056884,5446768,PDN
VR250,,2007,1963,,14288310,521056513,107002992,,14204996,497320007,102696100,,83314,23736506,4306892,PDN
VR250,,2008,1963,,14288310,521056513,107002992,,14223972,500080226,103206219,,64338,20976287,3796773,PDN
VR250,,2009,1963,,14273200,516253614,106133276,,14245633,510667260,105111695,,27567,5586354,1021581,PDN
VR250,,2010,1963,,14273200,516253614,106133276,,14265074,510725225,105141450,,8126,5528389,991826,PDN
VR250,,2011,1963,,14272877,515386373,105978639,,14265095,510781625,105151506,,7782,4604748,827133,PDN
VR250,,2012,1963,,14272877,515386373,105978639,,14265095,510781625,105151506,,7782,4604748,827133,PDN
VR250,,2013,1963,,14272877,515386373,105978639,,14265095,510781625,105151506,,7782,4604748,827133,PDN
VR250,,2014,1963,,14265095,510781625,105151506,,14265095,510781625,105151506,,0,0,0,PDN
VR250,,2015,1963,,14265095,510781625,105151506,,14265095,510781625,105151506,,0,0,0,PDN
VR250,,2016,1963,,14265095,510781625,105151506,,14265095,510781625,105151506,,0,0,0,PDN
VR250,,2017,1963,,14265095,510781625,105151506,,14265095,510781625,105151506,,0,0,0,PDN
VR250,,2017,1963,,14265095,510781625,105151506,,14265095,510781625,105151506,,0,0,0,PDN
VR255,,1975,1964,,22001366,290000000,73602789,,5735909,98774480,23311439,,16265457,191225520,50291350,PDN
VR255,,1976,1964,,22001366,290000000,73602789,,6682400,116568243,27424080,,15318966,173431757,46178709,PDN
VR255,,1977,1964,,22001366,290000000,73602789,,7852108,156066862,35622012,,14149258,133933138,37980777,PDN
VR255,,1978,1964,,18271016,517589255,110368748,,9481527,218616411,48381244,,8789489,298972844,61987504,PDN
VR255,,1979,1964,,18271016,517589255,110368748,,10294694,257720777,56152484,,7976322,259868478,54216264,PDN
VR255,,1980,1964,,19066455,529010935,113196515,,10920043,289158488,62371731,,8146412,239852447,50824784,PDN
VR255,,1981,1964,,19069955,530760935,113511403,,11498039,314567496,67470903,,7571916,216193439,46040500,PDN
VR255,,1982,1964,,26831640,537223525,122423015,,12026984,335542819,71732112,,14804656,201680706,50690903,PDN
VR255,,1983,1964,,21382939,546858779,118688772,,12334548,348949234,74425159,,9048391,197909545,44263613,PDN
VR255,,1984,1964,,21373457,547793133,118845545,,12591970,362557598,77103998,,8781487,185235535,41741547,PDN
VR255,,1985,1964,,21430042,554123134,120028464,,12835760,374560508,79483537,,8594282,179562626,40544927,PDN
VR255,,1986,1964,,21770932,582739198,125461181,,13127140,386161961,81839233,,8643792,196577237,43621948,PDN
VR255,,1987,1964,,21737359,591792961,127038598,,13363705,396179908,83858351,,8373654,195613053,43180247,PDN
VR255,,1988,1964,,21012295,585159737,125133245,,13563235,406183304,85837844,,7449060,178976433,39295401,PDN
VR255,,1989,1964,,21074259,593707612,126716183,,13816905,415756869,87794996,,7257354,177950743,38921187,PDN
VR255,,1990,1964,,18975035,513700168,110380759,,14337619,426697469,90262436,,4637416,87002699,20118323,PDN
VR255,,1991,1964,,18979840,513850019,110412228,,14936515,439516795,93142350,,4043325,74333224,17269878,PDN
VR255,,1992,1964,,19079175,516998716,111071829,,15636043,447721534,95301796,,3443132,69277182,15770033,PDN
VR255,,1993,1964,,19294096,523070956,112367220,,16180075,455383127,97209101,,3114021,67687829,15158119,PDN
VR255,,1994,1964,,20453164,524522302,113784534,,16688518,463884237,99230197,,3764646,60638065,14554337,PDN
VR255,,1995,1964,,21198897,517505141,113281662,,17393501,469256659,100891127,,3805396,48248482,12390535,PDN
VR255,,1996,1964,,21828285,520956871,114525237,,18306429,474341432,102708819,,3521856,46615439,11816418,PDN
VR255,,1997,1964,,20810579,512804275,112056891,,18759501,479214779,104029035,,2051078,33589496,8027856,PDN
VR255,,1998,1964,,20935635,514565605,112495351,,19150406,483141078,105118569,,1785229,31424527,7376782,PDN
VR255,,1999,1964,,23461034,547813978,120936831,,20045666,492049568,107598970,,3415368,55764410,13337861,PDN
VR255,,2000,1964,,25530344,626397579,136988988,,20897976,506751179,111067225,,4632368,119646400,25921763,PDN
VR255,,2001,1964,,26942018,635079920,139945563,,21460938,518962352,113802994,,5481080,116117568,26142569,PDN
VR255,,2002,1964,,25773633,627586298,137443793,,21941237,527723309,115842182,,3832396,99862989,21601611,PDN
VR255,,2003,1964,,25630670,619259427,135819181,,22412403,535947802,117776781,,3218267,83311625,18042400,PDN
VR255,,2004,1964,,25164009,609206110,133563672,,22798175,540092649,118900070,,2365834,69113461,14663602,PDN
VR255,,2005,1964,,25687100,610996740,134405381,,23049335,542737306,119621809,,2637765,68259434,14783572,PDN
VR255,,2006,1964,,24700055,607553258,132805617,,23163187,544753142,120094351,,1536868,62800116,12711266,PDN
VR255,,2007,1964,,24408499,593538037,130020250,,23316009,546249905,120513501,,1092490,47288132,9506749,PDN
VR255,,2008,1964,,24479794,596042922,130537254,,23387847,546823115,120687334,,1091947,49219807,9849920,PDN
VR255,,2009,1964,,24126789,584472883,128125519,,23428286,557581674,122642103,,698503,26891209,5483416,PDN
VR255,,2010,1964,,24128143,584657875,128159789,,23523180,560595393,123273245,,604963,24062482,4886544,PDN
VR255,,2011,1964,,24056136,579369596,127146806,,23574285,562520311,123666862,,481851,16849285,3479944,PDN
VR255,,2012,1964,,24056136,579369596,127146806,,23639331,563441903,123895892,,416805,15927693,3250913,PDN
VR255,,2013,1964,,24056136,579369596,127146806,,23676122,563875552,124009846,,380014,15494044,3136962,PDN
VR255,,2014,1964,,24246293,578351163,127155749,,23715636,563957364,124063917,,530657,14393799,3091831,PDN
VR255,,2015,1964,,24246293,578351163,127155749,,23793028,564096088,124165993,,453265,14255075,2989755,PDN
VR255,,2016,1964,,24246293,578351163,127155749,,23831185,564145292,124212905,,415108,14205871,2942843,PDN
VR255,,2017,1964,,23838410,564810634,124338518,,23831185,564145292,124212905,,7225,665342,125613,PDN
VR255,,2017,1964,,23838410,564810634,124338518,,23831185,564145292,124212905,,7225,665342,125613,PDN
VR257,,1993,1988,,111285,8573616,1636839,,0,170962,30420,,111285,8402654,1606419,PDN
VR257,,1994,1988,,111221,8568657,1635893,,0,2338680,416135,,111221,6229977,1219758,PDN
VR257,,1995,1988,,105328,8695577,1652584,,0,4221460,751149,,105328,4474117,901435,PDN
VR257,,1996,1988,,39648,7714095,1412263,,0,4810136,855896,,39648,2903959,556367,PDN
VR257,,1997,1988,,0,7877326,1401659,,0,6103107,1085962,,0,1774219,315697,PDN
VR257,,1998,1988,,0,6695145,1191307,,0,6695145,1191307,,0,0,0,PDN
VR257,,1999,1988,,0,6695145,1191307,,0,6695145,1191307,,0,0,0,PDN
VR257,,2000,1988,,0,6695145,1191307,,0,6695145,1191307,,0,0,0,PDN
VR257,,2001,1988,,0,6695145,1191307,,0,6695145,1191307,,0,0,0,PDN
VR257,,2002,1988,,0,6695145,1191307,,0,6695145,1191307,,0,0,0,PDN
VR257,,2003,1988,,0,6695145,1191307,,0,6695145,1191307,,0,0,0,PDN
VR257,,2004,1988,,0,6695145,1191307,,0,6695145,1191307,,0,0,0,PDN
VR257,,2005,1988,,0,6695145,1191307,,0,6695145,1191307,,0,0,0,PDN
VR257,,2006,1988,,0,6695145,1191307,,0,6695145,1191307,,0,0,0,PDN
VR257,,2007,1988,,0,6695145,1191307,,0,6695145,1191307,,0,0,0,PDN
VR257,,2008,1988,,0,6695145,1191307,,0,6695145,1191307,,0,0,0,PDN
VR257,,2009,1988,,0,6828702,1215072,,0,6828702,1215072,,0,0,0,PDN
VR257,,2010,1988,,0,6828702,1215072,,0,6828702,1215072,,0,0,0,PDN
VR257,,2011,1988,,0,6828702,1215072,,0,6828702,1215072,,0,0,0,PDN
VR257,,2012,1988,,0,6828702,1215072,,0,6828702,1215072,,0,0,0,PDN
VR257,,2013,1988,,0,6828702,1215072,,0,6828702,1215072,,0,0,0,PDN
VR257,,2014,1988,,0,6828702,1215072,,0,6828702,1215072,,0,0,0,PDN
VR257,,2015,1988,,0,6828702,1215072,,0,6828702,1215072,,0,0,0,PDN
VR257,,2016,1988,,0,6828702,1215072,,0,6828702,1215072,,0,0,0,PDN
VR257,,2017,1988,,0,6828702,1215072,,0,6828702,1215072,,0,0,0,PDN
VR257,,2017,1988,,0,6828702,1215072,,0,6828702,1215072,,0,0,0,PDN
VR265,,1975,1966,,10178839,128347626,33016495,,3596299,31099724,9130058,,6582540,97247902,23886437,PDP
VR265,,1976,1966,,10178839,128347626,33016495,,4692936,43778215,12482654,,5485903,84569411,20533841,PDP
VR265,,1977,1966,,10477324,135428826,34574980,,5655454,55512757,15533169,,4821870,79916069,19041811,PDP
VR265,,1978,1966,,10482644,140749836,35527099,,6625077,66290043,18420458,,3857567,74459793,17106641,PDP
VR265,,1979,1966,,10482644,140749836,35527099,,7730293,77411072,21504505,,2752351,63338764,14022594,PDP
VR265,,1980,1966,,12325821,170174592,42605998,,8838909,86878203,24297664,,3486912,83296389,18308334,PDP
VR265,,1981,1966,,12332287,170184317,42614194,,9750027,95465352,26736744,,2582260,74718965,15877450,PDP
VR265,,1982,1966,,15284522,178167552,46986933,,10621037,105904576,29465268,,4663485,72262976,17521665,PDP
VR265,,1983,1966,,17456555,244992746,61049570,,11446645,122149386,33181411,,6009910,122843360,27868159,PDP
VR265,,1984,1966,,18548705,260705026,64937500,,12268315,136304488,36521783,,6280390,124400538,28415717,PDP
VR265,,1985,1966,,19733541,273069442,68322410,,12999484,145377726,38867407,,6734057,127691716,29455003,PDP
VR265,,1986,1966,,20946708,288501054,72281415,,14186127,158958817,42470614,,6760581,129542237,29810801,PDP
VR265,,1987,1966,,20801931,255820129,66321527,,15080626,168175802,45005146,,5721305,87644327,21316381,PDP
VR265,,1988,1966,,20825754,269754487,68824773,,15809802,177429847,47380949,,5015952,92324640,21443824,PDP
VR265,,1989,1966,,20433160,266168231,67794055,,16378669,183345646,49002449,,4054491,82822585,18791606,PDP
VR265,,1990,1966,,18991946,233550161,60548914,,16797657,189327942,50485903,,2194289,44222219,10063011,PDP
VR265,,1991,1966,,18991946,233550161,60548914,,17119227,194541138,51735088,,1872719,39009023,8813826,PDP
VR265,,1992,1966,,18991946,233550161,60548914,,17420245,198510644,52742424,,1571701,35039517,7806490,PDP
VR265,,1993,1966,,19738684,243399579,63048218,,17836366,201952464,53770968,,1902318,41447115,9277250,PDP
VR265,,1994,1966,,19768538,243486656,63093566,,18362986,205189052,54873493,,1405552,38297604,8220073,PDP
VR265,,1995,1966,,20550303,215324915,58864345,,18869674,206985182,55699778,,1680629,8339733,3164567,PDP
VR265,,1996,1966,,20715803,216230429,59190968,,19217189,208543332,56324543,,1498614,7687097,2866425,PDP
VR265,,1997,1966,,20800593,215697449,59180922,,19510247,209333739,56758243,,1290346,6363710,2422679,PDP
VR265,,1998,1966,,20410217,215017109,58669489,,19750627,211167041,57324834,,659590,3850068,1344655,PDP
VR265,,1999,1966,,20711233,220440392,59935502,,19962858,212969796,57857839,,748375,7470596,2077663,PDP
VR265,,2000,1966,,21825718,234670246,63581990,,20379578,215465238,58718588,,1446140,19205008,4863402,PDP
VR265,,2001,1966,,21832378,234785604,63609176,,20684890,218782084,59614086,,1147488,16003520,3995090,PDP
VR265,,2002,1966,,21983192,228877279,62708686,,20900673,220004668,60047411,,1082519,8872611,2661275,PDP
VR265,,2003,1966,,21991605,228451217,62641288,,21109842,220826930,60402890,,881763,7624287,2238398,PDP
VR265,,2004,1966,,22303104,225265846,62385995,,21282293,221484495,60692345,,1020811,3781351,1693650,PDP
VR265,,2005,1966,,22370057,225276417,62454829,,21398430,221842958,60872266,,971627,3433459,1582563,PDP
VR265,,2006,1966,,25675455,233534003,67229548,,21511806,222057494,61023816,,4163649,11476509,6205732,PDP
VR265,,2007,1966,,23394940,228847185,64115080,,22002095,223068390,61693979,,1392845,5778795,2421101,PDP
VR265,,2008,1966,,23394940,228847185,64115080,,22357996,224098580,62233188,,1036944,4748605,1881892,PDP
VR265,,2009,1966,,24019803,232902336,65461500,,22708266,229311281,63510986,,1311537,3591055,1950516,PDP
VR265,,2010,1966,,24396686,233466872,65938837,,22958407,229767146,63842241,,1438279,3699726,2096596,PDP
VR265,,2011,1966,,24399842,233614705,65968295,,23140392,229989079,64063715,,1259450,3625626,1904579,PDP
VR265,,2012,1966,,24399842,233614705,65968295,,23360422,230264314,64332719,,1039420,3350391,1635576,PDP
VR265,,2013,1966,,24399842,233614705,65968295,,23614529,230732895,64670204,,785313,2881810,1298090,PDP
VR265,,2014,1966,,24399842,233614705,65968295,,23823392,231252384,64971504,,576450,2362321,996791,PDP
VR265,,2015,1966,,24635353,235465611,66533148,,23995710,231800547,65241359,,639643,3665064,1291790,PDP
VR265,,2016,1966,,24637953,235548480,66550493,,24133541,232162640,65443619,,504412,3385840,1106875,PDP
VR265,,2017,1966,,24649854,235302589,66518641,,24285148,232428609,65642552,,364706,2873980,876090,PDP
VR265,,2017,1966,,24649854,235302589,66518641,,24285148,232428609,65642552,,364706,2873980,876090,PDP
VR273,,1982,1964,,18458,9228785,1660591,,0,0,0,,18458,9228785,1660591,PDP
VR273,,1983,1964,,80907,40453397,7279020,,0,0,0,,80907,40453397,7279020,PDP
VR273,,1984,1964,,2906286,62323415,13995862,,0,0,0,,2906286,62323415,13995862,PDP
VR273,,1985,1964,,3764370,73478510,16838838,,324677,7217691,1608964,,3439693,66260819,15229874,PDP
VR273,,1986,1964,,2601778,21870018,6493240,,0,0,0,,2601778,21870018,6493240,PDP
VR273,,1987,1964,,2601778,21870018,6493240,,0,0,0,,2601778,21870018,6493240,PDP
VR273,,1989,1964,,1765197,31068481,7293396,,7110,246961,51053,,1758087,30821520,7242343,PDP
VR273,,1990,1964,,1765197,31068481,7293396,,47744,6329699,1174025,,1717453,24738782,6119371,PDP
VR273,,1991,1964,,1765197,31068481,7293396,,57534,8714649,1608183,,1707663,22353832,5685213,PDP
VR273,,1992,1964,,103923,18674928,3426864,,63468,10045828,1850982,,40455,8629100,1575882,PDP
VR273,,1993,1964,,103923,18674928,3426864,,73395,12138506,2233272,,30528,6536422,1193592,PDP
VR273,,1994,1964,,103923,18674928,3426864,,82040,13406344,2467510,,21883,5268584,959354,PDP
VR273,,1995,1964,,146498,30320637,5541629,,88820,14454552,2660804,,57678,15866085,2880825,PDP
VR273,,1996,1964,,221199,46969882,8578829,,134117,22705283,4174203,,87082,24264599,4404626,PDP
VR273,,1997,1964,,9428179,101729869,27529579,,4722021,71874435,17511066,,4706158,29855434,10018513,PDP
VR273,,1998,1964,,10633435,89872676,26625014,,6378062,76367403,19966568,,4255373,13505273,6658446,PDP
VR273,,1999,1964,,11942756,107963049,31153263,,8116190,80176538,22382478,,3826566,27786511,8770785,PDP
VR273,,2000,1964,,19516457,130325354,42706022,,10148627,93353648,26759596,,9367830,36971706,15946426,PDP
VR273,,2001,1964,,16671690,110613660,36353836,,11660901,97621577,29031288,,5010789,12992083,7322548,PDP
VR273,,2002,1964,,21171353,121745648,42834280,,13495081,102233317,31686063,,7676272,19512331,11148217,PDP
VR273,,2003,1964,,22920721,159707759,51338472,,15065336,106145500,33952436,,7855385,53562259,17386036,PDP
VR273,,2004,1964,,27179832,186713265,60402833,,17299537,116546676,38037380,,9880295,70166589,22365453,PDP
VR273,,2005,1964,,30013250,214657456,68208527,,19101215,122949753,40978395,,10912035,91707703,27230132,PDP
VR273,,2006,1964,,26713121,182561764,59197421,,20907393,128836553,43832047,,5805728,53725211,15365374,PDP
VR273,,2007,1964,,27772585,175442767,58990159,,22147196,134459011,46072287,,5625389,40983756,12917872,PDP
VR273,,2008,1964,,28816681,177525256,60404805,,23456697,136154967,47683559,,5359984,41370289,12721246,PDP
VR273,,2009,1964,,28807388,148087144,55157413,,24953431,138445933,49587939,,3853957,9641211,5569477,PDP
VR273,,2010,1964,,29522638,148766632,55993568,,25911449,139104183,50663081,,3611189,9662449,5330486,PDP
VR273,,2011,1964,,30020600,147235882,56219154,,26687913,139845804,51571506,,3332687,7390078,4647646,PDP
VR273,,2012,1964,,30020600,147220368,56216394,,27199082,140463135,52192523,,2821518,6757233,4023874,PDP
VR273,,2013,1964,,30144611,147126153,56323642,,27938184,140927108,53014183,,2206427,6199045,3309460,PDP
VR273,,2014,1964,,30423916,157202417,58395876,,28560688,142221056,53866924,,1863228,14981361,4528952,PDP
VR273,,2015,1964,,30225420,159324032,58574893,,29001157,143637276,54559392,,1224263,15686756,4015504,PDP
VR273,,2016,1964,,30977472,156084176,58750457,,29518226,144923190,55305270,,1459246,11160986,3445187,PDP
VR273,,2017,1964,,31530932,154937217,59099833,,29894056,145716077,55822182,,1636876,9221140,3277646,PDP
VR273,,2017,1964,,31530932,154937217,59099833,,29894056,145716077,55822182,,1636876,9221140,3277646,PDP
VR275,,1991,1990,,1242586,41381285,8605804,,21680,771369,158934,,1220906,40609916,8446870,PDN
VR275,,1992,1990,,1242586,41381285,8605804,,163425,5810143,1197258,,1079161,35571142,7408546,PDN
VR275,,1993,1990,,1242586,41381285,8605804,,200426,7550167,1543872,,1042160,33831118,7061932,PDN
VR275,,1994,1990,,1242586,41381285,8605804,,220658,8169685,1674339,,1021928,33211600,6931465,PDN
VR275,,1995,1990,,1242586,41381285,8605804,,230036,8465125,1736286,,1012550,32916160,6869518,PDN
VR275,,1996,1990,,229796,8511076,1744222,,229796,8511076,1744222,,0,0,0,PDN
VR275,,1997,1990,,229796,8511076,1744222,,229796,8511076,1744222,,0,0,0,PDN
VR275,,1998,1990,,229796,8511076,1744222,,229796,8511076,1744222,,0,0,0,PDN
VR275,,1999,1990,,229796,8511076,1744222,,229796,8511076,1744222,,0,0,0,PDN
VR275,,2000,1990,,229796,8511076,1744222,,229796,8511076,1744222,,0,0,0,PDN
VR275,,2001,1990,,229796,8511076,1744222,,229796,8511076,1744222,,0,0,0,PDN
VR275,,2002,1990,,229796,8511076,1744222,,229796,8511076,1744222,,0,0,0,PDN
VR275,,2003,1990,,229796,8511076,1744222,,229796,8511076,1744222,,0,0,0,PDN
VR275,,2004,1990,,229796,8511076,1744222,,229796,8511076,1744222,,0,0,0,PDN
VR275,,2005,1990,,229796,8511076,1744222,,229796,8511076,1744222,,0,0,0,PDN
VR275,,2006,1990,,229796,8511076,1744222,,229796,8511076,1744222,,0,0,0,PDN
VR275,,2007,1990,,229796,8511076,1744222,,229796,8511076,1744222,,0,0,0,PDN
VR275,,2008,1990,,229796,8511076,1744222,,229796,8511076,1744222,,0,0,0,PDN
VR275,,2009,1990,,229796,8681523,1774551,,229796,8681523,1774551,,0,0,0,PDN
VR275,,2010,1990,,229796,8681523,1774551,,229796,8681523,1774551,,0,0,0,PDN
VR275,,2011,1990,,229796,8681523,1774551,,229796,8681523,1774551,,0,0,0,PDN
VR275,,2012,1990,,229796,8681523,1774551,,229796,8681523,1774551,,0,0,0,PDN
VR275,,2013,1990,,229796,8681523,1774551,,229796,8681523,1774551,,0,0,0,PDN
VR275,,2014,1990,,229796,8681523,1774551,,229796,8681523,1774551,,0,0,0,PDN
VR275,,2015,1990,,229796,8681523,1774551,,229796,8681523,1774551,,0,0,0,PDN
VR275,,2016,1990,,229796,8681523,1774551,,229796,8681523,1774551,,0,0,0,PDN
VR275,,2017,1990,,229796,8681523,1774551,,229796,8681523,1774551,,0,0,0,PDN
VR275,,2017,1990,,229796,8681523,1774551,,229796,8681523,1774551,,0,0,0,PDN
VR284,,1990,1989,,5910576,2659759,6383843,,0,0,0,,5910576,2659759,6383843,PDP
VR284,,1991,1989,,5910576,2962485,6437709,,1954909,1850864,2284244,,3955667,1111621,4153465,PDP
VR284,,1992,1989,,10246964,9837086,11997335,,4139146,4376301,4917847,,6107818,5460785,7079488,PDP
VR284,,1993,1989,,10931546,11507992,12979231,,5812263,6394573,6950087,,5119283,5113419,6029144,PDP
VR284,,1994,1989,,8612012,9069545,10225810,,6813371,7713960,8185962,,1798641,1355585,2039848,PDP
VR284,,1995,1989,,9069650,9779015,10809688,,7507516,8883178,9088153,,1562134,895837,1721535,PDP
VR284,,1996,1989,,11173682,15190747,13876662,,8322039,10348278,10163370,,2851643,4842469,3713292,PDP
VR284,,1997,1989,,14884108,69701220,27286460,,9415173,19462845,12878313,,5468935,50238375,14408147,PDP
VR284,,1998,1989,,15705225,77843135,29556317,,10725170,32522856,16512155,,4980055,45320279,13044162,PDP
VR284,,1999,1989,,15485565,79239113,29585051,,11540349,40799771,18800095,,3945216,38439342,10784956,PDP
VR284,,2000,1989,,15416990,80278570,29701433,,12170849,45554244,20276586,,3246141,34724326,9424847,PDP
VR284,,2001,1989,,15342207,71811008,28119966,,12655178,49594434,21479810,,2687029,22216574,6640156,PDP
VR284,,2002,1989,,15647638,70796253,28244836,,12931197,51435454,22083413,,2716441,19360799,6161423,PDP
VR284,,2003,1989,,15509582,65614148,27184697,,13183020,53240105,22656348,,2326562,12374043,4528349,PDP
VR284,,2004,1989,,15560796,58948141,26049789,,13462230,53646954,23007951,,2098566,5301187,3041838,PDP
VR284,,2005,1989,,16953205,60382561,27697433,,13636855,53856590,23219878,,3316350,6525971,4477555,PDP
VR284,,2006,1989,,16395965,60011119,27074100,,13796457,54043262,23412696,,2599508,5967857,3661404,PDP
VR284,,2007,1989,,16220144,59756360,26852948,,14009346,54309373,23672936,,2210798,5446987,3180012,PDP
VR284,,2008,1989,,15885077,59415585,26457245,,14105456,54480560,23799506,,1779621,4935025,2657739,PDP
VR284,,2009,1989,,15864011,60072785,26553119,,14105456,55055628,23901831,,1758555,5017157,2651288,PDP
VR284,,2010,1989,,15864011,60072785,26553119,,14105456,55055628,23901831,,1758555,5017157,2651288,PDP
VR284,,2011,1989,,15864011,60072785,26553119,,14105456,55056017,23901900,,1758555,5016768,2651219,PDP
VR284,,2012,1989,,15864011,60072785,26553117,,14194549,55193869,24015522,,1669462,4878916,2537595,PDP
VR284,,2013,1989,,16297019,60405292,27045290,,14287302,55310103,24128956,,2009717,5095189,2916332,PDP
VR284,,2014,1989,,16297019,60405292,27045290,,14365985,55407452,24224962,,1931034,4997840,2820327,PDP
VR284,,2015,1989,,16298586,58012687,26621126,,14405266,55457171,24273090,,1893320,2555516,2348036,PDP
VR284,,2016,1989,,17481651,59314058,28035752,,14712791,56216345,24715699,,2768860,3097713,3320053,PDP
VR284,,2017,1989,,17680124,62141806,28737383,,14899302,57001879,25041985,,2780822,5139927,3695397,PDP
VR284,,2017,1989,,17680124,62141806,28737383,,14899302,57001879,25041985,,2780822,5139927,3695397,PDP
VR287,,1978,1976,,180000,180000000,32208470,,0,0,0,,180000,180000000,32208470,PDN
VR287,,1979,1976,,12701919,91963768,29065579,,0,0,0,,12701919,91963768,29065579,PDN
VR287,,1980,1976,,12076668,69373768,24420755,,369361,906518,530663,,11707307,68467250,23890092,PDN
VR287,,1981,1976,,12076668,69373768,24420755,,813919,1964671,1163505,,11262749,67409097,23257250,PDN
VR287,,1982,1976,,9992766,72429831,22880636,,1200820,2752567,1690601,,8791946,69677264,21190035,PDN
VR287,,1983,1976,,9992766,72429831,22880636,,1310853,2931705,1832509,,8681913,69498126,21048127,PDN
VR287,,1984,1976,,10539119,67670343,22580105,,1534915,5610612,2533245,,9004204,62059731,20046860,PDN
VR287,,1985,1976,,10539119,67670343,22580105,,1772492,8973404,3369183,,8766627,58696939,19210922,PDN
VR287,,1986,1976,,10539119,67900436,22621047,,1988588,11662648,4063792,,8550531,56237788,18557255,PDN
VR287,,1987,1976,,10525935,68039396,22632589,,2176184,14158611,4695510,,8349751,53880785,17937079,PDN
VR287,,1988,1976,,8423854,64946434,19980159,,2312566,16886251,5317237,,6111288,48060183,14662922,PDN
VR287,,1989,1976,,8033182,58204136,18389790,,2407921,19376924,5855772,,5625261,38827212,12534018,PDN
VR287,,1990,1976,,3626583,49374314,12412048,,2518156,24739855,6920265,,1108427,24634459,5491783,PDN
VR287,,1991,1976,,3626583,49374314,12412048,,2639089,32206907,8369855,,987494,17167407,4042193,PDN
VR287,,1992,1976,,3626717,52518650,12971673,,2694344,36574831,9202321,,932373,15943819,3769352,PDN
VR287,,1993,1976,,4081466,64170459,15499697,,2959166,44522990,10881406,,1122300,19647469,4618291,PDN
VR287,,1994,1976,,4081400,64170307,15499604,,3121598,49565767,11941129,,959802,14604540,3558475,PDN
VR287,,1995,1976,,4040769,72482963,16938093,,3239167,52740813,12623653,,801602,19742150,4314440,PDN
VR287,,1996,1976,,3731694,67915624,15816325,,3263216,55093311,13066296,,468478,12822313,2750029,PDN
VR287,,1997,1976,,3767585,59860366,14418896,,3290419,56441853,13333453,,477166,3418513,1085443,PDN
VR287,,1998,1976,,3775141,59892371,14432147,,3448481,57502135,13680178,,326660,2390236,751969,PDN
VR287,,1999,1976,,4193300,61181093,15079616,,3531621,58373122,13918298,,661679,2807971,1161318,PDN
VR287,,2000,1976,,4178747,61639948,15146709,,3593748,58896110,14073483,,584999,2743838,1073226,PDN
VR287,,2001,1976,,5260680,65208791,16863667,,3645548,59167306,14173538,,1615132,6041485,2690129,PDN
VR287,,2002,1976,,5237351,64324302,16682956,,3667734,59245987,14209725,,1569617,5078315,2473231,PDN
VR287,,2003,1976,,5237351,64324302,16682957,,3959173,59712828,14584231,,1278178,4611474,2098726,PDN
VR287,,2004,1976,,6039170,63985676,17424522,,4439609,60164273,15144996,,1599561,3821403,2279526,PDN
VR287,,2005,1976,,7655104,65535314,19316192,,4801080,60658185,15594351,,2854024,4877129,3721841,PDN
VR287,,2006,1976,,6503214,64058736,17901566,,5043449,60865902,15873681,,1459765,3192834,2027885,PDN
VR287,,2007,1976,,6503214,64058736,17901566,,5253651,61035169,16114001,,1249563,3023567,1787565,PDN
VR287,,2008,1976,,6503201,64057926,17901409,,5431571,61310959,16340994,,1071630,2746967,1560415,PDN
VR287,,2009,1976,,6295435,64130044,17706475,,5517251,62627674,16660967,,778184,1502370,1045509,PDN
VR287,,2010,1976,,6295435,64130044,17706475,,5645562,62905210,16838661,,649873,1224834,867815,PDN
VR287,,2011,1976,,6049141,63481463,17344775,,5693549,62979627,16899889,,355592,501836,444887,PDN
VR287,,2012,1976,,6049141,63481463,17344775,,5723882,63016516,16936786,,325259,464947,407990,PDN
VR287,,2013,1976,,6049141,63481463,17344775,,5756503,63069591,16978851,,292638,411872,365925,PDN
VR287,,2014,1976,,6049141,63481463,17344775,,5794794,63125222,17027040,,254347,356241,317735,PDN
VR287,,2015,1976,,6049141,63481463,17344775,,5825858,63185321,17068798,,223283,296142,275977,PDN
VR287,,2016,1976,,6049141,63481463,17344775,,5839737,63211155,17087274,,209404,270308,257502,PDN
VR287,,2017,1976,,5839737,63211155,17087274,,5839737,63211155,17087274,,0,0,0,PDN
VR287,,2017,1976,,5839737,63211155,17087274,,5839737,63211155,17087274,,0,0,0,PDN
VR288,,1983,1964,,52768,52188163,9338918,,0,0,0,,52768,52188163,9338918,PDN
VR288,,1984,1964,,257442,51488646,9419123,,0,0,0,,257442,51488646,9419123,PDN
VR288,,1985,1964,,257442,51488646,9419123,,0,0,0,,257442,51488646,9419123,PDN
VR288,,1986,1964,,289150,62820993,11467263,,7120,3081670,555460,,282030,59739323,10911803,PDN
VR288,,1987,1964,,289532,66643736,12147848,,13875,6885039,1238971,,275657,59758697,10908877,PDN
VR288,,1988,1964,,283267,66407834,12099608,,18511,11352808,2038584,,264756,55055026,10061024,PDN
VR288,,1989,1964,,372763,75945694,13886232,,21500,13796657,2476421,,351263,62149037,11409811,PDN
VR288,,1990,1964,,286629,47693777,8773066,,66571,18935396,3435859,,220058,28758381,5337207,PDN
VR288,,1991,1964,,286888,47740401,8781621,,87296,21608818,3932281,,199592,26131583,4849340,PDN
VR288,,1992,1964,,287467,48270427,8876511,,93704,22924510,4172798,,193763,25345917,4703713,PDN
VR288,,1993,1964,,208338,43812628,8004179,,101143,24095768,4388646,,107195,19716860,3615533,PDN
VR288,,1994,1964,,274245,60289422,11001900,,107315,24831587,4525747,,166930,35457835,6476153,PDN
VR288,,1995,1964,,439762,57147870,10608422,,149002,30032003,5492775,,290760,27115867,5115647,PDN
VR288,,1996,1964,,1145275,79817373,15347655,,188050,34451717,6318249,,957225,45365656,9029406,PDN
VR288,,1997,1964,,590331,73057952,13589967,,253619,40390680,7440573,,336712,32667272,6149394,PDN
VR288,,1998,1964,,996583,58847662,11467697,,422182,42729896,8025366,,574401,16117766,3442331,PDN
VR288,,1999,1964,,1021170,71349466,13716804,,497421,44038662,8333482,,523749,27310804,5383322,PDN
VR288,,2000,1964,,641821,77400480,14414148,,475168,45457976,8563776,,166653,31942504,5850372,PDN
VR288,,2001,1964,,674371,77611599,14484264,,507632,45980439,8689205,,166739,31631160,5795059,PDN
VR288,,2002,1964,,649712,74140296,13841935,,508627,46301430,8747316,,141085,27838866,5094619,PDN
VR288,,2003,1964,,644354,73574953,13735982,,509738,46581834,8798321,,134616,26993119,4937661,PDN
VR288,,2004,1964,,509761,46598835,8801369,,509761,46598835,8801369,,0,0,0,PDN
VR288,,2005,1964,,509761,46598835,8801369,,509761,46598835,8801369,,0,0,0,PDN
VR288,,2006,1964,,509761,46598835,8801369,,509761,46598835,8801369,,0,0,0,PDN
VR288,,2007,1964,,509761,46598835,8801369,,509761,46598835,8801369,,0,0,0,PDN
VR288,,2008,1964,,509761,46598835,8801369,,509761,46598835,8801369,,0,0,0,PDN
VR288,,2009,1964,,509761,47438212,8950721,,509761,47438212,8950721,,0,0,0,PDN
VR288,,2010,1964,,509761,47438212,8950721,,509761,47438212,8950721,,0,0,0,PDN
VR288,,2011,1964,,509761,47438212,8950721,,509761,47438212,8950721,,0,0,0,PDN
VR288,,2012,1964,,509761,47438212,8950721,,509761,47438212,8950721,,0,0,0,PDN
VR288,,2013,1964,,509761,47438212,8950721,,509761,47438212,8950721,,0,0,0,PDN
VR288,,2014,1964,,509761,47438212,8950721,,509761,47438212,8950721,,0,0,0,PDN
VR288,,2015,1964,,509761,47438212,8950721,,509761,47438212,8950721,,0,0,0,PDN
VR288,,2016,1964,,509761,47438212,8950721,,509761,47438212,8950721,,0,0,0,PDN
VR288,,2017,1964,,509761,47438212,8950721,,509761,47438212,8950721,,0,0,0,PDN
VR288,,2017,1964,,509761,47438212,8950721,,509761,47438212,8950721,,0,0,0,PDN
VR296,,1993,1993,,68501,5922205,1122274,,3158,405763,75358,,65343,5516442,1046916,PDN
VR296,,1994,1993,,73101,7936329,1485259,,19543,3877073,709414,,53558,4059256,775845,PDN
VR296,,1995,1993,,80089,8912218,1665893,,23359,4868968,889723,,56730,4043250,776170,PDN
VR296,,1996,1993,,87212,13229486,2441213,,45059,7572562,1392490,,42153,5656924,1048723,PDN
VR296,,1997,1993,,87212,13229486,2441213,,63175,10313553,1898327,,24037,2915933,542886,PDN
VR296,,1998,1993,,87212,13229486,2441213,,67892,11942116,2192824,,19320,1287370,248389,PDN
VR296,,1999,1993,,74846,15563796,2844205,,70323,13208174,2420532,,4523,2355622,423673,PDN
VR296,,2000,1993,,74846,15563796,2844205,,71485,13748123,2517770,,3361,1815673,326435,PDN
VR296,,2001,1993,,71488,13922652,2548828,,71488,13922652,2548828,,0,0,0,PDN
VR296,,2002,1993,,71488,13922652,2548828,,71488,13922652,2548828,,0,0,0,PDN
VR296,,2003,1993,,71488,13922652,2548828,,71488,13922652,2548828,,0,0,0,PDN
VR296,,2004,1993,,71488,13922652,2548828,,71488,13922652,2548828,,0,0,0,PDN
VR296,,2005,1993,,71488,13922652,2548828,,71488,13922652,2548828,,0,0,0,PDN
VR296,,2006,1993,,71488,13922652,2548828,,71488,13922652,2548828,,0,0,0,PDN
VR296,,2007,1993,,71488,13922652,2548828,,71488,13922652,2548828,,0,0,0,PDN
VR296,,2008,1993,,71488,13922652,2548828,,71488,13922652,2548828,,0,0,0,PDN
VR296,,2009,1993,,71488,14153479,2589901,,71488,14153479,2589901,,0,0,0,PDN
VR296,,2010,1993,,71488,14153479,2589901,,71488,14153479,2589901,,0,0,0,PDN
VR296,,2011,1993,,71488,14153479,2589901,,71488,14153479,2589901,,0,0,0,PDN
VR296,,2012,1993,,71488,14153479,2589901,,71488,14153479,2589901,,0,0,0,PDN
VR296,,2013,1993,,71488,14153479,2589901,,71488,14153479,2589901,,0,0,0,PDN
VR296,,2014,1993,,71488,14153479,2589901,,71488,14153479,2589901,,0,0,0,PDN
VR296,,2015,1993,,71488,14153479,2589901,,71488,14153479,2589901,,0,0,0,PDN
VR296,,2016,1993,,71488,14153479,2589901,,71488,14153479,2589901,,0,0,0,PDN
VR296,,2017,1993,,71488,14153479,2589901,,71488,14153479,2589901,,0,0,0,PDN
VR296,,2017,1993,,71488,14153479,2589901,,71488,14153479,2589901,,0,0,0,PDN
VR310,,1978,1966,,201000,201000000,35966125,,0,0,0,,201000,201000000,35966125,PDP
VR310,,1979,1966,,201000,201000000,35966125,,0,0,0,,201000,201000000,35966125,PDP
VR310,,1980,1966,,472000,201000000,36237125,,141410,15674935,2930544,,330590,185325065,33306581,PDP
VR310,,1981,1966,,472000,201000000,36237125,,348404,46323269,8590979,,123596,154676731,27646146,PDP
VR310,,1982,1966,,22011587,201000000,57776712,,8499784,77616238,22310503,,13511803,123383762,35466209,PDP
VR310,,1983,1966,,22011587,201000000,57776712,,8573573,98085418,26026494,,13438014,102914582,31750218,PDP
VR310,,1984,1966,,5000000,201000000,40765125,,2410104,133844541,26225859,,2589896,67155459,14539266,PDP
VR310,,1985,1966,,7389508,209070834,44590724,,2092162,143756574,27671624,,5297346,65314260,16919100,PDP
VR310,,1986,1966,,7393304,211932115,45103645,,2204773,149199832,28752786,,5188531,62732283,16350859,PDP
VR310,,1987,1966,,7253849,221515023,46669334,,2266321,155806420,29989883,,4987528,65708603,16679451,PDP
VR310,,1988,1966,,6722395,218897094,45672056,,2356972,160088206,30842418,,4365423,58808888,14829638,PDP
VR310,,1989,1966,,6746436,225168862,46812070,,2428419,163269902,31480003,,4318017,61898960,15332067,PDP
VR310,,1990,1966,,6549786,226968830,46935699,,2475666,166870254,32167882,,4074120,60098576,14767817,PDP
VR310,,1991,1966,,2867655,190022984,36679574,,2659677,171767681,33223321,,207978,18255303,3456253,PDP
VR310,,1992,1966,,3353586,191048917,37348055,,2849086,173873545,33787439,,504500,17175372,3560616,PDP
VR310,,1993,1966,,3378058,191885928,37521462,,2954295,174973936,34088447,,423763,16911992,3433015,PDP
VR310,,1994,1966,,3408931,197621994,38572987,,3009339,176117253,34346929,,399592,21504741,4226058,PDP
VR310,,1995,1966,,3435454,210974276,40975361,,3079587,179861882,35083481,,355867,31112394,5891880,PDP
VR310,,1996,1966,,4060845,206968146,40887917,,3338718,187887215,36770607,,722127,19080931,4117310,PDP
VR310,,1997,1966,,4231974,202493891,40262915,,3687891,192348941,37913681,,544083,10144950,2349234,PDP
VR310,,1998,1966,,4232063,202708662,40301220,,3991020,195379624,38756078,,241043,7329038,1545142,PDP
VR310,,1999,1966,,4644769,201143881,40435495,,4215282,197204410,39305035,,429487,3939471,1130460,PDP
VR310,,2000,1966,,4989231,203325015,41168059,,4428354,198394584,39729881,,560877,4930431,1438178,PDP
VR310,,2001,1966,,4785139,204364282,41148890,,4566813,199306877,40030670,,218326,5057405,1118220,PDP
VR310,,2002,1966,,4852177,205870535,41483945,,4615202,200334894,40261980,,236975,5535641,1221965,PDP
VR310,,2003,1966,,4849987,205481972,41412615,,4660494,201627358,40537248,,189493,3854614,875367,PDP
VR310,,2004,1966,,4848257,205313962,41380990,,4700036,202557731,40742337,,148221,2756231,638653,PDP
VR310,,2005,1966,,5069508,226180876,45315215,,4720661,203240692,40884485,,348847,22940184,4430730,PDP
VR310,,2006,1966,,4894048,217013801,43508603,,4781703,206398236,41507368,,112345,10615565,2001235,PDP
VR310,,2007,1966,,4917197,213290633,42869267,,4821765,209221829,42049848,,95432,4068804,819419,PDP
VR310,,2008,1966,,4917197,213290633,42869267,,4835085,210163667,42230755,,82112,3126966,638512,PDP
VR310,,2009,1966,,5045534,220376247,44258389,,4864148,215101970,43138519,,181386,5274277,1119869,PDP
VR310,,2010,1966,,5045534,220376247,44258389,,4888047,216075874,43335711,,157487,4300373,922677,PDP
VR310,,2011,1966,,5045534,220376247,44258389,,4910596,216932767,43510732,,134938,3443480,747656,PDP
VR310,,2012,1966,,5145584,220529429,44385695,,4948896,217574635,43663243,,196688,2954794,722453,PDP
VR310,,2013,1966,,5145584,220529429,44385695,,4985786,218281514,43825912,,159798,2247915,559783,PDP
VR310,,2014,1966,,5145278,220384377,44359579,,5026204,218791330,43957044,,119074,1593047,402535,PDP
VR310,,2015,1966,,5145498,220501025,44380555,,5046939,219068806,44027152,,98559,1432219,353402,PDP
VR310,,2016,1966,,5145498,220501025,44380555,,5065009,219302474,44086801,,80489,1198551,293754,PDP
VR310,,2017,1966,,5145246,220382982,44359299,,5087039,219496506,44143356,,58207,886476,215943,PDP
VR310,,2017,1966,,5145246,220382982,44359299,,5087039,219496506,44143356,,58207,886476,215943,PDP
VR313,,1975,1975,,6476190,68000000,18575834,,0,0,0,,6476190,68000000,18575834,PDP
VR313,,1976,1975,,6476190,68000000,18575834,,0,0,0,,6476190,68000000,18575834,PDP
VR313,,1977,1975,,291152,54415558,9973636,,0,0,0,,291152,54415558,9973636,PDP
VR313,,1978,1975,,336565,58374568,10723499,,27246,2453044,463731,,309319,55921524,10259768,PDP
VR313,,1979,1975,,336565,58374568,10723499,,171640,10406283,2023292,,164925,47968285,8700207,PDP
VR313,,1980,1975,,684005,72632625,13607960,,385874,18974953,3762200,,298131,53657672,9845760,PDP
VR313,,1981,1975,,1478866,95041535,18390171,,803463,31199054,6354896,,675403,63842481,12035275,PDP
VR313,,1982,1975,,2205790,102469377,20438775,,1084028,39160283,8052050,,1121762,63309094,12386725,PDP
VR313,,1983,1975,,2245703,104285923,20801917,,1352487,43968777,9176113,,893216,60317146,11625804,PDP
VR313,,1984,1975,,711901,80193226,14981158,,248363,25679358,4817644,,463538,54513868,10163514,PDP
VR313,,1985,1975,,711901,80193226,14981158,,250677,26294078,4929339,,461224,53899148,10051819,PDP
VR313,,1986,1975,,711901,80193226,14981158,,251689,26664039,4996180,,460212,53529187,9984978,PDP
VR313,,1987,1975,,369318,33472494,6325278,,252179,26825501,5025400,,117139,6646993,1299878,PDP
VR313,,1988,1975,,369318,33472494,6325278,,252557,26943732,5046815,,116761,6528762,1278463,PDP
VR313,,1989,1975,,369318,33472494,6325278,,252679,26972495,5052055,,116639,6499999,1273223,PDP
VR313,,1990,1975,,369318,33472494,6325278,,252679,26972495,5052055,,116639,6499999,1273223,PDP
VR313,,1991,1975,,252679,26972495,5052055,,252679,26972495,5052055,,0,0,0,PDP
VR313,,1992,1975,,252679,26972495,5052055,,252679,26972495,5052055,,0,0,0,PDP
VR313,,1993,1975,,252679,26972495,5052055,,252679,26972495,5052055,,0,0,0,PDP
VR313,,1994,1975,,252679,26972495,5052055,,252679,26972495,5052055,,0,0,0,PDP
VR313,,1995,1975,,252679,26972495,5052055,,252679,26972495,5052055,,0,0,0,PDP
VR313,,1996,1975,,252679,26972495,5052055,,252679,26972495,5052055,,0,0,0,PDP
VR313,,1997,1975,,252679,26972495,5052055,,252679,26972495,5052055,,0,0,0,PDP
VR313,,1998,1975,,252679,26972495,5052055,,252679,26972495,5052055,,0,0,0,PDP
VR313,,1999,1975,,253026,30447112,5670662,,252679,26972495,5052055,,347,3474617,618607,PDP
VR313,,2000,1975,,253026,30447112,5670662,,252679,26972495,5052055,,347,3474617,618607,PDP
VR313,,2001,1975,,253026,30447112,5670662,,252679,26972495,5052055,,347,3474617,618607,PDP
VR313,,2002,1975,,253026,30447112,5670662,,252679,26972495,5052055,,347,3474617,618607,PDP
VR313,,2003,1975,,1293746,33625297,7276895,,485916,27544297,5387036,,807830,6081000,1889859,PDP
VR313,,2004,1975,,1284455,33860450,7309446,,720776,28371640,5769111,,563679,5488810,1540335,PDP
VR313,,2005,1975,,1348626,36935477,7920775,,822614,29289470,6034263,,526012,7646007,1886512,PDP
VR313,,2006,1975,,1333154,34793810,7524223,,875237,29720269,6163541,,457917,5073541,1360682,PDP
VR313,,2007,1975,,1430505,34089216,7496202,,938289,30040643,6283599,,492216,4048573,1212603,PDP
VR313,,2008,1975,,1430639,34089818,7496443,,963695,30105157,6320485,,466944,3984661,1175958,PDP
VR313,,2009,1975,,1457871,31880487,7130557,,1132287,30970148,6642990,,325584,910339,487566,PDP
VR313,,2010,1975,,2020233,33477600,7977103,,1299298,31337773,6875416,,720935,2139827,1101687,PDP
VR313,,2011,1975,,1999323,32899120,7853260,,1436059,31680999,7073249,,563264,1218121,780012,PDP
VR313,,2012,1975,,1988402,33510308,7951091,,1542730,31941941,7226350,,445672,1568367,724741,PDP
VR313,,2013,1975,,1988402,33510308,7951091,,1613998,32118030,7328951,,374404,1392278,622141,PDP
VR313,,2014,1975,,2064509,33482215,8022199,,1674842,32320228,7425773,,389667,1161987,596426,PDP
VR313,,2015,1975,,2064509,33482215,8022199,,1695945,32362525,7454402,,368564,1119690,567797,PDP
VR313,,2016,1975,,2074189,32991136,7944499,,1716306,32392511,7480099,,357883,598625,464400,PDP
VR313,,2017,1975,,2074189,32991136,7944499,,1730054,32422162,7499122,,344135,568974,445376,PDP
VR313,,2017,1975,,2074189,32991136,7944499,,1730054,32422162,7499122,,344135,568974,445376,PDP
VR315,,1982,1981,,815000,603000,922295,,0,0,0,,815000,603000,922295,PDN
VR315,,1983,1981,,603000,815000,748018,,0,0,0,,603000,815000,748018,PDN
VR315,,1984,1981,,603000,815000,748018,,0,0,0,,603000,815000,748018,PDN
VR315,,1985,1981,,3589792,15108508,6278139,,977939,1179047,1187734,,2611853,13929461,5090405,PDN
VR315,,1986,1981,,2764417,6169014,3862106,,1662722,1952714,2010180,,1101695,4216300,1851926,PDN
VR315,,1987,1981,,2764417,6169014,3862106,,1943023,2146040,2324881,,821394,4022974,1537225,PDN
VR315,,1988,1981,,2789172,9583647,4494447,,2117055,2303112,2526861,,672117,7280535,1967586,PDN
VR315,,1989,1981,,2774279,9587684,4480273,,2254802,2388502,2679802,,519477,7199182,1800471,PDN
VR315,,1990,1981,,2771769,9909285,4534987,,2335211,2794078,2832378,,436558,7115207,1702609,PDN
VR315,,1991,1981,,2587500,4408709,3371968,,2391368,3123369,2947128,,196132,1285340,424840,PDN
VR315,,1992,1981,,2587500,4408709,3371968,,2454102,3293586,3040149,,133398,1115123,331819,PDN
VR315,,1993,1981,,2612387,8465332,4118674,,2534809,4864693,3400413,,77578,3600639,718261,PDN
VR315,,1994,1981,,3052623,8608597,4584402,,2681658,5712473,3698112,,370965,2896124,886290,PDN
VR315,,1995,1981,,3158361,10115292,4958235,,2773160,5998019,3840423,,385201,4117273,1117812,PDN
VR315,,1996,1981,,2965603,22567496,6981172,,2652170,6935701,3886280,,313433,15631795,3094892,PDN
VR315,,1997,1981,,2763643,14364839,5319664,,2684966,10306900,4518934,,78677,4057939,800730,PDN
VR315,,1998,1981,,2763643,14364839,5319664,,2688509,11443729,4724760,,75134,2921110,594904,PDN
VR315,,1999,1981,,3613390,81103904,18044690,,2917515,27138496,7746429,,695875,53965408,10298261,PDN
VR315,,2000,1981,,3514477,94921748,20404468,,3058525,44553582,10986209,,455952,50368166,9418259,PDN
VR315,,2001,1981,,3238876,70111926,15714308,,3114668,51501401,12278618,,124208,18610525,3435690,PDN
VR315,,2002,1981,,3250442,66747284,15127183,,3137819,53832274,12716515,,112623,12915010,2410668,PDN
VR315,,2003,1981,,3202676,62266560,14282135,,3150634,55912314,13099444,,52042,6354246,1182691,PDN
VR315,,2004,1981,,3341596,60487366,14104473,,3168905,57352440,13373965,,172691,3134926,730508,PDN
VR315,,2005,1981,,3584734,58986726,14080593,,3195307,57607974,13445836,,389427,1378752,634757,PDN
VR315,,2006,1981,,3462724,59313090,14016655,,3236280,57683699,13500283,,226444,1629391,516372,PDN
VR315,,2007,1981,,3336431,58569430,13758038,,3270176,57920417,13576300,,66255,649013,181738,PDN
VR315,,2008,1981,,3336431,58567104,13757624,,3285177,57979282,13601775,,51254,587822,155849,PDN
VR315,,2009,1981,,3335733,58660569,13773557,,3302324,58312844,13678275,,33409,347725,95282,PDN
VR315,,2010,1981,,3335733,58660569,13773557,,3317723,58369469,13703749,,18010,291100,69808,PDN
VR315,,2011,1981,,3322456,58505150,13732625,,3322078,58410527,13715410,,378,94623,17215,PDN
VR315,,2012,1981,,3322456,58505150,13732625,,3322078,58410527,13715410,,378,94623,17215,PDN
VR315,,2013,1981,,3322456,58505150,13732625,,3322078,58410527,13715410,,378,94623,17215,PDN
VR315,,2014,1981,,3322252,58454048,13723328,,3322078,58410527,13715410,,174,43521,7918,PDN
VR315,,2015,1981,,3322252,58454048,13723328,,3322078,58410527,13715410,,174,43521,7918,PDN
VR315,,2016,1981,,3322252,58454048,13723328,,3322078,58410527,13715410,,174,43521,7918,PDN
VR315,,2017,1981,,3322252,58454048,13723328,,3322078,58410527,13715410,,174,43521,7918,PDN
VR315,,2017,1981,,3322252,58454048,13723328,,3322078,58410527,13715410,,174,43521,7918,PDN
VR318,,1984,1983,,1735787,67803030,13800383,,15769,1092177,210107,,1720018,66710853,13590276,PDN
VR318,,1985,1983,,1431976,34832383,7629909,,179033,9736837,1911566,,1252943,25095546,5718343,PDN
VR318,,1986,1983,,1431958,34832372,7629889,,235633,13737531,2680034,,1196325,21094841,4949855,PDN
VR318,,1987,1983,,1531662,37484681,8201534,,427336,18978949,3804373,,1104326,18505732,4397161,PDN
VR318,,1988,1983,,1526317,36753150,8066023,,523788,19881856,4061485,,1002529,16871294,4004538,PDN
VR318,,1989,1983,,1526317,36753150,8066023,,624355,20261428,4229591,,901962,16491722,3836432,PDN
VR318,,1990,1983,,1600506,35861474,7981551,,802977,22948399,4886322,,797529,12913075,3095229,PDN
VR318,,1991,1983,,1717827,35827752,8092872,,936383,24560333,5306549,,781444,11267419,2786323,PDN
VR318,,1992,1983,,1637360,32842090,7481148,,1053422,25490675,5589129,,583938,7351415,1892019,PDN
VR318,,1993,1983,,1650710,35602090,7985601,,1165488,27710713,6096220,,485222,7891377,1889381,PDN
VR318,,1994,1983,,1651008,36399718,8127826,,1257891,29479492,6503352,,393117,6920226,1624474,PDN
VR318,,1995,1983,,2104802,73039688,15101188,,1345275,30857687,6835967,,759527,42182001,8265221,PDN
VR318,,1996,1983,,2179712,86029099,17487381,,1510926,39093286,8467027,,668786,46935813,9020354,PDN
VR318,,1997,1983,,2279889,86133839,17606195,,1622613,43219063,9312838,,657276,42914776,8293357,PDN
VR318,,1998,1983,,2277098,85897333,17561321,,1713941,49533122,10527664,,563157,36364211,7033657,PDN
VR318,,1999,1983,,2271480,63841318,13631146,,1834967,52165422,11117071,,436513,11675896,2514075,PDN
VR318,,2000,1983,,2408730,79457761,16547122,,1947364,55962137,11905040,,461366,23495624,4642082,PDN
VR318,,2001,1983,,2583524,68469831,14766768,,2079600,57349730,12284178,,503924,11120101,2482590,PDN
VR318,,2002,1983,,2589098,69894139,15025778,,2172558,58604535,12600411,,416540,11289604,2425367,PDN
VR318,,2003,1983,,2569558,66825714,14460255,,2261189,59762187,12895030,,308369,7063527,1565225,PDN
VR318,,2004,1983,,2582072,66337548,14385906,,2338691,60340257,13075392,,243381,5997291,1310514,PDN
VR318,,2005,1983,,2440369,67983399,14537059,,2385905,60587667,13166629,,54464,7395732,1370430,PDN
VR318,,2006,1983,,2433838,66100511,14195495,,2386242,61040324,13247510,,47596,5060187,947985,PDN
VR318,,2007,1983,,2430449,66103818,14192694,,2389426,61418602,13318003,,41023,4685216,874691,PDN
VR318,,2008,1983,,2388800,61412890,13316360,,2388800,61412890,13316360,,0,0,0,PDN
VR318,,2009,1983,,2388800,62369788,13486628,,2388800,62369788,13486628,,0,0,0,PDN
VR318,,2010,1983,,2388800,62369788,13486628,,2388800,62369788,13486628,,0,0,0,PDN
VR318,,2011,1983,,2388800,62369788,13486628,,2388800,62369788,13486628,,0,0,0,PDN
VR318,,2012,1983,,2388800,62369788,13486628,,2388800,62369788,13486628,,0,0,0,PDN
VR318,,2013,1983,,2388800,62369788,13486628,,2388800,62369788,13486628,,0,0,0,PDN
VR318,,2014,1983,,2388800,62369788,13486628,,2388800,62369788,13486628,,0,0,0,PDN
VR318,,2015,1983,,2388800,62369788,13486628,,2388800,62369788,13486628,,0,0,0,PDN
VR318,,2016,1983,,2388800,62369788,13486628,,2388800,62369788,13486628,,0,0,0,PDN
VR318,,2017,1983,,2388800,62369788,13486628,,2388800,62369788,13486628,,0,0,0,PDN
VR318,,2017,1983,,2388800,62369788,13486628,,2388800,62369788,13486628,,0,0,0,PDN
VR320,,1975,1971,,1562500,200000000,37149689,,339564,59337680,10897870,,1222936,140662320,26251819,PDN
VR320,,1976,1971,,1764706,300000000,55145489,,943262,134022756,24790727,,821444,165977244,30354762,PDN
VR320,,1977,1971,,1764706,300000000,55145489,,1501918,191650061,35603352,,262788,108349939,19542137,PDN
VR320,,1978,1971,,3000000,375000000,69725979,,1997009,238246331,44389595,,1002991,136753669,25336384,PDN
VR320,,1979,1971,,2845428,327119613,61051765,,2327440,275443730,51338780,,517988,51675883,9712985,PDN
VR320,,1980,1971,,3630252,434770883,80991619,,2623446,317455082,59110115,,1006806,117315801,21881504,PDN
VR320,,1981,1971,,3630252,434770883,80991619,,2867694,352789874,65641693,,762558,81981009,15349926,PDN
VR320,,1982,1971,,3725908,474249737,88111982,,3116705,382993135,71264950,,609203,91256602,16847032,PDN
VR320,,1983,1971,,4478255,521752594,97316795,,3380268,403080937,75102855,,1097987,118671657,22213940,PDN
VR320,,1984,1971,,4667664,532428395,99405813,,3662019,426549139,79560442,,1005645,105879256,19845371,PDN
VR320,,1985,1971,,5068860,551001965,103111914,,3887779,446040452,83254407,,1181081,104961513,19857507,PDN
VR320,,1986,1971,,5098887,559074365,104578311,,4094436,465500484,86923704,,1004451,93573881,17654607,PDN
VR320,,1987,1971,,5180602,582851581,108890848,,4316029,486195153,90827622,,864573,96656428,18063226,PDN
VR320,,1988,1971,,5808769,620128824,116151976,,4507718,505774849,94503243,,1301051,114353975,21648733,PDN
VR320,,1989,1971,,5810475,620858910,116283591,,4645948,522240043,97571223,,1164527,98618867,18712368,PDN
VR320,,1990,1971,,5132706,611465651,113934423,,4722917,531096164,99224014,,409789,80369487,14710409,PDN
VR320,,1991,1971,,5164205,613839526,114388320,,4767774,538426147,100573138,,396431,75413379,13815182,PDN
VR320,,1992,1971,,4939485,579104030,107982907,,4814820,551652161,102973568,,124665,27451869,5009339,PDN
VR320,,1993,1971,,4974057,588378284,109667702,,4860461,563879817,105194948,,113596,24498467,4472754,PDN
VR320,,1994,1971,,5158472,614549705,114508953,,4967551,580619266,108280588,,190921,33930439,6228365,PDN
VR320,,1995,1971,,5374413,633724922,118136855,,5043458,597615473,111380731,,330955,36109449,6756124,PDN
VR320,,1996,1971,,5438700,657794236,122483938,,5083705,605932277,112900836,,354995,51861959,9583102,PDN
VR320,,1997,1971,,5373079,644332511,120022992,,5138589,613843856,114363474,,234490,30488655,5659518,PDN
VR320,,1998,1971,,5385011,645442595,120232448,,5193499,627563213,116859551,,191512,17879382,3372897,PDN
VR320,,1999,1971,,5410162,690060901,128196799,,5228845,639488454,119016826,,181317,50572447,9179973,PDN
VR320,,2000,1971,,5611652,707884056,131569670,,5257675,651388495,121163101,,353977,56495561,10406569,PDN
VR320,,2001,1971,,5548027,701329337,130339724,,5281580,662048620,123083826,,266447,39280717,7255898,PDN
VR320,,2002,1971,,5549502,697511922,129661943,,5297278,667322954,124038017,,252224,30188968,5623926,PDN
VR320,,2003,1971,,5687077,706967237,131481959,,5315741,671478557,124795911,,371336,35488680,6686048,PDN
VR320,,2004,1971,,5490474,697113731,129532063,,5349797,678490193,126077589,,140677,18623538,3454474,PDN
VR320,,2005,1971,,5537374,711445515,132129102,,5362908,682173802,126746147,,174466,29271713,5382955,PDN
VR320,,2006,1971,,5548746,708734955,131658168,,5365572,683553019,126994223,,183174,25181936,4663945,PDN
VR320,,2007,1971,,5520898,704568950,130889038,,5376760,685565783,127363554,,144138,19003167,3525484,PDN
VR320,,2008,1971,,5423694,697377715,129512256,,5383103,686768818,127583960,,40591,10608897,1928296,PDN
VR320,,2009,1971,,5458056,703966522,130719006,,5384413,699590603,129866729,,73643,4375919,852276,PDN
VR320,,2010,1971,,5458056,703966522,130719006,,5387912,700068625,129955285,,70144,3897897,763721,PDN
VR320,,2011,1971,,5387912,700068625,129955285,,5387912,700068625,129955285,,0,0,0,PDN
VR320,,2012,1971,,5387912,700068625,129955285,,5387912,700068625,129955285,,0,0,0,PDN
VR320,,2013,1971,,5387912,700068625,129955285,,5387912,700068625,129955285,,0,0,0,PDN
VR320,,2014,1971,,5387912,700068625,129955285,,5387912,700068625,129955285,,0,0,0,PDN
VR320,,2015,1971,,5387912,700068625,129955285,,5387912,700068625,129955285,,0,0,0,PDN
VR320,,2016,1971,,5387912,700068625,129955285,,5387912,700068625,129955285,,0,0,0,PDN
VR320,,2017,1971,,5387912,700068625,129955285,,5387912,700068625,129955285,,0,0,0,PDN
VR320,,2017,1971,,5387912,700068625,129955285,,5387912,700068625,129955285,,0,0,0,PDN
VR328,,1993,1991,,176422,13863826,2643295,,0,0,0,,176422,13863826,2643295,PDN
VR328,,1994,1991,,171731,15327843,2899105,,12800,4837341,873537,,158931,10490502,2025568,PDN
VR328,,1995,1991,,175311,16652409,3138373,,18253,7258418,1309786,,157058,9393991,1828587,PDN
VR328,,1996,1991,,174201,16566922,3122052,,24399,9386625,1694617,,149802,7180297,1427435,PDN
VR328,,1997,1991,,174201,16566922,3122052,,30312,11184567,2020448,,143889,5382355,1101604,PDN
VR328,,1998,1991,,174201,16566922,3122052,,34053,11990744,2167637,,140148,4576178,954415,PDN
VR328,,1999,1991,,39584,12902960,2335484,,35065,12157648,2198348,,4519,745312,137136,PDN
VR328,,2000,1991,,39584,12902960,2335484,,35669,12232926,2212346,,3915,670034,123138,PDN
VR328,,2001,1991,,39562,12896186,2334257,,35985,12282393,2221464,,3577,613793,112793,PDN
VR328,,2002,1991,,39562,12896186,2334257,,36301,12327043,2229725,,3261,569143,104532,PDN
VR328,,2003,1991,,39562,12896186,2334257,,36585,12379356,2239317,,2977,516830,94940,PDN
VR328,,2004,1991,,37197,12556988,2271537,,36693,12411432,2245133,,504,145556,26404,PDN
VR328,,2005,1991,,37089,12542845,2268912,,36729,12425972,2247756,,360,116873,21156,PDN
VR328,,2006,1991,,36729,12425972,2247756,,36729,12425972,2247756,,0,0,0,PDN
VR328,,2007,1991,,36729,12425972,2247756,,36729,12425972,2247756,,0,0,0,PDN
VR328,,2008,1991,,36729,12425972,2247756,,36729,12425972,2247756,,0,0,0,PDN
VR328,,2009,1991,,36729,12664511,2290201,,36729,12664511,2290201,,0,0,0,PDN
VR328,,2010,1991,,36729,12664511,2290201,,36729,12664511,2290201,,0,0,0,PDN
VR328,,2011,1991,,36729,12664511,2290201,,36729,12664511,2290201,,0,0,0,PDN
VR328,,2012,1991,,36729,12664511,2290201,,36729,12664511,2290201,,0,0,0,PDN
VR328,,2013,1991,,36729,12664511,2290201,,36729,12664511,2290201,,0,0,0,PDN
VR328,,2014,1991,,36729,12664511,2290201,,36729,12664511,2290201,,0,0,0,PDN
VR328,,2015,1991,,36729,12664511,2290201,,36729,12664511,2290201,,0,0,0,PDN
VR328,,2016,1991,,36729,12664511,2290201,,36729,12664511,2290201,,0,0,0,PDN
VR328,,2017,1991,,36729,12664511,2290201,,36729,12664511,2290201,,0,0,0,PDN
VR328,,2017,1991,,36729,12664511,2290201,,36729,12664511,2290201,,0,0,0,PDN
VR329,,1977,1976,,457501,105145000,19166576,,0,0,0,,457501,105145000,19166576,PDN
VR329,,1978,1976,,457501,105145000,19166576,,0,0,0,,457501,105145000,19166576,PDN
VR329,,1979,1976,,457501,105145000,19166576,,71,7474112,1329984,,457430,97670888,17836592,PDN
VR329,,1980,1976,,457501,105145000,19166576,,212,19610389,3489605,,457289,85534611,15676971,PDN
VR329,,1981,1976,,457501,105145000,19166576,,270,29327398,5218668,,457231,75817602,13947908,PDN
VR329,,1982,1976,,455593,105505001,19228725,,474,36234361,6447869,,455119,69270640,12780856,PDN
VR329,,1983,1976,,455593,105571897,19240628,,528,40106373,7136893,,455065,65465524,12103735,PDN
VR329,,1984,1976,,455593,105571897,19240628,,588,44699995,7954324,,455005,60871902,11286304,PDN
VR329,,1985,1976,,455680,111911898,20368829,,832,47176449,8395218,,454848,64735449,11973611,PDN
VR329,,1986,1976,,455680,111911898,20368829,,914,48769907,8678833,,454766,63141991,11689996,PDN
VR329,,1987,1976,,346451,94159816,17100867,,951,51369285,9141393,,345500,42790531,7959474,PDN
VR329,,1988,1976,,346451,94159816,17100867,,960,53079024,9445626,,345491,41080792,7655241,PDN
VR329,,1989,1976,,346455,96095896,17445369,,998,54907170,9770957,,345457,41188726,7674412,PDN
VR329,,1990,1976,,346455,96095896,17445369,,998,56322750,10022840,,345457,39773146,7422529,PDN
VR329,,1991,1976,,1060,80646697,14351006,,998,57835175,10291954,,62,22811522,4059052,PDN
VR329,,1992,1976,,1060,80646697,14351006,,998,59777234,10637517,,62,20869463,3713489,PDN
VR329,,1993,1976,,8964,81437133,14499557,,998,61248234,10899260,,7966,20188899,3600297,PDN
VR329,,1994,1976,,20073265,82140297,34688976,,998,63837459,11359976,,20072267,18302838,23329000,PDN
VR329,,1995,1976,,1373,89904195,15998561,,998,66268319,11792514,,375,23635876,4206047,PDN
VR329,,1996,1976,,2571,89521736,15931706,,998,68690944,12223586,,1573,20830792,3708120,PDN
VR329,,1997,1976,,2571,89902310,15999423,,998,70818087,12602081,,1573,19084223,3397342,PDN
VR329,,1998,1976,,2571,89902310,15999423,,998,71390043,12703853,,1573,18512267,3295570,PDN
VR329,,1999,1976,,2733,85813161,15271979,,998,72874083,12967917,,1735,12939078,2304062,PDN
VR329,,2000,1976,,1150,103178285,18360275,,998,76930384,13689678,,152,26247901,4670597,PDN
VR329,,2001,1976,,1150,101725468,18101767,,998,81513560,14505190,,152,20211908,3596577,PDN
VR329,,2002,1976,,1150,97401423,17332364,,998,84138782,14972312,,152,13262641,2360052,PDN
VR329,,2003,1976,,1150,97401423,17332364,,998,85181912,15157922,,152,12219511,2174442,PDN
VR329,,2004,1976,,1150,92004647,16372084,,998,86099015,15321107,,152,5905632,1050977,PDN
VR329,,2005,1976,,1150,91839338,16342669,,998,86786573,15443449,,152,5052765,899220,PDN
VR329,,2006,1976,,1150,91839338,16342669,,998,86786573,15443449,,152,5052765,899220,PDN
VR329,,2007,1976,,10501,92774402,16518402,,998,86786573,15443449,,9503,5987829,1074953,PDN
VR329,,2008,1976,,10501,92774402,16518402,,998,86835643,15452180,,9503,5938759,1066222,PDN
VR329,,2009,1976,,998,88264529,15706432,,998,88264529,15706432,,0,0,0,PDN
VR329,,2010,1976,,998,88264529,15706432,,998,88264529,15706432,,0,0,0,PDN
VR329,,2011,1976,,998,88264529,15706432,,998,88264529,15706432,,0,0,0,PDN
VR329,,2012,1976,,998,88264529,15706432,,998,88264529,15706432,,0,0,0,PDN
VR329,,2013,1976,,998,88264529,15706432,,998,88264529,15706432,,0,0,0,PDN
VR329,,2014,1976,,998,88264529,15706432,,998,88264529,15706432,,0,0,0,PDN
VR329,,2015,1976,,998,88264529,15706432,,998,88264529,15706432,,0,0,0,PDN
VR329,,2016,1976,,998,88264529,15706432,,998,88264529,15706432,,0,0,0,PDN
VR329,,2017,1976,,998,88264529,15706432,,998,88264529,15706432,,0,0,0,PDN
VR329,,2017,1976,,998,88264529,15706432,,998,88264529,15706432,,0,0,0,PDN
VR331,,1977,1974,,4017188,59889406,14673666,,4303,1912,4643,,4012885,59887494,14669023,PDP
VR331,,1978,1974,,4017188,59889406,14673666,,623955,948617,792748,,3393233,58940789,13880918,PDP
VR331,,1979,1974,,4017188,59889406,14673666,,1977254,12547296,4209869,,2039934,47342110,10463797,PDP
VR331,,1980,1974,,9652064,106984369,28688429,,4862365,54258526,14516907,,4789699,52725843,14171522,PDP
VR331,,1981,1974,,9652064,106984369,28688429,,6709607,47244901,15116173,,2942457,59739468,13572256,PDP
VR331,,1982,1974,,10873972,130616912,34115415,,8131422,70002351,20587356,,2742550,60614561,13528059,PDP
VR331,,1983,1974,,15134123,150087972,41840168,,9904896,87718258,25513127,,5229227,62369714,16327041,PDP
VR331,,1984,1974,,18878252,167910624,48755587,,12227740,107466276,31349853,,6650512,60444348,17405734,PDP
VR331,,1985,1974,,27581632,181453784,59868782,,14341213,120153632,35720863,,13240419,61300152,24147919,PDP
VR331,,1986,1974,,30141578,185905124,63220782,,15994300,131616921,39413681,,14147278,54288203,23807101,PDP
VR331,,1987,1974,,31410848,195483311,66194355,,17180849,141468915,42353254,,14229999,54014396,23841101,PDP
VR331,,1988,1974,,30958814,196566277,65935020,,18154854,148944852,44657497,,12803960,47621425,21277523,PDP
VR331,,1989,1974,,32373361,201019774,68142004,,19299377,155931799,47045249,,13073984,45087975,21096755,PDP
VR331,,1990,1974,,27714119,188427123,61242077,,20336012,161007270,48984992,,7378107,27419853,12257085,PDP
VR331,,1991,1974,,27739602,188887842,61349538,,21230866,164198861,50447745,,6508736,24688981,10901793,PDP
VR331,,1992,1974,,27782571,189232640,61453859,,22059751,166058248,51607482,,5722820,23174392,9846377,PDP
VR331,,1993,1974,,27423291,195098990,62138414,,23182468,171362001,53673927,,4240823,23736989,8464487,PDP
VR331,,1994,1974,,27615358,196379240,62558283,,24283617,176265520,55647589,,3331741,20113720,6910694,PDP
VR331,,1995,1974,,29069757,194966331,63761275,,25166362,179669629,57136047,,3903395,15296702,6625228,PDP
VR331,,1996,1974,,29388120,200127301,64997960,,26086932,184301515,58880796,,3301188,15825786,6117164,PDP
VR331,,1997,1974,,29511864,200919269,65262624,,26763712,185591870,59787176,,2748152,15327399,5475448,PDP
VR331,,1998,1974,,29405726,194689371,64047963,,27298918,186373397,60461444,,2106808,8315974,3586519,PDP
VR331,,1999,1974,,29177195,189381003,62874883,,27754239,187231606,61069471,,1422956,2149397,1805412,PDP
VR331,,2000,1974,,29675497,191202885,63697363,,28073489,187929431,61512890,,1602008,3273454,2184473,PDP
VR331,,2001,1974,,29310984,190594538,63224603,,28301631,188460277,61835488,,1009353,2134261,1389115,PDP
VR331,,2002,1974,,30259721,191153188,64272744,,28481950,188866450,62088080,,1777771,2286738,2184664,PDP
VR331,,2003,1974,,30259721,191141801,64270718,,28713143,189283908,62393554,,1546578,1857893,1877164,PDP
VR331,,2004,1974,,30278850,192258667,64488577,,28929756,189646169,62674626,,1349094,2612498,1813951,PDP
VR331,,2005,1974,,30395018,194477099,64999484,,29117180,190125029,62947256,,1277838,4352070,2052228,PDP
VR331,,2006,1974,,31159941,215068277,69428318,,29261244,190495642,63157266,,1898697,24572635,6271052,PDP
VR331,,2007,1974,,30960151,202994465,67080162,,29540625,193651260,63998145,,1419526,9343205,3082017,PDP
VR331,,2008,1974,,30960151,202994465,67080162,,29816188,196933215,64857685,,1143963,6061250,2222477,PDP
VR331,,2009,1974,,31044594,203998255,67343218,,30033222,201748215,65931481,,1011372,2250040,1411736,PDP
VR331,,2010,1974,,31044594,203998255,67343218,,30246962,202660239,66307505,,797632,1338016,1035712,PDP
VR331,,2011,1974,,31044594,203998255,67343218,,30451958,203162209,66601819,,592636,836046,741399,PDP
VR331,,2012,1974,,31770761,204163220,68098736,,30680010,203323995,66858657,,1090751,839225,1240078,PDP
VR331,,2013,1974,,31770761,204163220,68098736,,30885535,203449718,67086554,,885226,713502,1012185,PDP
VR331,,2014,1974,,31771480,204268373,68118166,,31023787,203552309,67243059,,747693,716064,875106,PDP
VR331,,2015,1974,,31681449,204308354,68035248,,31170076,203672626,67410757,,511373,635728,624494,PDP
VR331,,2016,1974,,31744853,204207552,68080717,,31286840,203725822,67536987,,458013,481730,543731,PDP
VR331,,2017,1974,,31744592,204203052,68079655,,31385797,203728395,67636402,,358795,474657,443254,PDP
VR331,,2017,1974,,31744592,204203052,68079655,,31385797,203728395,67636402,,358795,474657,443254,PDP
VR332,,1994,1993,,7437947,22107972,11371750,,0,0,0,,7437947,22107972,11371750,PDP
VR332,,1995,1993,,8079720,22629284,12106283,,70116,90828,86278,,8009604,22538456,12020005,PDP
VR332,,1996,1993,,8324967,22677171,12360051,,1241168,5486959,2217495,,7083799,17190212,10142556,PDP
VR332,,1997,1993,,5799047,26243865,10468774,,2143003,8786013,3706351,,3656044,17457852,6762423,PDP
VR332,,1998,1993,,5799047,26243865,10468774,,2728943,10077099,4522021,,3070104,16166766,5946753,PDP
VR332,,1999,1993,,6004552,15192680,8707876,,3272175,11102599,5247726,,2732377,4090081,3460150,PDP
VR332,,2000,1993,,6004552,15192680,8707876,,3646651,11844364,5754189,,2357901,3348316,2953687,PDP
VR332,,2001,1993,,6120692,15248517,8833951,,3980057,12402066,6186830,,2140635,2846451,2647121,PDP
VR332,,2002,1993,,6120692,15248517,8833951,,4166808,12650123,6417720,,1953884,2598394,2416231,PDP
VR332,,2003,1993,,5801911,21383096,9606732,,4367117,14529109,6952368,,1434794,6853987,2654364,PDP
VR332,,2004,1993,,6279831,18584063,9586604,,4510776,15660240,7297296,,1769055,2923823,2289308,PDP
VR332,,2005,1993,,7771309,19775147,11290018,,4630111,15926860,7464072,,3141198,3848287,3825946,PDP
VR332,,2006,1993,,7925066,20900085,11643942,,4869163,16195605,7750943,,3055903,4704480,3892999,PDP
VR332,,2007,1993,,7466352,20426369,11100937,,5304951,16839141,8301239,,2161401,3587228,2799698,PDP
VR332,,2008,1993,,7466352,20426369,11100937,,5461812,16971446,8481642,,2004540,3454923,2619295,PDP
VR332,,2009,1993,,6919111,19380653,10367625,,5832682,17818003,9003144,,1086429,1562650,1364480,PDP
VR332,,2010,1993,,6919111,19380653,10367625,,6097085,18051599,9309112,,822026,1329054,1058513,PDP
VR332,,2011,1993,,7421163,19260104,10848226,,6288919,18192344,9525990,,1132244,1067760,1322236,PDP
VR332,,2012,1993,,7421163,19260104,10848226,,6441907,18330383,9703539,,979256,929721,1144686,PDP
VR332,,2013,1993,,7421163,19260104,10848226,,6580935,18457031,9865102,,840228,803073,983123,PDP
VR332,,2014,1993,,7421163,19260104,10848226,,6703695,18549959,10004399,,717468,710145,843828,PDP
VR332,,2015,1993,,7421163,19260104,10848226,,6813137,18630972,10128255,,608026,629132,719971,PDP
VR332,,2016,1993,,7706873,19397908,11158455,,6922124,18709656,10251244,,784749,688252,907213,PDP
VR332,,2017,1993,,7706873,19397908,11158455,,7016855,18784977,10359376,,690018,612931,799080,PDP
VR332,,2017,1993,,7706873,19397908,11158455,,7016855,18784977,10359376,,690018,612931,799080,PDP
VR335,,1998,1998,,13459,3929886,712727,,0,0,0,,13459,3929886,712727,PDN
VR335,,1999,1998,,908546,15309905,3632728,,110729,1865907,442741,,797817,13443998,3189987,PDN
VR335,,2000,1998,,908546,15309905,3632728,,442794,7208433,1725433,,465752,8101472,1907295,PDN
VR335,,2001,1998,,908546,15309905,3632728,,593896,9809811,2339414,,314650,5500094,1293314,PDN
VR335,,2002,1998,,908546,15309905,3632728,,633397,10374408,2479377,,275149,4935497,1153351,PDN
VR335,,2003,1998,,908546,15309905,3632728,,663322,10823747,2589256,,245224,4486158,1043472,PDN
VR335,,2004,1998,,908554,15310038,3632760,,702403,11376121,2726624,,206151,3933917,906136,PDN
VR335,,2005,1998,,944015,15310038,3668221,,769373,12292592,2956667,,174642,3017446,711554,PDN
VR335,,2006,1998,,814745,13066221,3139695,,814745,13066221,3139695,,0,0,0,PDN
VR335,,2007,1998,,814745,13066221,3139695,,814745,13066221,3139695,,0,0,0,PDN
VR335,,2008,1998,,814745,13066221,3139695,,814745,13066221,3139695,,0,0,0,PDN
VR335,,2009,1998,,814745,13066221,3139695,,814745,13066221,3139695,,0,0,0,PDN
VR335,,2010,1998,,814745,13066221,3139695,,814745,13066221,3139695,,0,0,0,PDN
VR335,,2011,1998,,814745,13066221,3139695,,814745,13066221,3139695,,0,0,0,PDN
VR335,,2012,1998,,814745,13066221,3139695,,814745,13066221,3139695,,0,0,0,PDN
VR335,,2013,1998,,814745,13066221,3139695,,814745,13066221,3139695,,0,0,0,PDN
VR335,,2014,1998,,814745,13066221,3139695,,814745,13066221,3139695,,0,0,0,PDN
VR335,,2015,1998,,814745,13066221,3139695,,814745,13066221,3139695,,0,0,0,PDN
VR335,,2016,1998,,814745,13066221,3139695,,814745,13066221,3139695,,0,0,0,PDN
VR335,,2017,1998,,814745,13066221,3139695,,814745,13066221,3139695,,0,0,0,PDN
VR335,,2017,1998,,814745,13066221,3139695,,814745,13066221,3139695,,0,0,0,PDN
VR336,,1998,1997,,143321,217561,182033,,0,0,0,,143321,217561,182033,PDN
VR336,,1999,1997,,576870,7960167,1993270,,133,2346,550,,576737,7957821,1992720,PDN
VR336,,2000,1997,,577127,7964582,1994313,,93515,1613956,380696,,483612,6350626,1613617,PDN
VR336,,2001,1997,,308500,3943825,1010248,,117734,2220743,512884,,190766,1723082,497364,PDN
VR336,,2002,1997,,272169,3943825,973917,,119885,2450766,555964,,152284,1493059,417953,PDN
VR336,,2003,1997,,263203,2985061,794353,,119885,2450766,555964,,143318,534295,238389,PDN
VR336,,2004,1997,,119885,2450766,555964,,119885,2450766,555964,,0,0,0,PDN
VR336,,2005,1997,,119885,2450766,555964,,119885,2450766,555964,,0,0,0,PDN
VR336,,2006,1997,,119885,2450766,555964,,119885,2450766,555964,,0,0,0,PDN
VR336,,2007,1997,,119885,2450766,555964,,119885,2450766,555964,,0,0,0,PDN
VR336,,2008,1997,,119885,2450766,555964,,119885,2450766,555964,,0,0,0,PDN
VR336,,2009,1997,,119885,2450766,555964,,119885,2450766,555964,,0,0,0,PDN
VR336,,2010,1997,,119885,2450766,555964,,119885,2450766,555964,,0,0,0,PDN
VR336,,2011,1997,,119885,2450766,555964,,119885,2450766,555964,,0,0,0,PDN
VR336,,2012,1997,,119885,2450766,555964,,119885,2450766,555964,,0,0,0,PDN
VR336,,2013,1997,,119885,2450766,555964,,119885,2450766,555964,,0,0,0,PDN
VR336,,2014,1997,,119885,2450766,555964,,119885,2450766,555964,,0,0,0,PDN
VR336,,2015,1997,,119885,2450766,555964,,119885,2450766,555964,,0,0,0,PDN
VR336,,2016,1997,,119885,2450766,555964,,119885,2450766,555964,,0,0,0,PDN
VR336,,2017,1997,,119885,2450766,555964,,119885,2450766,555964,,0,0,0,PDN
VR336,,2017,1997,,119885,2450766,555964,,119885,2450766,555964,,0,0,0,PDN
VR340,,1975,1971,,2000000,46000000,10185053,,0,0,0,,2000000,46000000,10185053,PDN
VR340,,1976,1971,,3451160,33170000,9353295,,0,0,0,,3451160,33170000,9353295,PDN
VR340,,1977,1971,,3451160,33170000,9353295,,0,0,0,,3451160,33170000,9353295,PDN
VR340,,1978,1971,,3451160,33875000,9478740,,1533,513,1624,,3449627,33874487,9477116,PDN
VR340,,1979,1971,,4693160,39563522,11732933,,714437,4869570,1580909,,3978723,34693952,10152024,PDN
VR340,,1980,1971,,5212160,40228640,12370281,,1518615,10928234,3463141,,3693545,29300406,8907140,PDN
VR340,,1981,1971,,5296292,40387184,12482624,,2163002,16245690,5053694,,3133290,24141494,7428930,PDN
VR340,,1982,1971,,5805457,49487220,14611012,,2824202,23024275,6921048,,2981255,26462945,7689964,PDN
VR340,,1983,1971,,6009205,54659409,15735078,,3209359,27902545,8174225,,2799846,26756864,7560853,PDN
VR340,,1984,1971,,6283576,56285853,16298852,,3532626,31463803,9131167,,2750950,24822050,7167685,PDN
VR340,,1985,1971,,6542436,58485851,16949171,,3902658,33558418,9873907,,2639778,24927433,7075264,PDN
VR340,,1986,1971,,6870436,56804600,16978016,,4190679,35018684,10421762,,2679757,21785916,6556254,PDN
VR340,,1987,1971,,8603954,77688823,22427588,,4413301,38938689,11341893,,4190653,38750134,11085695,PDN
VR340,,1988,1971,,6150246,74944719,19485605,,4603185,43505582,12344392,,1547061,31439137,7141213,PDN
VR340,,1989,1971,,6150246,74944719,19485605,,4759205,45909152,12928093,,1391041,29035567,6557512,PDN
VR340,,1990,1971,,6150246,74944719,19485605,,4881584,47302606,13298418,,1268662,27642113,6187187,PDN
VR340,,1991,1971,,6234846,64746059,17755497,,4977714,48817050,13664022,,1257132,15929009,4091475,PDN
VR340,,1992,1971,,5707846,68697169,17931542,,5093660,54663780,14820311,,614186,14033389,3111231,PDN
VR340,,1993,1971,,5797256,86791170,21240525,,5210157,61081081,16078677,,587099,25710089,5161848,PDN
VR340,,1994,1971,,5796898,87438201,21355297,,5312009,69770812,17726744,,484889,17667389,3628553,PDN
VR340,,1995,1971,,6148554,91620981,22451220,,5382772,76433394,18983020,,765782,15187587,3468200,PDN
VR340,,1996,1971,,6535170,98579908,24076079,,5427193,80224034,19701932,,1107977,18355874,4374147,PDN
VR340,,1997,1971,,5804172,102752935,24087612,,5472785,82999286,20241341,,331387,19753649,3846271,PDN
VR340,,1998,1971,,6131345,121876118,27817487,,5602572,89672400,21558515,,528773,32203718,6258972,PDN
VR340,,1999,1971,,6123039,121446275,27732696,,5690901,93897289,22398604,,432138,27548986,5334092,PDN
VR340,,2000,1971,,6127690,114988821,26588334,,5761658,96438678,22921565,,366032,18550143,3666769,PDN
VR340,,2001,1971,,5950449,114558290,26334486,,5802588,97878641,23218716,,147861,16679649,3115770,PDN
VR340,,2002,1971,,5959883,114314544,26300549,,5831710,98789509,23409914,,128173,15525035,2890635,PDN
VR340,,2003,1971,,6030704,110353179,25666501,,5841972,99175432,23488846,,188732,11177747,2177655,PDN
VR340,,2004,1971,,6050313,108693895,25390864,,5870716,99657900,23603438,,179597,9035995,1787426,PDN
VR340,,2005,1971,,6123849,109961396,25689934,,5910159,99893324,23684772,,213690,10068072,2005162,PDN
VR340,,2006,1971,,5972848,113716657,26207129,,5910159,99893324,23684772,,62689,13823333,2522357,PDN
VR340,,2007,1971,,6071653,115077264,26548034,,5927675,101643347,24013680,,143978,13433917,2534354,PDN
VR340,,2008,1971,,6071653,115077264,26548034,,5950289,102670702,24219097,,121364,12406562,2328937,PDN
VR340,,2009,1971,,6082469,114962681,26538463,,5975803,105145602,24684985,,106666,9817079,1853476,PDN
VR340,,2010,1971,,6082469,114962681,26538463,,5992162,105518020,24767611,,90307,9444661,1770852,PDN
VR340,,2011,1971,,5999300,105587990,24787200,,5999300,105587990,24787200,,0,0,0,PDN
VR340,,2012,1971,,5999300,105587990,24787200,,5999300,105587990,24787200,,0,0,0,PDN
VR340,,2013,1971,,5999300,105587990,24787200,,5999300,105587990,24787200,,0,0,0,PDN
VR340,,2014,1971,,5999300,105587990,24787200,,5999300,105587990,24787200,,0,0,0,PDN
VR340,,2015,1971,,5999300,105587990,24787200,,5999300,105587990,24787200,,0,0,0,PDN
VR340,,2016,1971,,5999300,105587990,24787200,,5999300,105587990,24787200,,0,0,0,PDN
VR340,,2017,1971,,5999300,105587990,24787200,,5999300,105587990,24787200,,0,0,0,PDN
VR340,,2017,1971,,5999300,105587990,24787200,,5999300,105587990,24787200,,0,0,0,PDN
VR342,,1976,1975,,0,2800000,498221,,0,0,0,,0,2800000,498221,PDP
VR342,,1977,1975,,0,2800000,498221,,0,0,0,,0,2800000,498221,PDP
VR342,,1989,1975,,59412,12854543,2346697,,15761,3976779,723373,,43651,8877764,1623324,PDP
VR342,,1990,1975,,59412,12854543,2346697,,23821,6328549,1149897,,35591,6525994,1196800,PDP
VR342,,1991,1975,,59412,12854543,2346697,,27701,8663337,1569220,,31711,4191206,777477,PDP
VR342,,1992,1975,,31085,9721613,1760909,,27699,8663350,1569220,,3386,1058263,191689,PDP
VR342,,1993,1975,,31085,9721613,1760909,,27699,8663350,1569220,,3386,1058263,191689,PDP
VR342,,1994,1975,,31085,9721613,1760909,,27699,8663350,1569220,,3386,1058263,191689,PDP
VR342,,1995,1975,,27699,8663350,1569220,,27699,8663350,1569220,,0,0,0,PDP
VR342,,1996,1975,,27699,8663350,1569220,,27699,8663350,1569220,,0,0,0,PDP
VR342,,1997,1975,,27699,8663350,1569220,,27699,8663350,1569220,,0,0,0,PDP
VR342,,1998,1975,,27699,8663350,1569220,,27699,8663350,1569220,,0,0,0,PDP
VR342,,1999,1975,,83915,10068757,1875509,,27699,8663350,1569220,,56216,1405407,306289,PDP
VR342,,2000,1975,,142665,25434800,4668430,,41722,10709032,1947244,,100943,14725768,2721186,PDP
VR342,,2001,1975,,142702,25440258,4669438,,52333,13219550,2404566,,90369,12220708,2264872,PDP
VR342,,2002,1975,,122060,17175437,3178188,,60421,14052245,2560820,,61639,3123192,617368,PDP
VR342,,2003,1975,,122060,17175437,3178188,,75829,14832954,2715145,,46231,2342483,463043,PDP
VR342,,2004,1975,,122060,17175437,3178188,,94093,15405726,2835325,,27967,1769711,342863,PDP
VR342,,2005,1975,,110411,16454680,3038290,,104160,15804715,2916387,,6251,649965,121903,PDP
VR342,,2006,1975,,159075,19107050,3558906,,104246,15819382,2919083,,54829,3287668,639823,PDP
VR342,,2007,1975,,159075,19107050,3558906,,111055,16265874,3005339,,48020,2841176,553567,PDP
VR342,,2008,1975,,159075,19107050,3558906,,117584,16717343,3092200,,41491,2389707,466706,PDP
VR342,,2009,1975,,159075,19280551,3589778,,118240,17024879,3147578,,40835,2255672,442200,PDP
VR342,,2010,1975,,159075,19280551,3589778,,120646,17563974,3245908,,38429,1716577,343870,PDP
VR342,,2011,1975,,159075,19280551,3589778,,123116,18145728,3351893,,35959,1134823,237885,PDP
VR342,,2012,1975,,159075,19280551,3589778,,125518,18478675,3413538,,33557,801876,176240,PDP
VR342,,2013,1975,,1391269,21960520,5298835,,401674,19154309,3809914,,989595,2806211,1488920,PDP
VR342,,2014,1975,,2223143,22360929,6201956,,633577,19726618,4143651,,1589566,2634311,2058304,PDP
VR342,,2015,1975,,2223143,22360929,6201956,,1473511,20617912,5142177,,749632,1743017,1059777,PDP
VR342,,2016,1975,,3316704,23022386,7413214,,2126046,21317898,5919267,,1190658,1704488,1493947,PDP
VR342,,2017,1975,,3316704,23022386,7413214,,2821459,22024397,6740391,,495245,997989,672823,PDP
VR342,,2017,1975,,3316704,23022386,7413214,,2821459,22024397,6740391,,495245,997989,672823,PDP
VR348,,1979,1973,,4025500,31100000,9559308,,0,0,0,,4025500,31100000,9559308,PDN
VR348,,1980,1973,,4026400,32000000,9720350,,0,0,0,,4026400,32000000,9720350,PDN
VR348,,1981,1973,,4026400,32000000,9720350,,0,0,0,,4026400,32000000,9720350,PDN
VR348,,1982,1973,,4026400,32000000,9720350,,101391,6048986,1177723,,3925009,25951014,8542627,PDN
VR348,,1983,1973,,14122268,80161708,28385917,,214934,12130019,2373300,,13907334,68031689,26012617,PDN
VR348,,1984,1973,,14122268,80161708,28385917,,268204,16364022,3179952,,13854064,63797686,25205965,PDN
VR348,,1985,1973,,4198684,59776356,14835046,,313720,21718463,4178215,,3884964,38057893,10656831,PDN
VR348,,1986,1973,,4198684,59776356,14835046,,355842,26054860,4991938,,3842842,33721496,9843108,PDN
VR348,,1987,1973,,4199696,61902202,15214323,,389471,29711967,5676298,,3810225,32190235,9538025,PDN
VR348,,1988,1973,,4220932,71437885,16932299,,413400,32753336,6241396,,3807532,38684549,10690903,PDN
VR348,,1989,1973,,4220932,71437885,16932299,,434554,36879995,6996831,,3786378,34557890,9935468,PDN
VR348,,1990,1973,,4202386,82001149,18793338,,453824,39963034,7564684,,3748562,42038115,11228654,PDN
VR348,,1991,1973,,554137,51129919,9651987,,469765,42263336,7989932,,84372,8866583,1662055,PDN
VR348,,1992,1973,,560398,51417543,9709427,,487138,43596555,8244532,,73260,7820988,1464895,PDN
VR348,,1993,1973,,585967,51417543,9734996,,499303,44174690,8359568,,86664,7242853,1375428,PDN
VR348,,1994,1973,,585967,51417543,9734996,,499764,44658518,8446120,,86203,6759025,1288876,PDN
VR348,,1995,1973,,585967,51417543,9734996,,500079,45099026,8524817,,85888,6318517,1210179,PDN
VR348,,1996,1973,,560074,46374519,8811768,,500419,45446723,8587025,,59655,927796,224743,PDN
VR348,,1997,1973,,560074,46374519,8811768,,500533,45621256,8618194,,59541,753263,193574,PDN
VR348,,1998,1973,,513076,52595546,9871714,,502602,46249801,8732104,,10474,6345745,1139610,PDN
VR348,,1999,1973,,676363,54098098,10302359,,541346,49021042,9263951,,135017,5077056,1038408,PDN
VR348,,2000,1973,,551892,49204122,9307074,,544976,49195964,9298706,,6916,8158,8368,PDN
VR348,,2001,1973,,544976,49195964,9298706,,544976,49195964,9298706,,0,0,0,PDN
VR348,,2002,1973,,544976,49195964,9298706,,544976,49195964,9298706,,0,0,0,PDN
VR348,,2003,1973,,544976,49195964,9298706,,544976,49195964,9298706,,0,0,0,PDN
VR348,,2004,1973,,544976,49195964,9298706,,544976,49195964,9298706,,0,0,0,PDN
VR348,,2005,1973,,544976,49195964,9298706,,544976,49195964,9298706,,0,0,0,PDN
VR348,,2006,1973,,569366,51634961,9757081,,544976,49195964,9298706,,24390,2438997,458375,PDN
VR348,,2007,1973,,569366,51634961,9757081,,544976,49195964,9298706,,24390,2438997,458375,PDN
VR348,,2008,1973,,549415,57050543,10700757,,548162,50035187,9451220,,1253,7015356,1249537,PDN
VR348,,2009,1973,,549428,58088075,10885385,,548764,51740114,9755190,,664,6347961,1130194,PDN
VR348,,2010,1973,,549428,58088075,10885385,,548815,52931797,9967285,,613,5156278,918100,PDN
VR348,,2011,1973,,548815,53432171,10056319,,548815,53432171,10056319,,0,0,0,PDN
VR348,,2012,1973,,548815,53432171,10056319,,548815,53432171,10056319,,0,0,0,PDN
VR348,,2013,1973,,548815,53432171,10056319,,548815,53432171,10056319,,0,0,0,PDN
VR348,,2014,1973,,548815,53432171,10056319,,548815,53432171,10056319,,0,0,0,PDN
VR348,,2015,1973,,548815,53432171,10056319,,548815,53432171,10056319,,0,0,0,PDN
VR348,,2016,1973,,548815,53432171,10056319,,548815,53432171,10056319,,0,0,0,PDN
VR348,,2017,1973,,548815,53432171,10056319,,548815,53432171,10056319,,0,0,0,PDN
VR348,,2017,1973,,548815,53432171,10056319,,548815,53432171,10056319,,0,0,0,PDN
VR355,,1995,1979,,113685,33196017,6020450,,3134,867986,157580,,110551,32328031,5862870,PDN
VR355,,1996,1979,,57146,16686633,3026298,,15771,4932377,893418,,41375,11754256,2132880,PDN
VR355,,1997,1979,,57146,16686633,3026298,,28744,8722984,1580876,,28402,7963649,1445422,PDN
VR355,,1998,1979,,57146,16686633,3026298,,41471,12861181,2329937,,15675,3825452,696361,PDN
VR355,,1999,1979,,57146,16686633,3026298,,46506,14110359,2557246,,10640,2576274,469052,PDN
VR355,,2000,1979,,48997,14609700,2648588,,47464,14302387,2592373,,1533,307313,56215,PDN
VR355,,2001,1979,,48679,14458810,2621421,,48182,14424481,2614816,,497,34329,6605,PDN
VR355,,2002,1979,,63068,15897724,2891845,,48668,14453744,2620509,,14400,1443980,271336,PDN
VR355,,2003,1979,,48702,14682090,2661174,,48679,14495841,2628010,,23,186249,33164,PDN
VR355,,2004,1979,,48679,14551744,2637957,,48679,14550992,2637823,,0,752,134,PDN
VR355,,2005,1979,,48679,14551744,2637957,,48679,14551744,2637957,,0,0,0,PDN
VR355,,2006,1979,,48679,14551744,2637957,,48679,14551744,2637957,,0,0,0,PDN
VR355,,2007,1979,,48679,14551744,2637957,,48679,14551744,2637957,,0,0,0,PDN
VR355,,2008,1979,,48679,14551744,2637957,,48679,14551744,2637957,,0,0,0,PDN
VR355,,2009,1979,,48679,14782626,2679039,,48679,14782626,2679039,,0,0,0,PDN
VR355,,2010,1979,,48679,14782626,2679039,,48679,14782626,2679039,,0,0,0,PDN
VR355,,2011,1979,,48679,14782626,2679039,,48679,14782626,2679039,,0,0,0,PDN
VR355,,2012,1979,,48679,14782626,2679039,,48679,14782626,2679039,,0,0,0,PDN
VR355,,2013,1979,,48679,14782626,2679039,,48679,14782626,2679039,,0,0,0,PDN
VR355,,2014,1979,,48679,14782626,2679039,,48679,14782626,2679039,,0,0,0,PDN
VR355,,2015,1979,,48679,14782626,2679039,,48679,14782626,2679039,,0,0,0,PDN
VR355,,2016,1979,,48679,14782626,2679039,,48679,14782626,2679039,,0,0,0,PDN
VR355,,2017,1979,,48679,14782626,2679039,,48679,14782626,2679039,,0,0,0,PDN
VR355,,2017,1979,,48679,14782626,2679039,,48679,14782626,2679039,,0,0,0,PDN
VR359,,1989,1988,,0,79461344,14139029,,0,0,0,,0,79461344,14139029,PDN
VR359,,1990,1988,,0,79461344,14139029,,0,1603088,285247,,0,77858256,13853782,PDN
VR359,,1991,1988,,45404,79461344,14184433,,12265,22345709,3988370,,33139,57115635,10196063,PDN
VR359,,1992,1988,,45404,79461344,14184433,,22465,41986010,7493285,,22939,37475334,6691148,PDN
VR359,,1993,1988,,50025,92117888,16441108,,35889,66866833,11933902,,14136,25251055,4507206,PDN
VR359,,1994,1988,,58836,128156961,22862566,,41077,80413546,14349537,,17759,47743415,8513029,PDN
VR359,,1995,1988,,58836,128156961,22862566,,45889,95028415,16954860,,12947,33128546,5907706,PDN
VR359,,1996,1988,,56010,118237423,21094697,,48372,99303565,17718045,,7638,18933858,3376652,PDN
VR359,,1997,1988,,48678,99977150,17838206,,48676,99973194,17837501,,2,3956,705,PDN
VR359,,1998,1988,,48678,99977150,17838206,,48678,99977150,17838206,,0,0,0,PDN
VR359,,1999,1988,,48678,99977150,17838206,,48678,99977150,17838206,,0,0,0,PDN
VR359,,2000,1988,,48678,99977150,17838206,,48678,99977150,17838206,,0,0,0,PDN
VR359,,2001,1988,,48678,99977150,17838206,,48678,99977150,17838206,,0,0,0,PDN
VR359,,2002,1988,,48678,99977150,17838206,,48678,99977150,17838206,,0,0,0,PDN
VR359,,2003,1988,,48678,99977150,17838206,,48678,99977150,17838206,,0,0,0,PDN
VR359,,2004,1988,,48678,99977150,17838206,,48678,99977150,17838206,,0,0,0,PDN
VR359,,2005,1988,,48678,99977150,17838206,,48678,99977150,17838206,,0,0,0,PDN
VR359,,2006,1988,,48678,99977150,17838206,,48678,99977150,17838206,,0,0,0,PDN
VR359,,2007,1988,,48678,99977150,17838206,,48678,99977150,17838206,,0,0,0,PDN
VR359,,2008,1988,,48678,99977150,17838206,,48678,99977150,17838206,,0,0,0,PDN
VR359,,2009,1988,,48678,101979413,18194481,,48678,101979413,18194481,,0,0,0,PDN
VR359,,2010,1988,,48678,101979413,18194481,,48678,101979413,18194481,,0,0,0,PDN
VR359,,2011,1988,,48678,101979413,18194481,,48678,101979413,18194481,,0,0,0,PDN
VR359,,2012,1988,,48678,101979413,18194481,,48678,101979413,18194481,,0,0,0,PDN
VR359,,2013,1988,,48678,101979413,18194481,,48678,101979413,18194481,,0,0,0,PDN
VR359,,2014,1988,,48678,101979413,18194481,,48678,101979413,18194481,,0,0,0,PDN
VR359,,2015,1988,,48678,101979413,18194481,,48678,101979413,18194481,,0,0,0,PDN
VR359,,2016,1988,,48678,101979413,18194481,,48678,101979413,18194481,,0,0,0,PDN
VR359,,2017,1988,,48678,101979413,18194481,,48678,101979413,18194481,,0,0,0,PDN
VR359,,2017,1988,,48678,101979413,18194481,,48678,101979413,18194481,,0,0,0,PDN
VR369,,1977,1976,,545021,70100000,13018331,,0,0,0,,545021,70100000,13018331,PDP
VR369,,1978,1976,,5886101,14806175,8520652,,0,0,0,,5886101,14806175,8520652,PDP
VR369,,1979,1976,,5886101,14806175,8520652,,0,0,0,,5886101,14806175,8520652,PDP
VR369,,1980,1976,,5886101,14806175,8520652,,905,1450,1163,,5885196,14804725,8519489,PDP
VR369,,1981,1976,,8444861,24996762,12892683,,133952,221253,173321,,8310909,24775509,12719362,PDP
VR369,,1982,1976,,9118356,25218221,13605584,,796430,3099705,1347979,,8321926,22118516,12257605,PDP
VR369,,1983,1976,,11017117,36693271,17546169,,2166782,10497989,4034752,,8850335,26195282,13511417,PDP
VR369,,1984,1976,,9172939,48125679,17736227,,2895480,17169222,5950502,,6277459,30956457,11785725,PDP
VR369,,1985,1976,,9290891,48853338,17983656,,3642915,19446182,7103090,,5647976,29407156,10880566,PDP
VR369,,1986,1976,,9901565,49064861,18631967,,4288699,20658760,7964635,,5612866,28406101,10667332,PDP
VR369,,1987,1976,,12477079,52266511,21777170,,4812894,21486213,8636064,,7664185,30780298,13141106,PDP
VR369,,1988,1976,,12057692,53339268,21548665,,5434739,22345837,9410867,,6622953,30993431,12137798,PDP
VR369,,1989,1976,,11442966,54746944,21184415,,6155098,23197433,10282755,,5287868,31549511,10901660,PDP
VR369,,1990,1976,,10452004,52231472,19745860,,6910123,24526275,11274229,,3541881,27705197,8471631,PDP
VR369,,1991,1976,,10188586,32822467,16028883,,7383851,25703043,11957346,,2804735,7119424,4071537,PDP
VR369,,1992,1976,,10188586,33348586,16122498,,7730576,26816062,12502117,,2458010,6532524,3620381,PDP
VR369,,1993,1976,,10188960,33829110,16208375,,8006749,27376505,12878013,,2182211,6452605,3330362,PDP
VR369,,1994,1976,,10324910,35856011,16704983,,8214787,27777670,13157433,,2110123,8078341,3547550,PDP
VR369,,1995,1976,,10445907,45358082,18516740,,8459769,33978480,14505762,,1986138,11379602,4010978,PDP
VR369,,1996,1976,,12686626,52273308,21987926,,8740902,39779994,15819193,,3945724,12493314,6168733,PDP
VR369,,1997,1976,,12335745,55420657,22197072,,8954284,42813442,16572334,,3381461,12607215,5624738,PDP
VR369,,1998,1976,,12335745,55420657,22197072,,9131527,43388435,16851889,,3204218,12032222,5345183,PDP
VR369,,1999,1976,,12313420,59059248,22822183,,9268785,44084301,17112967,,3044635,14974947,5709216,PDP
VR369,,2000,1976,,10542719,54862050,20304650,,9375592,44442057,17283431,,1167127,10419993,3021219,PDP
VR369,,2001,1976,,10237245,62238408,21311695,,9481274,45067406,17500385,,755971,17171002,3811310,PDP
VR369,,2002,1976,,10282196,56241940,20289659,,9561156,45989999,17744430,,721040,10251941,2545229,PDP
VR369,,2003,1976,,10284219,56265696,20295909,,9655127,46654062,17956562,,629092,9611634,2339347,PDP
VR369,,2004,1976,,10081447,54349416,19752162,,9740357,47092717,18119844,,341090,7256699,1632318,PDP
VR369,,2005,1976,,10260910,54292397,19921479,,9793177,47302833,18210051,,467733,6989564,1711428,PDP
VR369,,2006,1976,,10299708,54639727,20022080,,9827321,47388949,18259518,,472387,7250778,1762562,PDP
VR369,,2007,1976,,10178420,54215853,19825369,,9898389,47626678,18372887,,280031,6589175,1452482,PDP
VR369,,2008,1976,,10180001,54212528,19826358,,9942909,47767788,18442515,,237092,6444740,1383843,PDP
VR369,,2009,1976,,10566912,51917543,19804909,,9942909,48634337,18596704,,624003,3283206,1208204,PDP
VR369,,2010,1976,,10566912,51917543,19804909,,9942909,48634337,18596704,,624003,3283206,1208204,PDP
VR369,,2011,1976,,10566912,51917543,19804909,,10015587,48782759,18695792,,551325,3134784,1109118,PDP
VR369,,2012,1976,,10566912,51917543,19804909,,10090252,48865850,18785243,,476660,3051693,1019667,PDP
VR369,,2013,1976,,10354937,52286354,19658558,,10140695,49025030,18864011,,214242,3261324,794550,PDP
VR369,,2014,1976,,10354937,52286354,19658558,,10178957,49145348,18923681,,175980,3141006,734879,PDP
VR369,,2015,1976,,10504857,52734126,19888152,,10229491,49298405,19001449,,275366,3435721,886706,PDP
VR369,,2016,1976,,10516886,52802108,19912279,,10282095,49460300,19082859,,234791,3341808,829421,PDP
VR369,,2017,1976,,10558063,52646724,19925806,,10380827,49673276,19219488,,177236,2973448,706322,PDP
VR369,,2017,1976,,10558063,52646724,19925806,,10380827,49673276,19219488,,177236,2973448,706322,PDP
VR370,,1977,1973,,3500000,7000000,4745552,,0,0,0,,3500000,7000000,4745552,PDP
VR370,,1978,1973,,2675044,12204098,4846592,,0,0,0,,2675044,12204098,4846592,PDP
VR370,,1979,1973,,2675044,12204098,4846592,,0,0,0,,2675044,12204098,4846592,PDP
VR370,,1980,1973,,2675044,12204098,4846592,,0,829764,147645,,2675044,11374334,4698947,PDP
VR370,,1981,1973,,4361245,46041098,12553611,,120606,13952941,2603336,,4240639,32088157,9950275,PDP
VR370,,1982,1973,,4440532,117456098,25340194,,404,25396844,4519415,,4440128,92059254,20820779,PDP
VR370,,1983,1973,,4633915,86301159,19989993,,9877,33953505,6051426,,4624038,52347654,13938567,PDP
VR370,,1984,1973,,4664691,91100801,20874798,,37824,45071345,8057636,,4626867,46029456,12817162,PDP
VR370,,1985,1973,,4433233,87727381,20043087,,60172,51657081,9251823,,4373061,36070300,10791264,PDP
VR370,,1986,1973,,4555257,101561600,22626716,,81193,57215485,10261884,,4474064,44346115,12364832,PDP
VR370,,1987,1973,,241815,85129769,15389461,,100885,62413987,11206577,,140930,22715782,4182884,PDP
VR370,,1988,1973,,428361,85355330,15616142,,118869,66191311,11896682,,309492,19164019,3719460,PDP
VR370,,1989,1973,,428361,85355330,15616142,,134935,68626689,12346090,,293426,16728641,3270052,PDP
VR370,,1990,1973,,141876,70914049,12760034,,139637,69788299,12557484,,2239,1125750,202550,PDP
VR370,,1991,1973,,152611,73705913,13267542,,141730,70887309,12755130,,10881,2818604,512412,PDP
VR370,,1992,1973,,152611,73705913,13267542,,146867,71657302,12897277,,5744,2048611,370265,PDP
VR370,,1993,1973,,161835,73705913,13276766,,151708,72466087,13046030,,10127,1239826,230736,PDP
VR370,,1994,1973,,175738,77175971,13908117,,159041,74360409,13390431,,16697,2815562,517686,PDP
VR370,,1995,1973,,394179,92948611,16933078,,308394,77581222,14112882,,85785,15367389,2820196,PDP
VR370,,1996,1973,,5694056,141229511,30823862,,1969346,93858354,18670121,,3724710,47371157,12153741,PDP
VR370,,1997,1973,,4763995,139074327,29510317,,3192926,110489554,22852989,,1571069,28584773,6657328,PDP
VR370,,1998,1973,,4647271,142746892,30047074,,3583742,119961734,24929246,,1063529,22785158,5117828,PDP
VR370,,1999,1973,,5030623,153390036,32324224,,3967226,130788927,27239277,,1063397,22601109,5084947,PDP
VR370,,2000,1973,,6743099,171062913,37181339,,4436442,137979405,28987938,,2306657,33083508,8193401,PDP
VR370,,2001,1973,,8101519,172752541,38840405,,4959706,142644572,30341302,,3141813,30107969,8499103,PDP
VR370,,2002,1973,,6675424,166906264,36374047,,5209738,145504515,31100221,,1465686,21401749,5273826,PDP
VR370,,2003,1973,,7010950,173966231,37965795,,5425252,147772442,31719281,,1585698,26193789,6246514,PDP
VR370,,2004,1973,,5991742,157797343,34069561,,5704629,151041368,32580317,,287113,6755975,1489244,PDP
VR370,,2005,1973,,6167857,157507836,34194162,,5824586,152542007,32967292,,343271,4965829,1226870,PDP
VR370,,2006,1973,,7199009,166947837,36905030,,5867293,153054782,33101240,,1331716,13893055,3803790,PDP
VR370,,2007,1973,,7297050,179674249,39267557,,6072664,115228241,26575910,,1224386,64446008,12691647,PDP
VR370,,2008,1973,,7297051,179674754,39267648,,6248331,156593433,34111931,,1048720,23081321,5155717,PDP
VR370,,2009,1973,,7914621,183053555,40486430,,6398717,160777951,35006896,,1515904,22275604,5479534,PDP
VR370,,2010,1973,,7914621,183053555,40486430,,6655843,163255383,35704845,,1258778,19798172,4781584,PDP
VR370,,2011,1973,,7914621,183053555,40486430,,6970350,167938254,36852603,,944271,15115301,3633826,PDP
VR370,,2012,1973,,7914621,183053555,40486430,,7272279,171958173,37869820,,642342,11095382,2616609,PDP
VR370,,2013,1973,,7914621,183053555,40486430,,7481387,174463030,38524633,,433234,8590525,1961797,PDP
VR370,,2014,1973,,8424411,187646855,41813533,,7662008,176516039,39070557,,762403,11130816,2742975,PDP
VR370,,2015,1973,,8424411,187646855,41813533,,7814469,178270531,39535206,,609942,9376324,2278327,PDP
VR370,,2016,1973,,8424411,187646855,41813533,,7940932,179676031,39911757,,483479,7970824,1901775,PDP
VR370,,2017,1973,,8424411,187646855,41813533,,8013665,180284924,40092835,,410746,7361931,1720698,PDP
VR370,,2017,1973,,8424411,187646855,41813533,,8013665,180284924,40092835,,410746,7361931,1720698,PDP
VR380,,1977,1974,,23267460,53829314,32845630,,0,0,0,,23267460,53829314,32845630,PDP
VR380,,1978,1974,,23267460,53829314,32845630,,0,0,0,,23267460,53829314,32845630,PDP
VR380,,1979,1974,,23267460,53829314,32845630,,0,0,0,,23267460,53829314,32845630,PDP
VR380,,1980,1974,,27253650,84771314,42337514,,0,0,0,,27253650,84771314,42337514,PDP
VR380,,1981,1974,,25149866,96427114,42307715,,19388,1380771,265077,,25130478,95046343,42042638,PDP
VR380,,1982,1974,,25853613,98755295,43425730,,416477,14412757,2981025,,25437136,84342538,40444705,PDP
VR380,,1983,1974,,28572487,128728450,51477905,,1521977,28062184,6515248,,27050510,100666266,44962657,PDP
VR380,,1984,1974,,29880674,148804931,56358420,,2417778,49505252,11226542,,27462896,99299679,45131878,PDP
VR380,,1985,1974,,29940376,155526916,57614204,,3038950,64206178,14463537,,26901426,91320738,43150667,PDP
VR380,,1986,1974,,29344376,181160688,61579374,,3544970,70279347,16050192,,25799406,110881341,45529182,PDP
VR380,,1987,1974,,10255693,165527878,39709052,,3891396,74700991,17183387,,6364297,90826887,22525665,PDP
VR380,,1988,1974,,10246305,156026902,38009099,,4257324,77752663,18092317,,5988981,78274239,19916782,PDP
VR380,,1989,1974,,10244540,155730627,37954616,,4547129,80176717,18813449,,5697411,75553910,19141167,PDP
VR380,,1990,1974,,9885734,147687813,36164704,,4772381,82280833,19413099,,5113353,65406980,16751605,PDP
VR380,,1991,1974,,5818086,102696829,24091543,,4968221,84852647,20066557,,849865,17844182,4024986,PDP
VR380,,1992,1974,,6123951,103063867,24462717,,5212157,87056068,20702561,,911794,16007799,3760156,PDP
VR380,,1993,1974,,6124023,103096341,24468568,,5457905,88564524,21216717,,666118,14531817,3251851,PDP
VR380,,1994,1974,,6140414,107114103,25199863,,5648294,89714529,21611733,,492120,17399574,3588130,PDP
VR380,,1995,1974,,11315178,120821871,32813732,,5795875,91131446,22011435,,5519303,29690425,10802297,PDP
VR380,,1996,1974,,6545091,130355101,29739949,,5902177,98798493,23481980,,642914,31556608,6257969,PDP
VR380,,1997,1974,,10688294,130635122,33932978,,5985270,102905192,24295802,,4703024,27729930,9637176,PDP
VR380,,1998,1974,,10688294,130635121,33932977,,6057684,104973571,24736255,,4630610,25661550,9196722,PDP
VR380,,1999,1974,,8533711,131337292,31903336,,6339652,108911853,25718985,,2194059,22425439,6184351,PDP
VR380,,2000,1974,,12885934,186001655,45982314,,7376139,121936465,29073019,,5509795,64065190,16909295,PDP
VR380,,2001,1974,,14972252,186580146,48171566,,8876456,135758479,33032769,,6095796,50821667,15138797,PDP
VR380,,2002,1974,,19092443,202401135,55106879,,9899205,143040512,35351253,,9193238,59360623,19755626,PDP
VR380,,2003,1974,,24716115,203936417,61003734,,10558194,150376635,37315602,,14157921,53559782,23688132,PDP
VR380,,2004,1974,,23040655,201388110,58874838,,11175552,154858066,38730368,,11865103,46530044,20144470,PDP
VR380,,2005,1974,,23844807,201330171,59668681,,11511479,157129513,39470467,,12333328,44200658,20198214,PDP
VR380,,2006,1974,,24397536,200097180,60002016,,11643686,158514844,39849174,,12753850,41582336,20152842,PDP
VR380,,2007,1974,,24268281,199691526,59800581,,11974560,160008049,40445743,,12293721,39683477,19354838,PDP
VR380,,2008,1974,,25003209,191227141,59029391,,12299108,160818490,40914498,,12704101,30408651,18114893,PDP
VR380,,2009,1974,,17962887,181934987,50335664,,12841472,163851017,41996460,,5121415,18083970,8339205,PDP
VR380,,2010,1974,,18013765,187022866,51291859,,13602985,167197149,43353368,,4410780,19825717,7938487,PDP
VR380,,2011,1974,,18799802,183228151,51402678,,14411566,168203977,44341103,,4388236,15024174,7061579,PDP
VR380,,2012,1974,,19505414,182029358,51894983,,15445993,171079508,45887188,,4059421,10949850,6007793,PDP
VR380,,2013,1974,,19505414,182029358,51894983,,16557519,172861162,47315736,,2947895,9168196,4579247,PDP
VR380,,2014,1974,,19525161,182058979,51920001,,17310772,173973701,48266948,,2214389,8085278,3653052,PDP
VR380,,2015,1974,,19973778,181801820,52322858,,17886662,174679926,48968502,,2087116,7121894,3354357,PDP
VR380,,2016,1974,,20012555,181830601,52366758,,18394379,175623921,49644189,,1618176,6206680,2722567,PDP
VR380,,2017,1974,,20011946,181756700,52353000,,18745283,176040883,50069286,,1266663,5715817,2283713,PDP
VR380,,2017,1974,,20011946,181756700,52353000,,18745283,176040883,50069286,,1266663,5715817,2283713,PDP
VR398,,1994,1993,,1171397,13724475,3613474,,0,0,0,,1171397,13724475,3613474,PDN
VR398,,1995,1993,,954081,10577374,2836176,,0,0,0,,954081,10577374,2836176,PDN
VR398,,1996,1993,,2130720,15350048,4862045,,4646,7392,5961,,2126074,15342656,4856084,PDN
VR398,,1997,1993,,3398708,12911258,5696085,,675055,2761379,1166404,,2723653,10149879,4529681,PDN
VR398,,1998,1993,,3334717,14378803,5893223,,1111644,4816349,1968646,,2223073,9562454,3924577,PDN
VR398,,1999,1993,,3425567,15484957,6180897,,1366024,5898707,2415616,,2059543,9586250,3765281,PDN
VR398,,2000,1993,,3267044,16153030,6141249,,1667227,7977393,3086692,,1599817,8175637,3054557,PDN
VR398,,2001,1993,,3673026,20116497,7252474,,1902327,9757572,3638550,,1770699,10358925,3613924,PDN
VR398,,2002,1993,,3878148,20797018,7578685,,2089952,11235564,4089163,,1788196,9561454,3489522,PDN
VR398,,2003,1993,,3878148,20797018,7578685,,2269200,12597272,4510707,,1608948,8199746,3067978,PDN
VR398,,2004,1993,,4570933,21999494,8485434,,2413719,13658148,4843994,,2157214,8341346,3641440,PDN
VR398,,2005,1993,,4793715,23167285,8916008,,2502558,14286557,5044650,,2291157,8880728,3871358,PDN
VR398,,2006,1993,,4873808,25697056,9446238,,2613767,15073104,5295814,,2260041,10623952,4150424,PDN
VR398,,2007,1993,,4873808,25697056,9446238,,2742433,16578797,5692397,,2131375,9118259,3753841,PDN
VR398,,2008,1993,,4873808,25697056,9446238,,2820456,16983313,5842398,,2053352,8713743,3603840,PDN
VR398,,2009,1993,,4764328,22383820,8747214,,2864792,17249125,5934030,,1899536,5134695,2813184,PDN
VR398,,2010,1993,,3808781,22611801,7832234,,2885937,17346507,5972504,,922844,5265294,1859729,PDN
VR398,,2011,1993,,3808781,22611801,7832234,,2894852,17422092,5994869,,913929,5189709,1837365,PDN
VR398,,2012,1993,,3808781,22611801,7832234,,2894852,17422092,5994869,,913929,5189709,1837365,PDN
VR398,,2013,1993,,3808781,22611801,7832234,,2942164,17868548,6121621,,866617,4743253,1710613,PDN
VR398,,2014,1993,,2942164,17868548,6121621,,2942164,17868548,6121621,,0,0,0,PDN
VR398,,2015,1993,,2942164,17868548,6121621,,2942164,17868548,6121621,,0,0,0,PDN
VR398,,2016,1993,,2942164,17868548,6121621,,2942164,17868548,6121621,,0,0,0,PDN
VR398,,2017,1993,,2942164,17868548,6121621,,2942164,17868548,6121621,,0,0,0,PDN
VR398,,2017,1993,,2942164,17868548,6121621,,2942164,17868548,6121621,,0,0,0,PDN
VR407,,1982,1977,,257210,6030000,1330164,,0,0,0,,257210,6030000,1330164,PDN
VR407,,1983,1977,,253360,2180001,641261,,0,0,0,,253360,2180001,641261,PDN
VR407,,1999,1977,,22052,8093553,1462186,,0,0,0,,22052,8093553,1462186,PDN
VR407,,2000,1977,,19984,10572623,1901234,,1589,365984,66711,,18395,10206639,1834523,PDN
VR407,,2001,1977,,36726,12714690,2299127,,9863,2945616,533994,,26863,9769074,1765133,PDN
VR407,,2002,1977,,47161,12714690,2309562,,17938,4047522,738138,,29223,8667168,1571424,PDN
VR407,,2003,1977,,46898,13058575,2370488,,21566,4594099,839021,,25332,8464476,1531467,PDN
VR407,,2004,1977,,42453,14593704,2639197,,24095,5227112,954186,,18358,9366592,1685011,PDN
VR407,,2005,1977,,53485,14593704,2650229,,24371,5701310,1038839,,29114,8892394,1611390,PDN
VR407,,2006,1977,,49095,13793834,2503514,,25299,5874067,1070507,,23796,7919767,1433007,PDN
VR407,,2007,1977,,44979,13150651,2384952,,26578,6116303,1114888,,18401,7034348,1270064,PDN
VR407,,2008,1977,,44983,13152114,2385217,,27186,6212124,1132546,,17797,6939990,1252671,PDN
VR407,,2009,1977,,27186,6212124,1132546,,27186,6212124,1132546,,0,0,0,PDN
VR407,,2010,1977,,27186,6212124,1132546,,27186,6212124,1132546,,0,0,0,PDN
VR407,,2011,1977,,27186,6212124,1132546,,27186,6212124,1132546,,0,0,0,PDN
VR407,,2012,1977,,27186,6212124,1132546,,27186,6212124,1132546,,0,0,0,PDN
VR407,,2013,1977,,27186,6212124,1132546,,27186,6212124,1132546,,0,0,0,PDN
VR407,,2014,1977,,27186,6212124,1132546,,27186,6212124,1132546,,0,0,0,PDN
VR407,,2015,1977,,27186,6212124,1132546,,27186,6212124,1132546,,0,0,0,PDN
VR407,,2016,1977,,27186,6212124,1132546,,27186,6212124,1132546,,0,0,0,PDN
VR407,,2017,1977,,27186,6212124,1132546,,27186,6212124,1132546,,0,0,0,PDN
VR407,,2017,1977,,27186,6212124,1132546,,27186,6212124,1132546,,0,0,0,PDN
VR410,,1995,1975,,1199946,154100589,28619980,,0,0,0,,1199946,154100589,28619980,PDN
VR410,,1996,1975,,1200465,158540758,29410564,,0,291077,51793,,1200465,158249681,29358771,PDN
VR410,,1997,1975,,1186154,81527932,15692903,,563,23626412,4204551,,1185591,57901520,11488352,PDN
VR410,,1998,1975,,1186154,81527932,15692903,,567,40513287,7209337,,1185587,41014645,8483566,PDN
VR410,,1999,1975,,1186003,75887282,14689078,,567,48290773,8593231,,1185436,27596509,6095847,PDN
VR410,,2000,1975,,1185961,75875737,14686982,,567,54126588,9631632,,1185394,21749149,5055350,PDN
VR410,,2001,1975,,1185961,65105264,12770528,,567,55820382,9933019,,1185394,9284882,2837509,PDN
VR410,,2002,1975,,1185961,65109758,12771327,,567,56449369,10044939,,1185394,8660389,2726388,PDN
VR410,,2003,1975,,1185961,65211461,12789424,,567,56619685,10075244,,1185394,8591776,2714180,PDN
VR410,,2004,1975,,567,56653972,10081345,,567,56653972,10081345,,0,0,0,PDN
VR410,,2005,1975,,567,56653972,10081345,,567,56653972,10081345,,0,0,0,PDN
VR410,,2006,1975,,567,56653972,10081345,,567,56653972,10081345,,0,0,0,PDN
VR410,,2007,1975,,567,56653972,10081345,,567,56653972,10081345,,0,0,0,PDN
VR410,,2008,1975,,567,56653972,10081345,,567,56653972,10081345,,0,0,0,PDN
VR410,,2009,1975,,566,57376767,10209955,,566,57376767,10209955,,0,0,0,PDN
VR410,,2010,1975,,566,57376767,10209955,,566,57376767,10209955,,0,0,0,PDN
VR410,,2011,1975,,566,57376767,10209955,,566,57376767,10209955,,0,0,0,PDN
VR410,,2012,1975,,566,57376767,10209955,,566,57376767,10209955,,0,0,0,PDN
VR410,,2013,1975,,566,57376767,10209955,,566,57376767,10209955,,0,0,0,PDN
VR410,,2014,1975,,566,57376767,10209955,,566,57376767,10209955,,0,0,0,PDN
VR410,,2015,1975,,566,57376767,10209955,,566,57376767,10209955,,0,0,0,PDN
VR410,,2016,1975,,566,57376767,10209955,,566,57376767,10209955,,0,0,0,PDN
VR410,,2017,1975,,566,57376767,10209955,,566,57376767,10209955,,0,0,0,PDN
VR410,,2017,1975,,566,57376767,10209955,,566,57376767,10209955,,0,0,0,PDN
VR412,,1991,1987,,131517,18412422,3407749,,0,0,0,,131517,18412422,3407749,PDN
VR412,,1992,1987,,1278153,35925458,7670583,,194161,10192654,2007801,,1083992,25732804,5662782,PDN
VR412,,1993,1987,,3752750,53119761,13204665,,782613,16238544,3672034,,2970137,36881217,9532631,PDN
VR412,,1994,1987,,3752700,53119652,13204595,,1263659,16763612,4246508,,2489041,36356040,8958087,PDN
VR412,,1995,1987,,4147291,52143143,13425430,,1734987,19861090,5268989,,2412304,32282053,8156441,PDN
VR412,,1996,1987,,3986475,75962533,17502940,,2087818,31895812,7763229,,1898657,44066721,9739711,PDN
VR412,,1997,1987,,4118655,84350605,19127659,,2432568,41429228,9804317,,1686087,42921377,9323342,PDN
VR412,,1998,1987,,4118642,79881205,18332380,,2652001,47458944,11096653,,1466641,32422261,7235727,PDN
VR412,,1999,1987,,3603733,106948321,22633683,,2856769,59132452,13378558,,746964,47815869,9255125,PDN
VR412,,2000,1987,,3308845,88359092,19031103,,2932244,64920670,14483965,,376601,23438422,4547138,PDN
VR412,,2001,1987,,3122369,82885844,17870740,,2944658,67058952,14876856,,177711,15826892,2993884,PDN
VR412,,2002,1987,,3185765,84610428,18241001,,2947395,67889847,15027439,,238370,16720581,3213562,PDN
VR412,,2003,1987,,3041147,73835114,16179068,,2963262,68618225,15172911,,77885,5216889,1006157,PDN
VR412,,2004,1987,,2967251,68630558,15179094,,2967251,68630558,15179094,,0,0,0,PDN
VR412,,2005,1987,,2967251,68630558,15179094,,2967251,68630558,15179094,,0,0,0,PDN
VR412,,2006,1987,,2967251,68630558,15179094,,2967251,68630558,15179094,,0,0,0,PDN
VR412,,2007,1987,,2967251,68630558,15179094,,2967251,68630558,15179094,,0,0,0,PDN
VR412,,2008,1987,,2967251,68630558,15179094,,2967251,68630558,15179094,,0,0,0,PDN
VR412,,2009,1987,,2967250,69545256,15341850,,2967250,69545256,15341850,,0,0,0,PDN
VR412,,2010,1987,,2967250,69545256,15341850,,2967250,69545256,15341850,,0,0,0,PDN
VR412,,2011,1987,,2967250,69545256,15341850,,2967250,69545256,15341850,,0,0,0,PDN
VR412,,2012,1987,,2967250,69545256,15341850,,2967250,69545256,15341850,,0,0,0,PDN
VR412,,2013,1987,,2967250,69545256,15341850,,2967250,69545256,15341850,,0,0,0,PDN
VR412,,2014,1987,,2967250,69545256,15341850,,2967250,69545256,15341850,,0,0,0,PDN
VR412,,2015,1987,,2967250,69545256,15341850,,2967250,69545256,15341850,,0,0,0,PDN
VR412,,2016,1987,,2967250,69545256,15341850,,2967250,69545256,15341850,,0,0,0,PDN
VR412,,2017,1987,,2967250,69545256,15341850,,2967250,69545256,15341850,,0,0,0,PDN
VR412,,2017,1987,,2967250,69545256,15341850,,2967250,69545256,15341850,,0,0,0,PDN
WC017,,1975,1964,,3500093,375000000,70226072,,1553052,156539254,29407012,,1947041,218460746,40819060,PDP
WC017,,1976,1964,,3500093,375000000,70226072,,1553052,156539254,29407012,,1947041,218460746,40819060,PDP
WC017,,1977,1964,,3500093,375000000,70226072,,2318893,159204630,30647119,,1181200,215795370,39578953,PDP
WC017,,1978,1964,,3396744,447734200,83064751,,1251526,205382564,37796466,,2145218,242351636,45268285,PDP
WC017,,1979,1964,,3396744,447734200,83064751,,1502785,249558207,45908160,,1893959,198175993,37156591,PDP
WC017,,1980,1964,,3396744,447734200,83064751,,1578927,264279591,48603765,,1817817,183454609,34460986,PDP
WC017,,1981,1964,,3791657,641370047,117914441,,1568939,262134497,48212088,,2222718,379235550,69702353,PDP
WC017,,1982,1964,,3889366,655095940,120454480,,1621256,269939468,49653190,,2268110,385156472,70801290,PDP
WC017,,1983,1964,,3889366,655095940,120454480,,1636887,273023925,50217657,,2252479,382072015,70236823,PDP
WC017,,1984,1964,,3556206,616681535,113286016,,1693388,279261288,51384009,,1862818,337420247,61902007,PDP
WC017,,1985,1964,,3556206,616681535,113286016,,1736012,285931759,52613549,,1820194,330749776,60672467,PDP
WC017,,1986,1964,,3556206,616681535,113286016,,1773981,289763104,53333252,,1782225,326918431,59952764,PDP
WC017,,1987,1964,,2393980,418170729,76801583,,1804817,294081787,54132537,,589163,124088942,22669046,PDP
WC017,,1988,1964,,2393980,418170729,76801583,,1829863,297765078,54812973,,564117,120405651,21988610,PDP
WC017,,1989,1964,,2189300,357260613,65758804,,1852692,300970207,55406110,,336608,56290406,10352694,PDP
WC017,,1990,1964,,2229950,371869032,68398817,,1874321,304698483,56091133,,355629,67170549,12307684,PDP
WC017,,1991,1964,,2133481,364055213,66911989,,1887621,306888434,56494104,,245860,57166779,10417885,PDP
WC017,,1992,1964,,2138792,362091330,66567854,,1906993,310037412,57073792,,231799,52053918,9494062,PDP
WC017,,1993,1964,,2049438,342146240,62929552,,1920388,312867725,57590802,,129050,29278515,5338750,PDP
WC017,,1994,1964,,2485598,422877843,77730766,,1930671,314933752,57968705,,554927,107944091,19762061,PDP
WC017,,1995,1964,,2519006,416799049,76682538,,1939352,316495786,58255328,,579654,100303263,18427210,PDP
WC017,,1996,1964,,2160650,353849356,65123169,,1945689,317356791,58414869,,214961,36492565,6708300,PDP
WC017,,1997,1964,,2194335,359685703,66195350,,1959056,318747534,58675699,,235279,40938169,7519651,PDP
WC017,,1998,1964,,2251930,365638647,67312187,,1979423,322441216,59353305,,272507,43197431,7958882,PDP
WC017,,1999,1964,,2237587,353368533,65114551,,1992039,325606503,59929139,,245548,27762030,5185412,PDP
WC017,,2000,1964,,2470456,394416889,72651397,,2090611,338651239,62348839,,379845,55765650,10302558,PDP
WC017,,2001,1964,,3628690,607803837,111778839,,2415331,375995230,69318397,,1213359,231808607,42460442,PDP
WC017,,2002,1964,,3636604,610235659,112219461,,2354884,379211148,69830177,,1281720,231024511,42389284,PDP
WC017,,2003,1964,,3507458,604238375,111023183,,2793167,458655187,84404410,,714291,145583188,26618773,PDP
WC017,,2004,1964,,3447567,594290774,109193256,,2964628,498891698,91735393,,482939,95399076,17457863,PDP
WC017,,2005,1964,,3964027,640049811,117851894,,3071928,520583620,95702465,,892099,119466191,22149429,PDP
WC017,,2006,1964,,3854453,614565554,113207755,,3203820,538424351,99008865,,650633,76141203,14198890,PDP
WC017,,2007,1964,,3882292,617349438,113730947,,3305498,550978472,101344372,,576794,66370966,12386575,PDP
WC017,,2008,1964,,3984485,640181443,117895774,,3380387,559330301,102905352,,604098,80851142,14990422,PDP
WC017,,2009,1964,,3918255,637354255,117326486,,3497035,578879602,106500522,,421220,58474653,10825962,PDP
WC017,,2010,1964,,3918255,637354255,117326486,,3588350,590211102,108608120,,329905,47143153,8718368,PDP
WC017,,2011,1964,,3859604,631421528,116212189,,3635150,597628247,109974696,,224454,33793281,6237493,PDP
WC017,,2012,1964,,3887301,635623114,116987499,,3659303,602869332,110931427,,227998,32753782,6056075,PDP
WC017,,2013,1964,,3887301,635623114,116987499,,3684200,607401870,111762824,,203101,28221244,5224675,PDP
WC017,,2014,1964,,3887301,635623114,116987499,,3708679,611363717,112492258,,178622,24259397,4495241,PDP
WC017,,2015,1964,,3887301,635623114,116987499,,3720046,614032241,112978451,,167255,21590873,4009047,PDP
WC017,,2016,1964,,3887301,635623114,116987499,,3730302,616149624,113365466,,156999,19473490,3622034,PDP
WC017,,2017,1964,,3981480,644791718,118713103,,3739221,617309722,113580808,,242259,27481996,5132294,PDP
WC017,,2017,1964,,3981480,644791718,118713103,,3739221,617309722,113580808,,242259,27481996,5132294,PDP
WC028,,1975,1972,,43700,43700000,7819501,,26668,2382467,450595,,17032,41317533,7368906,PDN
WC028,,1976,1972,,705538,70008000,13162478,,125931,8526999,1643191,,579607,61481001,11519287,PDN
WC028,,1977,1972,,753660,77557700,14553962,,143566,11834559,2249359,,610094,65723141,12304603,PDN
WC028,,1978,1972,,753660,77557700,14553962,,161184,13801254,2616923,,592476,63756446,11937039,PDN
WC028,,1979,1972,,753660,77557700,14553962,,184878,16204690,3068275,,568782,61353010,11485687,PDN
WC028,,1980,1972,,815287,84512185,15853042,,203634,18334936,3466078,,611653,66177249,12386964,PDN
WC028,,1981,1972,,815287,84512185,15853042,,218750,20099705,3795210,,596537,64412480,12057832,PDN
WC028,,1982,1972,,814130,84513264,15852077,,234046,22202837,4184729,,580084,62310427,11667348,PDN
WC028,,1983,1972,,814154,84522922,15853820,,244509,23399986,4408208,,569645,61122936,11445612,PDN
WC028,,1984,1972,,814154,84522922,15853820,,259113,25089925,4723512,,555041,59432997,11130308,PDN
WC028,,1985,1972,,839426,88232922,16539234,,268133,26105729,4913281,,571293,62127193,11625953,PDN
WC028,,1986,1972,,839426,88232922,16539234,,273167,26722791,5028112,,566259,61510131,11511122,PDN
WC028,,1987,1972,,325119,58459190,10727110,,277451,27294817,5134180,,47668,31164373,5592930,PDN
WC028,,1988,1972,,325119,58459190,10727110,,278196,27399524,5153556,,46923,31059666,5573554,PDN
WC028,,1989,1972,,278196,27399524,5153556,,278196,27399524,5153556,,0,0,0,PDN
WC028,,1990,1972,,278196,27399524,5153556,,278196,27399524,5153556,,0,0,0,PDN
WC028,,1991,1972,,278196,27399524,5153556,,278196,27399524,5153556,,0,0,0,PDN
WC028,,1992,1972,,278196,27399524,5153556,,278196,27399524,5153556,,0,0,0,PDN
WC028,,1993,1972,,278196,27399524,5153556,,278196,27399524,5153556,,0,0,0,PDN
WC028,,1994,1972,,278196,27399524,5153556,,278196,27399524,5153556,,0,0,0,PDN
WC028,,1995,1972,,278196,27399524,5153556,,278196,27399524,5153556,,0,0,0,PDN
WC028,,1996,1972,,278196,27399524,5153556,,278196,27399524,5153556,,0,0,0,PDN
WC028,,1997,1972,,278196,27399524,5153556,,278196,27399524,5153556,,0,0,0,PDN
WC028,,1998,1972,,278196,27399524,5153556,,278196,27399524,5153556,,0,0,0,PDN
WC028,,1999,1972,,278196,27399524,5153556,,278196,27399524,5153556,,0,0,0,PDN
WC028,,2000,1972,,618195,50466711,9598037,,354270,32818650,6193887,,263925,17648061,3404150,PDN
WC028,,2001,1972,,539730,45443729,8625803,,476665,41904599,7932999,,63065,3539130,692804,PDN
WC028,,2002,1972,,604110,52316891,9913165,,498913,44541280,8424408,,105197,7775611,1488757,PDN
WC028,,2003,1972,,601048,52135547,9877836,,532621,47178056,8927293,,68427,4957491,950543,PDN
WC028,,2004,1972,,601879,52095682,9871573,,553616,49193532,9306914,,48263,2902150,564659,PDN
WC028,,2005,1972,,558664,50348158,9517411,,556618,49779163,9414120,,2046,568995,103291,PDN
WC028,,2006,1972,,565781,51604287,9748038,,558867,50331245,9514605,,6914,1273042,233433,PDN
WC028,,2007,1972,,565781,51604287,9748038,,561016,50653625,9574117,,4765,950662,173921,PDN
WC028,,2008,1972,,565758,51617264,9750325,,561227,50753863,9592163,,4531,863401,158162,PDN
WC028,,2009,1972,,576572,51497673,9739861,,561445,51368153,9701687,,15127,129520,38173,PDN
WC028,,2010,1972,,576572,51497673,9739861,,562085,51408183,9709450,,14487,89490,30410,PDN
WC028,,2011,1972,,562380,51443767,9716077,,562380,51443525,9716034,,0,242,43,PDN
WC028,,2012,1972,,562380,51443767,9716077,,562380,51443767,9716077,,0,0,0,PDN
WC028,,2013,1972,,562380,51443767,9716077,,562380,51443767,9716077,,0,0,0,PDN
WC028,,2014,1972,,562380,51443767,9716077,,562380,51443767,9716077,,0,0,0,PDN
WC028,,2015,1972,,562380,51443767,9716077,,562380,51443767,9716077,,0,0,0,PDN
WC028,,2016,1972,,562380,51443767,9716077,,562380,51443767,9716077,,0,0,0,PDN
WC028,,2017,1972,,562380,51443767,9716077,,562380,51443767,9716077,,0,0,0,PDN
WC028,,2017,1972,,562380,51443767,9716077,,562380,51443767,9716077,,0,0,0,PDN
WC033,,1975,1957,,700004,55000000,10486481,,678583,51853062,9905106,,21421,3146938,581375,PDP
WC033,,1976,1957,,898551,62000000,11930579,,775134,57151935,10944517,,123417,4848065,986062,PDP
WC033,,1977,1957,,898551,62000000,11930579,,786987,59028267,11290237,,111564,2971733,640342,PDP
WC033,,1978,1957,,6925958,165445243,36364613,,725863,57632960,10980838,,6200095,107812283,25383775,PDP
WC033,,1979,1957,,6935958,165445243,36374613,,741030,59594060,11344955,,6194928,105851183,25029658,PDP
WC033,,1980,1957,,6935958,165445240,36374613,,750567,61497645,11693208,,6185391,103947595,24681405,PDP
WC033,,1981,1957,,6950003,166272640,36535882,,754453,62296479,11839236,,6195550,103976161,24696646,PDP
WC033,,1982,1957,,6950622,166338112,36548151,,748449,61755056,11736893,,6202173,104583056,24811258,PDP
WC033,,1983,1957,,6950622,166338117,36548152,,748449,61755056,11736893,,6202173,104583061,24811259,PDP
WC033,,1984,1957,,6950622,166338117,36548152,,748812,61871836,11758035,,6201810,104466281,24790117,PDP
WC033,,1985,1957,,6951215,172272468,37604679,,749059,61999660,11781027,,6202156,110272808,25823652,PDP
WC033,,1986,1957,,6951215,172272468,37604679,,749405,62062518,11792558,,6201810,110209950,25812121,PDP
WC033,,1987,1957,,749998,62146139,11808030,,749998,62146139,11808030,,0,0,0,PDP
WC033,,1988,1957,,749998,62146139,11808030,,749998,62146139,11808030,,0,0,0,PDP
WC033,,1989,1957,,749998,62146139,11808030,,749998,62146139,11808030,,0,0,0,PDP
WC033,,1990,1957,,749998,62146139,11808030,,749998,62146139,11808030,,0,0,0,PDP
WC033,,1991,1957,,749998,62146139,11808030,,749998,62146139,11808030,,0,0,0,PDP
WC033,,1992,1957,,749998,62146139,11808030,,749998,62146139,11808030,,0,0,0,PDP
WC033,,1993,1957,,749998,62146139,11808030,,749998,62146139,11808030,,0,0,0,PDP
WC033,,1994,1957,,749998,62146139,11808030,,749998,62146139,11808030,,0,0,0,PDP
WC033,,1995,1957,,749998,62146139,11808030,,749998,62146139,11808030,,0,0,0,PDP
WC033,,1996,1957,,749998,62146139,11808030,,749998,62146139,11808030,,0,0,0,PDP
WC033,,1997,1957,,749998,62146139,11808030,,749998,62146139,11808030,,0,0,0,PDP
WC033,,1998,1957,,749998,62146139,11808030,,749998,62146139,11808030,,0,0,0,PDP
WC033,,1999,1957,,767202,63631354,12089507,,749998,62146139,11808030,,17204,1485215,281477,PDP
WC033,,2000,1957,,862206,70609254,13426130,,772453,63956406,12152596,,89753,6652848,1273534,PDP
WC033,,2001,1957,,867172,70609254,13431096,,816039,67233812,12779351,,51133,3375442,651745,PDP
WC033,,2002,1957,,943925,76656034,14583789,,831691,68315162,12987414,,112234,8340872,1596375,PDP
WC033,,2003,1957,,940567,76896323,14623187,,880203,72172192,13722230,,60364,4724131,900957,PDP
WC033,,2004,1957,,886106,72319540,13754352,,886106,72319540,13754352,,0,0,0,PDP
WC033,,2005,1957,,1045148,123384404,22999668,,887405,72658953,13816044,,157743,50725451,9183624,PDP
WC033,,2006,1957,,4684692,135046600,28714336,,998322,73102914,14005958,,3686370,61943686,14708378,PDP
WC033,,2007,1957,,4835293,133398785,28571731,,1743905,76092089,15283423,,3091388,57306696,13288308,PDP
WC033,,2008,1957,,4835293,133398668,28571711,,2469298,78215659,16386675,,2365995,55183009,12185036,PDP
WC033,,2009,1957,,4698130,86069633,20013011,,2853569,80174575,17119506,,1844561,5895058,2893504,PDP
WC033,,2010,1957,,4872762,85316669,20053663,,3001220,80332408,17295241,,1871542,4984261,2758420,PDP
WC033,,2011,1957,,4872762,85316669,20053663,,3221635,80576156,17559027,,1651127,4740513,2494635,PDP
WC033,,2012,1957,,4109869,83595104,18984442,,3526119,81161583,17967680,,583750,2433521,1016761,PDP
WC033,,2013,1957,,4109869,83595104,18984442,,3688514,81584121,18205260,,421355,2010983,779180,PDP
WC033,,2014,1957,,4023605,82832897,18762553,,3749122,81640952,18275980,,274483,1191945,486573,PDP
WC033,,2015,1957,,3999098,82807440,18733517,,3820260,81750712,18366649,,178838,1056728,366868,PDP
WC033,,2016,1957,,3999098,82807440,18733517,,3904413,81899905,18477349,,94685,907535,256167,PDP
WC033,,2017,1957,,4341696,83620877,19220854,,3981814,82095413,18589537,,359882,1525464,631317,PDP
WC033,,2017,1957,,4341696,83620877,19220854,,3981814,82095413,18589537,,359882,1525464,631317,PDP
WC040,,1975,1955,,35680,10526000,1908634,,35680,10526000,1908634,,0,0,0,PDP
WC040,,1976,1955,,35680,10526000,1908634,,35680,10526000,1908634,,0,0,0,PDP
WC040,,1977,1955,,42029,16875000,3044698,,37804,14444372,2607977,,4225,2430628,436721,PDP
WC040,,1978,1955,,44505,19351100,3487761,,38550,15550380,2805522,,5955,3800720,682239,PDP
WC040,,1979,1955,,155169,30417462,5567529,,41981,18708729,3370936,,113188,11708733,2196593,PDP
WC040,,1980,1955,,155169,30417462,5567529,,42000,18837586,3393884,,113169,11579876,2173645,PDP
WC040,,1981,1955,,155169,30417462,5567529,,42099,18927918,3410056,,113070,11489544,2157473,PDP
WC040,,1982,1955,,45317,10785971,1964529,,42927,8395871,1536854,,2390,2390100,427675,PDP
WC040,,1983,1955,,45317,10785971,1964529,,42927,8395871,1536854,,2390,2390100,427675,PDP
WC040,,1984,1955,,149203,41197809,7479774,,57058,21857596,3946310,,92145,19340213,3533464,PDP
WC040,,1985,1955,,149203,41197809,7479774,,57058,21958481,3964261,,92145,19239328,3515513,PDP
WC040,,1986,1955,,149203,41197809,7479774,,57058,21996887,3971095,,92145,19200922,3508679,PDP
WC040,,1987,1955,,87044,32867104,5935283,,57058,22030567,3977088,,29986,10836537,1958195,PDP
WC040,,1988,1955,,87044,32867104,5935283,,57058,22063629,3982971,,29986,10803475,1952312,PDP
WC040,,1989,1955,,87044,32867104,5935283,,57058,22098794,3989228,,29986,10768310,1946055,PDP
WC040,,1990,1955,,87044,32867104,5935283,,57058,22154062,3999062,,29986,10713042,1936221,PDP
WC040,,1991,1955,,60413,29503547,5310154,,57058,22641247,4085750,,3355,6862300,1224404,PDP
WC040,,1992,1955,,63390,30905421,5562575,,58005,23726556,4279812,,5385,7178865,1282763,PDP
WC040,,1993,1955,,64035,32105079,5776683,,58437,24406923,4401306,,5598,7698156,1375377,PDP
WC040,,1994,1955,,58437,24446478,4408344,,58437,24446478,4408344,,0,0,0,PDP
WC040,,1995,1955,,58437,24446478,4408344,,58437,24446478,4408344,,0,0,0,PDP
WC040,,1996,1955,,58437,24446478,4408344,,58437,24446478,4408344,,0,0,0,PDP
WC040,,1997,1955,,58437,24446478,4408344,,58437,24446478,4408344,,0,0,0,PDP
WC040,,1998,1955,,58437,24446478,4408344,,58437,24446478,4408344,,0,0,0,PDP
WC040,,1999,1955,,65254,17026002,3094792,,48807,10489346,1915239,,16447,6536656,1179553,PDP
WC040,,2000,1955,,66518,17148967,3117936,,62407,14283023,2603870,,4111,2865944,514066,PDP
WC040,,2001,1955,,85668,23381755,4246123,,66377,16324273,2971052,,19291,7057482,1275071,PDP
WC040,,2002,1955,,86920,23767223,4315963,,69411,18300906,3325800,,17509,5466317,990163,PDP
WC040,,2003,1955,,83615,23037400,4182797,,79905,21551103,3914621,,3710,1486297,268176,PDP
WC040,,2004,1955,,83833,22868513,4152964,,81720,22262332,4042989,,2113,606181,109975,PDP
WC040,,2005,1955,,206290,59092739,10721012,,83643,22679856,4119205,,122647,36412883,6601807,PDP
WC040,,2006,1955,,1077985,96908875,18321557,,212376,33167152,6114004,,865609,63741723,12207553,PDP
WC040,,2007,1955,,1147132,134934888,25156898,,398841,47254207,8807063,,748291,87680681,16349835,PDP
WC040,,2008,1955,,1149010,134934888,25158776,,502655,61036912,11363315,,646355,73897976,13795461,PDP
WC040,,2009,1955,,825334,122592969,22639029,,595409,74661183,13880316,,229925,47931786,8758713,PDP
WC040,,2010,1955,,825334,122592969,22639029,,679018,88829958,16485061,,146316,33763011,6153969,PDP
WC040,,2011,1955,,835401,122467373,22626748,,693731,92659796,17181239,,141670,29807577,5445509,PDP
WC040,,2012,1955,,835008,122414369,22616924,,742936,103027083,19075157,,92072,19387286,3541767,PDP
WC040,,2013,1955,,835008,122414369,22616924,,786564,113897913,21053097,,48444,8516456,1563828,PDP
WC040,,2014,1955,,862587,133906669,24689396,,821660,123067238,22719745,,40927,10839431,1969651,PDP
WC040,,2015,1955,,862587,133906669,24689396,,832199,126324597,23309885,,30388,7582072,1379511,PDP
WC040,,2016,1955,,862587,133906669,24689396,,838398,127716965,23563837,,24189,6189704,1125560,PDP
WC040,,2017,1955,,862587,133906669,24689396,,843988,128911593,23781994,,18599,4995076,907403,PDP
WC040,,2017,1955,,862587,133906669,24689396,,843988,128911593,23781994,,18599,4995076,907403,PDP
WC041,,1975,1966,,90967,38964041,7024070,,10771,5981704,1075131,,80196,32982337,5948939,PDN
WC041,,1976,1966,,90967,38964041,7024070,,10771,5981704,1075131,,80196,32982337,5948939,PDN
WC041,,1977,1966,,90967,38964041,7024070,,10771,5981704,1075131,,80196,32982337,5948939,PDN
WC041,,1978,1966,,90967,38964041,7024070,,10947,6320156,1135530,,80020,32643885,5888540,PDN
WC041,,1979,1966,,90967,38964041,7024070,,11272,6703998,1204154,,79695,32260043,5819916,PDN
WC041,,1980,1966,,90967,38964041,7024070,,11275,6731453,1209042,,79692,32232588,5815028,PDN
WC041,,1981,1966,,90967,38964041,7024070,,11299,6755759,1213391,,79668,32208282,5810679,PDN
WC041,,1982,1966,,223376,39465274,7245667,,74924,14317056,2622443,,148452,25148218,4623224,PDN
WC041,,1983,1966,,223376,39465274,7245667,,74924,14419721,2640711,,148452,25045553,4604956,PDN
WC041,,1984,1966,,135316,11519530,2185054,,33390,1071007,223961,,101926,10448523,1961093,PDN
WC041,,1985,1966,,135316,11519530,2185054,,33390,1072026,224142,,101926,10447504,1960912,PDN
WC041,,1986,1966,,135316,11519530,2185054,,1512,1072464,192342,,133804,10447066,1992712,PDN
WC041,,1987,1966,,135316,11519530,2185054,,1512,1072927,192424,,133804,10446603,1992630,PDN
WC041,,1988,1966,,135316,11519530,2185054,,1512,1073024,192442,,133804,10446506,1992612,PDN
WC041,,1989,1966,,1512,1073034,192443,,1512,1073034,192443,,0,0,0,PDN
WC041,,1990,1966,,1512,1073034,192443,,1512,1073034,192443,,0,0,0,PDN
WC041,,1991,1966,,1512,1073034,192443,,1512,1073034,192443,,0,0,0,PDN
WC041,,1992,1966,,1512,1073034,192443,,1512,1073034,192443,,0,0,0,PDN
WC041,,1993,1966,,1512,1073034,192443,,1512,1073034,192443,,0,0,0,PDN
WC041,,1994,1966,,1512,1073034,192443,,1512,1073034,192443,,0,0,0,PDN
WC041,,1995,1966,,1512,1073034,192443,,1512,1073034,192443,,0,0,0,PDN
WC041,,1996,1966,,1512,1073034,192443,,1512,1073034,192443,,0,0,0,PDN
WC041,,1997,1966,,1512,1073034,192443,,1512,1073034,192443,,0,0,0,PDN
WC041,,1998,1966,,1512,1073034,192443,,1512,1073034,192443,,0,0,0,PDN
WC041,,1999,1966,,17022,17123641,3063933,,17022,17123641,3063933,,0,0,0,PDN
WC041,,2000,1966,,17022,17123641,3063933,,17022,17123641,3063933,,0,0,0,PDN
WC041,,2001,1966,,73001,48115117,8634410,,17022,17123641,3063933,,55979,30991476,5570477,PDN
WC041,,2002,1966,,67680,44297618,7949818,,22841,21613269,3868618,,44839,22684349,4081200,PDN
WC041,,2003,1966,,67668,44354015,7959842,,25013,22856171,4091947,,42655,21497844,3867895,PDN
WC041,,2004,1966,,56168,40406564,7245948,,26121,23608208,4226870,,30047,16798356,3019078,PDN
WC041,,2005,1966,,56234,40611109,7282410,,26778,24362369,4361719,,29456,16248740,2920691,PDN
WC041,,2006,1966,,56234,40611109,7282410,,26844,24566914,4398181,,29390,16044195,2884229,PDN
WC041,,2007,1966,,56558,40957646,7344395,,26854,24673768,4417204,,29704,16283878,2927191,PDN
WC041,,2008,1966,,33961,28310055,5071337,,26935,24739307,4428947,,7026,3570748,642390,PDN
WC041,,2009,1966,,26935,25092243,4491748,,26935,25091266,4491574,,0,977,174,PDN
WC041,,2010,1966,,26935,25092243,4491748,,26935,25092243,4491748,,0,0,0,PDN
WC041,,2011,1966,,26935,25092243,4491748,,26935,25092243,4491748,,0,0,0,PDN
WC041,,2012,1966,,26935,25092243,4491748,,26935,25092243,4491748,,0,0,0,PDN
WC041,,2013,1966,,26935,25092243,4491748,,26935,25092243,4491748,,0,0,0,PDN
WC041,,2014,1966,,26935,25092243,4491748,,26935,25092243,4491748,,0,0,0,PDN
WC041,,2015,1966,,26935,25092243,4491748,,26935,25092243,4491748,,0,0,0,PDN
WC041,,2016,1966,,26935,25092243,4491748,,26935,25092243,4491748,,0,0,0,PDN
WC041,,2017,1966,,26935,25092243,4491748,,26935,25092243,4491748,,0,0,0,PDN
WC041,,2017,1966,,26935,25092243,4491748,,26935,25092243,4491748,,0,0,0,PDN
WC045,,1975,1949,,30042918,700000000,154598078,,17509615,550644231,115489016,,12533303,149355769,39109062,PDP
WC045,,1976,1949,,20000000,640000000,133879004,,17788095,565376761,118388942,,2211905,74623239,15490062,PDP
WC045,,1977,1949,,20000000,640000000,133879004,,19429122,580170629,122662330,,570878,59829371,11216674,PDP
WC045,,1978,1949,,30611150,810494198,174827199,,21598374,607572104,129707289,,9012776,202922094,45119910,PDP
WC045,,1979,1949,,44965557,1310494198,278149578,,17178178,614765124,126566990,,27787379,695729074,151582588,PDP
WC045,,1980,1949,,28617491,833606654,176946077,,17498259,626714801,129013348,,11119232,206891853,47932729,PDP
WC045,,1981,1949,,28454279,840613494,178029634,,17758275,636093155,130942110,,10696004,204520339,47087524,PDP
WC045,,1982,1949,,30097595,842101865,179937785,,16555825,583647678,120407725,,13541770,258454187,59530060,PDP
WC045,,1983,1949,,30085224,844957541,180433541,,16693362,589651686,121613591,,13391862,255305855,58819950,PDP
WC045,,1984,1949,,30146644,849502642,181303698,,15914728,594354817,121671813,,14231916,255147825,59631885,PDP
WC045,,1985,1949,,30149117,849502642,181306171,,16119843,597772806,122485111,,14029274,251729836,58821060,PDP
WC045,,1986,1949,,30195163,851741926,181750666,,16294683,601552595,123332511,,13900480,250189331,58418155,PDP
WC045,,1987,1949,,18333551,663898089,136464884,,16567919,604627099,124152812,,1765632,59270990,12312072,PDP
WC045,,1988,1949,,18984085,666717813,137617148,,16919329,609071434,125295029,,2064756,57646379,12322119,PDP
WC045,,1989,1949,,22351426,772101118,159735967,,17730849,644904270,132482498,,4620577,127196848,27253469,PDP
WC045,,1990,1949,,23568512,872911396,178890824,,18725079,741776359,150713755,,4843433,131135037,28177069,PDP
WC045,,1991,1949,,20781669,821597672,166973426,,19030705,771485265,156305663,,1750964,50112407,10667763,PDP
WC045,,1992,1949,,20949477,829750616,168591935,,19274191,780843430,158214303,,1675286,48907186,10377632,PDP
WC045,,1993,1949,,20931131,834010661,169331604,,19471536,785611198,159260005,,1459595,48399463,10071599,PDP
WC045,,1994,1949,,21665280,844580785,171946558,,19611541,786388966,159538403,,2053739,58191819,12408155,PDP
WC045,,1995,1949,,21242194,813271378,165952404,,19790216,789692700,160304931,,1451978,23578678,5647473,PDP
WC045,,1996,1949,,21593509,824141516,168237907,,19944775,792041453,160877418,,1648734,32100063,7360489,PDP
WC045,,1997,1949,,21425973,821426886,167587341,,20079943,794013353,161363458,,1346030,27413533,6223883,PDP
WC045,,1998,1949,,21960464,847662087,172790017,,20320216,800232321,162710309,,1640248,47429766,10079708,PDP
WC045,,1999,1949,,21377348,842550634,171297390,,20625463,814360931,165529543,,751885,28189703,5767847,PDP
WC045,,2000,1949,,21381706,850825951,172774224,,20762386,821134330,166871697,,619320,29691621,5902527,PDP
WC045,,2001,1949,,21767127,853998099,173724084,,20872966,825246501,167713980,,894161,28751598,6010104,PDP
WC045,,2002,1949,,21846114,865548882,175858371,,21143685,829081891,168667153,,702429,36466991,7191218,PDP
WC045,,2003,1949,,22688045,887978960,180691419,,21443621,845656031,171916224,,1244424,42322929,8775195,PDP
WC045,,2004,1949,,22025088,886001894,179676670,,21777621,855886961,174070675,,247467,30114933,5605995,PDP
WC045,,2005,1949,,23956121,972549477,197007629,,22018087,869961190,176815452,,1938034,102588287,20192177,PDP
WC045,,2006,1949,,23990390,1002780840,202421144,,22243776,881524893,179098739,,1746614,121255947,23322405,PDP
WC045,,2007,1949,,23786186,981665071,198459686,,22411047,890877898,180930246,,1375139,90787173,17529440,PDP
WC045,,2008,1949,,23991520,990269146,200195994,,22456761,895686547,181831591,,1534759,94582599,18364403,PDP
WC045,,2009,1949,,24274814,949058791,193146483,,22569160,916287752,185609683,,1705654,32771039,7536802,PDP
WC045,,2010,1949,,24338538,948174954,193052941,,22749520,920467173,186533712,,1589018,27707781,6519229,PDP
WC045,,2011,1949,,24068945,943126070,191884970,,22899811,924045915,187320790,,1169134,19080155,4564180,PDP
WC045,,2012,1949,,23335101,929705001,188763035,,22991535,925841300,187731978,,343566,3863701,1031057,PDP
WC045,,2013,1949,,23334712,929691075,188760168,,23080335,926598728,187955551,,254377,3092347,804618,PDP
WC045,,2014,1949,,23351263,931760872,189145010,,23169695,930032242,188655858,,181568,1728630,489153,PDP
WC045,,2015,1949,,23351263,931760872,189145010,,23217755,930718742,188826070,,133508,1042130,318940,PDP
WC045,,2016,1949,,23415168,933712362,189556156,,23262586,931413021,188994439,,152582,2299341,561717,PDP
WC045,,2017,1949,,23415168,933712362,189556156,,23269729,931669076,189047142,,145439,2043286,509013,PDP
WC045,,2017,1949,,23415168,933712362,189556156,,23269729,931669076,189047142,,145439,2043286,509013,PDP
WC049,,1975,1966,,500000,32000000,6193950,,170456,20767111,3865671,,329544,11232889,2328279,PDN
WC049,,1976,1966,,249727,40000000,7367165,,171080,27390426,5044821,,78647,12609574,2322344,PDN
WC049,,1982,1966,,367000,57505000,10599206,,28428,3599218,668858,,338572,53905782,9930348,PDN
WC049,,1983,1966,,368436,57698831,10635132,,52244,6091829,1136199,,316192,51607002,9498933,PDN
WC049,,1984,1966,,510296,64097191,11915490,,74820,8962020,1669485,,435476,55135171,10246005,PDN
WC049,,1985,1966,,520592,65487223,12173123,,99474,11417346,2131030,,421118,54069877,10042093,PDN
WC049,,1986,1966,,520592,65487223,12173123,,112889,13060900,2436893,,407703,52426323,9736230,PDN
WC049,,1987,1966,,507594,62842658,11689562,,135087,15325500,2862044,,372507,47517158,8827518,PDN
WC049,,1988,1966,,538071,64433086,12003033,,154964,17116007,3200517,,383107,47317079,8802516,PDN
WC049,,1989,1966,,540895,63847007,11901572,,203819,21120959,3961997,,337076,42726048,7939575,PDN
WC049,,1990,1966,,562446,65201217,12164086,,220910,23579249,4416506,,341536,41621968,7747580,PDN
WC049,,1991,1966,,346932,35366405,6639887,,237275,24914463,4670453,,109657,10451942,1969434,PDN
WC049,,1992,1966,,346932,35366405,6639887,,247928,25847243,4847082,,99004,9519162,1792805,PDN
WC049,,1993,1966,,890047,62866505,12076258,,444496,35308048,6727067,,445551,27558457,5349191,PDN
WC049,,1994,1966,,1453645,119226342,22668297,,811972,67214067,12771770,,641673,52012275,9896527,PDN
WC049,,1995,1966,,1494431,122081341,23217090,,1005989,98963809,18615208,,488442,23117532,4601882,PDN
WC049,,1996,1966,,1575156,207620264,38518263,,1103859,121850324,22785411,,471297,85769940,15732852,PDN
WC049,,1997,1966,,1590041,212392865,39382366,,1158563,135719089,25307867,,431478,76673776,14074499,PDN
WC049,,1998,1966,,1264825,157637734,29314244,,1193352,145277823,27043498,,71473,12359911,2270746,PDN
WC049,,1999,1966,,1280024,165525318,30732928,,1208669,149906473,27882419,,71355,15618845,2850509,PDN
WC049,,2000,1966,,1280024,165525318,30732928,,1222386,153688980,28569180,,57638,11836338,2163748,PDN
WC049,,2001,1966,,1298544,168560456,31291508,,1234025,156750134,29125508,,64519,11810322,2166000,PDN
WC049,,2002,1966,,1298571,168823986,31338426,,1243739,158627274,29469233,,54832,10196712,1869193,PDN
WC049,,2003,1966,,1290075,165709427,30775738,,1246350,159295993,29590833,,43725,6413434,1184905,PDN
WC049,,2004,1966,,1288548,173535475,32166746,,1248124,159380427,29607631,,40424,14155048,2559115,PDN
WC049,,2005,1966,,1291796,173556421,32173721,,1248144,159417784,29614298,,43652,14138637,2559423,PDN
WC049,,2006,1966,,1292660,172909743,32059518,,1248949,159591930,29646090,,43711,13317813,2413428,PDN
WC049,,2007,1966,,1292660,172909743,32059518,,1249260,159606632,29649017,,43400,13303111,2410501,PDN
WC049,,2008,1966,,1249261,159606640,29649019,,1249261,159606640,29649019,,0,0,0,PDN
WC049,,2009,1966,,1249261,162461379,30156980,,1249261,162461379,30156980,,0,0,0,PDN
WC049,,2010,1966,,1249261,162461379,30156980,,1249261,162461379,30156980,,0,0,0,PDN
WC049,,2011,1966,,1249261,162461379,30156980,,1249261,162461379,30156980,,0,0,0,PDN
WC049,,2012,1966,,1249261,162461379,30156980,,1249261,162461379,30156980,,0,0,0,PDN
WC049,,2013,1966,,1249261,162461379,30156980,,1249261,162461379,30156980,,0,0,0,PDN
WC049,,2014,1966,,1249261,162461379,30156980,,1249261,162461379,30156980,,0,0,0,PDN
WC049,,2015,1966,,1249261,162461379,30156980,,1249261,162461379,30156980,,0,0,0,PDN
WC049,,2016,1966,,1249261,162461379,30156980,,1249261,162461379,30156980,,0,0,0,PDN
WC049,,2017,1966,,1249261,162461379,30156980,,1249261,162461379,30156980,,0,0,0,PDN
WC049,,2017,1966,,1249261,162461379,30156980,,1249261,162461379,30156980,,0,0,0,PDN
WC055,,1993,1982,,1426746,83013539,16197838,,22215,499369,111071,,1404531,82514170,16086767,PDP
WC055,,1994,1982,,1426746,83013539,16197838,,67561,2357577,487059,,1359185,80655962,15710779,PDP
WC055,,1995,1982,,1426746,83013539,16197838,,91839,4006989,804826,,1334907,79006550,15393012,PDP
WC055,,1996,1982,,1001898,72262507,13859995,,109251,5350944,1061376,,892647,66911563,12798619,PDP
WC055,,1997,1982,,1556690,74351196,14786440,,139199,6280264,1256684,,1417491,68070932,13529756,PDP
WC055,,1998,1982,,144421,6568468,1313188,,143863,6536748,1306985,,558,31720,6203,PDP
WC055,,1999,1982,,144421,6568468,1313188,,144421,6568468,1313188,,0,0,0,PDP
WC055,,2000,1982,,144421,6568468,1313188,,144421,6568468,1313188,,0,0,0,PDP
WC055,,2001,1982,,144421,6568468,1313188,,144421,6568468,1313188,,0,0,0,PDP
WC055,,2002,1982,,144421,6568468,1313188,,144421,6568468,1313188,,0,0,0,PDP
WC055,,2003,1982,,1379821,96125580,18484017,,161335,7577271,1509604,,1218486,88548309,16974413,PDP
WC055,,2004,1982,,663425,55715893,10577285,,317362,20451393,3956400,,346063,35264500,6620885,PDP
WC055,,2005,1982,,715659,61927883,11734855,,352819,24892052,4782010,,362840,37035831,6952845,PDP
WC055,,2006,1982,,729206,60273355,11454002,,374044,27420386,5253116,,355162,32852969,6200886,PDP
WC055,,2007,1982,,729385,60273355,11454181,,393422,29343221,5614636,,335963,30930134,5839545,PDP
WC055,,2008,1982,,729363,60270336,11453622,,403718,30186857,5775045,,325645,30083479,5678577,PDP
WC055,,2009,1982,,693093,55868102,10634036,,411967,31114727,5948395,,281126,24753375,4685640,PDP
WC055,,2010,1982,,693093,55868102,10634036,,434298,33027011,6310990,,258795,22841091,4323045,PDP
WC055,,2011,1982,,693093,55868102,10634036,,445385,33841853,6467067,,247708,22026249,4166969,PDP
WC055,,2012,1982,,693093,55868102,10634036,,449937,34548912,6597430,,243156,21319190,4036606,PDP
WC055,,2013,1982,,693093,55868102,10634036,,453110,35064924,6692420,,239983,20803178,3941616,PDP
WC055,,2014,1982,,686492,56688867,10773478,,454215,35463705,6764483,,232277,21225162,4008996,PDP
WC055,,2015,1982,,689257,56688867,10776243,,456214,35788507,6824276,,233043,20900360,3951967,PDP
WC055,,2016,1982,,689257,56688867,10776243,,457459,36051447,6872307,,231798,20637420,3903936,PDP
WC055,,2017,1982,,689257,56688867,10776243,,494824,40033094,7618150,,194433,16655773,3158094,PDP
WC055,,2017,1982,,689257,56688867,10776243,,494824,40033094,7618150,,194433,16655773,3158094,PDP
WC066,,1975,1957,,32334275,362975834,96920722,,0,0,0,,32334275,362975834,96920722,PDP
WC066,,1976,1957,,33136626,373075834,99520226,,811249,11191760,2802665,,32325377,361884074,96717561,PDP
WC066,,1977,1957,,35261627,373577836,101734552,,3941956,35136773,10194051,,31319671,338441063,91540501,PDP
WC066,,1978,1957,,35261627,373577836,101734552,,5399551,66174470,17174368,,29862076,307403366,84560184,PDP
WC066,,1979,1957,,33441991,377057836,100534133,,4712847,93605044,21368549,,28729144,283452792,79165584,PDP
WC066,,1980,1957,,32857647,400322592,104089425,,5507534,128221058,28322669,,27350113,272101534,75766756,PDP
WC066,,1981,1957,,33294865,436072592,110887853,,7042069,167699402,36881820,,26252796,268373190,74006033,PDP
WC066,,1982,1957,,32759710,484441180,118959208,,8273649,199713728,43809900,,24486061,284727452,75149308,PDP
WC066,,1983,1957,,33321155,521317235,126082229,,9898516,221190802,49256310,,23422639,300126433,76825919,PDP
WC066,,1984,1957,,43767841,558515796,143147876,,11783262,250870850,56422203,,31984579,307644946,86725673,PDP
WC066,,1985,1957,,43767841,558515796,143147876,,13050910,271445793,61350873,,30716931,287070003,81797003,PDP
WC066,,1986,1957,,43875900,564206802,144268569,,14104246,287062908,65183055,,29771654,277143894,79085514,PDP
WC066,,1987,1957,,43798825,575981494,146286635,,15157465,302008388,68895612,,28641360,273973106,77391023,PDP
WC066,,1988,1957,,43216588,570170203,144670361,,15880353,311108220,71237688,,27336235,259061983,73432673,PDP
WC066,,1989,1957,,49885619,537461287,145519300,,16887255,320174645,73857832,,32998364,217286642,71661468,PDP
WC066,,1990,1957,,27409668,464183672,110004627,,17901733,328091880,76281071,,9507935,136091792,33723556,PDP
WC066,,1991,1957,,22740647,406302294,95036429,,18783025,338374046,78991930,,3957622,67928248,16044499,PDP
WC066,,1992,1957,,26836407,407218545,99295223,,19599445,347540830,81439450,,7236962,59677715,17855773,PDP
WC066,,1993,1957,,25113563,433424072,102235284,,20395088,359265096,84321262,,4718475,74158976,17914022,PDP
WC066,,1994,1957,,27488879,433344548,104596450,,21122951,374255701,87716492,,6365928,59088847,16879958,PDP
WC066,,1995,1957,,27507126,434879383,104887799,,21613316,382250688,89629453,,5893810,52628695,15258346,PDP
WC066,,1996,1957,,25378756,442767002,104162920,,22055808,391506736,91718928,,3322948,51260266,12443992,PDP
WC066,,1997,1957,,25373072,450145550,105470145,,22639539,402197227,94204882,,2733533,47948323,11265263,PDP
WC066,,1998,1957,,27969287,495236506,116089662,,23636242,411284485,96818535,,4333045,83952021,19271127,PDP
WC066,,1999,1957,,27338377,463402112,109794269,,24515157,420531379,99342805,,2823220,42870733,10451464,PDP
WC066,,2000,1957,,27510294,496307213,115821186,,25212333,435983380,102789447,,2297961,60323833,13031739,PDP
WC066,,2001,1957,,27394389,498780410,116145351,,25782724,455916306,106906622,,1611665,42864104,9238729,PDP
WC066,,2002,1957,,28161132,538877907,124046880,,26467825,477811325,111487634,,1693307,61066582,12559246,PDP
WC066,,2003,1957,,28378153,561293142,128252377,,27045311,491547254,114509235,,1332842,69745888,13743142,PDP
WC066,,2004,1957,,28376232,548193024,125919475,,27491803,509050594,118070201,,884429,39142430,7849274,PDP
WC066,,2005,1957,,28563118,568271914,129679117,,27692530,522403714,120646928,,870588,45868200,9032189,PDP
WC066,,2006,1957,,28394116,570651829,129933588,,27865044,529864311,122146950,,529072,40787518,7786638,PDP
WC066,,2007,1957,,28289906,563824005,128614462,,27951117,535371589,123212966,,338789,28452416,5401496,PDP
WC066,,2008,1957,,28642304,563905806,128981416,,28017003,540105027,124121100,,625301,23800779,4860316,PDP
WC066,,2009,1957,,28568523,585188765,132694639,,28083670,551637023,126239725,,484853,33551742,6454914,PDP
WC066,,2010,1957,,28563202,582528816,132216017,,28183830,556135574,127140339,,379372,26393242,5075677,PDP
WC066,,2011,1957,,28556012,582677471,132235279,,28260150,559976678,127900129,,295862,22700793,4335149,PDP
WC066,,2012,1957,,28556012,582677471,132235279,,28327976,564046075,128692048,,228036,18631396,3543230,PDP
WC066,,2013,1957,,28556012,582677471,132235279,,28384987,566924179,129261177,,171025,15753292,2974099,PDP
WC066,,2014,1957,,28553150,579416784,131652224,,28455039,569342994,129761622,,98111,10073790,1890600,PDP
WC066,,2015,1957,,28737694,583621562,132584948,,28520511,571554481,130220599,,217183,12067081,2364350,PDP
WC066,,2016,1957,,28931433,587249583,133424243,,28593422,573781747,130689821,,338011,13467836,2734422,PDP
WC066,,2017,1957,,29000536,586790560,133411667,,28676827,575705770,131115577,,323709,11084790,2296092,PDP
WC066,,2017,1957,,29000536,586790560,133411667,,28676827,575705770,131115577,,323709,11084790,2296092,PDP
WC068,,1975,1958,,2400000,600000000,109161566,,2355157,76214321,15916424,,44843,523785679,93245142,PDN
WC068,,1976,1958,,2941176,500000000,91909148,,1765827,68640230,13979391,,1175349,431359770,77929757,PDN
WC068,,1977,1958,,5618074,270672489,53780439,,2806418,80525222,17134749,,2811656,190147267,36645690,PDN
WC068,,1978,1958,,5618074,270672489,53780439,,2907805,84763328,17990248,,2710269,185909161,35790191,PDN
WC068,,1979,1958,,4947074,270672489,53109439,,2310424,87594320,17896602,,2636650,183078169,35212837,PDN
WC068,,1980,1958,,5041651,273926889,53783090,,2411700,91724466,18732779,,2629951,182202423,35050311,PDN
WC068,,1981,1958,,5539211,283325480,55952997,,2557178,97403574,19888775,,2982033,185921906,36064222,PDN
WC068,,1982,1958,,5822000,278817635,55433679,,2417663,96572376,19601360,,3404337,182245259,35832319,PDN
WC068,,1983,1958,,5893355,281402459,55964967,,2465281,99103014,20099269,,3428074,182299445,35865698,PDN
WC068,,1984,1958,,6546414,313368742,62305977,,2580897,103142979,20933740,,3965517,210225763,41372237,PDN
WC068,,1985,1958,,6554909,313368742,62314472,,2692713,106603827,21661365,,3862196,206764915,40653107,PDN
WC068,,1986,1958,,6554909,313368742,62314472,,2797449,110597155,22476658,,3757460,202771587,39837814,PDN
WC068,,1987,1958,,5691848,260952081,52124603,,2888478,114706046,23298806,,2803370,146246035,28825797,PDN
WC068,,1988,1958,,5482592,252378395,50389780,,2947867,117356519,23829810,,2534725,135021876,26559970,PDN
WC068,,1989,1958,,5695228,272080435,54108117,,2998523,119488837,24259882,,2696705,152591598,29848235,PDN
WC068,,1990,1958,,3372285,137483289,27835504,,3040846,121378767,24638491,,331439,16104522,3197013,PDN
WC068,,1991,1958,,3390249,134665246,27352037,,3104951,123644075,25105676,,285298,11021171,2246361,PDN
WC068,,1992,1958,,3390249,134665246,27352037,,3183928,126208831,25641015,,206321,8456415,1711022,PDN
WC068,,1993,1958,,3390249,134665246,27352037,,3231244,128233530,26048598,,159005,6431716,1303439,PDN
WC068,,1994,1958,,3629487,151875101,30653526,,3278995,130184467,26443491,,350492,21690634,4210035,PDN
WC068,,1995,1958,,3493610,146172530,29502957,,3323449,132008025,26812421,,170161,14164505,2690536,PDN
WC068,,1996,1958,,3535523,139892667,28427457,,3377554,133955569,27213064,,157969,5937098,1214393,PDN
WC068,,1997,1958,,3535523,139892667,28427457,,3418146,135892246,27598261,,117377,4000421,829196,PDN
WC068,,1998,1958,,3535523,139892667,28427457,,3458282,137655909,27952216,,77241,2236758,475241,PDN
WC068,,1999,1958,,3767262,150522065,30550547,,3475359,138557090,28129645,,291903,11964975,2420902,PDN
WC068,,2000,1958,,3767262,150522065,30550547,,3492164,139183666,28257941,,275098,11338399,2292606,PDN
WC068,,2001,1958,,4101530,168299925,34048136,,3562144,142928035,28994179,,539386,25371890,5053957,PDN
WC068,,2002,1958,,4215394,186972170,37484463,,3722691,153378336,31014210,,492703,33593834,6470253,PDN
WC068,,2003,1958,,4210487,186771436,37443838,,3818613,163038970,32829106,,391874,23732466,4614732,PDN
WC068,,2004,1958,,4210470,185917647,37291902,,3863094,168281589,33806437,,347376,17636058,3485465,PDN
WC068,,2005,1958,,4349506,196270998,39273171,,3891569,171530798,34413063,,457937,24740200,4860108,PDN
WC068,,2006,1958,,4344943,196271085,39268623,,3908639,173838384,34840736,,436304,22432701,4427887,PDN
WC068,,2007,1958,,4344943,196271085,39268623,,3925052,175773432,35201463,,419891,20497653,4067160,PDN
WC068,,2008,1958,,4021957,180989159,36226433,,3965728,177621531,35570983,,56229,3367628,655450,PDN
WC068,,2009,1958,,4110967,184039008,36858121,,3992451,181544255,36295699,,118516,2494753,562422,PDN
WC068,,2010,1958,,4110967,184039008,36858121,,4014462,182162275,36427678,,96505,1876733,430442,PDN
WC068,,2011,1958,,4110967,184039008,36858121,,4031414,182862045,36569144,,79553,1176963,288976,PDN
WC068,,2012,1958,,4057845,184091474,36814336,,4041598,183316380,36660171,,16247,775094,154163,PDN
WC068,,2013,1958,,4057845,184091474,36814336,,4048191,183587708,36715043,,9654,503766,99292,PDN
WC068,,2014,1958,,4048681,183642965,36725365,,4048681,183642965,36725365,,0,0,0,PDN
WC068,,2015,1958,,4048681,183642965,36725365,,4048681,183642965,36725365,,0,0,0,PDN
WC068,,2016,1958,,4048681,183626694,36722470,,4048681,183626694,36722470,,0,0,0,PDN
WC068,,2017,1958,,4048681,183626694,36722470,,4048681,183626694,36722470,,0,0,0,PDN
WC068,,2017,1958,,4048681,183626694,36722470,,4048681,183626694,36722470,,0,0,0,PDN
WC071,,1975,1955,,10000000,450000000,90071174,,6192023,313022534,61889983,,3807977,136977466,28181191,PDP
WC071,,1976,1955,,10000000,450000000,90071174,,6803529,339640712,67237819,,3196471,110359288,22833355,PDP
WC071,,1977,1955,,32083088,1257015571,255751339,,10739137,391142992,80337534,,21343951,865872579,175413805,PDP
WC071,,1978,1955,,32083058,1298246151,263087711,,11459214,442445374,90186149,,20623844,855800777,172901562,PDP
WC071,,1979,1955,,28743058,1298246151,259747711,,8849681,509455007,99500038,,19893377,788791144,160247673,PDP
WC071,,1980,1955,,29476995,1378319214,274729524,,9400592,562752248,109534444,,20076403,815566966,165195080,PDP
WC071,,1981,1955,,29704914,1381329214,275493030,,9943743,605722626,117723570,,19761171,775606588,157769460,PDP
WC071,,1982,1955,,30802703,1440662100,287148272,,10554252,616147161,120188978,,20248451,824514939,166959294,PDP
WC071,,1983,1955,,31807782,1498000200,298355860,,11292346,674175358,131252374,,20515436,823824842,167103486,PDP
WC071,,1984,1955,,33043160,1528311383,304984687,,11840404,717048338,139429076,,21202756,811263045,165555611,PDP
WC071,,1985,1955,,25364358,1399225225,274336818,,12436581,757471364,147217962,,12927777,641753861,127118856,PDP
WC071,,1986,1955,,25526643,1422829740,278699195,,13060841,790939311,153797373,,12465802,631890429,124901822,PDP
WC071,,1987,1955,,28975262,1479066596,292154372,,14049391,828714563,161507498,,14925871,650352033,130646874,PDP
WC071,,1988,1955,,28538178,1455515387,287526681,,14826282,854294618,166836001,,13711896,601220769,120690680,PDP
WC071,,1989,1955,,18980871,1057104163,207077697,,15412048,876134478,171307863,,3568823,180969685,35769834,PDP
WC071,,1990,1955,,20148272,1058530607,208498914,,16002415,896389096,175502254,,4145857,162141511,32996660,PDP
WC071,,1991,1955,,20255881,1102307150,216395943,,16382467,913766989,178974458,,3873414,188540161,37421485,PDP
WC071,,1992,1955,,18759345,1027833813,201647924,,16727350,928903260,182012628,,2031995,98930553,19635296,PDP
WC071,,1993,1955,,18798325,1027898937,201698492,,16923549,939511979,184096499,,1874776,88386958,17601993,PDP
WC071,,1994,1955,,18785020,1030903720,202219846,,17044933,947116071,185570924,,1740087,83787649,16648922,PDP
WC071,,1995,1955,,18406190,1021637660,200192250,,17102530,953313032,186731183,,1303660,68324628,13461067,PDP
WC071,,1996,1955,,18461389,1021993902,200310838,,17137929,958839412,187749924,,1323460,63154490,12560914,PDP
WC071,,1997,1955,,18461582,1023211439,200527674,,17170443,963234996,188564570,,1291139,59976443,11963104,PDP
WC071,,1998,1955,,18734937,1037166774,203284185,,17198190,967135649,189286384,,1536747,70031125,13997801,PDP
WC071,,1999,1955,,17827600,994886740,194853710,,17222221,970313518,189875872,,605379,24573222,4977838,PDP
WC071,,2000,1955,,17998814,1011927337,198057059,,17281078,975906710,190929959,,717736,36020627,7127100,PDP
WC071,,2001,1955,,17633657,1001043687,195755309,,17367068,981337128,191982215,,266589,19706559,3773094,PDP
WC071,,2002,1955,,17853365,1013179590,198134431,,17469738,988550278,193368364,,383627,24629312,4766067,PDP
WC071,,2003,1955,,17938502,1031060439,201401213,,17554388,994307336,194477402,,384114,36753103,6923811,PDP
WC071,,2004,1955,,18676022,1068218840,208750548,,17724992,1005822214,196696916,,951030,62396626,12053632,PDP
WC071,,2005,1955,,19355525,1094746847,214150338,,18035089,1024929935,200406964,,1320436,69816912,13743374,PDP
WC071,,2006,1955,,18772615,1092743287,213210923,,18231132,1036593904,202678446,,541483,56149383,10532477,PDP
WC071,,2007,1955,,18637154,1096181285,213687205,,18342974,1044286935,204159155,,294180,51894350,9528050,PDP
WC071,,2008,1955,,18640143,1096184487,213690764,,18396045,1053200916,205798343,,244098,42983571,7892421,PDP
WC071,,2009,1955,,18814001,1103403893,215149221,,18446080,1080980674,210791404,,367921,22423219,4357816,PDP
WC071,,2010,1955,,18814001,1103403893,215149221,,18517239,1085910573,211739768,,296762,17493320,3409451,PDP
WC071,,2011,1955,,18814001,1103403893,215149221,,18559767,1088968893,212326481,,254234,14435000,2822739,PDP
WC071,,2012,1955,,18903163,1111227829,216630542,,18610203,1093288458,213145525,,292960,17939371,3485019,PDP
WC071,,2013,1955,,19060788,1126990285,219592874,,18685115,1098219750,214097890,,375673,28770535,5494982,PDP
WC071,,2014,1955,,19116596,1128048677,219837008,,18705340,1100395440,214505250,,411256,27653237,5331761,PDP
WC071,,2015,1955,,19051916,1126259406,219453953,,18800724,1105064476,215431423,,251192,21194930,4022532,PDP
WC071,,2016,1955,,19060125,1128180347,219803966,,18879496,1109992425,216387056,,180629,18187922,3416914,PDP
WC071,,2017,1955,,19100437,1128445452,219891450,,18937930,1113977098,217154504,,162507,14468354,2736946,PDP
WC071,,2017,1955,,19100437,1128445452,219891450,,18937930,1113977098,217154504,,162507,14468354,2736946,PDP
WC076,,1992,1991,,861788,295902224,53513429,,5816,2265374,408907,,855972,293636850,53104522,PDP
WC076,,1993,1991,,861788,295902224,53513429,,30102,13251867,2388085,,831686,282650357,51125344,PDP
WC076,,1994,1991,,775746,189991876,34582130,,88783,29453739,5329662,,686963,160538137,29252468,PDP
WC076,,1995,1991,,775746,189991876,34582130,,134220,41290494,7481283,,641526,148701382,27100847,PDP
WC076,,1996,1991,,764824,188244298,34260251,,198615,53788005,9769434,,566209,134456293,24490817,PDP
WC076,,1997,1991,,764824,188244298,34260251,,267308,64493822,11743077,,497516,123750476,22517174,PDP
WC076,,1998,1991,,837114,249289896,45194747,,353737,78691353,14355757,,483377,170598543,30838990,PDP
WC076,,1999,1991,,935273,191404256,34992970,,480884,101381750,18520341,,454389,90022506,16472629,PDP
WC076,,2000,1991,,1464272,257768729,47330594,,734801,140647968,25761130,,729471,117120761,21569464,PDP
WC076,,2001,1991,,1399974,243713818,44765422,,965292,174003919,31926843,,434682,69709899,12838579,PDP
WC076,,2002,1991,,1740065,292547929,53794857,,1186904,209097441,38392854,,553161,83450488,15402003,PDP
WC076,,2003,1991,,1816588,297843104,54813582,,1375745,239191215,43936459,,440843,58651889,10877123,PDP
WC076,,2004,1991,,2084397,338832293,62374841,,1550212,265431243,48779971,,534185,73401050,13594870,PDP
WC076,,2005,1991,,3077300,470749342,86840528,,1676156,285687427,52510218,,1401144,185061915,34330310,PDP
WC076,,2006,1991,,2215441,386314648,70954702,,1775826,303782573,55829665,,439615,82532075,15125037,PDP
WC076,,2007,1991,,2274643,403281752,74032962,,1860633,320056480,58810185,,414010,83225272,15222777,PDP
WC076,,2008,1991,,2274319,403282368,74032747,,1865638,334575558,61398655,,408681,68706810,12634092,PDP
WC076,,2009,1991,,2233533,411070347,75377725,,1925814,349252477,64070385,,307719,61817870,11307339,PDP
WC076,,2010,1991,,2233533,411070347,75377725,,1975835,360418942,66107320,,257698,50651405,9270402,PDP
WC076,,2011,1991,,2233533,411070347,75377725,,2019416,369719230,67805756,,214117,41351117,7571966,PDP
WC076,,2012,1991,,2129099,390042561,71531692,,2058176,376993972,69138954,,70923,13048589,2392737,PDP
WC076,,2013,1991,,2129099,390042561,71531692,,2075225,380079820,69705088,,53874,9962741,1826604,PDP
WC076,,2014,1991,,2111798,383925771,70425992,,2081365,380879577,69853532,,30433,3046194,572460,PDP
WC076,,2015,1991,,2111798,383925771,70425992,,2084287,381402636,69949526,,27511,2523135,476467,PDP
WC076,,2016,1991,,2111798,383925771,70425992,,2087385,381660419,69998494,,24413,2265352,427500,PDP
WC076,,2017,1991,,2111798,383925771,70425992,,2088332,381809996,70026056,,23466,2115775,399939,PDP
WC076,,2017,1991,,2111798,383925771,70425992,,2088332,381809996,70026056,,23466,2115775,399939,PDP
WC077,,2006,2005,,236251,24970161,4679340,,112145,9970945,1886335,,124106,14999216,2793005,PDP
WC077,,2007,2005,,865122,51609394,10048288,,185597,16041623,3039978,,679525,35567771,7008310,PDP
WC077,,2008,2005,,873093,46719318,9186139,,225034,19008731,3607370,,648059,27710587,5578769,PDP
WC077,,2009,2005,,620277,45631584,8739777,,277816,22309945,4247558,,342461,23321639,4492219,PDP
WC077,,2010,2005,,622332,45781946,8768587,,322752,25537277,4866753,,299580,20244669,3901834,PDP
WC077,,2011,2005,,622332,45781946,8768587,,381282,30011737,5721449,,241050,15770209,3047136,PDP
WC077,,2012,2005,,622332,45781946,8768587,,427737,32683981,6243392,,194595,13097965,2525193,PDP
WC077,,2013,2005,,812744,51957360,10057827,,489649,36616739,7005083,,323095,15340621,3052743,PDP
WC077,,2014,2005,,812744,51957360,10057827,,550706,39826557,7637282,,262038,12130803,2420544,PDP
WC077,,2015,2005,,812744,51957360,10057827,,598665,42202718,8108046,,214079,9754642,1949780,PDP
WC077,,2016,2005,,812744,51957360,10057827,,661884,45949214,8837901,,150860,6008146,1219925,PDP
WC077,,2017,2005,,812744,51957360,10057827,,718067,49640168,9550837,,94677,2317192,506988,PDP
WC077,,2017,2005,,812744,51957360,10057827,,718067,49640168,9550837,,94677,2317192,506988,PDP
WC078,,2003,2003,,132525,8614093,1665282,,0,0,0,,132525,8614093,1665282,PDN
WC078,,2004,2003,,132525,8614093,1665282,,31802,2217271,426334,,100723,6396822,1238948,PDN
WC078,,2005,2003,,51567,4796100,904966,,45852,3889495,737933,,5715,906605,167033,PDN
WC078,,2006,2003,,47883,4244091,803059,,47104,4134103,782710,,779,109988,20349,PDN
WC078,,2007,2003,,46512,4241895,801298,,46512,4241895,801298,,0,0,0,PDN
WC078,,2008,2003,,46512,4242009,801318,,46512,4242009,801318,,0,0,0,PDN
WC078,,2009,2003,,46512,4242009,801318,,46512,4242009,801318,,0,0,0,PDN
WC078,,2010,2003,,46512,4242009,801318,,46512,4242009,801318,,0,0,0,PDN
WC078,,2011,2003,,46512,4242009,801318,,46512,4242009,801318,,0,0,0,PDN
WC078,,2012,2003,,46512,4242009,801318,,46512,4242009,801318,,0,0,0,PDN
WC078,,2013,2003,,46512,4242009,801318,,46512,4242009,801318,,0,0,0,PDN
WC078,,2014,2003,,46512,4242009,801318,,46512,4242009,801318,,0,0,0,PDN
WC078,,2015,2003,,46512,4242009,801318,,46512,4242009,801318,,0,0,0,PDN
WC078,,2016,2003,,46512,4242009,801318,,46512,4242009,801318,,0,0,0,PDN
WC078,,2017,2003,,46512,4242009,801318,,46512,4242009,801318,,0,0,0,PDN
WC078,,2017,2003,,46512,4242009,801318,,46512,4242009,801318,,0,0,0,PDN
WC081,,1982,1980,,12600,12600000,2254593,,0,0,0,,12600,12600000,2254593,PDN
WC081,,1983,1980,,12600,12600000,2254593,,0,0,0,,12600,12600000,2254593,PDN
WC081,,1984,1980,,12600,12600000,2254593,,0,1697461,302039,,12600,10902539,1952554,PDN
WC081,,1985,1980,,42341,6255379,1155398,,0,1943207,345766,,42341,4312172,809632,PDN
WC081,,1986,1980,,0,1891643,336591,,0,1891643,336591,,0,0,0,PDN
WC081,,1987,1980,,0,1891643,336591,,0,1891643,336591,,0,0,0,PDN
WC081,,1988,1980,,0,1891643,336591,,0,1891643,336591,,0,0,0,PDN
WC081,,1989,1980,,0,1891643,336591,,0,1891643,336591,,0,0,0,PDN
WC081,,1990,1980,,0,1891643,336591,,0,1891643,336591,,0,0,0,PDN
WC081,,1991,1980,,0,1891643,336591,,0,1891643,336591,,0,0,0,PDN
WC081,,1992,1980,,0,1891643,336591,,0,1891643,336591,,0,0,0,PDN
WC081,,1993,1980,,0,1891643,336591,,0,1891643,336591,,0,0,0,PDN
WC081,,1994,1980,,0,1891643,336591,,0,1891643,336591,,0,0,0,PDN
WC081,,1995,1980,,0,1891643,336591,,0,1891643,336591,,0,0,0,PDN
WC081,,1996,1980,,0,1891643,336591,,0,1891643,336591,,0,0,0,PDN
WC081,,1997,1980,,0,1891643,336591,,0,1891643,336591,,0,0,0,PDN
WC081,,1998,1980,,0,1891643,336591,,0,1891643,336591,,0,0,0,PDN
WC081,,1999,1980,,0,1891643,336591,,0,1891643,336591,,0,0,0,PDN
WC081,,2000,1980,,0,1891643,336591,,0,1891643,336591,,0,0,0,PDN
WC081,,2001,1980,,0,1891643,336591,,0,1891643,336591,,0,0,0,PDN
WC081,,2002,1980,,0,1891643,336591,,0,1891643,336591,,0,0,0,PDN
WC081,,2003,1980,,0,1891643,336591,,0,1891643,336591,,0,0,0,PDN
WC081,,2004,1980,,0,1891643,336591,,0,1891643,336591,,0,0,0,PDN
WC081,,2005,1980,,0,1891643,336591,,0,1891643,336591,,0,0,0,PDN
WC081,,2006,1980,,0,1891643,336591,,0,1891643,336591,,0,0,0,PDN
WC081,,2007,1980,,0,1891643,336591,,0,1891643,336591,,0,0,0,PDN
WC081,,2008,1980,,0,1891643,336591,,0,1891643,336591,,0,0,0,PDN
WC081,,2009,1980,,0,1929529,343333,,0,1929529,343333,,0,0,0,PDN
WC081,,2010,1980,,0,1929529,343333,,0,1929529,343333,,0,0,0,PDN
WC081,,2011,1980,,0,1929529,343333,,0,1929529,343333,,0,0,0,PDN
WC081,,2012,1980,,0,1929529,343333,,0,1929529,343333,,0,0,0,PDN
WC081,,2013,1980,,0,1929529,343333,,0,1929529,343333,,0,0,0,PDN
WC081,,2014,1980,,0,1929529,343333,,0,1929529,343333,,0,0,0,PDN
WC081,,2015,1980,,0,1929529,343333,,0,1929529,343333,,0,0,0,PDN
WC081,,2016,1980,,0,1929529,343333,,0,1929529,343333,,0,0,0,PDN
WC081,,2017,1980,,0,1929529,343333,,0,1929529,343333,,0,0,0,PDN
WC081,,2017,1980,,0,1929529,343333,,0,1929529,343333,,0,0,0,PDN
WC092,,1998,1998,,286,6732557,1198250,,0,268885,47844,,286,6463672,1150406,PDN
WC092,,1999,1998,,36,1017565,181097,,28,1003708,178624,,8,13857,2473,PDN
WC092,,2000,1998,,36,1015939,180808,,36,1015939,180808,,0,0,0,PDN
WC092,,2001,1998,,36,1015939,180808,,36,1015939,180808,,0,0,0,PDN
WC092,,2002,1998,,36,1015939,180808,,36,1015939,180808,,0,0,0,PDN
WC092,,2003,1998,,36,1015939,180808,,36,1015939,180808,,0,0,0,PDN
WC092,,2004,1998,,36,1015939,180808,,36,1015939,180808,,0,0,0,PDN
WC092,,2005,1998,,36,1015939,180808,,36,1015939,180808,,0,0,0,PDN
WC092,,2006,1998,,36,1015939,180808,,36,1015939,180808,,0,0,0,PDN
WC092,,2007,1998,,36,1015939,180808,,36,1015939,180808,,0,0,0,PDN
WC092,,2008,1998,,36,1015939,180808,,36,1015939,180808,,0,0,0,PDN
WC092,,2009,1998,,36,1015939,180808,,36,1015939,180808,,0,0,0,PDN
WC092,,2010,1998,,36,1015939,180808,,36,1015939,180808,,0,0,0,PDN
WC092,,2011,1998,,36,1015939,180808,,36,1015939,180808,,0,0,0,PDN
WC092,,2012,1998,,36,1015939,180808,,36,1015939,180808,,0,0,0,PDN
WC092,,2013,1998,,36,1015939,180808,,36,1015939,180808,,0,0,0,PDN
WC092,,2014,1998,,36,1015939,180808,,36,1015939,180808,,0,0,0,PDN
WC092,,2015,1998,,36,1015939,180808,,36,1015939,180808,,0,0,0,PDN
WC092,,2016,1998,,36,1015939,180808,,36,1015939,180808,,0,0,0,PDN
WC092,,2017,1998,,36,1015939,180808,,36,1015939,180808,,0,0,0,PDN
WC092,,2017,1998,,36,1015939,180808,,36,1015939,180808,,0,0,0,PDN
WC095,,1985,1971,,21952,3248959,600059,,0,0,0,,21952,3248959,600059,PDN
WC095,,1986,1971,,21952,3248959,600059,,0,0,0,,21952,3248959,600059,PDN
WC095,,1987,1971,,47147,6977737,1288737,,3738,3125403,559860,,43409,3852334,728877,PDN
WC095,,1988,1971,,17529,14654233,2625044,,6775,5635983,1009619,,10754,9018250,1615425,PDN
WC095,,1989,1971,,17529,14654233,2625044,,10261,7970046,1428419,,7268,6684187,1196625,PDN
WC095,,1990,1971,,24424,14654233,2631939,,15170,9726376,1745842,,9254,4927857,886097,PDN
WC095,,1991,1971,,35000,14654233,2642515,,20576,11456923,2059174,,14424,3197310,583341,PDN
WC095,,1992,1971,,27375,15527070,2790199,,22912,13120607,2357540,,4463,2406463,432659,PDN
WC095,,1993,1971,,27375,15527070,2790199,,25194,14678628,2637050,,2181,848442,153149,PDN
WC095,,1994,1971,,31332,17771769,3193568,,26498,16230611,2914507,,4834,1541158,279061,PDN
WC095,,1995,1971,,31198,17695525,3179868,,27287,17434892,3129581,,3911,260633,50287,PDN
WC095,,1996,1971,,31599,22119406,3967436,,27460,18170520,3260649,,4139,3948886,706787,PDN
WC095,,1997,1971,,40106,22119406,3975943,,34581,18875564,3393222,,5525,3243842,582721,PDN
WC095,,1998,1971,,36221,19056740,3427100,,36221,19056740,3427100,,0,0,0,PDN
WC095,,1999,1971,,36221,19056740,3427100,,36221,19056740,3427100,,0,0,0,PDN
WC095,,2000,1971,,36221,19056740,3427100,,36221,19056740,3427100,,0,0,0,PDN
WC095,,2001,1971,,36221,19056740,3427100,,36221,19056740,3427100,,0,0,0,PDN
WC095,,2002,1971,,36221,19056740,3427100,,36221,19056740,3427100,,0,0,0,PDN
WC095,,2003,1971,,36221,19056740,3427100,,36221,19056740,3427100,,0,0,0,PDN
WC095,,2004,1971,,36221,19056740,3427100,,36221,19056740,3427100,,0,0,0,PDN
WC095,,2005,1971,,36221,19056740,3427100,,36221,19056740,3427100,,0,0,0,PDN
WC095,,2006,1971,,125163,23463639,4300188,,36221,19056740,3427100,,88942,4406899,873088,PDN
WC095,,2007,1971,,125163,23463639,4300188,,55449,20000864,3614322,,69714,3462775,685866,PDN
WC095,,2008,1971,,1091038,49542268,9906388,,63485,20412566,3695614,,1027553,29129702,6210774,PDN
WC095,,2009,1971,,491813,36785084,7037201,,74872,21378897,3878946,,416941,15406187,3158255,PDN
WC095,,2010,1971,,491813,36785084,7037201,,138055,23771727,4367899,,353758,13013357,2669302,PDN
WC095,,2011,1971,,491813,36785084,7037201,,211220,26451669,4917922,,280593,10333415,2119279,PDN
WC095,,2012,1971,,491813,36785084,7037201,,244685,27667069,5167651,,247128,9118015,1869551,PDN
WC095,,2013,1971,,491813,36785084,7037201,,263927,28319280,5302944,,227886,8465804,1734257,PDN
WC095,,2014,1971,,291145,40255713,7454083,,272727,30170912,5641217,,18418,10084801,1812867,PDN
WC095,,2015,1971,,285285,42218157,7797412,,274755,32372118,6034918,,10530,9846039,1762494,PDN
WC095,,2016,1971,,285166,42218175,7797296,,274636,32374159,6035162,,10530,9844016,1762134,PDN
WC095,,2017,1971,,274636,32374345,6035195,,274636,32374345,6035195,,0,0,0,PDN
WC095,,2017,1971,,274636,32374345,6035195,,274636,32374345,6035195,,0,0,0,PDN
WC109,,1989,1988,,86896,14988531,2753894,,0,0,0,,86896,14988531,2753894,PDP
WC109,,1990,1988,,281536,25499112,4818745,,27280,1472642,289316,,254256,24026470,4529429,PDP
WC109,,1991,1988,,1032998,57708064,11301337,,370877,19901327,3912038,,662121,37806737,7389299,PDP
WC109,,1992,1988,,1748943,102692438,20021619,,638957,43145079,8316017,,1109986,59547359,11705602,PDP
WC109,,1993,1988,,1773128,104081154,20292906,,751695,55341873,10599003,,1021433,48739281,9693903,PDP
WC109,,1994,1988,,1499478,84190097,16479922,,759639,56903756,10884862,,739839,27286341,5595060,PDP
WC109,,1995,1988,,779869,57074223,10935425,,779869,57074223,10935425,,0,0,0,PDP
WC109,,1996,1988,,779869,57074223,10935425,,779869,57074223,10935425,,0,0,0,PDP
WC109,,1997,1988,,779869,57074223,10935425,,779869,57074223,10935425,,0,0,0,PDP
WC109,,1998,1988,,779869,57074223,10935425,,779869,57074223,10935425,,0,0,0,PDP
WC109,,1999,1988,,779869,57074223,10935425,,779869,57074223,10935425,,0,0,0,PDP
WC109,,2000,1988,,779869,57074223,10935425,,779869,57074223,10935425,,0,0,0,PDP
WC109,,2001,1988,,779869,57074223,10935425,,779869,57074223,10935425,,0,0,0,PDP
WC109,,2002,1988,,1625979,204158359,37953089,,803915,60544203,11576905,,822064,143614156,26376184,PDP
WC109,,2003,1988,,1625979,204158359,37953089,,954695,83562766,15823515,,671284,120595593,22129574,PDP
WC109,,2004,1988,,1566782,176811900,33027974,,1109825,113274556,21265440,,456957,63537344,11762534,PDP
WC109,,2005,1988,,2382459,182159721,34795221,,1205024,126245048,23668556,,1177435,55914673,11126665,PDP
WC109,,2006,1988,,2405558,176464056,33804856,,1396257,137248115,25817630,,1009301,39215941,7987226,PDP
WC109,,2007,1988,,2281403,176464056,33680701,,1566873,145285518,27418389,,714530,31178538,6262312,PDP
WC109,,2008,1988,,2281403,176464056,33680701,,1711375,151266047,28627042,,570028,25198009,5053659,PDP
WC109,,2009,1988,,2573259,202808784,38660232,,1984156,164657892,31282714,,589103,38150892,7377518,PDP
WC109,,2010,1988,,2573259,202808784,38660232,,2253502,175749742,33525699,,319757,27059042,5134533,PDP
WC109,,2011,1988,,2540089,199128438,37972197,,2355996,182858405,34893080,,184093,16270033,3079117,PDP
WC109,,2012,1988,,2547895,198647005,37894338,,2403137,186752286,35633082,,144758,11894719,2261256,PDP
WC109,,2013,1988,,2547895,198647005,37894338,,2429827,189640924,36173765,,118068,9006081,1720574,PDP
WC109,,2014,1988,,2547895,198647005,37894338,,2452499,192138410,36640830,,95396,6508595,1253509,PDP
WC109,,2015,1988,,2547895,198647005,37894338,,2472295,193800552,36956380,,75600,4846453,937958,PDP
WC109,,2016,1988,,2547895,198647005,37894338,,2482278,195137892,37204324,,65617,3509113,690015,PDP
WC109,,2017,1988,,2547895,198647005,37894338,,2486074,195663229,37301596,,61821,2983776,592742,PDP
WC109,,2017,1988,,2547895,198647005,37894338,,2486074,195663229,37301596,,61821,2983776,592742,PDP
WC110,,1975,1954,,4000000,500000000,92967972,,2208104,269925600,50237570,,1791896,230074400,42730402,PDP
WC110,,1976,1954,,7550555,839402277,156910391,,2585699,292010932,54544940,,4964856,547391345,102365451,PDP
WC110,,1977,1954,,7720562,851336780,159203975,,2720346,305112642,57010852,,5000216,546224138,102193123,PDP
WC110,,1978,1954,,7800537,850239576,159088718,,2749237,318832601,59481017,,5051300,531406975,99607701,PDP
WC110,,1979,1954,,6141710,523168805,99232245,,2879915,378434844,70217076,,3261795,144733961,29015169,PDP
WC110,,1980,1954,,6262664,545684696,103359585,,2889964,385558262,71494637,,3372700,160126434,31864948,PDP
WC110,,1981,1954,,6492042,538101946,102239719,,2405237,335437421,62091611,,4086805,202664525,40148108,PDP
WC110,,1982,1954,,6482511,538388886,102281245,,2596148,362580724,67112291,,3886363,175808162,35168954,PDP
WC110,,1983,1954,,6796072,542381376,103305214,,2605757,367973805,68081523,,4190315,174407571,35223691,PDP
WC110,,1984,1954,,6793196,545241376,103811234,,2613029,371265441,68674495,,4180167,173975935,35136739,PDP
WC110,,1985,1954,,6831958,549682465,104640226,,2620218,375118242,69367236,,4211740,174564223,35272990,PDP
WC110,,1986,1954,,6838797,554732066,105545570,,2631824,379610120,70178109,,4206973,175121946,35367461,PDP
WC110,,1987,1954,,3106618,460501040,85046305,,2646545,383608400,70904267,,460073,76892640,14142038,PDP
WC110,,1988,1954,,3142787,462504067,85438884,,2655549,386287864,71390044,,487238,76216203,14048840,PDP
WC110,,1989,1954,,2929619,464669580,85611039,,2659347,388483274,71784485,,270272,76186306,13826554,PDP
WC110,,1990,1954,,2931181,465325580,85729327,,2662517,390449470,72137512,,268664,74876110,13591815,PDP
WC110,,1991,1954,,2684544,416688547,76828414,,2664421,391690281,72360201,,20123,24998266,4468213,PDP
WC110,,1992,1954,,2716580,428428141,78949345,,2674315,395426096,73034830,,42265,33002045,5914515,PDP
WC110,,1993,1954,,2780892,439385971,80963449,,2696602,404372194,74648950,,84290,35013777,6314499,PDP
WC110,,1994,1954,,2868691,452009741,83297471,,2723705,411557632,75954600,,144986,40452109,7342871,PDP
WC110,,1995,1954,,3721520,538983660,99626086,,2862643,432105245,79749697,,858877,106878415,19876389,PDP
WC110,,1996,1954,,3656271,530172945,97993094,,3046275,449033812,82945530,,609996,81139133,15047564,PDP
WC110,,1997,1954,,3659567,533008617,98500958,,3116334,454521158,83991985,,543233,78487459,14508973,PDP
WC110,,1998,1954,,3821440,553384780,102288483,,3153959,456604221,84400262,,667481,96780559,17888221,PDP
WC110,,1999,1954,,3203354,483728059,89275962,,3171742,458163589,84695512,,31612,25564470,4580450,PDP
WC110,,2000,1954,,3226006,483953826,89338786,,3182560,459938745,85022194,,43446,24015081,4316592,PDP
WC110,,2001,1954,,3321422,499298008,92164484,,3207647,462570272,85515525,,113775,36727736,6648959,PDP
WC110,,2002,1954,,3385223,512714528,94615566,,3231598,469147324,86709770,,153625,43567204,7905796,PDP
WC110,,2003,1954,,3386473,514471421,94929430,,3282757,480611609,88800837,,103716,33859812,6128593,PDP
WC110,,2004,1954,,3832527,567221375,104761597,,3395679,498217943,92046559,,436848,69003432,12715038,PDP
WC110,,2005,1954,,5020449,629779973,117080943,,3542942,517460341,95617736,,1477507,112319632,21463207,PDP
WC110,,2006,1954,,4929117,635490109,118005649,,3666933,534101161,98702727,,1262184,101388948,19302922,PDP
WC110,,2007,1954,,4935004,623900376,115949306,,3575370,531633770,98172126,,1359634,92266606,17777180,PDP
WC110,,2008,1954,,4639386,592074191,109990666,,3738935,546963682,101063434,,900451,45110509,8927232,PDP
WC110,,2009,1954,,3943039,606203249,111808385,,3885192,577284923,106604928,,57847,28918326,5203456,PDP
WC110,,2010,1954,,3975435,609862991,112491981,,3895674,580433593,107175674,,79761,29429398,5316307,PDP
WC110,,2011,1954,,3975435,609862991,112491981,,3899462,582676151,107578492,,75973,27186840,4913488,PDP
WC110,,2012,1954,,3981100,610886204,112679713,,3904684,585928457,108162417,,76416,24957747,4517295,PDP
WC110,,2013,1954,,3970043,615379295,113468139,,3915159,589414157,108793123,,54884,25965138,4675015,PDP
WC110,,2014,1954,,3970043,615380499,113468353,,3919105,591972987,109252377,,50938,23407512,4215975,PDP
WC110,,2015,1954,,3957856,616089306,113582288,,3923387,593879694,109595931,,34469,22209612,3986357,PDP
WC110,,2016,1954,,3973189,613378483,113115269,,3932413,595252903,109849300,,40776,18125580,3265967,PDP
WC110,,2017,1954,,4131152,615119352,113582994,,3936557,596767057,110122866,,194595,18352295,3460128,PDP
WC110,,2017,1954,,4131152,615119352,113582994,,3936557,596767057,110122866,,194595,18352295,3460128,PDP
WC116,,1979,1979,,24000,24000000,4294463,,0,0,0,,24000,24000000,4294463,PDN
WC116,,1980,1979,,24000,24000000,4294463,,0,0,0,,24000,24000000,4294463,PDN
WC116,,1981,1979,,24000,24000000,4294463,,22223,2589410,482972,,1777,21410590,3811491,PDN
WC116,,1982,1979,,180555,21124880,3939430,,53060,6753448,1254741,,127495,14371432,2684689,PDN
WC116,,1983,1979,,186102,21423074,3998037,,66227,8735735,1620628,,119875,12687339,2377409,PDN
WC116,,1984,1979,,205421,23927698,4463019,,82548,11204871,2076297,,122873,12722827,2386722,PDN
WC116,,1985,1979,,227739,27638579,5145636,,90258,12947166,2394024,,137481,14691413,2751612,PDN
WC116,,1986,1979,,227739,27638579,5145636,,98955,14466880,2673133,,128784,13171699,2472503,PDN
WC116,,1987,1979,,239993,30338579,5638317,,106020,15723853,2903859,,133973,14614726,2734458,PDN
WC116,,1988,1979,,239993,30338579,5638317,,113592,17092542,3154970,,126401,13246037,2483347,PDN
WC116,,1989,1979,,247506,31150555,5790309,,123001,18193171,3360220,,124505,12957384,2430089,PDN
WC116,,1990,1979,,273085,34582764,6426602,,136301,20528673,3789090,,136784,14054091,2637512,PDN
WC116,,1991,1979,,311226,43607826,8070626,,139705,21783110,4015703,,171521,21824716,4054923,PDN
WC116,,1992,1979,,192310,33048782,6072876,,153319,24573657,4525856,,38991,8475125,1547020,PDN
WC116,,1993,1979,,232520,37070901,6828766,,162926,25584751,4715373,,69594,11486150,2113393,PDN
WC116,,1994,1979,,232520,37070901,6828766,,164096,25858922,4765328,,68424,11211979,2063438,PDN
WC116,,1995,1979,,164096,25858922,4765328,,164096,25858922,4765328,,0,0,0,PDN
WC116,,1996,1979,,164096,25858922,4765328,,164096,25858922,4765328,,0,0,0,PDN
WC116,,1997,1979,,164096,25858922,4765328,,164096,25858922,4765328,,0,0,0,PDN
WC116,,1998,1979,,164096,25858922,4765328,,164096,25858922,4765328,,0,0,0,PDN
WC116,,1999,1979,,164096,25858922,4765328,,164096,25858922,4765328,,0,0,0,PDN
WC116,,2000,1979,,164096,25858922,4765328,,164096,25858922,4765328,,0,0,0,PDN
WC116,,2001,1979,,164096,25858922,4765328,,164096,25858922,4765328,,0,0,0,PDN
WC116,,2002,1979,,186048,34310543,6291127,,167850,27432846,5049139,,18198,6877697,1241988,PDN
WC116,,2003,1979,,186048,34310543,6291127,,176233,30474997,5598830,,9815,3835546,692297,PDN
WC116,,2004,1979,,179150,31693453,5818554,,178558,31665205,5812936,,592,28248,5618,PDN
WC116,,2005,1979,,179150,31693453,5818554,,179150,31693453,5818554,,0,0,0,PDN
WC116,,2006,1979,,391722,51303470,9520453,,179150,31693453,5818554,,212572,19610017,3701899,PDN
WC116,,2007,1979,,391722,51303470,9520453,,241833,38445146,7082606,,149889,12858324,2437847,PDN
WC116,,2008,1979,,465733,60298891,11195073,,284288,41425598,7655391,,181445,18873293,3539682,PDN
WC116,,2009,1979,,379502,53553800,9908649,,297462,42974999,7944260,,82040,10578801,1964389,PDN
WC116,,2010,1979,,379502,53553800,9908649,,321538,45801340,8471244,,57964,7752460,1437405,PDN
WC116,,2011,1979,,379502,53553800,9908649,,339529,48368945,8946104,,39973,5184855,962545,PDN
WC116,,2012,1979,,445557,63468628,11738908,,360534,50837677,9406385,,85023,12630951,2332523,PDN
WC116,,2013,1979,,445557,63468628,11738908,,376028,52470658,9712445,,69529,10997970,2026463,PDN
WC116,,2014,1979,,445557,63468628,11738908,,387196,54726565,10125020,,58361,8742063,1613888,PDN
WC116,,2015,1979,,445557,63468628,11738908,,391326,55975793,10351432,,54231,7492835,1387476,PDN
WC116,,2016,1979,,445557,63468628,11738908,,391382,56325830,10413773,,54175,7142798,1325135,PDN
WC116,,2017,1979,,391382,56328802,10414301,,391382,56328802,10414301,,0,0,0,PDN
WC116,,2017,1979,,391382,56328802,10414301,,391382,56328802,10414301,,0,0,0,PDN
WC118,,1975,1960,,212481,37408290,6868760,,158099,17539811,3279062,,54382,19868479,3589698,PDN
WC118,,1976,1960,,212481,37408290,6868760,,162837,19323036,3601100,,49644,18085254,3267660,PDN
WC118,,1977,1960,,212481,37408290,6868760,,169172,21692216,4028997,,43309,15716074,2839763,PDN
WC118,,1978,1960,,202484,37535230,6881351,,174738,23680062,4388272,,27746,13855168,2493079,PDN
WC118,,1979,1960,,202484,37535230,6881351,,179848,25480397,4713726,,22636,12054833,2167625,PDN
WC118,,1980,1960,,201559,37437370,6863013,,185215,26247134,4855524,,16344,11190236,2007489,PDN
WC118,,1981,1960,,201559,37437370,6863013,,187675,26622896,4924845,,13884,10814474,1938168,PDN
WC118,,1982,1960,,96587,37457243,6761577,,86567,27871970,5045992,,10020,9585273,1715585,PDN
WC118,,1983,1960,,103410,39503955,7132583,,87794,28422663,5145207,,15616,11081292,1987376,PDN
WC118,,1984,1960,,133261,47829982,8643934,,99737,31796066,5757400,,33524,16033916,2886534,PDN
WC118,,1985,1960,,136163,50729169,9162706,,102640,33255762,6020035,,33523,17473407,3142671,PDN
WC118,,1986,1960,,464802,69177529,12773971,,126400,36073013,6545086,,338402,33104516,6228885,PDN
WC118,,1987,1960,,385291,55621485,10282352,,143133,38613626,7013885,,242158,17007859,3268467,PDN
WC118,,1988,1960,,411007,63337966,11681108,,151864,41304990,7501506,,259143,22032976,4179602,PDN
WC118,,1989,1960,,532011,77189801,14266851,,195897,44832158,8173149,,336114,32357643,6093702,PDN
WC118,,1990,1960,,583628,68546384,12780493,,242570,47359121,8669460,,341058,21187263,4111033,PDN
WC118,,1991,1960,,637280,63435876,11924802,,266808,50335853,9223365,,370472,13100023,2701437,PDN
WC118,,1992,1960,,760741,63557381,12069884,,308379,51906178,9544354,,452362,11651203,2525530,PDN
WC118,,1993,1960,,760741,63471562,12054613,,349092,52083759,9616665,,411649,11387803,2437948,PDN
WC118,,1994,1960,,807532,68150660,12933984,,371493,52296941,9676999,,436039,15853719,3256985,PDN
WC118,,1995,1960,,519054,52734645,9902443,,401726,52386485,9723165,,117328,348160,179278,PDN
WC118,,1996,1960,,684687,72912815,13658497,,440078,54741908,10180631,,244609,18170907,3477866,PDN
WC118,,1997,1960,,805335,93677768,17473977,,563992,70237009,13061680,,241343,23440759,4412297,PDN
WC118,,1998,1960,,805316,94388688,17600456,,619730,78745894,14631455,,185586,15642794,2969001,PDN
WC118,,1999,1960,,765155,91126740,16979877,,648364,82778249,15377590,,116791,8348491,1602287,PDN
WC118,,2000,1960,,765155,91126740,16979877,,669967,85460051,15876382,,95188,5666689,1103495,PDN
WC118,,2001,1960,,852692,100724235,18775154,,711949,88160975,16398955,,140743,12563260,2376199,PDN
WC118,,2002,1960,,799067,97540398,18155010,,724477,90549281,16836449,,74590,6991117,1318561,PDN
WC118,,2003,1960,,791572,95465069,17778239,,737933,92752606,17241955,,53639,2712463,536284,PDN
WC118,,2004,1960,,786515,95693956,17813909,,749773,93133560,17321581,,36742,2560396,492328,PDN
WC118,,2005,1960,,801571,99765478,18553436,,763158,94961930,17660299,,38413,4803548,893137,PDN
WC118,,2006,1960,,830597,105441025,19592346,,780157,95985616,17859448,,50440,9455409,1732898,PDN
WC118,,2007,1960,,811662,105101403,19512980,,800066,97364168,18124651,,11596,7737235,1388329,PDN
WC118,,2008,1960,,812067,105103698,19513793,,802631,97777906,18200835,,9436,7325792,1312958,PDN
WC118,,2009,1960,,802821,99539785,18514527,,802740,99516697,18510338,,81,23088,4190,PDN
WC118,,2010,1960,,802821,99539785,18514527,,802821,99539785,18514527,,0,0,0,PDN
WC118,,2011,1960,,802821,99539785,18514527,,802821,99539785,18514527,,0,0,0,PDN
WC118,,2012,1960,,802821,99539785,18514527,,802821,99539785,18514527,,0,0,0,PDN
WC118,,2013,1960,,802821,99539785,18514527,,802821,99539785,18514527,,0,0,0,PDN
WC118,,2014,1960,,802821,99539785,18514527,,802821,99539785,18514527,,0,0,0,PDN
WC118,,2015,1960,,802821,99539785,18514527,,802821,99539785,18514527,,0,0,0,PDN
WC118,,2016,1960,,802821,99539785,18514527,,802821,99539785,18514527,,0,0,0,PDN
WC118,,2017,1960,,802821,99539785,18514527,,802821,99539785,18514527,,0,0,0,PDN
WC118,,2017,1960,,802821,99539785,18514527,,802821,99539785,18514527,,0,0,0,PDN
WC130,,1996,1996,,74603,9218749,1714950,,0,0,0,,74603,9218749,1714950,PDN
WC130,,1997,1996,,74603,9218749,1714950,,0,0,0,,74603,9218749,1714950,PDN
WC130,,1998,1996,,29161,10756376,1943107,,0,921491,163966,,29161,9834885,1779141,PDN
WC130,,1999,1996,,29161,10756376,1943107,,1478,2256112,402921,,27683,8500264,1540186,PDN
WC130,,2000,1996,,29161,10756376,1943107,,2413,3491844,623738,,26748,7264532,1319369,PDN
WC130,,2001,1996,,7932,9008104,1610797,,3426,4748209,848303,,4506,4259895,762494,PDN
WC130,,2002,1996,,24404,24285331,4345637,,6833,8266292,1477703,,17571,16019039,2867934,PDN
WC130,,2003,1996,,43044,35716264,6398251,,13222,13689542,2449084,,29822,22026722,3949167,PDN
WC130,,2004,1996,,36148,35716264,6391355,,22060,23512499,4205779,,14088,12203765,2185576,PDN
WC130,,2005,1996,,85188,65924344,11815498,,26711,30128456,5387646,,58477,35795888,6427852,PDN
WC130,,2006,1996,,81627,60493555,10845605,,43810,39561061,7083145,,37817,20932494,3762460,PDN
WC130,,2007,1996,,66885,53184777,9530368,,58019,46245984,8286842,,8866,6938793,1243526,PDN
WC130,,2008,1996,,125811,68808467,12369310,,66480,49947412,8953920,,59331,18861055,3415390,PDN
WC130,,2009,1996,,126700,68137555,12250821,,78438,53843969,9659216,,48262,14293586,2591605,PDN
WC130,,2010,1996,,126700,68137555,12250821,,88229,56427099,10128639,,38471,11710456,2122182,PDN
WC130,,2011,1996,,126700,68137555,12250821,,94282,58372582,10480863,,32418,9764973,1769958,PDN
WC130,,2012,1996,,126700,68137555,12250821,,96204,58850234,10567777,,30496,9287321,1683044,PDN
WC130,,2013,1996,,126700,68137555,12250821,,96396,58890404,10575116,,30304,9247151,1675705,PDN
WC130,,2014,1996,,96818,58970294,10589754,,96547,58919437,10580433,,271,50857,9320,PDN
WC130,,2015,1996,,96554,58921159,10580747,,96554,58921159,10580747,,0,0,0,PDN
WC130,,2016,1996,,97191,58921159,10581384,,97191,58921159,10581384,,0,0,0,PDN
WC130,,2017,1996,,97191,58921159,10581384,,97191,58921159,10581384,,0,0,0,PDN
WC130,,2017,1996,,97191,58921159,10581384,,97191,58921159,10581384,,0,0,0,PDN
WC146,,1975,1971,,5000000,600000000,111761566,,1381646,98752276,18953225,,3618354,501247724,92808341,PDN
WC146,,1976,1971,,7257936,331623381,66265655,,2710942,145490026,28598847,,4546994,186133355,37666808,PDN
WC146,,1977,1971,,8445459,480152950,93881927,,3377535,174765573,34474612,,5067924,305387377,59407315,PDN
WC146,,1978,1971,,8484168,487150636,95165776,,3633297,198283588,38915074,,4850871,288867048,56250702,PDN
WC146,,1979,1971,,7643168,487150636,94324776,,2994070,219535533,42057332,,4649098,267615103,52267444,PDN
WC146,,1980,1971,,7542485,512085168,98660842,,3184753,238550784,45631512,,4357732,273534384,53029330,PDN
WC146,,1981,1971,,7821397,517122949,99836157,,3382537,250334439,47926031,,4438860,266788510,51910126,PDN
WC146,,1982,1971,,8687243,590211784,113707133,,3556770,260521476,49912905,,5130473,329690308,63794228,PDN
WC146,,1983,1971,,8937407,592314596,114331463,,3755100,269001212,51620084,,5182307,323313384,62711379,PDN
WC146,,1984,1971,,8934681,601988074,116049997,,3933394,277565303,53322238,,5001287,324422771,62727759,PDN
WC146,,1985,1971,,11045076,627530110,122705238,,4087364,284707884,54747130,,6957712,342822226,67958108,PDN
WC146,,1986,1971,,11351862,632622305,123918108,,4920736,298228381,57986284,,6431126,334393924,65931824,PDN
WC146,,1987,1971,,10251425,504636010,100044309,,5408363,309377029,60457656,,4843062,195258981,39586653,PDN
WC146,,1988,1971,,16354307,564045186,116718219,,5875857,317514118,62373031,,10478450,246531068,54345188,PDN
WC146,,1989,1971,,7693609,363851640,72435894,,6207197,326047917,64222841,,1486412,37803723,8213053,PDN
WC146,,1990,1971,,7678956,371619351,73803396,,6403726,333066786,65668279,,1275230,38552565,8135117,PDN
WC146,,1991,1971,,7354565,375232363,74121889,,6505635,339262492,66872626,,848930,35969871,7249263,PDN
WC146,,1992,1971,,7590808,403022294,79302960,,6583398,343539645,67711449,,1007410,59482649,11591511,PDN
WC146,,1993,1971,,7537898,392643709,77403327,,6691305,349405907,68863175,,846593,43237802,8540152,PDN
WC146,,1994,1971,,7902423,419531229,82552108,,6789855,353920726,69765073,,1112568,65610503,12787035,PDN
WC146,,1995,1971,,7782626,386180014,76497931,,6846688,357397858,70440613,,935938,28782156,6057318,PDN
WC146,,1996,1971,,7099513,365283331,72096547,,6906913,359039539,70792952,,192600,6243792,1303595,PDN
WC146,,1997,1971,,7524015,395946124,77977062,,7000024,361368285,71300431,,523991,34577839,6676631,PDN
WC146,,1998,1971,,8508330,424019446,83956630,,7107003,367702961,72534576,,1401327,56316485,11422054,PDN
WC146,,1999,1971,,8565274,454970562,89520890,,7346584,404245013,79276302,,1218690,50725549,10244588,PDN
WC146,,2000,1971,,9242101,460932638,91258585,,7713337,416773466,81872317,,1528764,44159172,9386268,PDN
WC146,,2001,1971,,10580871,480781329,96129150,,8529732,435228649,85972552,,2051139,45552680,10156598,PDN
WC146,,2002,1971,,12203342,494452757,100184260,,9761802,449847356,89805816,,2441540,44605401,10378444,PDN
WC146,,2003,1971,,10764479,478678296,95938553,,10231961,462161128,92467037,,532518,16517168,3471516,PDN
WC146,,2004,1971,,11591034,494052587,99500747,,10527231,471704899,94460487,,1063803,22347688,5040260,PDN
WC146,,2005,1971,,12182824,537076500,107748038,,10665803,475716955,95312948,,1517021,61359545,12435090,PDN
WC146,,2006,1971,,11617371,524405802,104928012,,10892936,482013067,96660386,,724435,42392735,8267626,PDN
WC146,,2007,1971,,11770532,527816128,105687993,,11016236,486452318,97573588,,754296,41363810,8114405,PDN
WC146,,2008,1971,,11683254,524815726,105066835,,11094808,489107810,98124667,,588446,35707916,6942168,PDN
WC146,,2009,1971,,12309099,531931694,106958867,,11198328,500450501,100246457,,1110771,31481193,6712408,PDN
WC146,,2010,1971,,12311471,532223122,107013095,,11238453,502671718,100681819,,1073018,29551404,6331275,PDN
WC146,,2011,1971,,11743735,530079484,106063929,,11311160,505670655,101288145,,432575,24408829,4775784,PDN
WC146,,2012,1971,,11837120,524532011,105170220,,11399895,506914301,101598170,,437225,17617710,3572048,PDN
WC146,,2013,1971,,11837120,524532011,105170220,,11441707,507764972,101791346,,395413,16767039,3378871,PDN
WC146,,2014,1971,,11829117,523025948,104894235,,11480759,508157019,101900158,,348358,14868929,2994076,PDN
WC146,,2015,1971,,11486850,508241815,101921337,,11486850,508241815,101921337,,0,0,0,PDN
WC146,,2016,1971,,11487230,508241815,101921717,,11487230,508241815,101921717,,0,0,0,PDN
WC146,,2017,1971,,11487230,508241815,101921717,,11487230,508241815,101921717,,0,0,0,PDN
WC146,,2017,1971,,11487230,508241815,101921717,,11487230,508241815,101921717,,0,0,0,PDN
WC149,,1975,1949,,559994,150000000,27250385,,164736,145830350,26113197,,395258,4169650,1137188,PDP
WC149,,1976,1949,,802913,346560820,62468539,,293029,149580550,26908785,,509884,196980270,35559754,PDP
WC149,,1977,1949,,808998,352476710,63527274,,295974,152441025,27420712,,513024,200035685,36106562,PDP
WC149,,1978,1949,,808998,352476710,63527274,,299158,156029437,28062403,,509840,196447273,35464871,PDP
WC149,,1979,1949,,512185,352476710,63230461,,172345,158227816,28326761,,339840,194248894,34903700,PDP
WC149,,1980,1949,,507580,351656406,63079894,,172345,158584028,28390144,,335235,193072378,34689750,PDP
WC149,,1981,1949,,507580,351656406,63079894,,172345,158877775,28442412,,335235,192778631,34637482,PDP
WC149,,1982,1949,,504558,353994931,63492980,,170899,167578791,29989189,,333659,186416140,33503791,PDP
WC149,,1983,1949,,510569,361921661,64909441,,180249,176191618,31531071,,330320,185730043,33378370,PDP
WC149,,1984,1949,,561735,382938454,68700250,,191558,183636409,32867076,,370177,199302045,35833174,PDP
WC149,,1985,1949,,583109,388089489,69638178,,198787,189165065,33858051,,384322,198924424,35780127,PDP
WC149,,1986,1949,,589907,392311649,70396250,,201469,193202457,34579130,,388438,199109192,35817120,PDP
WC149,,1987,1949,,383760,313437657,56155585,,206837,203712944,36454692,,176923,109724713,19700893,PDP
WC149,,1988,1949,,378516,317071892,56797002,,218159,216075656,38665785,,160357,100996236,18131217,PDP
WC149,,1989,1949,,608345,345032033,62001945,,247650,223125673,39949727,,360695,121906360,22052218,PDP
WC149,,1990,1949,,1534052,349183746,63666391,,548834,227328938,40998823,,985218,121854808,22667568,PDP
WC149,,1991,1949,,1439328,263606136,48344334,,721756,231822990,41971398,,717572,31783146,6372936,PDP
WC149,,1992,1949,,1442072,354883857,64588666,,832577,235684055,42769242,,609495,119199802,21819424,PDP
WC149,,1993,1949,,1444845,356344858,64851403,,1018086,240610385,43831322,,426759,115734473,21020081,PDP
WC149,,1994,1949,,1801897,276124161,50934310,,1142145,242901126,44362986,,659752,33223035,6571324,PDP
WC149,,1995,1949,,1836482,281945063,52004643,,1165237,243583539,44507504,,671245,38361524,7497139,PDP
WC149,,1996,1949,,1817210,284474204,52435396,,1311324,248333471,45498774,,505886,36140733,6936622,PDP
WC149,,1997,1949,,1818050,287035973,52892067,,1398530,253255089,46461713,,419520,33780884,6430354,PDP
WC149,,1998,1949,,1818216,287260594,52932201,,1491636,256249496,47087632,,326580,31011098,5844569,PDP
WC149,,1999,1949,,1894810,283019527,52254156,,1725448,259934459,47977131,,169362,23085068,4277025,PDP
WC149,,2000,1949,,1950106,278463286,51498733,,1863650,263750070,48794267,,86456,14713216,2704466,PDP
WC149,,2001,1949,,2120592,280428141,52018838,,1895554,265595085,49154466,,225038,14833056,2864372,PDP
WC149,,2002,1949,,2416319,281930420,52581874,,2138588,269145931,50029323,,277731,12784489,2552551,PDP
WC149,,2003,1949,,2415271,280556240,52336310,,2224874,271398818,50516479,,190397,9157422,1819831,PDP
WC149,,2004,1949,,2477734,281456708,52558999,,2287177,272776122,50823854,,190557,8680586,1735145,PDP
WC149,,2005,1949,,2715544,320243306,59698338,,2347879,274013721,51104769,,367665,46229585,8593569,PDP
WC149,,2006,1949,,3153288,354393733,66212671,,2422379,277289583,51762162,,730909,77104150,14450509,PDP
WC149,,2007,1949,,5270112,356876659,68771297,,2563460,283696251,53043220,,2706652,73180408,15728077,PDP
WC149,,2008,1949,,4147945,375619101,70984084,,2991591,292235419,54990776,,1156354,83383682,15993308,PDP
WC149,,2009,1949,,4129035,365003951,69076354,,3433466,308045523,58245834,,695569,56958428,10830521,PDP
WC149,,2010,1949,,4092504,343946726,65292987,,3700234,317189669,60139674,,392270,26757057,5153312,PDP
WC149,,2011,1949,,4098202,346000376,65664104,,3830309,328445126,62272502,,267893,17555250,3391605,PDP
WC149,,2012,1949,,4098288,346088224,65679821,,3891814,333483117,63230445,,206474,12605107,2449376,PDP
WC149,,2013,1949,,4123831,353686493,67057369,,3920570,334141887,63376419,,203261,19544606,3680949,PDP
WC149,,2014,1949,,4079821,353219969,66930347,,3929158,335856717,63690138,,150663,17363252,3240210,PDP
WC149,,2015,1949,,4141325,353362113,67017143,,3929170,336322015,63772943,,212155,17040098,3244202,PDP
WC149,,2016,1949,,5904807,361826797,70286796,,4075306,336927103,64026746,,1829501,24899694,6260052,PDP
WC149,,2017,1949,,5904807,361825452,70286557,,4140036,337117131,64125289,,1764771,24708321,6161270,PDP
WC149,,2017,1949,,5904807,361825452,70286557,,4140036,337117131,64125289,,1764771,24708321,6161270,PDP
WC151,,2002,2002,,2088,3329426,594513,,0,0,0,,2088,3329426,594513,PDN
WC151,,2003,2002,,2088,3329426,594513,,0,0,0,,2088,3329426,594513,PDN
WC151,,2004,2002,,137,112256,20111,,137,112256,20111,,0,0,0,PDN
WC151,,2005,2002,,137,112256,20111,,137,112256,20111,,0,0,0,PDN
WC151,,2006,2002,,137,112256,20111,,137,112256,20111,,0,0,0,PDN
WC151,,2007,2002,,137,112256,20111,,137,112256,20111,,0,0,0,PDN
WC151,,2008,2002,,137,112256,20111,,137,112256,20111,,0,0,0,PDN
WC151,,2009,2002,,137,112256,20111,,137,112256,20111,,0,0,0,PDN
WC151,,2010,2002,,137,112256,20111,,137,112256,20111,,0,0,0,PDN
WC151,,2011,2002,,137,112256,20111,,137,112256,20111,,0,0,0,PDN
WC151,,2012,2002,,137,112256,20111,,137,112256,20111,,0,0,0,PDN
WC151,,2013,2002,,137,112256,20111,,137,112256,20111,,0,0,0,PDN
WC151,,2014,2002,,137,112256,20111,,137,112256,20111,,0,0,0,PDN
WC151,,2015,2002,,137,112256,20111,,137,112256,20111,,0,0,0,PDN
WC151,,2016,2002,,137,112256,20111,,137,112256,20111,,0,0,0,PDN
WC151,,2017,2002,,137,112256,20111,,137,112256,20111,,0,0,0,PDN
WC151,,2017,2002,,137,112256,20111,,137,112256,20111,,0,0,0,PDN
WC157,,2008,1983,,220904,11327963,2236556,,15274,799992,157621,,205630,10527971,2078935,PDN
WC157,,2009,1983,,220904,11327963,2236556,,62740,3206454,633283,,158164,8121509,1603272,PDN
WC157,,2010,1983,,220904,11327963,2236556,,63402,3260496,643561,,157502,8067467,1592994,PDN
WC157,,2011,1983,,63402,3260900,643633,,63402,3260900,643633,,0,0,0,PDN
WC157,,2012,1983,,63402,3260900,643633,,63402,3260900,643633,,0,0,0,PDN
WC157,,2013,1983,,63402,3260900,643633,,63402,3260900,643633,,0,0,0,PDN
WC157,,2014,1983,,63402,3260900,643633,,63402,3260900,643633,,0,0,0,PDN
WC157,,2015,1983,,63402,3260900,643633,,63402,3260900,643633,,0,0,0,PDN
WC157,,2016,1983,,63402,3260900,643633,,63402,3260900,643633,,0,0,0,PDN
WC157,,2017,1983,,63402,3260900,643633,,63402,3260900,643633,,0,0,0,PDN
WC157,,2017,1983,,63402,3260900,643633,,63402,3260900,643633,,0,0,0,PDN
WC165,,1975,1960,,1148525,114428402,21509451,,508555,62586138,11644878,,639970,51842264,9864573,PDN
WC165,,1976,1960,,1148525,114428402,21509451,,580540,71381604,13281893,,567985,43046798,8227558,PDN
WC165,,1977,1960,,1582525,114428402,21943451,,1059929,77252636,14805950,,522596,37175766,7137501,PDN
WC165,,1978,1960,,2097599,190509077,35996011,,1160617,96731681,18372660,,936982,93777396,17623351,PDN
WC165,,1979,1960,,1663599,190509077,35562011,,794300,114879910,21235565,,869299,75629167,14326446,PDN
WC165,,1980,1960,,1663599,190509077,35562011,,860127,131300329,24223175,,803472,59208748,11338836,PDN
WC165,,1981,1960,,1663599,190509077,35562011,,907059,144784704,26669462,,756540,45724373,8892549,PDN
WC165,,1982,1960,,1752712,214008077,39832441,,1013197,166538710,30646419,,739515,47469367,9186022,PDN
WC165,,1983,1960,,1752712,214008077,39832441,,1046439,176786896,32503182,,706273,37221181,7329259,PDN
WC165,,1984,1960,,1895609,238446244,44323766,,1065783,185535475,34079213,,829826,52910769,10244553,PDN
WC165,,1985,1960,,1896157,243930244,45300115,,1072324,192184635,35268878,,823833,51745609,10031237,PDN
WC165,,1986,1960,,1896157,243930244,45300115,,1076077,195649670,35889186,,820080,48280574,9410929,PDN
WC165,,1987,1960,,1533426,276001009,50643926,,1094977,198844732,36476602,,438449,77156277,14167324,PDN
WC165,,1988,1960,,1404338,272729974,49932803,,1105736,202254987,37094168,,298602,70474987,12838635,PDN
WC165,,1989,1960,,1486830,278450381,51033161,,1118307,205638428,37708775,,368523,72811953,13324386,PDN
WC165,,1990,1960,,1189263,225030183,41230221,,1117340,206139150,37796904,,71923,18891033,3433317,PDN
WC165,,1991,1960,,1189263,225030183,41230221,,1119129,206542352,37870437,,70134,18487831,3359784,PDN
WC165,,1992,1960,,1189263,225030183,41230221,,1120975,206944318,37943807,,68288,18085865,3286414,PDN
WC165,,1993,1960,,1256719,231775828,42497970,,1131412,208426300,38217942,,125307,23349528,4280028,PDN
WC165,,1994,1960,,1510196,249071040,45828886,,1189552,217121728,39823311,,320644,31949312,6005575,PDN
WC165,,1995,1960,,1405730,256486118,47043829,,1239912,225315471,41331633,,165818,31170647,5712196,PDN
WC165,,1996,1960,,1458824,265757158,48746575,,1288201,232292477,42621382,,170623,33464681,6125193,PDN
WC165,,1997,1960,,1342597,249199123,45684078,,1308865,235699502,43248278,,33732,13499621,2435800,PDN
WC165,,1998,1960,,2094954,273074439,50684712,,1365422,239024918,43896546,,729532,34049521,6788166,PDN
WC165,,1999,1960,,2076828,286231933,53007777,,1523421,245237149,45159924,,553407,40994784,7847853,PDN
WC165,,2000,1960,,2083215,266299912,49467541,,1647705,250525028,46225112,,435510,15774884,3242429,PDN
WC165,,2001,1960,,1691666,264727768,48796251,,1674715,254084355,46885454,,16951,10643413,1910797,PDN
WC165,,2002,1960,,1745206,272703223,50268911,,1690970,259048626,47785032,,54236,13654597,2483879,PDN
WC165,,2003,1960,,1746779,274682376,50622647,,1710562,262769961,48466783,,36217,11912415,2155864,PDN
WC165,,2004,1960,,1914831,296322243,54641209,,1740273,269446968,49684573,,174558,26875275,4956636,PDN
WC165,,2005,1960,,2124226,325799099,60095596,,1789263,277647497,51192732,,334963,48151602,8902864,PDN
WC165,,2006,1960,,2135966,333627743,61500333,,1822900,282715288,52128111,,313066,50912455,9372222,PDN
WC165,,2007,1960,,2111109,340635436,62722396,,1901581,293161091,54065476,,209528,47474345,8656920,PDN
WC165,,2008,1960,,2110942,338981156,62427874,,1942672,303105984,55876121,,168270,35875172,6551753,PDN
WC165,,2009,1960,,2150153,343506603,63272325,,1978502,318033946,58568173,,171651,25472657,4704152,PDN
WC165,,2010,1960,,2150153,343506603,63272325,,1991384,322166050,59316304,,158769,21340553,3956021,PDN
WC165,,2011,1960,,2133056,342810173,63131307,,1996670,324046169,59656131,,136386,18764004,3475177,PDN
WC165,,2012,1960,,2133056,342810173,63131307,,2010755,326254867,60063224,,122301,16555306,3068086,PDN
WC165,,2013,1960,,2133056,342810173,63131307,,2026521,328066129,60401278,,106535,14744044,2730031,PDN
WC165,,2014,1960,,2135721,340690942,62756886,,2039690,329507902,60670991,,96031,11183040,2085896,PDN
WC165,,2015,1960,,2133945,341125942,62832512,,2048454,330605696,60875091,,85491,10520246,1957421,PDN
WC165,,2016,1960,,2133982,341260599,62856509,,2055001,331305246,61006113,,78981,9955353,1850397,PDN
WC165,,2017,1960,,2055001,331305246,61006113,,2055001,331305246,61006113,,0,0,0,PDN
WC165,,2017,1960,,2055001,331305246,61006113,,2055001,331305246,61006113,,0,0,0,PDN
WC167,,1985,1983,,10728,10727518,1919539,,0,0,0,,10728,10727518,1919539,PDN
WC167,,1990,1983,,476865,33866496,6502932,,32976,2776783,527066,,443889,31089713,5975866,PDN
WC167,,1991,1983,,479613,33866496,6505680,,58849,4829651,918218,,420764,29036845,5587462,PDN
WC167,,1992,1983,,539107,37325679,7180687,,81392,6161037,1177662,,457715,31164642,6003025,PDN
WC167,,1993,1983,,539107,37325679,7180687,,91692,7001243,1337465,,447415,30324436,5843222,PDN
WC167,,1994,1983,,367271,28550710,5447469,,110204,8873082,1689044,,257067,19677628,3758425,PDN
WC167,,1995,1983,,367256,28543110,5446101,,127341,10659187,2023993,,239915,17883923,3422108,PDN
WC167,,1996,1983,,366424,28613762,5457841,,143255,12299641,2331803,,223169,16314121,3126038,PDN
WC167,,1997,1983,,378211,30003204,5716859,,156981,13727289,2599559,,221230,16275915,3117300,PDN
WC167,,1998,1983,,381396,30350565,5781852,,169330,14964490,2832051,,212066,15386075,2949801,PDN
WC167,,1999,1983,,395514,32658082,6206561,,176016,15895660,3004425,,219498,16762422,3202136,PDN
WC167,,2000,1983,,269798,24363596,4604957,,185237,16730211,3162143,,84561,7633385,1442814,PDN
WC167,,2001,1983,,192701,17493163,3305363,,191076,17334800,3275560,,1625,158363,29803,PDN
WC167,,2002,1983,,194722,18265910,3444884,,193183,17539657,3314118,,1539,726253,130766,PDN
WC167,,2003,1983,,193183,17539657,3314118,,193183,17539657,3314118,,0,0,0,PDN
WC167,,2004,1983,,193183,17539657,3314118,,193183,17539657,3314118,,0,0,0,PDN
WC167,,2005,1983,,193183,17539657,3314118,,193183,17539657,3314118,,0,0,0,PDN
WC167,,2006,1983,,193183,17539657,3314118,,193183,17539657,3314118,,0,0,0,PDN
WC167,,2007,1983,,193183,17539657,3314118,,193183,17539657,3314118,,0,0,0,PDN
WC167,,2008,1983,,193183,17539657,3314118,,193183,17539657,3314118,,0,0,0,PDN
WC167,,2009,1983,,193183,17831919,3366123,,193183,17831919,3366123,,0,0,0,PDN
WC167,,2010,1983,,193183,17831919,3366123,,193183,17831919,3366123,,0,0,0,PDN
WC167,,2011,1983,,193183,17831919,3366123,,193183,17831919,3366123,,0,0,0,PDN
WC167,,2012,1983,,193183,17831919,3366123,,193183,17831919,3366123,,0,0,0,PDN
WC167,,2013,1983,,193183,17831919,3366123,,193183,17831919,3366123,,0,0,0,PDN
WC167,,2014,1983,,193183,17831919,3366123,,193183,17831919,3366123,,0,0,0,PDN
WC167,,2015,1983,,193183,17831919,3366123,,193183,17831919,3366123,,0,0,0,PDN
WC167,,2016,1983,,193183,17831919,3366123,,193183,17831919,3366123,,0,0,0,PDN
WC167,,2017,1983,,193183,17831919,3366123,,193183,17831919,3366123,,0,0,0,PDN
WC167,,2017,1983,,193183,17831919,3366123,,193183,17831919,3366123,,0,0,0,PDN
WC180,,1975,1961,,13000010,1364000000,255704636,,10842194,827170780,158025607,,2157816,536829220,97679029,PDN
WC180,,1976,1961,,13413467,1401000000,262701723,,11442859,925431227,176110337,,1970608,475568773,86591386,PDN
WC180,,1977,1961,,15133467,1401000000,264421723,,13499037,1009853301,193188236,,1634430,391146699,71233487,PDN
WC180,,1978,1961,,15133467,1401000000,264421723,,13719801,1077525683,205450350,,1413666,323474317,58971373,PDN
WC180,,1979,1961,,10679874,1532117594,283298663,,8513425,1175889329,217746402,,2166449,356228265,65552261,PDN
WC180,,1980,1961,,10776429,1539285537,284670653,,8617157,1239147558,229106046,,2159272,300137979,55564607,PDN
WC180,,1981,1961,,10771880,1545166830,285712597,,8687073,1280999073,236622851,,2084807,264167757,49089746,PDN
WC180,,1982,1961,,10723758,1543427635,285355010,,8430115,1305354380,240699578,,2293643,238073255,44655432,PDN
WC180,,1983,1961,,10471994,1556111418,287360147,,8571761,1342799950,247504136,,1900233,213311468,39856011,PDN
WC180,,1984,1961,,10598551,1602417649,295726247,,8645306,1370631863,252529979,,1953245,231785786,43196268,PDN
WC180,,1985,1961,,10665123,1615845268,298182075,,8705447,1387376337,255569564,,1959676,228468931,42612511,PDN
WC180,,1986,1961,,10605225,1627888558,300265111,,8422207,1402289309,257939878,,2183018,225599249,42325233,PDN
WC180,,1987,1961,,11822679,1556317561,288747512,,8485912,1423752432,261822644,,3336767,132565129,26924868,PDN
WC180,,1988,1961,,10587779,1520442356,281129123,,8577281,1450171608,266614934,,2010498,70270748,14514189,PDN
WC180,,1989,1961,,11034415,1609510414,297424168,,8710135,1473779899,270948551,,2324280,135730515,26475617,PDN
WC180,,1990,1961,,9398691,1600784556,294235801,,8807660,1495049379,274830681,,591031,105735177,19405120,PDN
WC180,,1991,1961,,9395320,1605505210,295072404,,8852129,1511250443,277757902,,543191,94254767,17314502,PDN
WC180,,1992,1961,,9396715,1618311365,297352474,,8886297,1525280497,280288521,,510418,93030868,17063953,PDN
WC180,,1993,1961,,9547929,1644095666,302091642,,8922492,1537857304,282562582,,625437,106238362,19529060,PDN
WC180,,1994,1961,,9424326,1612113231,296277214,,9071695,1554754954,285718484,,352631,57358277,10558730,PDN
WC180,,1995,1961,,9591574,1634636427,300452148,,9178110,1571660567,288833015,,413464,62975860,11619133,PDN
WC180,,1996,1961,,9647509,1652989641,303773780,,9228064,1586378410,291501802,,419445,66611231,12271978,PDN
WC180,,1997,1961,,10689776,1676328173,308968810,,9332147,1600673318,294149463,,1357629,75654855,14819347,PDN
WC180,,1998,1961,,10744599,1682958072,310203331,,9921971,1617086119,297659715,,822628,65871953,12543616,PDN
WC180,,1999,1961,,10782021,1676869222,309157328,,10243904,1619870612,298477109,,538117,56998610,10680219,PDN
WC180,,2000,1961,,12993962,1753563584,325015952,,12157004,1676167821,310407506,,836958,77395763,14608446,PDN
WC180,,2001,1961,,12661815,1779436369,329287504,,12339596,1704787671,315682598,,322219,74648698,13604906,PDN
WC180,,2002,1961,,13008351,1801950694,333640147,,12443088,1726553026,319658929,,565263,75397668,13981218,PDN
WC180,,2003,1961,,12752430,1795236631,332189553,,12599872,1749291049,323861624,,152558,45945582,8327929,PDN
WC180,,2004,1961,,12764381,1794099595,331999184,,12649606,1763034800,326356866,,114775,31064795,5642318,PDN
WC180,,2005,1961,,12861762,1847475545,341594065,,12665543,1772103450,327986442,,196219,75372095,13607623,PDN
WC180,,2006,1961,,12866805,1837624310,339846219,,12684550,1779497484,329321113,,182255,58126826,10525106,PDN
WC180,,2007,1961,,13351542,1843144836,341313256,,12858630,1786365841,330717321,,492912,56778995,10595935,PDN
WC180,,2008,1961,,13674342,1854680983,343688752,,12884868,1779152114,329459977,,789474,75528869,14228775,PDN
WC180,,2009,1961,,13441373,1868127781,345848448,,13027850,1829787838,338612867,,413523,38339943,7235575,PDN
WC180,,2010,1961,,13450516,1868638419,345948452,,13099138,1835451414,339691912,,351378,33187005,6256538,PDN
WC180,,2011,1961,,13450516,1868638419,345948452,,13167109,1840181109,340601465,,283407,28457310,5346986,PDN
WC180,,2012,1961,,13339147,1864479578,345097074,,13207910,1843221473,341183255,,131237,21258105,3913818,PDN
WC180,,2013,1961,,13343213,1864680768,345136939,,13214147,1844888558,341486126,,129066,19792210,3650813,PDN
WC180,,2014,1961,,13295993,1861828467,344582193,,13216802,1845646093,341623574,,79191,16182374,2958617,PDN
WC180,,2015,1961,,13230303,1848363302,342120565,,13217486,1845833069,341657528,,12817,2530233,463036,PDN
WC180,,2016,1961,,13217486,1845833258,341657561,,13217486,1845833258,341657561,,0,0,0,PDN
WC180,,2017,1961,,13217489,1845834046,341657704,,13217489,1845834046,341657704,,0,0,0,PDN
WC180,,2017,1961,,13217489,1845834046,341657704,,13217489,1845834046,341657704,,0,0,0,PDN
WC187,,1988,1987,,16586,5805009,1049506,,0,0,0,,16586,5805009,1049506,PDN
WC187,,1989,1987,,222243,39428512,7237992,,9686,1835068,336211,,212557,37593444,6901781,PDN
WC187,,1990,1987,,614608,109038896,20016547,,186326,36622905,6702857,,428282,72415991,13313690,PDN
WC187,,1991,1987,,414914,88791520,16214117,,244948,53446519,9755005,,169966,35345001,6459112,PDN
WC187,,1992,1987,,414914,88791520,16214117,,262508,59934413,10926994,,152406,28857107,5287123,PDN
WC187,,1993,1987,,414914,88791520,16214117,,269327,61692105,11246570,,145587,27099415,4967547,PDN
WC187,,1994,1987,,484168,95716818,17515630,,271607,62437361,11381458,,212561,33279457,6134172,PDN
WC187,,1995,1987,,340860,69362658,12682970,,275292,63856516,11637661,,65568,5506142,1045309,PDN
WC187,,1996,1987,,446181,69502313,12813141,,280852,64667277,11787485,,165329,4835036,1025656,PDN
WC187,,1997,1987,,280920,64712776,11795649,,280920,64712776,11795649,,0,0,0,PDN
WC187,,1998,1987,,285096,65854035,12002896,,282338,64956415,11840419,,2758,897620,162477,PDN
WC187,,1999,1987,,285096,65854035,12002896,,284097,65406176,11922207,,999,447859,80689,PDN
WC187,,2000,1987,,285096,65854035,12002896,,284492,65531699,11944937,,604,322336,57959,PDN
WC187,,2001,1987,,285096,65854035,12002896,,284581,65565972,11951124,,515,288063,51772,PDN
WC187,,2002,1987,,285096,65853867,12002866,,284761,65626824,11962132,,335,227043,40734,PDN
WC187,,2003,1987,,284765,65637551,11964045,,284765,65637551,11964045,,0,0,0,PDN
WC187,,2004,1987,,284797,65640094,11964529,,284797,65640094,11964529,,0,0,0,PDN
WC187,,2005,1987,,284821,65883126,12007797,,284797,65640094,11964529,,24,243032,43268,PDN
WC187,,2006,1987,,284821,65883126,12007797,,284797,65640094,11964529,,24,243032,43268,PDN
WC187,,2007,1987,,284821,65883126,12007797,,284797,65640094,11964529,,24,243032,43268,PDN
WC187,,2008,1987,,284797,65640116,11964533,,284797,65640116,11964533,,0,0,0,PDN
WC187,,2009,1987,,284797,66936125,12195140,,284797,66936125,12195140,,0,0,0,PDN
WC187,,2010,1987,,284797,66936125,12195140,,284797,66936125,12195140,,0,0,0,PDN
WC187,,2011,1987,,284797,66936125,12195140,,284797,66936125,12195140,,0,0,0,PDN
WC187,,2012,1987,,284797,66936125,12195140,,284797,66936125,12195140,,0,0,0,PDN
WC187,,2013,1987,,284797,66936125,12195140,,284797,66936125,12195140,,0,0,0,PDN
WC187,,2014,1987,,284797,66936125,12195140,,284797,66936125,12195140,,0,0,0,PDN
WC187,,2015,1987,,284797,66936125,12195140,,284797,66936125,12195140,,0,0,0,PDN
WC187,,2016,1987,,284797,66936125,12195140,,284797,66936125,12195140,,0,0,0,PDN
WC187,,2017,1987,,284797,66936125,12195140,,284797,66936125,12195140,,0,0,0,PDN
WC187,,2017,1987,,284797,66936125,12195140,,284797,66936125,12195140,,0,0,0,PDN
WC192,,1975,1954,,9352985,1119235801,208505263,,7156252,735473820,138023480,,2196733,383761981,70481783,PDP
WC192,,1976,1954,,9254011,1097155801,204477463,,7925545,849834106,159141578,,1328466,247321695,45335885,PDP
WC192,,1977,1954,,14061963,1220561461,231243718,,10576376,861891985,163937939,,3485587,358669476,67305779,PDP
WC192,,1978,1954,,14067246,1221297901,231380040,,10811918,881216321,167611975,,3255328,340081580,63768065,PDP
WC192,,1979,1954,,11550090,1226141901,229724805,,8309829,892162695,167057639,,3240261,333979206,62667166,PDP
WC192,,1980,1954,,11595346,1237000670,231702227,,8401043,903611043,169185926,,3194303,333389627,62516301,PDP
WC192,,1981,1954,,11601943,1248257670,233711849,,8452006,895729337,167834450,,3149937,352528333,65877399,PDP
WC192,,1982,1954,,12872244,1350695113,253209453,,8789882,905580803,169925256,,4082362,445114310,83284197,PDP
WC192,,1983,1954,,13023573,1272198141,239393349,,8916372,914312325,171605398,,4107201,357885816,67787951,PDP
WC192,,1984,1954,,13593448,1273792284,240246879,,10340258,935490943,176797721,,3253190,338301341,63449158,PDP
WC192,,1985,1954,,16140948,1305635403,248460415,,11692455,963634897,183157739,,4448493,342000506,65302676,PDP
WC192,,1986,1954,,16467082,1341432564,255156150,,12899005,996266972,190170708,,3568077,345165592,64985442,PDP
WC192,,1987,1954,,17302276,1362446386,259730459,,13717752,1027004138,196458702,,3584524,335442248,63271757,PDP
WC192,,1988,1954,,17575044,1386052731,264203644,,14361694,1049893316,201175451,,3213350,336159415,63028193,PDP
WC192,,1989,1954,,18853948,1231096862,237910329,,14856035,1068243158,204934889,,3997913,162853704,32975440,PDP
WC192,,1990,1954,,18784078,1227056984,237121620,,15484382,1080450496,207735360,,3299696,146606488,29386260,PDP
WC192,,1991,1954,,18901029,1212207124,234596247,,15825206,1094838183,210636271,,3075823,117368941,23959976,PDP
WC192,,1992,1954,,19709049,1216461677,236161305,,16285358,1106732169,213212790,,3423691,109729508,22948515,PDP
WC192,,1993,1954,,20798143,1203306958,234909701,,17080643,1122370715,216790735,,3717500,80936243,18118966,PDP
WC192,,1994,1954,,21005874,1213466579,236925194,,17931431,1138968952,220594946,,3074443,74497627,16330248,PDP
WC192,,1995,1954,,20941968,1230359400,239867128,,18413092,1150227149,223079844,,2528876,80132251,16787284,PDP
WC192,,1996,1954,,21150832,1250897323,243730427,,18788033,1161542151,225468131,,2362799,89355172,18262296,PDP
WC192,,1997,1954,,21283062,1258747920,245259560,,19081291,1174702014,228103002,,2201771,84045906,17156558,PDP
WC192,,1998,1954,,21317357,1264760870,246363775,,19321238,1186528958,230447387,,1996119,78231912,15916388,PDP
WC192,,1999,1954,,20568895,1260171983,244798785,,19552321,1199491187,232984917,,1016574,60680796,11813868,PDP
WC192,,2000,1954,,20781608,1275042523,247657502,,19787877,1214876989,235958160,,993731,60165534,11699342,PDP
WC192,,2001,1954,,21209477,1310233724,254347150,,20316100,1241290516,241186299,,893377,68943208,13160851,PDP
WC192,,2002,1954,,22440384,1372909392,266730311,,20832865,1272498038,247256003,,1607519,100411354,19474308,PDP
WC192,,2003,1954,,22768532,1384455292,269112890,,21534013,1314431830,255418680,,1234519,70023462,13694210,PDP
WC192,,2004,1954,,22703266,1374161369,267215965,,21949862,1338700568,260152810,,753404,35460801,7063155,PDP
WC192,,2005,1954,,23079010,1395427293,271375682,,22230720,1351029659,262627456,,848290,44397634,8748226,PDP
WC192,,2006,1954,,23819410,1407668410,274294216,,22298722,1356837784,263728933,,1520688,50830626,10565283,PDP
WC192,,2007,1954,,23656343,1419316143,276203700,,22527728,1365225190,265450360,,1128615,54090953,10753340,PDP
WC192,,2008,1954,,23948217,1484073984,288018321,,22680976,1370149091,266479747,,1267241,113924893,21538574,PDP
WC192,,2009,1954,,23628256,1439012835,279680365,,22812133,1398503682,271656209,,816123,40509153,8024156,PDP
WC192,,2010,1954,,23702368,1442648215,280401343,,22977900,1405759268,273113004,,724468,36888947,7288339,PDP
WC192,,2011,1954,,23699301,1441081529,280119506,,23057640,1409995503,273946520,,641661,31086026,6172983,PDP
WC192,,2012,1954,,23698764,1440940356,280093848,,23144642,1412932219,274556071,,554122,28008137,5537775,PDP
WC192,,2013,1954,,23544579,1430962835,278164303,,23195889,1414676225,274917639,,348690,16286610,3246663,PDP
WC192,,2014,1954,,23607580,1420431563,276353412,,23254256,1415485435,275119994,,353324,4946128,1233418,PDP
WC192,,2015,1954,,23607580,1420431563,276353412,,23290191,1415864569,275223391,,317389,4566994,1130021,PDP
WC192,,2016,1954,,23607580,1420431563,276353412,,23314323,1416086623,275287035,,293257,4344940,1066377,PDP
WC192,,2017,1954,,23607580,1420431563,276353412,,23350029,1416277069,275356627,,257551,4154494,996785,PDP
WC192,,2017,1954,,23607580,1420431563,276353412,,23350029,1416277069,275356627,,257551,4154494,996785,PDP
WC196,,1990,1984,,1180898,162337123,30066507,,4286,456314,85481,,1176612,161880809,29981026,PDN
WC196,,1991,1984,,1180898,162337123,30066507,,94618,13805955,2551194,,1086280,148531168,27515313,PDN
WC196,,1992,1984,,788934,111297503,20592760,,311540,37253945,6940356,,477394,74043558,13652404,PDN
WC196,,1993,1984,,1122148,132096625,24626886,,522013,57014541,10666949,,600135,75082084,13959937,PDN
WC196,,1994,1984,,1122154,132097334,24627018,,764171,83371889,15599027,,357983,48725445,9027991,PDN
WC196,,1995,1984,,1185104,143615372,26739441,,862263,101478933,18919013,,322841,42136439,7820428,PDN
WC196,,1996,1984,,1273839,169931466,31510755,,1040138,128281341,23865999,,233701,41650125,7644756,PDN
WC196,,1997,1984,,1315261,180952939,33513293,,1147212,148028547,27486811,,168049,32924392,6026482,PDN
WC196,,1998,1984,,1369189,191241868,35397991,,1263560,169752945,31468710,,105629,21488923,3929281,PDN
WC196,,1999,1984,,1487527,221319001,40868132,,1335938,185918300,34417486,,151589,35400701,6450646,PDN
WC196,,2000,1984,,1491889,232461430,42855133,,1365546,196848676,36392001,,126343,35612754,6463132,PDN
WC196,,2001,1984,,1467201,226370389,41746629,,1380431,205267119,37904829,,86770,21103270,3841800,PDN
WC196,,2002,1984,,1601262,240779850,44444652,,1434139,214756756,39647085,,167123,26023094,4797567,PDN
WC196,,2003,1984,,1614665,241918456,44660653,,1474997,222272389,41025244,,139668,19646067,3635409,PDN
WC196,,2004,1984,,1562552,236383900,43623744,,1488819,225720188,41652554,,73733,10663712,1971190,PDN
WC196,,2005,1984,,1565723,246974615,45511384,,1494554,227530115,41980340,,71169,19444500,3531044,PDN
WC196,,2006,1984,,1605904,247409311,45628913,,1513152,231697683,42740498,,92752,15711628,2888415,PDN
WC196,,2007,1984,,1605904,247409311,45628913,,1522588,234701056,43284342,,83316,12708255,2344571,PDN
WC196,,2008,1984,,1605904,247409311,45628913,,1527673,236258051,43566472,,78231,11151260,2062441,PDN
WC196,,2009,1984,,1553258,247664206,45621621,,1531557,240630971,44348455,,21701,7033235,1273167,PDN
WC196,,2010,1984,,1553258,247664206,45621621,,1536660,242085241,44612325,,16598,5578965,1009296,PDN
WC196,,2011,1984,,1543864,244268475,45008004,,1540914,243376490,44846338,,2950,891985,161666,PDN
WC196,,2012,1984,,1543864,244268475,45008004,,1543864,244263479,45007116,,0,4996,888,PDN
WC196,,2013,1984,,1543864,244268475,45008004,,1543864,244268475,45008004,,0,0,0,PDN
WC196,,2014,1984,,1543864,244268475,45008004,,1543864,244268475,45008004,,0,0,0,PDN
WC196,,2015,1984,,1543864,244268475,45008004,,1543864,244268475,45008004,,0,0,0,PDN
WC196,,2016,1984,,1543864,244268475,45008004,,1543864,244268475,45008004,,0,0,0,PDN
WC196,,2017,1984,,1543864,244268475,45008004,,1543864,244268475,45008004,,0,0,0,PDN
WC196,,2017,1984,,1543864,244268475,45008004,,1543864,244268475,45008004,,0,0,0,PDN
WC198,,1977,1976,,7912744,111042401,27671178,,0,0,0,,7912744,111042401,27671178,PDN
WC198,,1978,1976,,680732,119945200,22023294,,30934,2112003,406735,,649798,117833197,21616559,PDN
WC198,,1979,1976,,680732,119945200,22023294,,169732,24170053,4470453,,511000,95775147,17552841,PDN
WC198,,1980,1976,,755964,125310000,23053117,,266251,39076262,7219323,,489713,86233738,15833794,PDN
WC198,,1981,1976,,755964,125310000,23053117,,299587,55646994,10201187,,456377,69663006,12851930,PDN
WC198,,1982,1976,,755964,125310000,23053117,,398797,77413053,14173362,,357167,47896947,8879755,PDN
WC198,,1983,1976,,2592864,288989690,54014517,,808864,136900002,25168295,,1784000,152089688,28846222,PDN
WC198,,1984,1976,,886469,157241157,28865323,,381303,87667276,15980462,,505166,69573881,12884861,PDN
WC198,,1985,1976,,886469,157241157,28865323,,411999,93667748,17078858,,474470,63573409,11786465,PDN
WC198,,1986,1976,,886469,157241157,28865323,,438325,98859872,18029050,,448144,58381285,10836273,PDN
WC198,,1987,1976,,886469,157241157,28865323,,474675,106201575,19371752,,411794,51039582,9493571,PDN
WC198,,1988,1976,,892595,152021098,27942612,,503856,106955704,19535120,,388739,45065394,8407492,PDN
WC198,,1989,1976,,991971,176420498,32383519,,522645,110928795,20260865,,469326,65491703,12122654,PDN
WC198,,1990,1976,,991971,176420498,32383519,,534371,113578745,20744112,,457600,62841753,11639407,PDN
WC198,,1991,1976,,755402,152213484,27839652,,544989,112133106,20497499,,210413,40080378,7342153,PDN
WC198,,1992,1976,,805160,162114063,29651079,,606753,124969368,22843295,,198407,37144695,6807784,PDN
WC198,,1993,1976,,859687,175414505,32072232,,653500,135196473,24709812,,206187,40218032,7362420,PDN
WC198,,1994,1976,,957582,185032936,33881592,,711287,144083162,26348860,,246295,40949774,7532732,PDN
WC198,,1995,1976,,2188520,195859904,37039037,,1037537,153602690,28368977,,1150983,42257214,8670060,PDN
WC198,,1996,1976,,2188520,195859904,37039037,,1374044,163101000,30395574,,814476,32758904,6643463,PDN
WC198,,1997,1976,,2679920,202045789,38631128,,1889768,169692369,32084140,,790152,32353420,6546988,PDN
WC198,,1998,1976,,3028520,222966785,42702325,,2315335,182483161,34785648,,713185,40483624,7916677,PDN
WC198,,1999,1976,,3034369,223133453,42737830,,2505071,193513732,36938119,,529298,29619721,5799711,PDN
WC198,,2000,1976,,937017,199844590,36496553,,873716,175081433,32026996,,63301,24763157,4469557,PDN
WC198,,2001,1976,,1080876,213919558,39144854,,905071,180217291,32972205,,175805,33702267,6172649,PDN
WC198,,2002,1976,,1335578,224135967,41217423,,998644,186758377,34229672,,336934,37377590,6987751,PDN
WC198,,2003,1976,,1335317,219961007,40474286,,1069000,192865798,35386758,,266317,27095209,5087528,PDN
WC198,,2004,1976,,1316453,212089138,39054734,,1127711,197916152,36344108,,188742,14172986,2710626,PDN
WC198,,2005,1976,,1291404,230561541,42316589,,1150713,201343335,36976929,,140691,29218206,5339660,PDN
WC198,,2006,1976,,1263443,226409241,41549785,,1170540,204467219,37552607,,92903,21942022,3997178,PDN
WC198,,2007,1976,,1263443,226409241,41549785,,1190083,206865477,37998887,,73360,19543764,3550898,PDN
WC198,,2008,1976,,1263443,226409241,41549785,,1199132,208819246,38355581,,64311,17589995,3194204,PDN
WC198,,2009,1976,,1254917,224081312,41127038,,1209605,213856666,39262392,,45312,10224646,1864644,PDN
WC198,,2010,1976,,1254917,224081312,41127038,,1221498,215552980,39576120,,33419,8528332,1550914,PDN
WC198,,2011,1976,,1256664,222524488,40851770,,1225617,216794992,39801239,,31047,5729496,1050530,PDN
WC198,,2012,1976,,1244683,221389381,40637812,,1229684,218032995,40025592,,14999,3356386,612220,PDN
WC198,,2013,1976,,1234478,219551128,40300516,,1231299,218529979,40115638,,3179,1021149,184878,PDN
WC198,,2014,1976,,1231302,218540527,40117518,,1231302,218540527,40117518,,0,0,0,PDN
WC198,,2015,1976,,1231302,218540527,40117518,,1231302,218540527,40117518,,0,0,0,PDN
WC198,,2016,1976,,1231302,218540527,40117518,,1231302,218540527,40117518,,0,0,0,PDN
WC198,,2017,1976,,1231302,218540527,40117518,,1231302,218540527,40117518,,0,0,0,PDN
WC198,,2017,1976,,1231302,218540527,40117518,,1231302,218540527,40117518,,0,0,0,PDN
WC205,,1983,1977,,500000,12000000,2635231,,171058,4823762,1029379,,328942,7176238,1605852,PDN
WC205,,1984,1977,,5019846,378057009,72289776,,1255021,115434484,21794965,,3764825,262622525,50494811,PDN
WC205,,1985,1977,,5127368,391119327,74721554,,1901656,159921120,30357371,,3225712,231198207,44364183,PDN
WC205,,1986,1977,,5209965,404912991,77258540,,2398253,195376824,37162812,,2811712,209536167,40095728,PDN
WC205,,1987,1977,,5214952,408131313,77836182,,2611874,223053385,42301088,,2603078,185077928,35535094,PDN
WC205,,1988,1977,,5216985,412419547,78601246,,2730962,240387341,45504510,,2486023,172032206,33096736,PDN
WC205,,1989,1977,,3621194,339331101,64000393,,2798137,252969459,47810496,,823057,86361642,16189897,PDN
WC205,,1990,1977,,3568601,329891213,62268105,,2817496,259872745,49058198,,751105,70018468,13209907,PDN
WC205,,1991,1977,,3200108,343169039,64262215,,2829435,267742215,50470399,,370673,75426824,13791816,PDN
WC205,,1992,1977,,3123406,318621739,59817666,,2839155,273560834,51515460,,284251,45060905,8302206,PDN
WC205,,1993,1977,,2870676,286793474,53901543,,2844811,275834907,51925755,,25865,10958567,1975788,PDN
WC205,,1994,1977,,2870793,287069207,53950723,,2847987,277350292,52198573,,22806,9718915,1752150,PDN
WC205,,1995,1977,,2870793,287069207,53950723,,2850106,278493597,52404127,,20687,8575610,1546596,PDN
WC205,,1996,1977,,2915196,290511114,54607565,,2850790,279014289,52497461,,64406,11496825,2110104,PDN
WC205,,1997,1977,,3059490,307963683,57857298,,2897348,284321739,53488405,,162142,23641944,4368893,PDN
WC205,,1998,1977,,3059490,307963683,57857298,,2996421,298976919,56195161,,63069,8986764,1662137,PDN
WC205,,1999,1977,,3209271,337711765,63300332,,3074790,313580347,58872005,,134481,24131418,4428327,PDN
WC205,,2000,1977,,3220369,345381857,64676215,,3136952,328688008,61622363,,83417,16693849,3053852,PDN
WC205,,2001,1977,,3320370,367665586,68741293,,3184314,340181183,63714774,,136056,27484403,5026519,PDN
WC205,,2002,1977,,3319551,367694243,68745573,,3217135,349071950,65329582,,102416,18622293,3415991,PDN
WC205,,2003,1977,,3345174,372907457,69698814,,3258364,356515345,66695258,,86810,16392112,3003556,PDN
WC205,,2004,1977,,3300168,366353678,68487655,,3287774,364045425,68064540,,12394,2308253,423115,PDN
WC205,,2005,1977,,3387391,391561589,73060271,,3301503,365953577,68417798,,85888,25608012,4642473,PDN
WC205,,2006,1977,,3329870,386056882,72023265,,3318636,368145917,68825027,,11234,17910965,3198238,PDN
WC205,,2007,1977,,3347321,389707944,72690371,,3322225,368999496,68980498,,25096,20708448,3709873,PDN
WC205,,2008,1977,,3350774,390360579,72809951,,3323560,369306992,69036548,,27214,21053587,3773403,PDN
WC205,,2009,1977,,3352350,385405025,71929755,,3327774,375938272,70220704,,24576,9466753,1709052,PDN
WC205,,2010,1977,,3352350,385405025,71929755,,3336951,378702685,70721769,,15399,6702340,1207986,PDN
WC205,,2011,1977,,3352350,385405025,71929755,,3341082,380540370,71052890,,11268,4864655,876865,PDN
WC205,,2012,1977,,3352350,385405025,71929755,,3343342,381582346,71240555,,9008,3822679,689200,PDN
WC205,,2013,1977,,3352350,385405025,71929755,,3343847,381865407,71291427,,8503,3539618,638328,PDN
WC205,,2014,1977,,3343847,381865407,71291427,,3343847,381865407,71291427,,0,0,0,PDN
WC205,,2015,1977,,3343847,381865407,71291427,,3343847,381865407,71291427,,0,0,0,PDN
WC205,,2016,1977,,3343847,381865407,71291427,,3343847,381865407,71291427,,0,0,0,PDN
WC205,,2017,1977,,3343847,381865407,71291427,,3343847,381865407,71291427,,0,0,0,PDN
WC205,,2017,1977,,3343847,381865407,71291427,,3343847,381865407,71291427,,0,0,0,PDN
WC222,,1977,1976,,36673,36673380,6562185,,0,0,0,,36673,36673380,6562185,PDN
WC222,,1978,1976,,36673,36673380,6562185,,0,0,0,,36673,36673380,6562185,PDN
WC222,,1979,1976,,36673,36673380,6562185,,0,0,0,,36673,36673380,6562185,PDN
WC222,,1980,1976,,722310,41998070,8195276,,206838,13581998,2623564,,515472,28416072,5571712,PDN
WC222,,1981,1976,,757000,44900070,8746336,,367871,26834465,5142687,,389129,18065605,3603649,PDN
WC222,,1982,1976,,766000,50570070,9764233,,431165,33612105,6411967,,334835,16957965,3352266,PDN
WC222,,1983,1976,,766000,50570070,9764233,,460074,37675227,7163851,,305926,12894843,2600382,PDN
WC222,,1984,1976,,898403,62670070,12049661,,483163,41130592,7801774,,415240,21539478,4247887,PDN
WC222,,1985,1976,,898403,62670070,12049661,,500088,43819902,8297224,,398315,18850168,3752437,PDN
WC222,,1986,1976,,675943,60552139,11450345,,506859,46845350,8842331,,169084,13706789,2608014,PDN
WC222,,1987,1976,,675943,60552139,11450345,,510401,48510904,9142234,,165542,12041235,2308111,PDN
WC222,,1988,1976,,675943,60552139,11450345,,512660,53290030,9994872,,163283,7262109,1455473,PDN
WC222,,1989,1976,,640569,64128509,12051336,,518332,55102198,10322994,,122237,9026311,1728342,PDN
WC222,,1990,1976,,640569,64128509,12051336,,521255,56035454,10491976,,119314,8093055,1559360,PDN
WC222,,1991,1976,,640569,64128509,12051336,,524610,57128876,10689890,,115959,6999633,1361446,PDN
WC222,,1992,1976,,585533,65140287,12176331,,525648,58238266,10888329,,59885,6902021,1288002,PDN
WC222,,1993,1976,,585533,65140287,12176331,,525839,58933509,11012229,,59694,6206778,1164102,PDN
WC222,,1994,1976,,585533,65140287,12176331,,526481,59929432,11190081,,59052,5210855,986250,PDN
WC222,,1995,1976,,585533,65140287,12176331,,527137,60997964,11380867,,58396,4142323,795464,PDN
WC222,,1996,1976,,549332,67062585,12482176,,527274,61959641,11552121,,22058,5102944,930055,PDN
WC222,,1997,1976,,549332,67062585,12482176,,527274,62810960,11703601,,22058,4251625,778575,PDN
WC222,,1998,1976,,549332,67062585,12482176,,527428,63174908,11768515,,21904,3887677,713661,PDN
WC222,,1999,1976,,563917,67062951,12496826,,530995,63756478,11875564,,32922,3306473,621262,PDN
WC222,,2000,1976,,563917,67062951,12496826,,535160,64125753,11945436,,28757,2937198,551390,PDN
WC222,,2001,1976,,563917,67062951,12496826,,538663,64335281,11986222,,25254,2727670,510604,PDN
WC222,,2002,1976,,563917,67062951,12496826,,541267,64453830,12009920,,22650,2609121,486906,PDN
WC222,,2003,1976,,566774,66461225,12392615,,545305,64610221,12041786,,21469,1851004,350829,PDN
WC222,,2004,1976,,566421,66412950,12383672,,546853,64659689,12052136,,19568,1753261,331536,PDN
WC222,,2005,1976,,546853,64659689,12052136,,546853,64659689,12052136,,0,0,0,PDN
WC222,,2006,1976,,546853,64659689,12052136,,546853,64659689,12052136,,0,0,0,PDN
WC222,,2007,1976,,546853,64659689,12052136,,546853,64659689,12052136,,0,0,0,PDN
WC222,,2008,1976,,546853,64659689,12052136,,546853,64659689,12052136,,0,0,0,PDN
WC222,,2009,1976,,546853,65924135,12277127,,546853,65924135,12277127,,0,0,0,PDN
WC222,,2010,1976,,546853,65924135,12277127,,546853,65924135,12277127,,0,0,0,PDN
WC222,,2011,1976,,546853,65924135,12277127,,546853,65924135,12277127,,0,0,0,PDN
WC222,,2012,1976,,546853,65924135,12277127,,546853,65924135,12277127,,0,0,0,PDN
WC222,,2013,1976,,546853,65924135,12277127,,546853,65924135,12277127,,0,0,0,PDN
WC222,,2014,1976,,546853,65924135,12277127,,546853,65924135,12277127,,0,0,0,PDN
WC222,,2015,1976,,546853,65924135,12277127,,546853,65924135,12277127,,0,0,0,PDN
WC222,,2016,1976,,546853,65924135,12277127,,546853,65924135,12277127,,0,0,0,PDN
WC222,,2017,1976,,546853,65924135,12277127,,546853,65924135,12277127,,0,0,0,PDN
WC222,,2017,1976,,546853,65924135,12277127,,546853,65924135,12277127,,0,0,0,PDN
WC225,,1975,1962,,530789,123845892,22567425,,141117,32877896,5991276,,389672,90967996,16576149,PDN
WC225,,1976,1962,,530789,123845892,22567425,,157649,36969922,6735927,,373140,86875970,15831498,PDN
WC225,,1977,1962,,530789,123845892,22567425,,169744,40447704,7366844,,361045,83398188,15200581,PDN
WC225,,1978,1962,,530789,123845892,22567425,,182150,44017065,8014368,,348639,79828827,14553057,PDN
WC225,,1979,1962,,530789,123845892,22567425,,191907,46742108,8509008,,338882,77103784,14058417,PDN
WC225,,1980,1962,,530789,123845892,22567425,,198149,49352823,8979790,,332640,74493069,13587635,PDN
WC225,,1981,1962,,530789,123845892,22567425,,207602,51282062,9332524,,323187,72563830,13234901,PDN
WC225,,1982,1962,,530789,123845892,22567425,,214953,52745046,9600193,,315836,71100846,12967232,PDN
WC225,,1983,1962,,530789,123845892,22567425,,225282,55049449,10020558,,305507,68796443,12546867,PDN
WC225,,1984,1962,,530789,123845892,22567425,,232563,57129099,10397883,,298226,66716793,12169542,PDN
WC225,,1985,1962,,530789,123845892,22567425,,237015,58696793,10681284,,293774,65149099,11886141,PDN
WC225,,1986,1962,,314012,70765856,12905801,,239060,59678773,10858059,,74952,11087083,2047742,PDN
WC225,,1987,1962,,315578,75463096,13743175,,240750,60764836,11052998,,74828,14698260,2690177,PDN
WC225,,1988,1962,,316245,75463096,13743842,,242150,62653246,11390414,,74095,12809850,2353428,PDN
WC225,,1989,1962,,316961,76453947,13920866,,242880,64180072,11662822,,74081,12273875,2258044,PDN
WC225,,1990,1962,,318405,77938453,14186457,,243367,65040295,11816373,,75038,12898158,2370084,PDN
WC225,,1991,1962,,285698,77654648,14103251,,243756,66119876,12008858,,41942,11534772,2094393,PDN
WC225,,1992,1962,,286231,77701635,14112145,,244191,67280563,12215821,,42040,10421072,1896324,PDN
WC225,,1993,1962,,286247,79421701,14418222,,244553,69029327,12527351,,41694,10392374,1890871,PDN
WC225,,1994,1962,,286247,79421701,14418222,,244651,69729796,12652088,,41596,9691905,1766134,PDN
WC225,,1995,1962,,244859,72368630,13121839,,244710,70343794,12761399,,149,2024836,360440,PDN
WC225,,1996,1962,,251469,72100839,13080800,,244770,70609829,12808797,,6699,1491010,272003,PDN
WC225,,1997,1962,,280116,79161841,14365853,,248061,71597615,12987850,,32055,7564226,1378003,PDN
WC225,,1998,1962,,280115,79160959,14365695,,252409,72900462,13224021,,27706,6260497,1141674,PDN
WC225,,1999,1962,,279394,76059404,13813096,,254601,73387531,13312881,,24793,2671873,500215,PDN
WC225,,2000,1962,,279490,76343623,13863765,,255867,73896487,13404708,,23623,2447136,459057,PDN
WC225,,2001,1962,,267359,80573921,14604356,,257262,75779350,13741132,,10097,4794571,863224,PDN
WC225,,2002,1962,,271225,84510791,15308732,,258607,77715189,14086932,,12618,6795602,1221800,PDN
WC225,,2003,1962,,271248,85079464,15409943,,260338,79453539,14397978,,10910,5625925,1011965,PDN
WC225,,2004,1962,,261337,85693151,15509229,,260757,81469588,14757125,,580,4223563,752104,PDN
WC225,,2005,1962,,261213,91722999,16582031,,260910,83183274,15062204,,303,8539725,1519827,PDN
WC225,,2006,1962,,261373,87602140,15848943,,260916,83772395,15167036,,457,3829745,681907,PDN
WC225,,2007,1962,,265404,91925067,16622177,,260882,84912693,15369902,,4522,7012374,1252275,PDN
WC225,,2008,1962,,265404,91869636,16612315,,261485,85598512,15492537,,3919,6271124,1119778,PDN
WC225,,2009,1962,,272746,92746801,16775735,,263387,88672135,16041347,,9359,4074666,734389,PDN
WC225,,2010,1962,,272746,92746801,16775735,,263712,88979767,16096410,,9034,3767034,679325,PDN
WC225,,2011,1962,,272746,92746801,16775735,,265670,89896830,16261547,,7076,2849971,514189,PDN
WC225,,2012,1962,,269218,91598451,16567874,,265950,90112368,16300179,,3268,1486083,267695,PDN
WC225,,2013,1962,,269218,91598451,16567874,,266038,90158951,16308555,,3180,1439500,259319,PDN
WC225,,2014,1962,,269218,91598451,16567874,,266229,90461272,16362540,,2989,1137179,205334,PDN
WC225,,2015,1962,,269218,91598451,16567874,,266382,90816846,16425962,,2836,781605,141912,PDN
WC225,,2016,1962,,269218,91598451,16567874,,266401,90909601,16442486,,2817,688850,125388,PDN
WC225,,2017,1962,,266401,90909601,16442486,,266401,90909601,16442486,,0,0,0,PDN
WC225,,2017,1962,,266401,90909601,16442486,,266401,90909601,16442486,,0,0,0,PDN
WC228,,1987,1985,,22864,6859282,1243377,,32,410136,73010,,22832,6449146,1170367,PDN
WC228,,1988,1985,,2741,12668215,2256872,,929,2037875,363540,,1812,10630340,1893332,PDN
WC228,,1989,1985,,3836,15481596,2758568,,1228,3116735,555807,,2608,12364861,2202761,PDN
WC228,,1990,1985,,3370,10433125,1859798,,1322,3557489,634327,,2048,6875636,1225471,PDN
WC228,,1991,1985,,3370,10433125,1859798,,1346,3643563,649667,,2024,6789562,1210131,PDN
WC228,,1992,1985,,2956,5695544,1016398,,1379,3831431,683128,,1577,1864113,333270,PDN
WC228,,1993,1985,,1573,4217205,751965,,1573,4217205,751965,,0,0,0,PDN
WC228,,1994,1985,,1573,4217205,751965,,1573,4217205,751965,,0,0,0,PDN
WC228,,1995,1985,,1573,4217205,751965,,1573,4217205,751965,,0,0,0,PDN
WC228,,1996,1985,,1573,4217205,751965,,1573,4217205,751965,,0,0,0,PDN
WC228,,1997,1985,,1573,4217205,751965,,1573,4217205,751965,,0,0,0,PDN
WC228,,1998,1985,,1573,4217205,751965,,1573,4217205,751965,,0,0,0,PDN
WC228,,1999,1985,,1573,4217205,751965,,1573,4217205,751965,,0,0,0,PDN
WC228,,2000,1985,,1573,4217205,751965,,1573,4217205,751965,,0,0,0,PDN
WC228,,2001,1985,,1573,4217205,751965,,1573,4217205,751965,,0,0,0,PDN
WC228,,2002,1985,,1573,4217205,751965,,1573,4217205,751965,,0,0,0,PDN
WC228,,2003,1985,,1573,4217205,751965,,1573,4217205,751965,,0,0,0,PDN
WC228,,2004,1985,,1573,4217205,751965,,1573,4217205,751965,,0,0,0,PDN
WC228,,2005,1985,,1573,4217205,751965,,1573,4217205,751965,,0,0,0,PDN
WC228,,2006,1985,,1573,4217205,751965,,1573,4217205,751965,,0,0,0,PDN
WC228,,2007,1985,,1573,4217205,751965,,1573,4217205,751965,,0,0,0,PDN
WC228,,2008,1985,,1573,4217205,751965,,1573,4217205,751965,,0,0,0,PDN
WC228,,2009,1985,,1573,4301663,766994,,1573,4301663,766994,,0,0,0,PDN
WC228,,2010,1985,,1573,4301663,766994,,1573,4301663,766994,,0,0,0,PDN
WC228,,2011,1985,,1573,4301663,766994,,1573,4301663,766994,,0,0,0,PDN
WC228,,2012,1985,,1573,4301663,766994,,1573,4301663,766994,,0,0,0,PDN
WC228,,2013,1985,,1573,4301663,766994,,1573,4301663,766994,,0,0,0,PDN
WC228,,2014,1985,,1573,4301663,766994,,1573,4301663,766994,,0,0,0,PDN
WC228,,2015,1985,,1573,4301663,766994,,1573,4301663,766994,,0,0,0,PDN
WC228,,2016,1985,,1573,4301663,766994,,1573,4301663,766994,,0,0,0,PDN
WC228,,2017,1985,,1573,4301663,766994,,1573,4301663,766994,,0,0,0,PDN
WC228,,2017,1985,,1573,4301663,766994,,1573,4301663,766994,,0,0,0,PDN
WC229,,1975,1962,,63782,37932671,6813368,,18379,9893437,1778777,,45403,28039234,5034591,PDN
WC229,,1976,1962,,63782,37932671,6813368,,21186,11186340,2011638,,42596,26746331,4801730,PDN
WC229,,1977,1962,,63782,37932671,6813368,,21761,11770980,2116241,,42021,26161691,4697127,PDN
WC229,,1978,1962,,63782,37932671,6813368,,21761,12301717,2210679,,42021,25630954,4602689,PDN
WC229,,1979,1962,,63782,37932671,6813368,,21761,12789813,2297528,,42021,25142858,4515840,PDN
WC229,,1980,1962,,63782,37932671,6813368,,21761,13365885,2400032,,42021,24566786,4413336,PDN
WC229,,1981,1962,,63782,37932671,6813368,,21761,13902388,2495496,,42021,24030283,4317872,PDN
WC229,,1982,1962,,63782,37932671,6813368,,21754,14312606,2568481,,42028,23620065,4244887,PDN
WC229,,1983,1962,,63782,37932671,6813368,,21754,14792092,2653799,,42028,23140579,4159569,PDN
WC229,,1984,1962,,63782,37932671,6813368,,21754,15228776,2731501,,42028,22703895,4081867,PDN
WC229,,1985,1962,,65600,39750992,7138730,,21759,15645979,2805741,,43841,24105013,4332989,PDN
WC229,,1986,1962,,38972,21226029,3815845,,26371,17330222,3110040,,12601,3895807,705805,PDN
WC229,,1987,1962,,40308,23727749,4262327,,30541,20586608,3693639,,9767,3141141,568688,PDN
WC229,,1988,1962,,40308,23727749,4262327,,33230,21827957,3917208,,7078,1899792,345119,PDN
WC229,,1989,1962,,37437,25213897,4523896,,34716,22835372,4097949,,2721,2378525,425947,PDN
WC229,,1990,1962,,38890,25213897,4525349,,35237,23080999,4142176,,3653,2132898,383173,PDN
WC229,,1991,1962,,763759,78997372,14820231,,126910,30650625,5580758,,636849,48346747,9239473,PDN
WC229,,1992,1962,,686762,101623757,18769281,,207657,42454504,7761839,,479105,59169253,11007442,PDN
WC229,,1993,1962,,672369,93549576,17318201,,259169,50604307,9263494,,413200,42945269,8054707,PDN
WC229,,1994,1962,,333316,71871690,13121873,,269253,53496919,9788278,,64063,18374771,3333595,PDN
WC229,,1995,1962,,272383,55415860,10132856,,271189,54205533,9916302,,1194,1210327,216554,PDN
WC229,,1996,1962,,272917,56195026,10272032,,271173,54211781,9917397,,1744,1983245,354635,PDN
WC229,,1997,1962,,271173,54211878,9917415,,271173,54211878,9917415,,0,0,0,PDN
WC229,,1998,1962,,271173,54211878,9917415,,271173,54211878,9917415,,0,0,0,PDN
WC229,,1999,1962,,271173,54211878,9917415,,271173,54211878,9917415,,0,0,0,PDN
WC229,,2000,1962,,274023,55689080,10183112,,271173,54211878,9917415,,2850,1477202,265697,PDN
WC229,,2001,1962,,281532,60221922,10997176,,273413,55511502,10150904,,8119,4710420,846272,PDN
WC229,,2002,1962,,302171,64436204,11767688,,276669,58879827,10753507,,25502,5556377,1014181,PDN
WC229,,2003,1962,,300970,64334264,11748348,,286011,61097671,11157483,,14959,3236593,590865,PDN
WC229,,2004,1962,,294497,66364080,12103052,,290174,64491625,11765552,,4323,1872455,337500,PDN
WC229,,2005,1962,,295172,65786932,12001032,,293844,65145483,11885567,,1328,641449,115465,PDN
WC229,,2006,1962,,400492,74191934,13601904,,283876,57609545,10534685,,116616,16582389,3067219,PDN
WC229,,2007,1962,,321521,71295251,13007509,,293945,65145483,11885668,,27576,6149768,1121841,PDN
WC229,,2008,1962,,321521,71295251,13007509,,295088,65426500,11936814,,26433,5868751,1070695,PDN
WC229,,2009,1962,,322079,72505585,13223429,,302807,68431253,12479187,,19272,4074332,744242,PDN
WC229,,2010,1962,,322079,72505585,13223429,,306528,69622178,12694816,,15551,2883407,528613,PDN
WC229,,2011,1962,,308370,70377928,12831133,,307259,70087193,12778290,,1111,290735,52843,PDN
WC229,,2012,1962,,308370,70377928,12831133,,308362,70372711,12830197,,8,5217,936,PDN
WC229,,2013,1962,,308370,70377928,12831133,,308370,70377928,12831133,,0,0,0,PDN
WC229,,2014,1962,,308370,70377928,12831133,,308370,70377928,12831133,,0,0,0,PDN
WC229,,2015,1962,,308370,70377928,12831133,,308370,70377928,12831133,,0,0,0,PDN
WC229,,2016,1962,,308370,70377928,12831133,,308370,70377928,12831133,,0,0,0,PDN
WC229,,2017,1962,,308370,70377928,12831133,,308370,70377928,12831133,,0,0,0,PDN
WC229,,2017,1962,,308370,70377928,12831133,,308370,70377928,12831133,,0,0,0,PDN
WC236,,1989,1986,,15132,5044004,912642,,33,45816,8185,,15099,4998188,904457,PDN
WC236,,1990,1986,,35837,10204100,1851513,,7834,3071876,554431,,28003,7132224,1297082,PDN
WC236,,1991,1986,,35837,10204100,1851513,,10224,4942246,889627,,25613,5261854,961886,PDN
WC236,,1992,1986,,35837,10204100,1851513,,10789,5270771,948649,,25048,4933329,902864,PDN
WC236,,1993,1986,,10789,5270771,948649,,10789,5270771,948649,,0,0,0,PDN
WC236,,1994,1986,,10789,5270771,948649,,10789,5270771,948649,,0,0,0,PDN
WC236,,1995,1986,,10789,5270771,948649,,10789,5270771,948649,,0,0,0,PDN
WC236,,1996,1986,,10789,5270771,948649,,10789,5270771,948649,,0,0,0,PDN
WC236,,1997,1986,,10789,5270771,948649,,10789,5270771,948649,,0,0,0,PDN
WC236,,1998,1986,,10789,5270771,948649,,10789,5270771,948649,,0,0,0,PDN
WC236,,1999,1986,,10789,5270771,948649,,10789,5270771,948649,,0,0,0,PDN
WC236,,2000,1986,,10789,5270771,948649,,10789,5270771,948649,,0,0,0,PDN
WC236,,2001,1986,,10789,5270771,948649,,10789,5270771,948649,,0,0,0,PDN
WC236,,2002,1986,,10789,5270771,948649,,10789,5270771,948649,,0,0,0,PDN
WC236,,2003,1986,,10789,5270771,948649,,10789,5270771,948649,,0,0,0,PDN
WC236,,2004,1986,,10789,5270771,948649,,10789,5270771,948649,,0,0,0,PDN
WC236,,2005,1986,,10789,5270771,948649,,10789,5270771,948649,,0,0,0,PDN
WC236,,2006,1986,,10789,5270771,948649,,10789,5270771,948649,,0,0,0,PDN
WC236,,2007,1986,,10789,5270771,948649,,10789,5270771,948649,,0,0,0,PDN
WC236,,2008,1986,,10789,5270771,948649,,10789,5270771,948649,,0,0,0,PDN
WC236,,2009,1986,,10789,5376328,967431,,10789,5376328,967431,,0,0,0,PDN
WC236,,2010,1986,,10789,5376328,967431,,10789,5376328,967431,,0,0,0,PDN
WC236,,2011,1986,,10789,5376328,967431,,10789,5376328,967431,,0,0,0,PDN
WC236,,2012,1986,,10789,5376328,967431,,10789,5376328,967431,,0,0,0,PDN
WC236,,2013,1986,,10789,5376328,967431,,10789,5376328,967431,,0,0,0,PDN
WC236,,2014,1986,,10789,5376328,967431,,10789,5376328,967431,,0,0,0,PDN
WC236,,2015,1986,,10789,5376328,967431,,10789,5376328,967431,,0,0,0,PDN
WC236,,2016,1986,,10789,5376328,967431,,10789,5376328,967431,,0,0,0,PDN
WC236,,2017,1986,,10789,5376328,967431,,10789,5376328,967431,,0,0,0,PDN
WC236,,2017,1986,,10789,5376328,967431,,10789,5376328,967431,,0,0,0,PDN
WC237,,1976,1976,,100000,50000000,8996797,,0,0,0,,100000,50000000,8996797,PDN
WC237,,1977,1976,,1092,1092169,195428,,0,0,0,,1092,1092169,195428,PDN
WC237,,1978,1976,,1092,1092169,195428,,0,0,0,,1092,1092169,195428,PDN
WC237,,1979,1976,,1082292,137292169,25511504,,2734,3214211,574658,,1079558,134077958,24936846,PDN
WC237,,1980,1976,,1082292,137292169,25511504,,165439,20254607,3769462,,916853,117037562,21742042,PDN
WC237,,1981,1976,,1106708,161708169,29880404,,407716,49097504,9143927,,698992,112610665,20736477,PDN
WC237,,1982,1976,,1092708,169327169,31222098,,625220,91987812,16993158,,467488,77339357,14228940,PDN
WC237,,1983,1976,,1103244,179417958,33028148,,767216,133912991,24595150,,336028,45504967,8432998,PDN
WC237,,1984,1976,,1398399,229916732,42308850,,896206,174383012,31925212,,502193,55533720,10383638,PDN
WC237,,1985,1976,,1381919,288201395,52663306,,939601,200482700,36612679,,442318,87718695,16050627,PDN
WC237,,1986,1976,,1395660,296040375,54071883,,959292,216322018,39450754,,436368,79718357,14621129,PDN
WC237,,1987,1976,,1420423,300904104,54962079,,979609,235426681,42870478,,440814,65477423,12091601,PDN
WC237,,1988,1976,,1426551,376876698,68486462,,1012361,252459856,45934044,,414190,124416842,22552418,PDN
WC237,,1989,1976,,1221109,342809356,62219215,,1031784,260643590,47409647,,189325,82165766,14809568,PDN
WC237,,1990,1976,,1438311,364521227,66299739,,1085356,284653077,51735370,,352955,79868150,14564369,PDN
WC237,,1991,1976,,1410513,383032240,69565716,,1177382,309813899,56304410,,233131,73218341,13261306,PDN
WC237,,1992,1976,,1412381,388027253,70456376,,1224501,325945391,59221902,,187880,62081862,11234474,PDN
WC237,,1993,1976,,1482923,396468854,72028982,,1254324,336231540,61082000,,228599,60237314,10946982,PDN
WC237,,1994,1976,,1482922,396468853,72028981,,1276320,344843779,62636423,,206602,51625074,9392558,PDN
WC237,,1995,1976,,1491113,391972525,71237114,,1287342,350142849,63590340,,203771,41829676,7646774,PDN
WC237,,1996,1976,,1339025,375994702,68241997,,1295420,354390540,64354235,,43605,21604162,3887762,PDN
WC237,,1997,1976,,1465392,427766348,77580401,,1306511,358556225,65106551,,158881,69210123,12473850,PDN
WC237,,1998,1976,,1465392,427766348,77580401,,1321057,365095308,66284635,,144335,62671040,11295766,PDN
WC237,,1999,1976,,1365452,378809378,68769256,,1328840,369061177,66998089,,36612,9748201,1771167,PDN
WC237,,2000,1976,,1384418,387606460,70353539,,1337330,373688774,67829994,,47088,13917686,2523545,PDN
WC237,,2001,1976,,1411131,400161265,72614203,,1343725,379623904,68892462,,67406,20537361,3721741,PDN
WC237,,2002,1976,,1393350,397921421,72197873,,1372753,388000404,70411971,,20597,9921017,1785902,PDN
WC237,,2003,1976,,1387250,394006190,71495113,,1383025,391204590,70992383,,4225,2801600,502730,PDN
WC237,,2004,1976,,1396723,400460388,72653020,,1387267,393459803,71397908,,9456,7000585,1255112,PDN
WC237,,2005,1976,,1401019,400090944,72591578,,1391427,397137726,72056503,,9592,2953218,535075,PDN
WC237,,2006,1976,,1397784,410105171,74370234,,1393459,398305897,72266394,,4325,11799274,2103840,PDN
WC237,,2007,1976,,1396154,407096149,73833191,,1393986,400392184,72638147,,2168,6703965,1195044,PDN
WC237,,2008,1976,,1395975,408579374,74096931,,1395142,403053678,73112878,,833,5525696,984053,PDN
WC237,,2009,1976,,1395985,415338512,75299632,,1395164,411907834,74688370,,821,3430678,611262,PDN
WC237,,2010,1976,,1395985,415338512,75299632,,1395214,412416673,74778962,,771,2921839,520671,PDN
WC237,,2011,1976,,1395985,415366236,75304565,,1395222,412985562,74880196,,763,2380674,424371,PDN
WC237,,2012,1976,,1395985,415366236,75304565,,1395222,412993765,74881655,,763,2372471,422911,PDN
WC237,,2013,1976,,1395222,412993765,74881655,,1395222,412993765,74881655,,0,0,0,PDN
WC237,,2014,1976,,1395222,412993765,74881655,,1395222,412993765,74881655,,0,0,0,PDN
WC237,,2015,1976,,1395222,412993765,74881655,,1395222,412993765,74881655,,0,0,0,PDN
WC237,,2016,1976,,1395222,412993765,74881655,,1395222,412993765,74881655,,0,0,0,PDN
WC237,,2017,1976,,1395222,412993765,74881655,,1395222,412993765,74881655,,0,0,0,PDN
WC237,,2017,1976,,1395222,412993765,74881655,,1395222,412993765,74881655,,0,0,0,PDN
WC253,,1983,1956,,207000,41550000,7600238,,0,0,0,,207000,41550000,7600238,PDN
WC253,,1984,1956,,351140,51968679,9598236,,13971,8520838,1530134,,337169,43447841,8068102,PDN
WC253,,1985,1956,,332073,61396753,11256762,,34344,20239429,3635666,,297729,41157324,7621096,PDN
WC253,,1986,1956,,333603,63396753,11614164,,44699,28976240,5200614,,288904,34420513,6413550,PDN
WC253,,1987,1956,,333603,63396753,11614164,,49003,33361418,5985198,,284600,30035335,5628966,PDN
WC253,,1988,1956,,336820,66614046,12189853,,50667,35167964,6308312,,286153,31446082,5881541,PDN
WC253,,1989,1956,,327895,63752421,11671742,,51695,36086506,6472781,,276200,27665915,5198961,PDN
WC253,,1990,1956,,327895,63752421,11671742,,52558,36788755,6598600,,275337,26963666,5073142,PDN
WC253,,1991,1956,,60984,44259217,7936290,,53439,37802528,6779867,,7545,6456689,1156423,PDN
WC253,,1992,1956,,61317,44269904,7938524,,53795,38304819,6869599,,7522,5965085,1068925,PDN
WC253,,1993,1956,,61317,44271671,7938839,,54225,38819222,6961560,,7092,5452449,977279,PDN
WC253,,1994,1956,,65015,49439973,8862163,,54900,39462707,7076734,,10115,9977266,1785429,PDN
WC253,,1995,1956,,80895,50242640,9020867,,55241,39910731,7156795,,25654,10331909,1864072,PDN
WC253,,1996,1956,,83431,56979112,10222063,,57228,41417400,7426872,,26203,15561712,2795191,PDN
WC253,,1997,1956,,82203,56716428,10174094,,58178,42476327,7616243,,24025,14240101,2557851,PDN
WC253,,1998,1956,,58495,42638061,7645339,,58495,42638061,7645339,,0,0,0,PDN
WC253,,1999,1956,,58495,42638061,7645339,,58495,42638061,7645339,,0,0,0,PDN
WC253,,2000,1956,,58495,42638061,7645339,,58495,42638061,7645339,,0,0,0,PDN
WC253,,2001,1956,,58495,42638061,7645339,,58495,42638061,7645339,,0,0,0,PDN
WC253,,2002,1956,,58495,42638061,7645339,,58495,42638061,7645339,,0,0,0,PDN
WC253,,2003,1956,,58495,42638061,7645339,,58495,42638061,7645339,,0,0,0,PDN
WC253,,2004,1956,,58495,42638061,7645339,,58495,42638061,7645339,,0,0,0,PDN
WC253,,2005,1956,,58495,42638061,7645339,,58495,42638061,7645339,,0,0,0,PDN
WC253,,2006,1956,,240429,68108808,12359434,,58495,42638061,7645339,,181934,25470747,4714095,PDN
WC253,,2007,1956,,240429,68108808,12359434,,58495,42638061,7645339,,181934,25470747,4714095,PDN
WC253,,2008,1956,,240429,68108808,12359434,,64976,44231792,7935402,,175453,23877016,4424032,PDN
WC253,,2009,1956,,71533,48283646,8662930,,71533,48283646,8662930,,0,0,0,PDN
WC253,,2010,1956,,71533,48283646,8662930,,71533,48283646,8662930,,0,0,0,PDN
WC253,,2011,1956,,71533,48283646,8662930,,71533,48283646,8662930,,0,0,0,PDN
WC253,,2012,1956,,71533,48283646,8662930,,71533,48283646,8662930,,0,0,0,PDN
WC253,,2013,1956,,71533,48283646,8662930,,71533,48283646,8662930,,0,0,0,PDN
WC253,,2014,1956,,71533,48283646,8662930,,71533,48283646,8662930,,0,0,0,PDN
WC253,,2015,1956,,71533,48283646,8662930,,71533,48283646,8662930,,0,0,0,PDN
WC253,,2016,1956,,71533,48283646,8662930,,71533,48283646,8662930,,0,0,0,PDN
WC253,,2017,1956,,71533,48283646,8662930,,71533,48283646,8662930,,0,0,0,PDN
WC253,,2017,1956,,71533,48283646,8662930,,71533,48283646,8662930,,0,0,0,PDN
WC254,,1990,1977,,1531,15308753,2725508,,0,0,0,,1531,15308753,2725508,PDN
WC254,,1991,1977,,1794,17941076,3194156,,0,1177460,209512,,1794,16763616,2984644,PDN
WC254,,1992,1977,,1729,23096005,4111338,,0,2849233,506981,,1729,20246772,3604357,PDN
WC254,,1993,1977,,9229,24596005,4385742,,0,4043643,719509,,9229,20552362,3666233,PDN
WC254,,1994,1977,,9229,24596005,4385742,,0,5756553,1024298,,9229,18839452,3361444,PDN
WC254,,1995,1977,,1313,17774834,3164095,,0,7752697,1379483,,1313,10022137,1784612,PDN
WC254,,1996,1977,,1309,17738783,3157676,,0,9235486,1643325,,1309,8503297,1514351,PDN
WC254,,1997,1977,,0,9929334,1766785,,0,9902975,1762095,,0,26359,4690,PDN
WC254,,1998,1977,,0,9929334,1766785,,0,9929334,1766785,,0,0,0,PDN
WC254,,1999,1977,,0,9929334,1766785,,0,9929334,1766785,,0,0,0,PDN
WC254,,2000,1977,,0,9929334,1766785,,0,9929334,1766785,,0,0,0,PDN
WC254,,2001,1977,,0,9929334,1766785,,0,9929334,1766785,,0,0,0,PDN
WC254,,2002,1977,,0,9929334,1766785,,0,9929334,1766785,,0,0,0,PDN
WC254,,2003,1977,,0,9929334,1766785,,0,9929334,1766785,,0,0,0,PDN
WC254,,2004,1977,,0,9929334,1766785,,0,9929334,1766785,,0,0,0,PDN
WC254,,2005,1977,,0,9929334,1766785,,0,9929334,1766785,,0,0,0,PDN
WC254,,2006,1977,,0,9929334,1766785,,0,9929334,1766785,,0,0,0,PDN
WC254,,2007,1977,,0,9929334,1766785,,0,9929334,1766785,,0,0,0,PDN
WC254,,2008,1977,,0,9929334,1766785,,0,9929334,1766785,,0,0,0,PDN
WC254,,2009,1977,,0,10128194,1802170,,0,10128194,1802170,,0,0,0,PDN
WC254,,2010,1977,,0,10128194,1802170,,0,10128194,1802170,,0,0,0,PDN
WC254,,2011,1977,,0,10128194,1802170,,0,10128194,1802170,,0,0,0,PDN
WC254,,2012,1977,,0,10128194,1802170,,0,10128194,1802170,,0,0,0,PDN
WC254,,2013,1977,,0,10128194,1802170,,0,10128194,1802170,,0,0,0,PDN
WC254,,2014,1977,,0,10128194,1802170,,0,10128194,1802170,,0,0,0,PDN
WC254,,2015,1977,,0,10128194,1802170,,0,10128194,1802170,,0,0,0,PDN
WC254,,2016,1977,,0,10128194,1802170,,0,10128194,1802170,,0,0,0,PDN
WC254,,2017,1977,,0,10128194,1802170,,0,10128194,1802170,,0,0,0,PDN
WC254,,2017,1977,,0,10128194,1802170,,0,10128194,1802170,,0,0,0,PDN
WC264,,1988,1977,,49247,35350000,6339283,,29356,29248748,5233760,,19891,6101252,1105523,PDN
WC264,,1989,1977,,49247,35350000,6339283,,29356,29348318,5251477,,19891,6001682,1087806,PDN
WC264,,1990,1977,,32449,30913266,5533030,,29356,29348318,5251477,,3093,1564948,281553,PDN
WC264,,1991,1977,,29356,29348318,5251477,,29356,29348318,5251477,,0,0,0,PDN
WC264,,1992,1977,,29356,29348318,5251477,,29356,29348318,5251477,,0,0,0,PDN
WC264,,1993,1977,,29356,29348318,5251477,,29356,29348318,5251477,,0,0,0,PDN
WC264,,1994,1977,,29356,29348318,5251477,,29356,29348318,5251477,,0,0,0,PDN
WC264,,1995,1977,,29356,29348318,5251477,,29356,29348318,5251477,,0,0,0,PDN
WC264,,1996,1977,,29356,29348318,5251477,,29356,29348318,5251477,,0,0,0,PDN
WC264,,1997,1977,,29356,29348318,5251477,,29356,29348318,5251477,,0,0,0,PDN
WC264,,1998,1977,,29356,29348318,5251477,,29356,29348318,5251477,,0,0,0,PDN
WC264,,1999,1977,,29356,29348318,5251477,,29356,29348318,5251477,,0,0,0,PDN
WC264,,2000,1977,,29356,29348318,5251477,,29356,29348318,5251477,,0,0,0,PDN
WC264,,2001,1977,,29356,29348318,5251477,,29356,29348318,5251477,,0,0,0,PDN
WC264,,2002,1977,,29356,29348318,5251477,,29356,29348318,5251477,,0,0,0,PDN
WC264,,2003,1977,,29356,29348318,5251477,,29356,29348318,5251477,,0,0,0,PDN
WC264,,2004,1977,,29356,29348318,5251477,,29356,29348318,5251477,,0,0,0,PDN
WC264,,2005,1977,,29356,29348318,5251477,,29356,29348318,5251477,,0,0,0,PDN
WC264,,2006,1977,,29356,29348318,5251477,,29356,29348318,5251477,,0,0,0,PDN
WC264,,2007,1977,,29356,29348318,5251477,,29356,29348318,5251477,,0,0,0,PDN
WC264,,2008,1977,,29356,29348318,5251477,,29356,29348318,5251477,,0,0,0,PDN
WC264,,2009,1977,,29356,29936081,5356061,,29356,29936081,5356061,,0,0,0,PDN
WC264,,2010,1977,,29356,29936081,5356061,,29356,29936081,5356061,,0,0,0,PDN
WC264,,2011,1977,,29356,29936081,5356061,,29356,29936081,5356061,,0,0,0,PDN
WC264,,2012,1977,,29356,29936081,5356061,,29356,29936081,5356061,,0,0,0,PDN
WC264,,2013,1977,,29356,29936081,5356061,,29356,29936081,5356061,,0,0,0,PDN
WC264,,2014,1977,,29356,29936081,5356061,,29356,29936081,5356061,,0,0,0,PDN
WC264,,2015,1977,,29356,29936081,5356061,,29356,29936081,5356061,,0,0,0,PDN
WC264,,2016,1977,,29356,29936081,5356061,,29356,29936081,5356061,,0,0,0,PDN
WC264,,2017,1977,,29356,29936081,5356061,,29356,29936081,5356061,,0,0,0,PDN
WC264,,2017,1977,,29356,29936081,5356061,,29356,29936081,5356061,,0,0,0,PDN
WC265,,1976,1974,,3140221,15663404,5927304,,0,0,0,,3140221,15663404,5927304,PDP
WC265,,1977,1974,,2871013,16469850,5801591,,293809,1717140,599350,,2577204,14752710,5202241,PDP
WC265,,1978,1974,,2902461,21806631,6782644,,618475,5332195,1567264,,2283986,16474436,5215380,PDP
WC265,,1979,1974,,2902461,21806631,6782644,,773814,9824808,2522000,,2128647,11981823,4260644,PDP
WC265,,1980,1974,,2989423,30502740,8416957,,885397,16033637,3738357,,2104026,14469103,4678600,PDP
WC265,,1981,1974,,3016367,57640839,13272744,,928721,25793498,5518311,,2087646,31847341,7754433,PDP
WC265,,1982,1974,,3026267,62290839,14110046,,951244,34721823,7129504,,2075023,27569016,6980542,PDP
WC265,,1983,1974,,3030767,62790839,14203514,,959642,39382126,7967138,,2071125,23408713,6236376,PDP
WC265,,1984,1974,,3037457,64425539,14501076,,973853,43458268,8706641,,2063604,20967271,5794435,PDP
WC265,,1985,1974,,3740162,68275409,15888811,,1009174,46614879,9303636,,2730988,21660530,6585175,PDP
WC265,,1986,1974,,3764413,69499790,16130924,,1108647,48004367,9650349,,2655766,21495423,6480575,PDP
WC265,,1987,1974,,3838470,74930217,17171249,,1170749,49213106,9927529,,2667721,25717111,7243720,PDP
WC265,,1988,1974,,3777205,38327940,10597123,,1206249,20496828,4853371,,2570956,17831112,5743752,PDP
WC265,,1989,1974,,3155932,33077872,9041674,,1215220,20563364,4874182,,1940712,12514508,4167492,PDP
WC265,,1990,1974,,2998233,31736430,8645285,,1274620,21144887,5037055,,1723613,10591543,3608230,PDP
WC265,,1991,1974,,1550488,23116211,5663693,,1307571,21465669,5127085,,242917,1650542,536608,PDP
WC265,,1992,1974,,1315036,21542352,5148195,,1315036,21542352,5148195,,0,0,0,PDP
WC265,,1993,1974,,1315036,21542352,5148195,,1315036,21542352,5148195,,0,0,0,PDP
WC265,,1994,1974,,1315036,21542352,5148195,,1315036,21542352,5148195,,0,0,0,PDP
WC265,,1995,1974,,1315036,21542352,5148195,,1315036,21542352,5148195,,0,0,0,PDP
WC265,,1996,1974,,1779983,47463148,10225383,,1500011,31854506,7168073,,279972,15608642,3057310,PDP
WC265,,1997,1974,,3852857,102676189,22122642,,1820317,47736296,10314320,,2032540,54939893,11808322,PDP
WC265,,1998,1974,,3549634,96199578,20666997,,2513457,68333153,14672381,,1036177,27866425,5994616,PDP
WC265,,1999,1974,,3555171,100755759,21483242,,2782144,78485863,16747600,,773027,22269896,4735642,PDP
WC265,,2000,1974,,3783465,105134165,22490612,,2860738,82496412,17539815,,922727,22637753,4950797,PDP
WC265,,2001,1974,,3284670,99163505,20929422,,2867119,83682950,17757324,,417551,15480555,3172098,PDP
WC265,,2002,1974,,3276457,97204857,20572695,,2870381,84276128,17866133,,406076,12928729,2706562,PDP
WC265,,2003,1974,,2980163,86811051,18426969,,2878377,84965152,17996731,,101786,1845899,430238,PDP
WC265,,2004,1974,,2994789,88251701,18697939,,2903624,85667061,18146873,,91165,2584640,551066,PDP
WC265,,2005,1974,,2977924,93283122,19576344,,2937490,86803451,18382944,,40434,6479671,1193400,PDP
WC265,,2006,1974,,2972838,93283122,19571258,,2949180,87708816,18555731,,23658,5574306,1015527,PDP
WC265,,2007,1974,,2972838,93283122,19571258,,2950395,87908728,18592517,,22443,5374394,978741,PDP
WC265,,2008,1974,,2974607,93231843,19563903,,2952565,88216479,18649447,,22042,5015364,914456,PDP
WC265,,2009,1974,,4105426,94657287,20948359,,2954633,89728244,18920513,,1150793,4929043,2027847,PDP
WC265,,2010,1974,,4105426,94657287,20948359,,3014208,89833372,18998794,,1091218,4823915,1949566,PDP
WC265,,2011,1974,,4626329,101092773,22614366,,3416709,92742898,19919003,,1209620,8349875,2695363,PDP
WC265,,2012,1974,,4626329,101092773,22614366,,3605848,94229826,20372720,,1020481,6862947,2241646,PDP
WC265,,2013,1974,,4626401,101099993,22615722,,3731347,94722530,20585889,,895054,6377463,2029833,PDP
WC265,,2014,1974,,4634324,101535745,22701181,,3816757,95000970,20720843,,817567,6534775,1980338,PDP
WC265,,2015,1974,,4244015,101827203,22362733,,3904069,95506873,20898174,,339946,6320330,1464559,PDP
WC265,,2016,1974,,4336190,102289005,22537079,,3979704,95982173,21058382,,356486,6306832,1478698,PDP
WC265,,2017,1974,,4520377,103702623,22972799,,4075333,96580834,21260533,,445044,7121789,1712266,PDP
WC265,,2017,1974,,4520377,103702623,22972799,,4075333,96580834,21260533,,445044,7121789,1712266,PDP
WC277,,1986,1984,,12517,5006743,903397,,0,0,0,,12517,5006743,903397,PDN
WC277,,1987,1984,,12517,5006743,903397,,0,0,0,,12517,5006743,903397,PDN
WC277,,1988,1984,,22784,9113683,1644436,,19471,1263770,244341,,3313,7849913,1400095,PDN
WC277,,1989,1984,,110425,8498100,1622542,,40511,3690299,697148,,69914,4807801,925394,PDN
WC277,,1990,1984,,110425,8498100,1622542,,45114,4818366,902474,,65311,3679734,720068,PDN
WC277,,1991,1984,,110425,8498100,1622542,,48152,5680136,1058852,,62273,2817964,563690,PDN
WC277,,1992,1984,,59684,9113683,1681336,,49942,6408939,1190323,,9742,2704744,491013,PDN
WC277,,1993,1984,,59684,9113683,1681336,,51209,6775904,1256886,,8475,2337779,424450,PDN
WC277,,1994,1984,,59684,9113683,1681336,,51954,7018963,1300880,,7730,2094720,380456,PDN
WC277,,1995,1984,,59684,9113683,1681336,,52311,7123087,1319764,,7373,1990596,361572,PDN
WC277,,1996,1984,,52477,8499944,1564923,,52340,7129824,1320992,,137,1370120,243931,PDN
WC277,,1997,1984,,180130,36906901,6747194,,76658,13882280,2546815,,103472,23024621,4200379,PDN
WC277,,1998,1984,,177536,31844386,5843797,,89415,16443305,3015270,,88121,15401081,2828527,PDN
WC277,,1999,1984,,150507,23718864,4370945,,139557,21600294,3983026,,10950,2118570,387919,PDN
WC277,,2000,1984,,174273,25720789,4750926,,163942,24043821,4442202,,10331,1676968,308724,PDN
WC277,,2001,1984,,177949,25339803,4686811,,176912,25200370,4660964,,1037,139433,25847,PDN
WC277,,2002,1984,,177949,25339803,4686811,,177949,25339803,4686811,,0,0,0,PDN
WC277,,2003,1984,,177949,25339803,4686811,,177949,25339803,4686811,,0,0,0,PDN
WC277,,2004,1984,,177949,25339803,4686811,,177949,25339803,4686811,,0,0,0,PDN
WC277,,2005,1984,,177950,25339802,4686812,,177950,25339802,4686812,,0,0,0,PDN
WC277,,2006,1984,,177950,25339802,4686812,,177950,25339802,4686812,,0,0,0,PDN
WC277,,2007,1984,,177950,25339802,4686812,,177950,25339802,4686812,,0,0,0,PDN
WC277,,2008,1984,,177950,25339802,4686812,,177950,25339802,4686812,,0,0,0,PDN
WC277,,2009,1984,,177950,25646515,4741387,,177950,25646515,4741387,,0,0,0,PDN
WC277,,2010,1984,,177950,25646515,4741387,,177950,25646515,4741387,,0,0,0,PDN
WC277,,2011,1984,,177950,25646515,4741387,,177950,25646515,4741387,,0,0,0,PDN
WC277,,2012,1984,,177950,25646515,4741387,,177950,25646515,4741387,,0,0,0,PDN
WC277,,2013,1984,,177950,25646515,4741387,,177950,25646515,4741387,,0,0,0,PDN
WC277,,2014,1984,,177950,25646515,4741387,,177950,25646515,4741387,,0,0,0,PDN
WC277,,2015,1984,,177950,25646515,4741387,,177950,25646515,4741387,,0,0,0,PDN
WC277,,2016,1984,,177950,25646515,4741387,,177950,25646515,4741387,,0,0,0,PDN
WC277,,2017,1984,,177950,25646515,4741387,,177950,25646515,4741387,,0,0,0,PDN
WC277,,2017,1984,,177950,25646515,4741387,,177950,25646515,4741387,,0,0,0,PDN
WC280,,1975,1965,,238545,184079686,32992938,,43345,25743981,4624125,,195200,158335705,28368813,PDN
WC280,,1976,1965,,238545,184079686,32992938,,72919,40889596,7348648,,165626,143190090,25644290,PDN
WC280,,1977,1965,,266395,194899920,34946096,,103010,54108307,9730823,,163385,140791613,25215273,PDN
WC280,,1978,1965,,266395,194899920,34946096,,132208,66716111,12003402,,134187,128183809,22942694,PDN
WC280,,1979,1965,,7105602,240906570,49971540,,180557,96251254,17307115,,6925045,144655316,32664425,PDN
WC280,,1980,1965,,7244151,281502921,57333639,,226068,133554436,23990203,,7018083,147948485,33343436,PDN
WC280,,1981,1965,,598755,362640231,65125486,,274833,172303573,30933832,,323922,190336658,34191654,PDN
WC280,,1982,1965,,609755,367740231,66043960,,302933,190696087,34234621,,306822,177044144,31809339,PDN
WC280,,1983,1965,,612669,371865578,66780921,,320228,202757817,36398131,,292441,169107761,30382790,PDN
WC280,,1984,1965,,635665,383867413,68939475,,340091,214052696,38427759,,295574,169814717,30511716,PDN
WC280,,1985,1965,,637195,385146628,69168623,,355811,222074709,39870884,,281384,163071919,29297739,PDN
WC280,,1986,1965,,642153,387851726,69654916,,365707,226735542,40710109,,276446,161116184,28944807,PDN
WC280,,1987,1965,,525089,317162274,56959657,,375205,230637093,41413834,,149884,86525181,15545823,PDN
WC280,,1988,1965,,525089,317162274,56959657,,381133,234372867,42084490,,143956,82789407,14875167,PDN
WC280,,1989,1965,,528544,313402744,56294157,,386364,237240428,42599963,,142180,76162316,13694194,PDN
WC280,,1990,1965,,528544,313402744,56294157,,388147,238302763,42790774,,140397,75099981,13503383,PDN
WC280,,1991,1965,,540716,307398357,55237933,,397972,240135349,43126682,,142744,67263008,12111251,PDN
WC280,,1992,1965,,549626,296249535,53263066,,403961,242569862,43565858,,145665,53679673,9697208,PDN
WC280,,1993,1965,,605463,302409225,54414934,,406741,243959366,43815881,,198722,58449859,10599053,PDN
WC280,,1994,1965,,638451,317596552,57150293,,410083,245566042,44105108,,228368,72030510,13045185,PDN
WC280,,1995,1965,,578287,301776331,54275143,,414817,248399308,44613982,,163470,53377023,9661161,PDN
WC280,,1996,1965,,475283,271939757,48863140,,426602,254821413,45768490,,48681,17118344,3094650,PDN
WC280,,1997,1965,,627855,309403916,55681933,,476492,263454052,47354437,,151363,45949864,8327496,PDN
WC280,,1998,1965,,630416,310775603,55928566,,557751,276591137,49773256,,72665,34184466,6155310,PDN
WC280,,1999,1965,,874429,328904753,59398406,,671516,294058755,52995138,,202913,34845998,6403268,PDN
WC280,,2000,1965,,897536,336568151,60785107,,719335,306892780,55326591,,178201,29675371,5458516,PDN
WC280,,2001,1965,,818297,332102753,59911314,,733816,311147169,56098081,,84481,20955584,3813233,PDN
WC280,,2002,1965,,764939,322399073,58131322,,739364,313690250,56556134,,25575,8708823,1575188,PDN
WC280,,2003,1965,,764801,323154675,58265633,,742166,315651832,56907972,,22635,7502843,1357661,PDN
WC280,,2004,1965,,745358,316880384,57129768,,744719,316616157,57082113,,639,264227,47655,PDN
WC280,,2005,1965,,745681,317262953,57198163,,745379,317040127,57158213,,302,222826,39950,PDN
WC280,,2006,1965,,745682,317264626,57198462,,745675,317198394,57186670,,7,66232,11792,PDN
WC280,,2007,1965,,745682,317263948,57198342,,745675,317197716,57186550,,7,66232,11792,PDN
WC280,,2008,1965,,745682,317266472,57198791,,745675,317200240,57186999,,7,66232,11792,PDN
WC280,,2009,1965,,745676,322653011,58157245,,745676,322653011,58157245,,0,0,0,PDN
WC280,,2010,1965,,745676,322653011,58157245,,745676,322653011,58157245,,0,0,0,PDN
WC280,,2011,1965,,745676,322653011,58157245,,745676,322653011,58157245,,0,0,0,PDN
WC280,,2012,1965,,745676,322653011,58157245,,745676,322653011,58157245,,0,0,0,PDN
WC280,,2013,1965,,745676,322653011,58157245,,745676,322653011,58157245,,0,0,0,PDN
WC280,,2014,1965,,745676,322653011,58157245,,745676,322653011,58157245,,0,0,0,PDN
WC280,,2015,1965,,745676,322653011,58157245,,745676,322653011,58157245,,0,0,0,PDN
WC280,,2016,1965,,745676,322653011,58157245,,745676,322653011,58157245,,0,0,0,PDN
WC280,,2017,1965,,745676,322653011,58157245,,745676,322653011,58157245,,0,0,0,PDN
WC280,,2017,1965,,745676,322653011,58157245,,745676,322653011,58157245,,0,0,0,PDN
WC284,,2001,1996,,648,9183027,1634639,,0,0,0,,648,9183027,1634639,PDN
WC284,,2002,1996,,645,6475994,1152957,,0,0,0,,645,6475994,1152957,PDN
WC284,,2003,1996,,645,6482725,1154155,,68,1042651,185593,,577,5440074,968562,PDN
WC284,,2004,1996,,645,4330994,771284,,260,2756134,490675,,385,1574860,280609,PDN
WC284,,2005,1996,,313,3112064,554061,,277,3035441,540391,,36,76623,13670,PDN
WC284,,2006,1996,,313,3112064,554061,,310,3084547,549162,,3,27517,4899,PDN
WC284,,2007,1996,,313,3112064,554061,,310,3084547,549162,,3,27517,4899,PDN
WC284,,2008,1996,,310,3084547,549162,,310,3084547,549162,,0,0,0,PDN
WC284,,2009,1996,,310,3084547,549162,,310,3084547,549162,,0,0,0,PDN
WC284,,2010,1996,,310,3084547,549162,,310,3084547,549162,,0,0,0,PDN
WC284,,2011,1996,,310,3084547,549162,,310,3084547,549162,,0,0,0,PDN
WC284,,2012,1996,,310,3084547,549162,,310,3084547,549162,,0,0,0,PDN
WC284,,2013,1996,,310,3084547,549162,,310,3084547,549162,,0,0,0,PDN
WC284,,2014,1996,,310,3084547,549162,,310,3084547,549162,,0,0,0,PDN
WC284,,2015,1996,,310,3084547,549162,,310,3084547,549162,,0,0,0,PDN
WC284,,2016,1996,,310,3084547,549162,,310,3084547,549162,,0,0,0,PDN
WC284,,2017,1996,,310,3084547,549162,,310,3084547,549162,,0,0,0,PDN
WC284,,2017,1996,,310,3084547,549162,,310,3084547,549162,,0,0,0,PDN
WC294,,1975,1960,,941620,35000000,7169378,,432321,13300531,2798964,,509299,21699469,4370414,PDP
WC294,,1976,1960,,941620,35000000,7169378,,434767,13726825,2877263,,506853,21273175,4292115,PDP
WC294,,1977,1960,,941620,35000000,7169378,,434767,13756974,2882627,,506853,21243026,4286751,PDP
WC294,,1978,1960,,434769,13756974,2882629,,434769,13756974,2882629,,0,0,0,PDP
WC294,,1979,1960,,434769,13756974,2882629,,434769,13756974,2882629,,0,0,0,PDP
WC294,,1980,1960,,50738,14052076,2551107,,50738,14052076,2551107,,0,0,0,PDP
WC294,,1981,1960,,50738,14052076,2551107,,50738,14052076,2551107,,0,0,0,PDP
WC294,,1982,1960,,226551,101958737,18368675,,50738,14052076,2551107,,175813,87906661,15817568,PDP
WC294,,1983,1960,,234200,105783101,19056816,,50738,14052076,2551107,,183462,91731025,16505709,PDP
WC294,,1984,1960,,242795,112135042,20195649,,50738,14052076,2551107,,192057,98082966,17644542,PDP
WC294,,1985,1960,,387174,121108288,21936691,,103113,21658661,3956967,,284061,99449627,17979724,PDP
WC294,,1986,1960,,713929,123180980,22632253,,217759,38841713,7129096,,496170,84339267,15503157,PDP
WC294,,1987,1960,,801366,137429560,25255024,,340948,62691494,11496018,,460418,74738066,13759006,PDP
WC294,,1988,1960,,824363,143160928,26297838,,422751,82302817,15067380,,401612,60858111,11230458,PDP
WC294,,1989,1960,,845509,174817633,31951849,,476123,96338207,17618153,,369386,78479426,14333696,PDP
WC294,,1990,1960,,855665,176318728,32229104,,541377,114683925,20947769,,314288,61634803,11281335,PDP
WC294,,1991,1960,,745149,171384668,31240642,,584563,125604592,22934135,,160586,45780076,8306507,PDP
WC294,,1992,1960,,942731,189405352,34644751,,629397,134992129,24649349,,313334,54413223,9995402,PDP
WC294,,1993,1960,,1163096,221186637,40520149,,702898,148144884,27063198,,460198,73041753,13456951,PDP
WC294,,1994,1960,,1249056,236486007,43328417,,774793,165973144,30307381,,474263,70512863,13021036,PDP
WC294,,1995,1960,,978945,219240804,39989764,,835169,182257256,33265286,,143776,36983548,6724478,PDP
WC294,,1996,1960,,1027046,234630197,42776191,,897983,198156165,36157087,,129063,36474032,6619104,PDP
WC294,,1997,1960,,1060131,233688323,42641683,,949259,211074664,38507028,,110872,22613659,4134655,PDP
WC294,,1998,1960,,1080610,238792212,43570327,,991486,223704694,40796592,,89124,15087518,2773735,PDP
WC294,,1999,1960,,1088251,256801837,46782528,,1016066,232327488,42355477,,72185,24474349,4427051,PDP
WC294,,2000,1960,,1134924,266471745,48549825,,1034649,239518915,43653673,,100275,26952830,4896152,PDP
WC294,,2001,1960,,1665369,314130706,57560512,,1184621,253836789,46351309,,480748,60293917,11209203,PDP
WC294,,2002,1960,,1847014,323842266,59470193,,1399826,274178997,50186124,,447188,49663269,9284069,PDP
WC294,,2003,1960,,2041010,335606713,61757507,,1563513,293765426,53834941,,477497,41841287,7922566,PDP
WC294,,2004,1960,,2159802,336824685,62093020,,1701016,307600215,56434150,,458786,29224470,5658870,PDP
WC294,,2005,1960,,2063796,352277077,64746550,,1769813,315627508,57931291,,293983,36649569,6815259,PDP
WC294,,2006,1960,,2028616,354472255,65101971,,1828449,323856147,59454098,,200167,30616108,5647873,PDP
WC294,,2007,1960,,1931361,343536802,63058906,,1865674,329912038,60568884,,65687,13624764,2490022,PDP
WC294,,2008,1960,,1936409,344146140,63172377,,1886316,333414281,61212701,,50093,10731859,1959676,PDP
WC294,,2009,1960,,1988650,360325036,66103423,,1911566,342241321,62808598,,77084,18083715,3294829,PDP
WC294,,2010,1960,,1988650,360325036,66103423,,1929346,345071435,63329956,,59304,15253601,2773469,PDP
WC294,,2011,1960,,1953757,353622481,64875905,,1939596,347347278,63745160,,14161,6275203,1130746,PDP
WC294,,2012,1960,,1956198,354114827,64965952,,1944184,349049568,64052646,,12014,5065259,913306,PDP
WC294,,2013,1960,,1956198,354114827,64965952,,1944815,349952964,64214024,,11383,4161863,751928,PDP
WC294,,2014,1960,,1956198,354114827,64965952,,1946030,350895074,64382874,,10168,3219753,583078,PDP
WC294,,2015,1960,,1956198,354114827,64965952,,1946393,351518394,64494148,,9805,2596433,471804,PDP
WC294,,2016,1960,,1956198,354114827,64965952,,1946777,351869944,64557086,,9421,2244883,408866,PDP
WC294,,2017,1960,,1954965,352974894,64761884,,1946992,352078649,64594437,,7973,896245,167447,PDP
WC294,,2017,1960,,1954965,352974894,64761884,,1946992,352078649,64594437,,7973,896245,167447,PDP
WC295,,2005,2005,,206209,51012408,9283150,,0,0,0,,206209,51012408,9283150,PDP
WC295,,2006,2005,,174498,32944360,6036484,,20469,4091409,748478,,154029,28852951,5288006,PDP
WC295,,2007,2005,,174498,32904360,6029366,,61567,11965776,2190709,,112931,20938584,3838657,PDP
WC295,,2008,2005,,350930,66770025,12231717,,92669,17139345,3142375,,258261,49630680,9089342,PDP
WC295,,2009,2005,,351522,67001679,12273529,,133597,23989724,4402231,,217925,43011955,7871297,PDP
WC295,,2010,2005,,351522,67001679,12273529,,177732,31558638,5793148,,173790,35443041,6480381,PDP
WC295,,2011,2005,,351522,67001679,12273529,,212050,38017286,6976692,,139472,28984393,5296837,PDP
WC295,,2012,2005,,327078,62696737,11483081,,242513,43729561,8023574,,84565,18967176,3459507,PDP
WC295,,2013,2005,,327078,62696737,11483081,,263252,47963202,8797630,,63826,14733535,2685451,PDP
WC295,,2014,2005,,327078,62696737,11483081,,282958,50919797,9343420,,44120,11776940,2139661,PDP
WC295,,2015,2005,,327078,62696737,11483081,,293546,53048112,9732712,,33532,9648625,1750369,PDP
WC295,,2016,2005,,327078,62696737,11483081,,302436,54440877,9989425,,24642,8255860,1493656,PDP
WC295,,2017,2005,,327078,62696737,11483081,,307675,55828543,10241580,,19403,6868194,1241501,PDP
WC295,,2017,2005,,327078,62696737,11483081,,307675,55828543,10241580,,19403,6868194,1241501,PDP
WC297,,2000,2000,,4566,8630996,1540330,,0,2402,427,,4566,8628594,1539903,PDN
WC297,,2001,2000,,1276,2223292,396880,,493,1149469,205025,,783,1073823,191855,PDN
WC297,,2002,2000,,1395,2199868,392831,,938,1329454,237496,,457,870414,155335,PDN
WC297,,2003,2000,,1395,2199868,392831,,938,1329454,237496,,457,870414,155335,PDN
WC297,,2004,2000,,938,1329454,237496,,938,1329454,237496,,0,0,0,PDN
WC297,,2005,2000,,938,1329454,237496,,938,1329454,237496,,0,0,0,PDN
WC297,,2006,2000,,938,1329454,237496,,938,1329454,237496,,0,0,0,PDN
WC297,,2007,2000,,938,1329454,237496,,938,1329454,237496,,0,0,0,PDN
WC297,,2008,2000,,938,1329454,237496,,938,1329454,237496,,0,0,0,PDN
WC297,,2009,2000,,938,1329454,237496,,938,1329454,237496,,0,0,0,PDN
WC297,,2010,2000,,938,1329454,237496,,938,1329454,237496,,0,0,0,PDN
WC297,,2011,2000,,938,1329454,237496,,938,1329454,237496,,0,0,0,PDN
WC297,,2012,2000,,938,1329454,237496,,938,1329454,237496,,0,0,0,PDN
WC297,,2013,2000,,938,1329454,237496,,938,1329454,237496,,0,0,0,PDN
WC297,,2014,2000,,938,1329454,237496,,938,1329454,237496,,0,0,0,PDN
WC297,,2015,2000,,938,1329454,237496,,938,1329454,237496,,0,0,0,PDN
WC297,,2016,2000,,938,1329454,237496,,938,1329454,237496,,0,0,0,PDN
WC297,,2017,2000,,938,1329454,237496,,938,1329454,237496,,0,0,0,PDN
WC297,,2017,2000,,938,1329454,237496,,938,1329454,237496,,0,0,0,PDN
WC310,,2000,2000,,589,5894228,1049384,,0,0,0,,589,5894228,1049384,PDN
WC310,,2001,2000,,13159,4338240,785088,,3537,1382422,249520,,9622,2955818,535568,PDN
WC310,,2002,2000,,44567,10250517,1868502,,11604,3711860,672077,,32963,6538657,1196425,PDN
WC310,,2003,2000,,44567,10250517,1868502,,22412,5571860,1013846,,22155,4678657,854656,PDN
WC310,,2004,2000,,59419,14774000,2688245,,29851,7210479,1312854,,29568,7563521,1375391,PDN
WC310,,2005,2000,,47811,11302200,2058879,,32836,8209228,1493553,,14975,3092972,565326,PDN
WC310,,2006,2000,,54781,14900100,2706044,,33307,8347454,1518619,,21474,6552646,1187425,PDN
WC310,,2007,2000,,54781,14900100,2706044,,37298,9739490,1770303,,17483,5160610,935741,PDN
WC310,,2008,2000,,54781,14900100,2706044,,40937,10443296,1899175,,13844,4456804,806869,PDN
WC310,,2009,2000,,48443,14900100,2699706,,41827,10928007,1986312,,6616,3972093,713394,PDN
WC310,,2010,2000,,48443,14900100,2699706,,43202,12150313,2205179,,5241,2749787,494527,PDN
WC310,,2011,2000,,48443,14900100,2699706,,43920,12497094,2267602,,4523,2403006,432104,PDN
WC310,,2012,2000,,48443,14900100,2699706,,44790,12979628,2354332,,3653,1920472,345374,PDN
WC310,,2013,2000,,48443,14900100,2699706,,45569,13227663,2399246,,2874,1672437,300461,PDN
WC310,,2014,2000,,48443,14900100,2699706,,45994,13390091,2428572,,2449,1510009,271134,PDN
WC310,,2015,2000,,46129,13468259,2442616,,46129,13468259,2442616,,0,0,0,PDN
WC310,,2016,2000,,46129,13468301,2442624,,46129,13468301,2442624,,0,0,0,PDN
WC310,,2017,2000,,46129,13468301,2442624,,46129,13468301,2442624,,0,0,0,PDN
WC310,,2017,2000,,46129,13468301,2442624,,46129,13468301,2442624,,0,0,0,PDN
WC311,,1987,1986,,78064,11085089,2050500,,6258,891459,164881,,71806,10193630,1885619,PDN
WC311,,1988,1986,,78064,11085089,2050500,,16535,2281928,422572,,61529,8803161,1627928,PDN
WC311,,1989,1986,,78064,11085089,2050500,,22708,3273319,605149,,55356,7811770,1445351,PDN
WC311,,1990,1986,,78064,11085089,2050500,,27258,4205739,775610,,50806,6879350,1274890,PDN
WC311,,1991,1986,,29648,4958914,912017,,29648,4958914,912017,,0,0,0,PDN
WC311,,1992,1986,,29639,4958914,912008,,29639,4958914,912008,,0,0,0,PDN
WC311,,1993,1986,,29639,4958914,912008,,29639,4958914,912008,,0,0,0,PDN
WC311,,1994,1986,,64488,10789483,1984325,,29639,4958914,912008,,34849,5830569,1072317,PDN
WC311,,1995,1986,,64280,10772147,1981032,,31610,5834178,1069720,,32670,4937969,911312,PDN
WC311,,1996,1986,,64355,21976530,3974770,,41838,10515704,1912960,,22517,11460826,2061810,PDN
WC311,,1997,1986,,45636,17110277,3090169,,43873,11633732,2113932,,1763,5476545,976237,PDN
WC311,,1998,1986,,45636,17110277,3090169,,44344,12897648,2339299,,1292,4212629,750870,PDN
WC311,,1999,1986,,75275,22069191,4002177,,44400,14741105,2667372,,30875,7328086,1334805,PDN
WC311,,2000,1986,,75275,22069191,4002177,,45078,15403541,2785922,,30197,6665650,1216255,PDN
WC311,,2001,1986,,45092,15533391,2809041,,45089,15483738,2800203,,3,49653,8838,PDN
WC311,,2002,1986,,45092,15533391,2809041,,45092,15533391,2809041,,0,0,0,PDN
WC311,,2003,1986,,45092,15533391,2809041,,45092,15533391,2809041,,0,0,0,PDN
WC311,,2004,1986,,45092,15536356,2809568,,45092,15536356,2809568,,0,0,0,PDN
WC311,,2005,1986,,45092,15536356,2809568,,45092,15536356,2809568,,0,0,0,PDN
WC311,,2006,1986,,45092,15536356,2809568,,45092,15536356,2809568,,0,0,0,PDN
WC311,,2007,1986,,45092,15536356,2809568,,45092,15536356,2809568,,0,0,0,PDN
WC311,,2008,1986,,45092,15536356,2809568,,45092,15536356,2809568,,0,0,0,PDN
WC311,,2009,1986,,45092,15777217,2852426,,45092,15777217,2852426,,0,0,0,PDN
WC311,,2010,1986,,45092,15777217,2852426,,45092,15777217,2852426,,0,0,0,PDN
WC311,,2011,1986,,45092,15777217,2852426,,45092,15777217,2852426,,0,0,0,PDN
WC311,,2012,1986,,45092,15777217,2852426,,45092,15777217,2852426,,0,0,0,PDN
WC311,,2013,1986,,45092,15777217,2852426,,45092,15777217,2852426,,0,0,0,PDN
WC311,,2014,1986,,45092,15777217,2852426,,45092,15777217,2852426,,0,0,0,PDN
WC311,,2015,1986,,45092,15777217,2852426,,45092,15777217,2852426,,0,0,0,PDN
WC311,,2016,1986,,45092,15777217,2852426,,45092,15777217,2852426,,0,0,0,PDN
WC311,,2017,1986,,45092,15777217,2852426,,45092,15777217,2852426,,0,0,0,PDN
WC311,,2017,1986,,45092,15777217,2852426,,45092,15777217,2852426,,0,0,0,PDN
WC313,,1987,1985,,63635,19833153,3592666,,47,2463674,438423,,63588,17369479,3154243,PDN
WC313,,1988,1985,,2235,22510692,4007696,,183,6924825,1232358,,2052,15585867,2775338,PDN
WC313,,1989,1985,,2312,28381432,5052389,,384,11131748,1981122,,1928,17249684,3071267,PDN
WC313,,1990,1985,,3417,32191112,5731373,,741,13870945,2468881,,2676,18320167,3262492,PDN
WC313,,1991,1985,,20836,42285628,7544969,,875,16344902,2909221,,19961,25940726,4635748,PDN
WC313,,1992,1985,,2272,35360062,6294098,,905,17639282,3139567,,1367,17720780,3154531,PDN
WC313,,1993,1985,,2022,31837592,5667074,,960,19695198,3505444,,1062,12142394,2161630,PDN
WC313,,1994,1985,,39249,45541575,8142732,,1157,22890060,4074121,,38092,22651515,4068611,PDN
WC313,,1995,1985,,39249,45541575,8142732,,1169,25388125,4518629,,38080,20153450,3624103,PDN
WC313,,1996,1985,,8130,47931478,8536863,,1186,27813716,4950246,,6944,20117762,3586617,PDN
WC313,,1997,1985,,47830,53283391,9528860,,1192,28991405,5159805,,46638,24291986,4369055,PDN
WC313,,1998,1985,,87016,50609642,9092290,,38134,32052320,5741394,,48882,18557322,3350896,PDN
WC313,,1999,1985,,156051,43383317,7875502,,86956,36365000,6557597,,69095,7018317,1317905,PDN
WC313,,2000,1985,,166842,46457712,8433338,,109893,39044405,7057296,,56949,7413307,1376042,PDN
WC313,,2001,1985,,167813,53056206,9608419,,130739,43241889,7825025,,37074,9814317,1783394,PDN
WC313,,2002,1985,,167825,53056206,9608431,,140125,45758559,8282217,,27700,7297647,1326214,PDN
WC313,,2003,1985,,150371,51462655,9307427,,142538,47801497,8648142,,7833,3661158,659285,PDN
WC313,,2004,1985,,147980,48849901,8840133,,143686,48270984,8732829,,4294,578917,107304,PDN
WC313,,2005,1985,,143838,49269981,8910739,,143737,49174261,8893606,,101,95720,17133,PDN
WC313,,2006,1985,,143838,49269981,8910739,,143838,49269981,8910739,,0,0,0,PDN
WC313,,2007,1985,,143838,49275195,8911666,,143838,49275195,8911666,,0,0,0,PDN
WC313,,2008,1985,,143838,49275195,8911666,,143838,49275195,8911666,,0,0,0,PDN
WC313,,2009,1985,,143838,49888540,9020804,,143838,49888540,9020804,,0,0,0,PDN
WC313,,2010,1985,,143838,49888540,9020804,,143838,49888540,9020804,,0,0,0,PDN
WC313,,2011,1985,,143838,49888540,9020804,,143838,49888540,9020804,,0,0,0,PDN
WC313,,2012,1985,,143838,49888540,9020804,,143838,49888540,9020804,,0,0,0,PDN
WC313,,2013,1985,,143838,49888540,9020804,,143838,49888540,9020804,,0,0,0,PDN
WC313,,2014,1985,,143838,49888540,9020804,,143838,49888540,9020804,,0,0,0,PDN
WC313,,2015,1985,,143838,49888540,9020804,,143838,49888540,9020804,,0,0,0,PDN
WC313,,2016,1985,,143838,49888540,9020804,,143838,49888540,9020804,,0,0,0,PDN
WC313,,2017,1985,,143838,49888540,9020804,,143838,49888540,9020804,,0,0,0,PDN
WC313,,2017,1985,,143838,49888540,9020804,,143838,49888540,9020804,,0,0,0,PDN
WC315,,1984,1982,,5000,5000000,894680,,0,744315,132440,,5000,4255685,762240,PDN
WC315,,1985,1982,,1659,16578453,2951562,,0,2206913,392689,,1659,14371540,2558873,PDN
WC315,,1986,1982,,1659,16578453,2951562,,0,2217946,394652,,1659,14360507,2556910,PDN
WC315,,1987,1982,,24793,33097059,5913949,,247,3254050,579259,,24546,29843009,5334690,PDN
WC315,,1988,1982,,31870,47700346,8519476,,619,5253204,935353,,31251,42447142,7584123,PDN
WC315,,1989,1982,,50001,47996932,8590380,,1275,9919919,1766385,,48726,38077013,6823995,PDN
WC315,,1990,1982,,50341,55070453,9849354,,1670,13461818,2397011,,48671,41608635,7452343,PDN
WC315,,1991,1982,,53680,55621527,9950749,,1769,15291840,2722737,,51911,40329687,7228012,PDN
WC315,,1992,1982,,8354,29775029,5306402,,1810,15594169,2776573,,6544,14180860,2529829,PDN
WC315,,1993,1982,,7743,37376912,6658439,,1832,17762603,3162438,,5911,19614309,3496001,PDN
WC315,,1994,1982,,7743,37376912,6658439,,1833,17985795,3202152,,5910,19391117,3456287,PDN
WC315,,1995,1982,,4432,35300148,6285597,,1919,18511899,3295851,,2513,16788249,2989746,PDN
WC315,,1996,1982,,3267,24188817,4307327,,1952,18676053,3325093,,1315,5512764,982234,PDN
WC315,,1997,1982,,3267,24487961,4360555,,1973,18976310,3378541,,1294,5511651,982014,PDN
WC315,,1998,1982,,3267,24487961,4360555,,2082,19215125,3421143,,1185,5272836,939412,PDN
WC315,,1999,1982,,2115,19245875,3426648,,2082,19216108,3421318,,33,29767,5330,PDN
WC315,,2000,1982,,4998,27965958,4981147,,2867,21480442,3825010,,2131,6485516,1156137,PDN
WC315,,2001,1982,,5214,31750371,5654746,,3156,23366320,4160864,,2058,8384051,1493882,PDN
WC315,,2002,1982,,5214,31750371,5654746,,3197,24058127,4284003,,2017,7692244,1370743,PDN
WC315,,2003,1982,,4139,29617616,5274177,,3271,24529783,4368001,,868,5087833,906176,PDN
WC315,,2004,1982,,3271,24546659,4371004,,3271,24546659,4371004,,0,0,0,PDN
WC315,,2005,1982,,3969,33228319,5916481,,3357,24913039,4436282,,612,8315280,1480199,PDN
WC315,,2006,1982,,3531,27184709,4840668,,3472,26530072,4724125,,59,654637,116543,PDN
WC315,,2007,1982,,3499,27248260,4851944,,3499,27248260,4851944,,0,0,0,PDN
WC315,,2008,1982,,3499,27251499,4852520,,3499,27251499,4852520,,0,0,0,PDN
WC315,,2009,1982,,3499,27636304,4920991,,3499,27636304,4920991,,0,0,0,PDN
WC315,,2010,1982,,3499,27636304,4920991,,3499,27636304,4920991,,0,0,0,PDN
WC315,,2011,1982,,3499,27636304,4920991,,3499,27636304,4920991,,0,0,0,PDN
WC315,,2012,1982,,3499,27636304,4920991,,3499,27636304,4920991,,0,0,0,PDN
WC315,,2013,1982,,3499,27636304,4920991,,3499,27636304,4920991,,0,0,0,PDN
WC315,,2014,1982,,3499,27636304,4920991,,3499,27636304,4920991,,0,0,0,PDN
WC315,,2015,1982,,3499,27636304,4920991,,3499,27636304,4920991,,0,0,0,PDN
WC315,,2016,1982,,3499,27636304,4920991,,3499,27636304,4920991,,0,0,0,PDN
WC315,,2017,1982,,3499,27636304,4920991,,3499,27636304,4920991,,0,0,0,PDN
WC315,,2017,1982,,3499,27636304,4920991,,3499,27636304,4920991,,0,0,0,PDN
WC331,,1978,1977,,6100,6099840,1091481,,0,0,0,,6100,6099840,1091481,PDN
WC331,,1979,1977,,23230,23229840,4156653,,0,16110,2867,,23230,23213730,4153786,PDN
WC331,,1980,1977,,138050,30619840,5586420,,89928,6618393,1267578,,48122,24001447,4318842,PDN
WC331,,1981,1977,,138050,30619840,5586420,,89923,9969144,1863792,,48127,20650696,3722628,PDN
WC331,,1982,1977,,138050,30619840,5586420,,10040,11859479,2120268,,128010,18760361,3466152,PDN
WC331,,1983,1977,,138050,30619840,5586420,,10040,13908639,2484887,,128010,16711201,3101533,PDN
WC331,,1984,1977,,77080,33097901,5966386,,10040,14968836,2673534,,67040,18129065,3292852,PDN
WC331,,1985,1977,,77080,33097901,5966386,,10040,15392311,2748885,,67040,17705590,3217501,PDN
WC331,,1986,1977,,13551,30563577,5451910,,10040,15506662,2769233,,3511,15056915,2682677,PDN
WC331,,1987,1977,,13551,30563577,5451910,,10040,16566771,2957864,,3511,13996806,2494046,PDN
WC331,,1988,1977,,13551,30563577,5451910,,10040,18127478,3235570,,3511,12436099,2216340,PDN
WC331,,1989,1977,,13474,32771706,5844738,,10153,19537665,3486606,,3321,13234041,2358132,PDN
WC331,,1990,1977,,14319,32771706,5845583,,10461,20794053,3710470,,3858,11977653,2135113,PDN
WC331,,1991,1977,,14319,32771706,5845583,,10783,21935910,3913970,,3536,10835796,1931613,PDN
WC331,,1992,1977,,14050,36222767,6459382,,11045,23090946,4119754,,3005,13131821,2339628,PDN
WC331,,1993,1977,,14050,36222767,6459382,,11252,24216368,4320214,,2798,12006399,2139168,PDN
WC331,,1994,1977,,48149,48695787,8712880,,12188,25255937,4506127,,35961,23439850,4206753,PDN
WC331,,1995,1977,,92844,59666560,10709670,,25004,31851430,5692518,,67840,27815130,5017152,PDN
WC331,,1996,1977,,91760,60324392,10825638,,28027,35730023,6385682,,63733,24594369,4439956,PDN
WC331,,1997,1977,,91763,60995135,10944990,,28027,39156790,6995427,,63736,21838345,3949563,PDN
WC331,,1998,1977,,91763,60995135,10944990,,28044,40553983,7244055,,63719,20441152,3700935,PDN
WC331,,1999,1977,,28154,42133077,7525143,,28047,41067415,7335416,,107,1065662,189727,PDN
WC331,,2000,1977,,29496,46083906,8229479,,28047,42991843,7677841,,1449,3092063,551638,PDN
WC331,,2001,1977,,28446,47025079,8395898,,28152,44541587,7953701,,294,2483492,442197,PDN
WC331,,2002,1977,,28403,46640192,8327370,,28181,45352083,8097947,,222,1288109,229423,PDN
WC331,,2003,1977,,28403,46640192,8327370,,28192,45792393,8176305,,211,847799,151065,PDN
WC331,,2004,1977,,28207,45962926,8206664,,28207,45962926,8206664,,0,0,0,PDN
WC331,,2005,1977,,32978,58673167,10473043,,28207,46170275,8243558,,4771,12502892,2229485,PDN
WC331,,2006,1977,,31243,52855542,9436144,,28840,48078590,8583749,,2403,4776952,852395,PDN
WC331,,2007,1977,,31243,52855542,9436144,,29666,49575789,8850981,,1577,3279753,585163,PDN
WC331,,2008,1977,,31243,52855542,9436144,,29672,49681018,8869711,,1571,3174524,566433,PDN
WC331,,2009,1977,,29672,50491223,9013874,,29672,50491223,9013874,,0,0,0,PDN
WC331,,2010,1977,,29672,50491223,9013874,,29672,50491223,9013874,,0,0,0,PDN
WC331,,2011,1977,,29672,50491223,9013874,,29672,50491223,9013874,,0,0,0,PDN
WC331,,2012,1977,,29672,50491223,9013874,,29672,50491223,9013874,,0,0,0,PDN
WC331,,2013,1977,,29672,50491223,9013874,,29672,50491223,9013874,,0,0,0,PDN
WC331,,2014,1977,,29672,50491223,9013874,,29672,50491223,9013874,,0,0,0,PDN
WC331,,2015,1977,,29672,50491223,9013874,,29672,50491223,9013874,,0,0,0,PDN
WC331,,2016,1977,,29672,50491223,9013874,,29672,50491223,9013874,,0,0,0,PDN
WC331,,2017,1977,,29672,50491223,9013874,,29672,50491223,9013874,,0,0,0,PDN
WC331,,2017,1977,,29672,50491223,9013874,,29672,50491223,9013874,,0,0,0,PDN
WC333,,1976,1976,,0,47000000,8362989,,0,0,0,,0,47000000,8362989,PDN
WC333,,1977,1976,,93876,93877150,16797995,,0,0,0,,93876,93877150,16797995,PDN
WC333,,1978,1976,,93876,93877150,16797995,,2772,8187061,1459544,,91104,85690089,15338451,PDN
WC333,,1979,1976,,97392,97392330,17426988,,11805,24962246,4453486,,85587,72430084,12973502,PDN
WC333,,1980,1976,,91034,125123660,22355030,,18925,46115055,8224451,,72109,79008605,14130579,PDN
WC333,,1981,1976,,91034,125123660,22355030,,24959,64874818,11568521,,66075,60248842,10786509,PDN
WC333,,1982,1976,,90544,127836660,22837281,,27888,76783725,13690473,,62656,51052935,9146808,PDN
WC333,,1983,1976,,90604,131836660,23549084,,27328,87178874,15539583,,63276,44657786,8009501,PDN
WC333,,1984,1976,,90326,132762591,23713563,,30845,95184075,16967513,,59481,37578516,6746050,PDN
WC333,,1985,1976,,67143,135663283,24206517,,32476,100117780,17847028,,34667,35545503,6359489,PDN
WC333,,1986,1976,,43689,123831953,22077844,,33671,103461556,18443201,,10018,20370397,3634643,PDN
WC333,,1987,1976,,45677,123831953,22079832,,36443,109470090,19515107,,9234,14361863,2564725,PDN
WC333,,1988,1976,,47633,128720737,22951679,,39694,116900974,20840579,,7939,11819763,2111100,PDN
WC333,,1989,1976,,55123,155512450,27726377,,43690,125717453,22413344,,11433,29794997,5313033,PDN
WC333,,1990,1976,,61276,156278530,27868844,,47417,134234600,23932577,,13859,22043930,3936267,PDN
WC333,,1991,1976,,70782,193956429,34582602,,50806,144049406,25682373,,19976,49907023,8900229,PDN
WC333,,1992,1976,,70782,193956429,34582602,,52416,148939870,26554172,,18366,45016559,8028430,PDN
WC333,,1993,1976,,67073,186314380,33219098,,53213,151157227,26949517,,13860,35157153,6269581,PDN
WC333,,1994,1976,,65461,183823762,32774315,,54430,152732426,27231018,,11031,31091336,5543297,PDN
WC333,,1995,1976,,65461,183823762,32774315,,55080,153310971,27334612,,10381,30512791,5439703,PDN
WC333,,1996,1976,,57019,155303683,27691126,,55856,153784176,27419588,,1163,1519507,271538,PDN
WC333,,1997,1976,,56875,154234534,27500742,,56559,154173080,27489491,,316,61454,11251,PDN
WC333,,1998,1976,,56875,154234534,27500742,,56875,154234534,27500742,,0,0,0,PDN
WC333,,1999,1976,,56875,154234534,27500742,,56875,154234534,27500742,,0,0,0,PDN
WC333,,2000,1976,,56875,154234534,27500742,,56875,154234534,27500742,,0,0,0,PDN
WC333,,2001,1976,,56875,154234534,27500742,,56875,154234534,27500742,,0,0,0,PDN
WC333,,2002,1976,,56875,154234534,27500742,,56875,154234534,27500742,,0,0,0,PDN
WC333,,2003,1976,,57710,155949560,27806742,,56875,154234534,27500742,,835,1715026,306000,PDN
WC333,,2004,1976,,57265,157001729,27993516,,56875,154234534,27500742,,390,2767195,492774,PDN
WC333,,2005,1976,,57265,159207447,28385992,,56883,155589850,27741910,,382,3617597,644082,PDN
WC333,,2006,1976,,60540,159415001,28426199,,56999,156393069,27884947,,3541,3021932,541252,PDN
WC333,,2007,1976,,60540,159415001,28426199,,57508,157042928,28001089,,3032,2372073,425110,PDN
WC333,,2008,1976,,60540,159414996,28426198,,58025,157717921,28121712,,2515,1697075,304486,PDN
WC333,,2009,1976,,58595,161156110,28734061,,58561,161123540,28728232,,34,32570,5829,PDN
WC333,,2010,1976,,58595,161156110,28734061,,58595,161156110,28734061,,0,0,0,PDN
WC333,,2011,1976,,58595,161156110,28734061,,58595,161156110,28734061,,0,0,0,PDN
WC333,,2012,1976,,58595,161156110,28734061,,58595,161156110,28734061,,0,0,0,PDN
WC333,,2013,1976,,58595,161156110,28734061,,58595,161156110,28734061,,0,0,0,PDN
WC333,,2014,1976,,58595,161156110,28734061,,58595,161156110,28734061,,0,0,0,PDN
WC333,,2015,1976,,58595,161156110,28734061,,58595,161156110,28734061,,0,0,0,PDN
WC333,,2016,1976,,58595,161156110,28734061,,58595,161156110,28734061,,0,0,0,PDN
WC333,,2017,1976,,58595,161156110,28734061,,58595,161156110,28734061,,0,0,0,PDN
WC333,,2017,1976,,58595,161156110,28734061,,58595,161156110,28734061,,0,0,0,PDN
WC342,,2006,2006,,949,6819637,1214408,,0,4255082,757132,,949,2564555,457276,PDN
WC342,,2007,2006,,949,6819637,1214408,,79,5304054,943861,,870,1515583,270547,PDN
WC342,,2008,2006,,949,6819637,1214408,,367,5604795,997661,,582,1214842,216747,PDN
WC342,,2009,2006,,367,5690014,1012825,,367,5690014,1012825,,0,0,0,PDN
WC342,,2010,2006,,367,5690014,1012825,,367,5690014,1012825,,0,0,0,PDN
WC342,,2011,2006,,367,5690014,1012825,,367,5690014,1012825,,0,0,0,PDN
WC342,,2012,2006,,367,5690014,1012825,,367,5690014,1012825,,0,0,0,PDN
WC342,,2013,2006,,367,5690014,1012825,,367,5690014,1012825,,0,0,0,PDN
WC342,,2014,2006,,367,5690014,1012825,,367,5690014,1012825,,0,0,0,PDN
WC342,,2015,2006,,367,5690014,1012825,,367,5690014,1012825,,0,0,0,PDN
WC342,,2016,2006,,367,5690014,1012825,,367,5690014,1012825,,0,0,0,PDN
WC342,,2017,2006,,367,5690014,1012825,,367,5690014,1012825,,0,0,0,PDN
WC342,,2017,2006,,367,5690014,1012825,,367,5690014,1012825,,0,0,0,PDN
WC347,,2001,2002,,643,1738154,309923,,0,0,0,,643,1738154,309923,PDN
WC347,,2002,2002,,849,5120856,912033,,0,122262,21755,,849,4998594,890278,PDN
WC347,,2003,2002,,907,5358849,954439,,471,3277374,583634,,436,2081475,370805,PDN
WC347,,2004,2002,,4013,5775513,1031684,,1374,4651069,828966,,2639,1124444,202718,PDN
WC347,,2005,2002,,5237,6156843,1100761,,4238,5848808,1044951,,999,308035,55810,PDN
WC347,,2006,2002,,5399,8581488,1532354,,4576,6768567,1208947,,823,1812921,323407,PDN
WC347,,2007,2002,,5385,8554316,1527505,,4818,7108549,1269684,,567,1445767,257821,PDN
WC347,,2008,2002,,5386,8584378,1532855,,4829,7347303,1312178,,557,1237075,220677,PDN
WC347,,2009,2002,,4830,7380748,1318131,,4830,7380748,1318131,,0,0,0,PDN
WC347,,2010,2002,,4830,7380748,1318131,,4830,7380748,1318131,,0,0,0,PDN
WC347,,2011,2002,,4830,7380748,1318131,,4830,7380748,1318131,,0,0,0,PDN
WC347,,2012,2002,,4830,7380748,1318131,,4830,7380748,1318131,,0,0,0,PDN
WC347,,2013,2002,,4830,7380748,1318131,,4830,7380748,1318131,,0,0,0,PDN
WC347,,2014,2002,,4830,7380748,1318131,,4830,7380748,1318131,,0,0,0,PDN
WC347,,2015,2002,,4830,7380748,1318131,,4830,7380748,1318131,,0,0,0,PDN
WC347,,2016,2002,,4830,7380748,1318131,,4830,7380748,1318131,,0,0,0,PDN
WC347,,2017,2002,,4830,7380748,1318131,,4830,7380748,1318131,,0,0,0,PDN
WC347,,2017,2002,,4830,7380748,1318131,,4830,7380748,1318131,,0,0,0,PDN
WC353,,1977,1975,,76071,76071213,13611874,,0,0,0,,76071,76071213,13611874,PDN
WC353,,1978,1975,,76071,76071213,13611874,,0,0,0,,76071,76071213,13611874,PDN
WC353,,1979,1975,,76071,76071213,13611874,,29508,6025919,1101736,,46563,70045294,12510138,PDN
WC353,,1980,1975,,1184259,76898213,14867215,,173789,29251309,5378648,,1010470,47646904,9488567,PDN
WC353,,1981,1975,,1196127,83028013,15969795,,325125,58379761,10712983,,871002,24648252,5256812,PDN
WC353,,1982,1975,,1690845,115996953,22330872,,708165,78979155,14761395,,982680,37017798,7569477,PDN
WC353,,1983,1975,,1700845,123029953,23592296,,783349,90307628,16852322,,917496,32722325,6739974,PDN
WC353,,1984,1975,,1700845,123029953,23592296,,599417,95060049,17514016,,1101428,27969904,6078280,PDN
WC353,,1985,1975,,1170290,125672968,23532028,,611765,97195938,17906416,,558525,28477030,5625612,PDN
WC353,,1986,1975,,667195,126281802,23137267,,623552,100772406,18554585,,43643,25509396,4582682,PDN
WC353,,1987,1975,,653417,129425607,23682884,,631812,103673120,19078986,,21605,25752487,4603898,PDN
WC353,,1988,1975,,645553,125862103,23040945,,638359,104754552,19277959,,7194,21107551,3762986,PDN
WC353,,1989,1975,,661962,128380832,23505526,,643656,106140791,19529918,,18306,22240041,3975608,PDN
WC353,,1990,1975,,750727,126476479,23255439,,647810,107350560,19749333,,102917,19125919,3506106,PDN
WC353,,1991,1975,,684379,114983458,21144069,,652035,108382427,19937164,,32344,6601031,1206905,PDN
WC353,,1992,1975,,669366,117335298,21547533,,656332,109942975,20219139,,13034,7392323,1328394,PDN
WC353,,1993,1975,,669366,117335298,21547533,,657791,110153564,20258069,,11575,7181734,1289464,PDN
WC353,,1994,1975,,873247,148250578,27252353,,660186,114382589,21012960,,213061,33867989,6239393,PDN
WC353,,1995,1975,,774464,158069967,28900793,,660797,122740285,22500705,,113667,35329682,6400088,PDN
WC353,,1996,1975,,670631,166665515,30326417,,661040,126662532,23198857,,9591,40002983,7127560,PDN
WC353,,1997,1975,,670121,147500361,26915737,,661218,127772765,23396585,,8903,19727596,3519152,PDN
WC353,,1998,1975,,670121,147500361,26915737,,661333,128471904,23521102,,8788,19028457,3394635,PDN
WC353,,1999,1975,,661615,131263731,24018151,,661353,128755399,23571566,,262,2508332,446585,PDN
WC353,,2000,1975,,661619,132504045,24238851,,661353,129395312,23685430,,266,3108733,553421,PDN
WC353,,2001,1975,,664218,133868717,24484274,,661353,129847491,23765889,,2865,4021226,718385,PDN
WC353,,2002,1975,,663925,134150127,24534054,,661353,130180374,23825121,,2572,3969753,708933,PDN
WC353,,2003,1975,,677170,144899167,26459940,,666155,137504645,25133174,,11015,7394522,1326766,PDN
WC353,,2004,1975,,678998,144598475,26408264,,673233,142681220,26061350,,5765,1917255,346914,PDN
WC353,,2005,1975,,679035,148173029,27044343,,677845,144508112,26391032,,1190,3664917,653311,PDN
WC353,,2006,1975,,678679,141388549,25836783,,678609,140609235,25698046,,70,779314,138737,PDN
WC353,,2007,1975,,678679,141516204,25859498,,678609,140828544,25737069,,70,687660,122429,PDN
WC353,,2008,1975,,678609,140828544,25737069,,678609,140828544,25737069,,0,0,0,PDN
WC353,,2009,1975,,678608,143312806,26179108,,678608,143312806,26179108,,0,0,0,PDN
WC353,,2010,1975,,678608,143312806,26179108,,678608,143312806,26179108,,0,0,0,PDN
WC353,,2011,1975,,678608,143312806,26179108,,678608,143312806,26179108,,0,0,0,PDN
WC353,,2012,1975,,678608,143312806,26179108,,678608,143312806,26179108,,0,0,0,PDN
WC353,,2013,1975,,678608,143312806,26179108,,678608,143312806,26179108,,0,0,0,PDN
WC353,,2014,1975,,678608,143312806,26179108,,678608,143312806,26179108,,0,0,0,PDN
WC353,,2015,1975,,678608,143312806,26179108,,678608,143312806,26179108,,0,0,0,PDN
WC353,,2016,1975,,678608,143312806,26179108,,678608,143312806,26179108,,0,0,0,PDN
WC353,,2017,1975,,678608,143312806,26179108,,678608,143312806,26179108,,0,0,0,PDN
WC353,,2017,1975,,678608,143312806,26179108,,678608,143312806,26179108,,0,0,0,PDN
WC359,,1983,1979,,98821,29646340,5373970,,0,0,0,,98821,29646340,5373970,PDN
WC359,,1992,1979,,20829,11572571,2080005,,2664,1443451,259506,,18165,10129120,1820499,PDN
WC359,,1993,1979,,74820,16971682,3094692,,5033,2986671,536469,,69787,13985011,2558223,PDN
WC359,,1994,1979,,86552,18144845,3315172,,5075,3244294,582352,,81477,14900551,2732820,PDN
WC359,,1995,1979,,5633,8592418,1534533,,5075,4955628,886859,,558,3636790,647674,PDN
WC359,,1996,1979,,5875,11007146,1964442,,5075,5638072,1008291,,800,5369074,956151,PDN
WC359,,1997,1979,,5075,5638072,1008291,,5075,5638072,1008291,,0,0,0,PDN
WC359,,1998,1979,,5075,5638072,1008291,,5075,5638072,1008291,,0,0,0,PDN
WC359,,1999,1979,,5075,5638072,1008291,,5075,5638072,1008291,,0,0,0,PDN
WC359,,2000,1979,,5075,5638072,1008291,,5075,5638072,1008291,,0,0,0,PDN
WC359,,2001,1979,,5075,5638072,1008291,,5075,5638072,1008291,,0,0,0,PDN
WC359,,2002,1979,,5075,5638072,1008291,,5075,5638072,1008291,,0,0,0,PDN
WC359,,2003,1979,,5075,5638072,1008291,,5075,5638072,1008291,,0,0,0,PDN
WC359,,2004,1979,,5075,5638072,1008291,,5075,5638072,1008291,,0,0,0,PDN
WC359,,2005,1979,,5075,5638072,1008291,,5075,5638072,1008291,,0,0,0,PDN
WC359,,2006,1979,,5075,5638072,1008291,,5075,5638072,1008291,,0,0,0,PDN
WC359,,2007,1979,,5075,5638072,1008291,,5075,5638072,1008291,,0,0,0,PDN
WC359,,2008,1979,,5075,5638072,1008291,,5075,5638072,1008291,,0,0,0,PDN
WC359,,2009,1979,,5075,5750990,1028382,,5075,5750990,1028382,,0,0,0,PDN
WC359,,2010,1979,,5075,5750990,1028382,,5075,5750990,1028382,,0,0,0,PDN
WC359,,2011,1979,,5075,5750990,1028382,,5075,5750990,1028382,,0,0,0,PDN
WC359,,2012,1979,,5075,5750990,1028382,,5075,5750990,1028382,,0,0,0,PDN
WC359,,2013,1979,,5075,5750990,1028382,,5075,5750990,1028382,,0,0,0,PDN
WC359,,2014,1979,,5075,5750990,1028382,,5075,5750990,1028382,,0,0,0,PDN
WC359,,2015,1979,,5075,5750990,1028382,,5075,5750990,1028382,,0,0,0,PDN
WC359,,2016,1979,,5075,5750990,1028382,,5075,5750990,1028382,,0,0,0,PDN
WC359,,2017,1979,,5075,5750990,1028382,,5075,5750990,1028382,,0,0,0,PDN
WC359,,2017,1979,,5075,5750990,1028382,,5075,5750990,1028382,,0,0,0,PDN
WC368,,1988,1962,,149156,30990778,5663529,,48649,6589718,1221197,,100507,24401060,4442332,PDN
WC368,,1989,1962,,639395,78407368,14590884,,127653,20637459,3799799,,511742,57769909,10791085,PDN
WC368,,1990,1962,,707065,100847846,18651522,,261823,37692075,6968598,,445242,63155771,11682924,PDN
WC368,,1991,1962,,625369,95596088,17635349,,366084,51700417,9565446,,259285,43895671,8069903,PDN
WC368,,1992,1962,,497271,77126356,14220822,,413177,59461266,10993473,,84094,17665090,3227349,PDN
WC368,,1993,1962,,512796,93118066,17081847,,426961,74456503,13675449,,85835,18661563,3406398,PDN
WC368,,1994,1962,,467364,101134925,18462902,,435139,77928740,14301463,,32225,23206185,4161439,PDN
WC368,,1995,1962,,467364,101134925,18462902,,439199,79797095,14637970,,28165,21337830,3824932,PDN
WC368,,1996,1962,,474248,104321223,19036743,,441650,81631913,14966901,,32598,22689310,4069842,PDN
WC368,,1997,1962,,640155,112870912,20723947,,442007,83458596,15292291,,198148,29412316,5431656,PDN
WC368,,1998,1962,,707262,124392377,22841137,,525204,88606574,16291498,,182058,35785803,6549639,PDN
WC368,,1999,1962,,766178,106061592,19638347,,534697,90485695,16635354,,231481,15575897,3002993,PDN
WC368,,2000,1962,,790319,112790931,20859880,,539538,93237150,17129778,,250781,19553781,3730102,PDN
WC368,,2001,1962,,621776,119305604,21850531,,593948,101330898,18624357,,27828,17974706,3226174,PDN
WC368,,2002,1962,,630640,121487008,22247545,,607467,106167277,19498442,,23173,15319731,2749103,PDN
WC368,,2003,1962,,633425,126236108,23095366,,617306,109900435,20172544,,16119,16335673,2922822,PDN
WC368,,2004,1962,,629972,127157112,23255793,,622131,113392435,20798721,,7841,13764677,2457072,PDN
WC368,,2005,1962,,634057,140369222,25610787,,623301,116319803,21320775,,10756,24049419,4290012,PDN
WC368,,2006,1962,,631888,143466834,26159794,,624961,120503493,22066864,,6927,22963341,4092930,PDN
WC368,,2007,1962,,631522,143470349,26160054,,625614,123979965,22686106,,5908,19490384,3473948,PDN
WC368,,2008,1962,,1559733,169386227,31699631,,688862,127286855,23337769,,870871,42099372,8361862,PDN
WC368,,2009,1962,,1746091,189310871,35431300,,1118169,141858238,26359848,,627922,47452633,9071451,PDN
WC368,,2010,1962,,1746091,189310871,35431300,,1282565,149637321,27908423,,463526,39673550,7522877,PDN
WC368,,2011,1962,,1746091,189310871,35431300,,1343466,153676800,28688093,,402625,35634071,6743207,PDN
WC368,,2012,1962,,1746091,189310871,35431300,,1379383,156029996,29142727,,366708,33280875,6288572,PDN
WC368,,2013,1962,,1746091,189310871,35431300,,1394304,157160212,29358755,,351787,32150659,6072545,PDN
WC368,,2014,1962,,1432745,165292756,30844268,,1404102,157790588,29480719,,28643,7502168,1363548,PDN
WC368,,2015,1962,,1411102,158389978,29594373,,1411053,158200833,29560668,,49,189145,33705,PDN
WC368,,2016,1962,,1411053,158200833,29560668,,1411053,158200833,29560668,,0,0,0,PDN
WC368,,2017,1962,,1411053,158200374,29560586,,1411053,158200374,29560586,,0,0,0,PDN
WC368,,2017,1962,,1411053,158200374,29560586,,1411053,158200374,29560586,,0,0,0,PDN
WC370,,1983,1980,,35000,32457000,5810267,,0,0,0,,35000,32457000,5810267,PDN
WC370,,1984,1980,,35000,32457000,5810267,,0,0,0,,35000,32457000,5810267,PDN
WC370,,1985,1980,,23688,10612977,1912118,,0,0,0,,23688,10612977,1912118,PDN
WC370,,1986,1980,,23688,10612977,1912118,,0,0,0,,23688,10612977,1912118,PDN
WC370,,1987,1980,,23688,10612977,1912118,,0,0,0,,23688,10612977,1912118,PDN
WC370,,1988,1980,,91258,46668305,8395227,,2525,4782484,853501,,88733,41885821,7541726,PDN
WC370,,1989,1980,,65859,49413021,8858211,,6452,10585455,1889985,,59407,38827566,6968226,PDN
WC370,,1990,1980,,58346,55573255,9946826,,10341,17723226,3163940,,48005,37850029,6782886,PDN
WC370,,1991,1980,,58346,55573255,9946826,,12821,20749961,3704985,,45525,34823294,6241841,PDN
WC370,,1992,1980,,64288,49536886,8878681,,14689,23521409,4199993,,49599,26015477,4678688,PDN
WC370,,1993,1980,,20369,23056696,4122984,,15148,15205769,2720801,,5221,7850927,1402183,PDN
WC370,,1994,1980,,21452,23056696,4124067,,15663,15678838,2805492,,5789,7377858,1318575,PDN
WC370,,1995,1980,,22356,18571279,3326854,,16287,15887191,2843189,,6069,2684088,483665,PDN
WC370,,1996,1980,,21359,16640572,2982315,,16523,15907360,2847014,,4836,733212,135301,PDN
WC370,,1997,1980,,21359,16640572,2982315,,17362,15932611,2852346,,3997,707961,129969,PDN
WC370,,1998,1980,,17460,15946520,2854919,,17440,15946024,2854811,,20,496,108,PDN
WC370,,1999,1980,,17460,15946520,2854919,,17460,15946520,2854919,,0,0,0,PDN
WC370,,2000,1980,,17460,15946520,2854919,,17460,15946520,2854919,,0,0,0,PDN
WC370,,2001,1980,,18628,49151347,8764419,,17746,23569203,4211554,,882,25582144,4552865,PDN
WC370,,2002,1980,,18678,44353191,7910705,,18019,29416560,5252282,,659,14936631,2658423,PDN
WC370,,2003,1980,,18627,39281829,7008276,,18173,30602154,5463396,,454,8679675,1544880,PDN
WC370,,2004,1980,,18352,32042206,5719812,,18257,31051152,5543373,,95,991054,176439,PDN
WC370,,2005,1980,,18354,33351272,5952744,,18258,31473948,5618605,,96,1877324,334139,PDN
WC370,,2006,1980,,18349,33518602,5982513,,18259,31677395,5654806,,90,1841207,327707,PDN
WC370,,2007,1980,,18349,33518602,5982513,,18260,32100271,5730052,,89,1418331,252461,PDN
WC370,,2008,1980,,18349,33518602,5982513,,18260,32232703,5753616,,89,1285899,228897,PDN
WC370,,2009,1980,,18267,33016882,5893155,,18260,32588483,5816920,,7,428399,76235,PDN
WC370,,2010,1980,,18267,33113115,5910279,,18260,32764669,5848271,,7,348446,62008,PDN
WC370,,2011,1980,,18260,32838938,5861485,,18260,32838938,5861485,,0,0,0,PDN
WC370,,2012,1980,,18260,32838938,5861485,,18260,32838938,5861485,,0,0,0,PDN
WC370,,2013,1980,,18260,32838938,5861485,,18260,32838938,5861485,,0,0,0,PDN
WC370,,2014,1980,,18260,32838938,5861485,,18260,32838938,5861485,,0,0,0,PDN
WC370,,2015,1980,,18260,32838938,5861485,,18260,32838938,5861485,,0,0,0,PDN
WC370,,2016,1980,,18260,32838938,5861485,,18260,32838938,5861485,,0,0,0,PDN
WC370,,2017,1980,,18260,32838938,5861485,,18260,32838938,5861485,,0,0,0,PDN
WC370,,2017,1980,,18260,32838938,5861485,,18260,32838938,5861485,,0,0,0,PDN
WC379,,1985,1983,,3216,3215959,575451,,0,0,0,,3216,3215959,575451,PDN
WC379,,1986,1983,,3216,3215959,575451,,0,0,0,,3216,3215959,575451,PDN
WC379,,1987,1983,,3216,3215959,575451,,0,0,0,,3216,3215959,575451,PDN
WC379,,1988,1983,,9241,9241292,1653599,,20,1539835,274012,,9221,7701457,1379587,PDN
WC379,,1989,1983,,1180,19152894,3409168,,197,6418255,1142235,,983,12734639,2266933,PDN
WC379,,1990,1983,,3051,30502178,5430485,,420,12069958,2148099,,2631,18432220,3282386,PDN
WC379,,1991,1983,,2597,30502178,5430031,,449,16506892,2937618,,2148,13995286,2492413,PDN
WC379,,1992,1983,,775,31157264,5544772,,449,19189650,3414977,,326,11967614,2129795,PDN
WC379,,1993,1983,,674,28520328,5075465,,449,21464474,3819750,,225,7055854,1255715,PDN
WC379,,1994,1983,,4085,39387703,7012573,,822,23487209,4180041,,3263,15900494,2832532,PDN
WC379,,1995,1983,,4085,39387703,7012573,,856,23550223,4191287,,3229,15837480,2821286,PDN
WC379,,1996,1983,,856,23550223,4191287,,856,23550223,4191287,,0,0,0,PDN
WC379,,1997,1983,,856,23550223,4191287,,856,23550223,4191287,,0,0,0,PDN
WC379,,1998,1983,,856,23550223,4191287,,856,23550223,4191287,,0,0,0,PDN
WC379,,1999,1983,,856,23550223,4191287,,856,23550223,4191287,,0,0,0,PDN
WC379,,2000,1983,,856,23550223,4191287,,856,23550223,4191287,,0,0,0,PDN
WC379,,2001,1983,,856,23550223,4191287,,856,23550223,4191287,,0,0,0,PDN
WC379,,2002,1983,,856,23550223,4191287,,856,23550223,4191287,,0,0,0,PDN
WC379,,2003,1983,,856,23550223,4191287,,856,23550223,4191287,,0,0,0,PDN
WC379,,2004,1983,,856,23550223,4191287,,856,23550223,4191287,,0,0,0,PDN
WC379,,2005,1983,,856,23550223,4191287,,856,23550223,4191287,,0,0,0,PDN
WC379,,2006,1983,,856,23550223,4191287,,856,23550223,4191287,,0,0,0,PDN
WC379,,2007,1983,,856,23550223,4191287,,856,23550223,4191287,,0,0,0,PDN
WC379,,2008,1983,,856,23550223,4191287,,856,23550223,4191287,,0,0,0,PDN
WC379,,2009,1983,,856,24021861,4275208,,856,24021861,4275208,,0,0,0,PDN
WC379,,2010,1983,,856,24021861,4275208,,856,24021861,4275208,,0,0,0,PDN
WC379,,2011,1983,,856,24021861,4275208,,856,24021861,4275208,,0,0,0,PDN
WC379,,2012,1983,,856,24021861,4275208,,856,24021861,4275208,,0,0,0,PDN
WC379,,2013,1983,,856,24021861,4275208,,856,24021861,4275208,,0,0,0,PDN
WC379,,2014,1983,,856,24021861,4275208,,856,24021861,4275208,,0,0,0,PDN
WC379,,2015,1983,,856,24021861,4275208,,856,24021861,4275208,,0,0,0,PDN
WC379,,2016,1983,,856,24021861,4275208,,856,24021861,4275208,,0,0,0,PDN
WC379,,2017,1983,,856,24021861,4275208,,856,24021861,4275208,,0,0,0,PDN
WC379,,2017,1983,,856,24021861,4275208,,856,24021861,4275208,,0,0,0,PDN
WC391,,1986,1984,,19163,4790695,871600,,0,0,0,,19163,4790695,871600,PDN
WC391,,1987,1984,,19163,4790695,871600,,0,0,0,,19163,4790695,871600,PDN
WC391,,1988,1984,,43836,10959085,1993851,,430,525134,93870,,43406,10433951,1899981,PDN
WC391,,1989,1984,,4483,9279632,1655663,,792,1681100,299920,,3691,7598532,1355743,PDN
WC391,,1990,1984,,4483,9279632,1655663,,2003,3086503,551203,,2480,6193129,1104460,PDN
WC391,,1991,1984,,11101,9279632,1662281,,3623,4474746,799841,,7478,4804886,862440,PDN
WC391,,1992,1984,,9499,12396341,2215254,,4290,5420604,968810,,5209,6975737,1246444,PDN
WC391,,1993,1984,,9499,12396341,2215254,,4367,5577151,996743,,5132,6819190,1218511,PDN
WC391,,1994,1984,,9499,12396341,2215254,,4372,5745386,1026683,,5127,6650955,1188571,PDN
WC391,,1995,1984,,4372,5771549,1031338,,4372,5771549,1031338,,0,0,0,PDN
WC391,,1996,1984,,4372,5771549,1031338,,4372,5771549,1031338,,0,0,0,PDN
WC391,,1997,1984,,4372,5771549,1031338,,4372,5771549,1031338,,0,0,0,PDN
WC391,,1998,1984,,4372,5771549,1031338,,4372,5771549,1031338,,0,0,0,PDN
WC391,,1999,1984,,4372,5771549,1031338,,4372,5771549,1031338,,0,0,0,PDN
WC391,,2000,1984,,4372,5771549,1031338,,4372,5771549,1031338,,0,0,0,PDN
WC391,,2001,1984,,4372,5771549,1031338,,4372,5771549,1031338,,0,0,0,PDN
WC391,,2002,1984,,4372,5771549,1031338,,4372,5771549,1031338,,0,0,0,PDN
WC391,,2003,1984,,4372,5771549,1031338,,4372,5771549,1031338,,0,0,0,PDN
WC391,,2004,1984,,4372,5771549,1031338,,4372,5771549,1031338,,0,0,0,PDN
WC391,,2005,1984,,4372,5771549,1031338,,4372,5771549,1031338,,0,0,0,PDN
WC391,,2006,1984,,4372,5771549,1031338,,4372,5771549,1031338,,0,0,0,PDN
WC391,,2007,1984,,4372,5771549,1031338,,4372,5771549,1031338,,0,0,0,PDN
WC391,,2008,1984,,4372,5771549,1031338,,4372,5771549,1031338,,0,0,0,PDN
WC391,,2009,1984,,4372,5887136,1051905,,4372,5887136,1051905,,0,0,0,PDN
WC391,,2010,1984,,4372,5887136,1051905,,4372,5887136,1051905,,0,0,0,PDN
WC391,,2011,1984,,4372,5887136,1051905,,4372,5887136,1051905,,0,0,0,PDN
WC391,,2012,1984,,4372,5887136,1051905,,4372,5887136,1051905,,0,0,0,PDN
WC391,,2013,1984,,4372,5887136,1051905,,4372,5887136,1051905,,0,0,0,PDN
WC391,,2014,1984,,4372,5887136,1051905,,4372,5887136,1051905,,0,0,0,PDN
WC391,,2015,1984,,4372,5887136,1051905,,4372,5887136,1051905,,0,0,0,PDN
WC391,,2016,1984,,4372,5887136,1051905,,4372,5887136,1051905,,0,0,0,PDN
WC391,,2017,1984,,4372,5887136,1051905,,4372,5887136,1051905,,0,0,0,PDN
WC391,,2017,1984,,4372,5887136,1051905,,4372,5887136,1051905,,0,0,0,PDN
WC398,,2004,1989,,300,7152222,1272937,,0,2381295,423718,,300,4770927,849219,PDN
WC398,,2005,1989,,482,6579647,1171238,,13,4603482,819138,,469,1976165,352100,PDN
WC398,,2006,1989,,505,6731386,1198261,,191,5254543,935163,,314,1476843,263098,PDN
WC398,,2007,1989,,505,6731386,1198261,,212,5561740,989845,,293,1169646,208416,PDN
WC398,,2008,1989,,505,6731386,1198261,,212,5733452,1020399,,293,997934,177862,PDN
WC398,,2009,1989,,212,5775773,1027929,,212,5775773,1027929,,0,0,0,PDN
WC398,,2010,1989,,212,5775773,1027929,,212,5775773,1027929,,0,0,0,PDN
WC398,,2011,1989,,212,5775773,1027929,,212,5775773,1027929,,0,0,0,PDN
WC398,,2012,1989,,212,5775773,1027929,,212,5775773,1027929,,0,0,0,PDN
WC398,,2013,1989,,212,5775773,1027929,,212,5775773,1027929,,0,0,0,PDN
WC398,,2014,1989,,212,5775773,1027929,,212,5775773,1027929,,0,0,0,PDN
WC398,,2015,1989,,212,5775773,1027929,,212,5775773,1027929,,0,0,0,PDN
WC398,,2016,1989,,212,5775773,1027929,,212,5775773,1027929,,0,0,0,PDN
WC398,,2017,1989,,212,5775773,1027929,,212,5775773,1027929,,0,0,0,PDN
WC398,,2017,1989,,212,5775773,1027929,,212,5775773,1027929,,0,0,0,PDN
WC403,,2003,2003,,100,1466564,261054,,0,0,0,,100,1466564,261054,PDN
WC403,,2004,2003,,226,1466564,261180,,73,1426465,253892,,153,40099,7288,PDN
WC403,,2005,2003,,226,1466564,261180,,218,1451867,258557,,8,14697,2623,PDN
WC403,,2006,2003,,218,1531331,272697,,218,1451867,258557,,0,79464,14140,PDN
WC403,,2007,2003,,218,1498391,266836,,218,1498391,266836,,0,0,0,PDN
WC403,,2008,2003,,218,1499517,267036,,218,1499517,267036,,0,0,0,PDN
WC403,,2009,2003,,218,1499517,267036,,218,1499517,267036,,0,0,0,PDN
WC403,,2010,2003,,218,1499517,267036,,218,1499517,267036,,0,0,0,PDN
WC403,,2011,2003,,218,1499517,267036,,218,1499517,267036,,0,0,0,PDN
WC403,,2012,2003,,218,1499517,267036,,218,1499517,267036,,0,0,0,PDN
WC403,,2013,2003,,218,1499517,267036,,218,1499517,267036,,0,0,0,PDN
WC403,,2014,2003,,218,1499517,267036,,218,1499517,267036,,0,0,0,PDN
WC403,,2015,2003,,218,1499517,267036,,218,1499517,267036,,0,0,0,PDN
WC403,,2016,2003,,218,1499517,267036,,218,1499517,267036,,0,0,0,PDN
WC403,,2017,2003,,218,1499517,267036,,218,1499517,267036,,0,0,0,PDN
WC403,,2017,2003,,218,1499517,267036,,218,1499517,267036,,0,0,0,PDN
WC406,,1978,1977,,50672,50671010,9066866,,0,0,0,,50672,50671010,9066866,PDN
WC406,,1979,1977,,85162,85161010,15238367,,11937,3808537,689613,,73225,81352473,14548754,PDN
WC406,,1980,1977,,120000,50671010,9136194,,27013,9795791,1770036,,92987,40875219,7366158,PDN
WC406,,1981,1977,,120000,50671010,9136194,,48038,19704432,3554165,,71962,30966578,5582029,PDN
WC406,,1982,1977,,148000,58689510,10590973,,90791,36621746,6607116,,57209,22067764,3983857,PDN
WC406,,1983,1977,,148000,58689510,10590973,,105648,42886280,7736659,,42352,15803230,2854314,PDN
WC406,,1984,1977,,150859,59700731,10773765,,113568,47398951,8547545,,37291,12301780,2226220,PDN
WC406,,1985,1977,,150859,59700731,10773765,,116893,49414489,8909507,,33966,10286242,1864258,PDN
WC406,,1986,1977,,150859,59700731,10773765,,118186,49151494,8864003,,32673,10549237,1909762,PDN
WC406,,1987,1977,,152783,60711951,10955621,,122095,50467742,9102120,,30688,10244209,1853501,PDN
WC406,,1988,1977,,152783,60711951,10955621,,125130,52318562,9434483,,27653,8393389,1521138,PDN
WC406,,1989,1977,,158654,64840950,11696190,,128216,53940843,9726231,,30438,10900107,1969959,PDN
WC406,,1990,1977,,158654,64840950,11696190,,132965,56359741,10161389,,25689,8481209,1534801,PDN
WC406,,1991,1977,,287473,67570423,12310680,,137006,58270572,10505435,,150467,9299851,1805245,PDN
WC406,,1992,1977,,287473,67570423,12310680,,139280,59868459,10792031,,148193,7701964,1518649,PDN
WC406,,1993,1977,,150204,67571200,12173549,,142477,61468573,11079946,,7727,6102627,1093603,PDN
WC406,,1994,1977,,204213,72972216,13188593,,149674,64178583,11569351,,54539,8793633,1619242,PDN
WC406,,1995,1977,,212944,79848063,14420784,,162785,69436148,12517971,,50159,10411915,1902813,PDN
WC406,,1996,1977,,212944,85421604,15412518,,164971,72296153,13029055,,47973,13125451,2383463,PDN
WC406,,1997,1977,,212944,85421604,15412518,,165348,72599979,13083494,,47596,12821625,2329024,PDN
WC406,,1998,1977,,165958,73193669,13189743,,165894,73140112,13180149,,64,53557,9594,PDN
WC406,,1999,1977,,165958,73193669,13189743,,165958,73193669,13189743,,0,0,0,PDN
WC406,,2000,1977,,165958,73193669,13189743,,165958,73193669,13189743,,0,0,0,PDN
WC406,,2001,1977,,165958,73193669,13189743,,165958,73193669,13189743,,0,0,0,PDN
WC406,,2002,1977,,165958,73193669,13189743,,165958,73193669,13189743,,0,0,0,PDN
WC406,,2003,1977,,165958,73193669,13189743,,165958,73193669,13189743,,0,0,0,PDN
WC406,,2004,1977,,165958,73193669,13189743,,165958,73193669,13189743,,0,0,0,PDN
WC406,,2005,1977,,165958,73193669,13189743,,165958,73193669,13189743,,0,0,0,PDN
WC406,,2006,1977,,165958,73193669,13189743,,165958,73193669,13189743,,0,0,0,PDN
WC406,,2007,1977,,165958,73193669,13189743,,165958,73193669,13189743,,0,0,0,PDN
WC406,,2008,1977,,165958,73193669,13189743,,165958,73193669,13189743,,0,0,0,PDN
WC406,,2009,1977,,165958,74655855,13449917,,165958,74655855,13449917,,0,0,0,PDN
WC406,,2010,1977,,165958,74655855,13449917,,165958,74655855,13449917,,0,0,0,PDN
WC406,,2011,1977,,165958,74655855,13449917,,165958,74655855,13449917,,0,0,0,PDN
WC406,,2012,1977,,165958,74655855,13449917,,165958,74655855,13449917,,0,0,0,PDN
WC406,,2013,1977,,165958,74655855,13449917,,165958,74655855,13449917,,0,0,0,PDN
WC406,,2014,1977,,165958,74655855,13449917,,165958,74655855,13449917,,0,0,0,PDN
WC406,,2015,1977,,165958,74655855,13449917,,165958,74655855,13449917,,0,0,0,PDN
WC406,,2016,1977,,165958,74655855,13449917,,165958,74655855,13449917,,0,0,0,PDN
WC406,,2017,1977,,165958,74655855,13449917,,165958,74655855,13449917,,0,0,0,PDN
WC406,,2017,1977,,165958,74655855,13449917,,165958,74655855,13449917,,0,0,0,PDN
WC409,,1977,1976,,642857,180000000,32671327,,0,0,0,,642857,180000000,32671327,PDN
WC409,,1978,1976,,642857,180000000,32671327,,29823,10239144,1851735,,613034,169760856,30819592,PDN
WC409,,1979,1976,,642857,180000000,32671327,,71036,20806909,3773333,,571821,159193091,28897994,PDN
WC409,,1980,1976,,642857,180000000,32671327,,96502,27672218,5020384,,546355,152327782,27650943,PDN
WC409,,1981,1976,,642857,180000000,32671327,,115796,33285712,6038521,,527061,146714288,26632806,PDN
WC409,,1982,1976,,642857,180000000,32671327,,123662,35781559,6490487,,519195,144218441,26180840,PDN
WC409,,1983,1976,,642857,180000000,32671327,,115577,39238313,7097483,,527280,140761687,25573844,PDN
WC409,,1984,1976,,642857,180000000,32671327,,121656,41796629,7558779,,521201,138203371,25112548,PDN
WC409,,1985,1976,,642857,180000000,32671327,,124525,43196796,7810788,,518332,136803204,24860539,PDN
WC409,,1986,1976,,201404,85049872,15334833,,127066,44593041,8061771,,74338,40456831,7273062,PDN
WC409,,1987,1976,,201404,85049872,15334833,,130569,46924774,8480173,,70835,38125098,6854660,PDN
WC409,,1988,1976,,201404,85049872,15334833,,133976,49014193,8855363,,67428,36035679,6479470,PDN
WC409,,1989,1976,,201404,85049872,15334833,,140682,52401976,9464877,,60722,32647896,5869956,PDN
WC409,,1990,1976,,201404,85049872,15334833,,145145,54839963,9903146,,56259,30209909,5431687,PDN
WC409,,1991,1976,,201404,85049872,15334833,,150936,58356093,10534582,,50468,26693779,4800251,PDN
WC409,,1992,1976,,164584,68302140,12317990,,153455,60364029,10894385,,11129,7938111,1423605,PDN
WC409,,1993,1976,,164584,68302140,12317990,,156193,62151833,11215238,,8391,6150307,1102752,PDN
WC409,,1994,1976,,164584,68302140,12317990,,157905,63659498,11485218,,6679,4642642,832772,PDN
WC409,,1995,1976,,164584,68302140,12317990,,159434,64890632,11705810,,5150,3411508,612180,PDN
WC409,,1996,1976,,164583,68302140,12317989,,162237,65828055,11875414,,2346,2474085,442575,PDN
WC409,,1997,1976,,257000,70353962,12775499,,167138,66335971,11970692,,89862,4017991,804807,PDN
WC409,,1998,1976,,537693,68731337,12767468,,262979,67313642,12240495,,274714,1417695,526973,PDN
WC409,,1999,1976,,541561,70576562,13099668,,297411,68001003,12397234,,244150,2575559,702434,PDN
WC409,,2000,1976,,377737,71740385,13142930,,315680,69442369,12671973,,62057,2298016,470957,PDN
WC409,,2001,1976,,337719,71630860,13083424,,320890,70272720,12824933,,16829,1358140,258491,PDN
WC409,,2002,1976,,337719,71630860,13083424,,322290,70472992,12861968,,15429,1157868,221456,PDN
WC409,,2003,1976,,332706,71624650,13077306,,329518,70648539,12900432,,3188,976111,176874,PDN
WC409,,2004,1976,,329926,70656755,12902302,,329926,70656755,12902302,,0,0,0,PDN
WC409,,2005,1976,,329926,70656755,12902302,,329926,70656755,12902302,,0,0,0,PDN
WC409,,2006,1976,,329926,70656755,12902302,,329926,70656755,12902302,,0,0,0,PDN
WC409,,2007,1976,,329926,70656755,12902302,,329926,70656755,12902302,,0,0,0,PDN
WC409,,2008,1976,,329926,70656755,12902302,,329926,70656755,12902302,,0,0,0,PDN
WC409,,2009,1976,,329926,72000916,13141478,,329926,72000916,13141478,,0,0,0,PDN
WC409,,2010,1976,,329926,72000916,13141478,,329926,72000916,13141478,,0,0,0,PDN
WC409,,2011,1976,,329926,72000916,13141478,,329926,72000916,13141478,,0,0,0,PDN
WC409,,2012,1976,,329926,72000916,13141478,,329926,72000916,13141478,,0,0,0,PDN
WC409,,2013,1976,,329926,72000916,13141478,,329926,72000916,13141478,,0,0,0,PDN
WC409,,2014,1976,,329926,72000916,13141478,,329926,72000916,13141478,,0,0,0,PDN
WC409,,2015,1976,,329926,72000916,13141478,,329926,72000916,13141478,,0,0,0,PDN
WC409,,2016,1976,,329926,72000916,13141478,,329926,72000916,13141478,,0,0,0,PDN
WC409,,2017,1976,,329926,72000916,13141478,,329926,72000916,13141478,,0,0,0,PDN
WC409,,2017,1976,,329926,72000916,13141478,,329926,72000916,13141478,,0,0,0,PDN
WC414,,1986,1975,,7349,1469834,268885,,0,0,0,,7349,1469834,268885,PDN
WC414,,1987,1975,,3640,3639681,651270,,0,0,0,,3640,3639681,651270,PDN
WC414,,1988,1975,,3640,3639681,651270,,0,0,0,,3640,3639681,651270,PDN
WC414,,1989,1975,,3640,3639681,651270,,19,1024189,182259,,3621,2615492,469011,PDN
WC414,,1990,1975,,3640,3639681,651270,,26,1785161,317670,,3614,1854520,333600,PDN
WC414,,1991,1975,,14997,5116104,925336,,41,2868982,510536,,14956,2247122,414800,PDN
WC414,,1992,1975,,714,11273435,2006663,,148,4183619,744564,,566,7089816,1262099,PDN
WC414,,1993,1975,,714,11273435,2006663,,148,4655872,828595,,566,6617563,1178068,PDN
WC414,,1994,1975,,4278,11629816,2073640,,148,4918293,875289,,4130,6711523,1198351,PDN
WC414,,1995,1975,,6355,8149329,1456414,,148,5357680,953472,,6207,2791649,502942,PDN
WC414,,1996,1975,,203,9540728,1697841,,159,6416472,1141880,,44,3124256,555961,PDN
WC414,,1997,1975,,2231217,19290835,5663750,,169,7266620,1293162,,2231048,12024215,4370588,PDN
WC414,,1998,1975,,1183,19290835,3433716,,180,8564960,1524194,,1003,10725875,1909522,PDN
WC414,,1999,1975,,1153,17553707,3124588,,252,9783107,1741018,,901,7770600,1383570,PDN
WC414,,2000,1975,,898,13975088,2487568,,349,10125964,1802122,,549,3849124,685446,PDN
WC414,,2001,1975,,634,13975088,2487304,,362,10465352,1862524,,272,3509736,624780,PDN
WC414,,2002,1975,,1086,13664578,2432506,,429,10794776,1921208,,657,2869802,511298,PDN
WC414,,2003,1975,,1234,13660677,2431959,,618,10959784,1950758,,616,2700893,481201,PDN
WC414,,2004,1975,,1371,14203350,2528657,,988,11343269,2019363,,383,2860081,509294,PDN
WC414,,2005,1975,,1371,14204137,2528798,,1046,11553175,2056771,,325,2650962,472027,PDN
WC414,,2006,1975,,53285,22093935,3984590,,1046,11567216,2059269,,52239,10526719,1925321,PDN
WC414,,2007,1975,,49592,21724648,3915188,,1046,11567216,2059269,,48546,10157432,1855919,PDN
WC414,,2008,1975,,6952,31245134,5566584,,1191,14482205,2578096,,5761,16762929,2988488,PDN
WC414,,2009,1975,,4279,26747727,4763662,,1580,16863933,3002282,,2699,9883794,1761381,PDN
WC414,,2010,1975,,4279,29733012,5294852,,3472,19935894,3550786,,807,9797118,1744066,PDN
WC414,,2011,1975,,4009,27203663,4844520,,3517,21490976,3827535,,492,5712687,1016984,PDN
WC414,,2012,1975,,4009,27203663,4844520,,3587,23276386,4145294,,422,3927277,699225,PDN
WC414,,2013,1975,,4009,27203663,4844520,,3601,24081447,4288557,,408,3122216,555962,PDN
WC414,,2014,1975,,4753,27203663,4845264,,3720,24532493,4368932,,1033,2671170,476330,PDN
WC414,,2015,1975,,3720,24577077,4376865,,3720,24577077,4376865,,0,0,0,PDN
WC414,,2016,1975,,3720,24577077,4376865,,3720,24577077,4376865,,0,0,0,PDN
WC414,,2017,1975,,3720,24576361,4376740,,3720,24576361,4376740,,0,0,0,PDN
WC414,,2017,1975,,3720,24576361,4376740,,3720,24576361,4376740,,0,0,0,PDN
WC416,,2002,2002,,2877,5622499,1003322,,0,0,0,,2877,5622499,1003322,PDN
WC416,,2003,2002,,1063,4970615,885514,,899,3367370,600075,,164,1603245,285439,PDN
WC416,,2004,2002,,1174,4789000,853309,,1029,4221583,752200,,145,567417,101109,PDN
WC416,,2005,2002,,1572,6043320,1076896,,1031,4505411,802706,,541,1537909,274190,PDN
WC416,,2006,2002,,1273,6468230,1152204,,1173,5362991,955442,,100,1105239,196762,PDN
WC416,,2007,2002,,1273,6468230,1152204,,1209,5622506,1001655,,64,845724,150549,PDN
WC416,,2008,2002,,1273,6468230,1152204,,1213,5770122,1027925,,60,698108,124279,PDN
WC416,,2009,2002,,1332,5955514,1061032,,1332,5955514,1061032,,0,0,0,PDN
WC416,,2010,2002,,1510,5985883,1066614,,1510,5985883,1066614,,0,0,0,PDN
WC416,,2011,2002,,1510,5985883,1066614,,1510,5985883,1066614,,0,0,0,PDN
WC416,,2012,2002,,1510,5985883,1066614,,1510,5985883,1066614,,0,0,0,PDN
WC416,,2013,2002,,1510,5985883,1066614,,1510,5985883,1066614,,0,0,0,PDN
WC416,,2014,2002,,1510,5985883,1066614,,1510,5985883,1066614,,0,0,0,PDN
WC416,,2015,2002,,1510,5985883,1066614,,1510,5985883,1066614,,0,0,0,PDN
WC416,,2016,2002,,1510,5985883,1066614,,1510,5985883,1066614,,0,0,0,PDN
WC416,,2017,2002,,1510,5985883,1066614,,1510,5985883,1066614,,0,0,0,PDN
WC416,,2017,2002,,1510,5985883,1066614,,1510,5985883,1066614,,0,0,0,PDN
WC417,,2001,2001,,2145,9559836,1703183,,0,0,0,,2145,9559836,1703183,PDN
WC417,,2002,2001,,3690,9973914,1778408,,628,1423486,253917,,3062,8550428,1524491,PDN
WC417,,2003,2001,,2043,3669026,654895,,1966,3129864,558881,,77,539162,96014,PDN
WC417,,2004,2001,,2135,3627218,647547,,1876,3439607,613906,,259,187611,33641,PDN
WC417,,2005,2001,,2443,3852967,688024,,1955,3535234,631000,,488,317733,57024,PDN
WC417,,2006,2001,,2878,3939779,703906,,1940,3645032,650522,,938,294747,53384,PDN
WC417,,2007,2001,,2878,3939779,703906,,1996,3676675,656209,,882,263104,47697,PDN
WC417,,2008,2001,,2878,3939779,703906,,2103,3692496,659131,,775,247283,44775,PDN
WC417,,2009,2001,,2180,3711469,662584,,2170,3711136,662514,,10,333,69,PDN
WC417,,2010,2001,,2180,3711469,662584,,2180,3711469,662584,,0,0,0,PDN
WC417,,2011,2001,,2180,3711469,662584,,2180,3711469,662584,,0,0,0,PDN
WC417,,2012,2001,,2180,3711469,662584,,2180,3711469,662584,,0,0,0,PDN
WC417,,2013,2001,,2180,3711469,662584,,2180,3711469,662584,,0,0,0,PDN
WC417,,2014,2001,,2180,3711469,662584,,2180,3711469,662584,,0,0,0,PDN
WC417,,2015,2001,,2180,3711469,662584,,2180,3711469,662584,,0,0,0,PDN
WC417,,2016,2001,,2180,3711469,662584,,2180,3711469,662584,,0,0,0,PDN
WC417,,2017,2001,,2180,3711469,662584,,2180,3711469,662584,,0,0,0,PDN
WC417,,2017,2001,,2180,3711469,662584,,2180,3711469,662584,,0,0,0,PDN
WC420,,1986,1984,,971,9701106,1727146,,0,0,0,,971,9701106,1727146,PDN
WC420,,1987,1984,,1100,10994162,1957357,,0,1751868,311720,,1100,9242294,1645637,PDN
WC420,,1988,1984,,2807,28061265,4995915,,0,4463445,794207,,2807,23597820,4201708,PDN
WC420,,1989,1984,,7208,32189452,5734868,,700,8165073,1453560,,6508,24024379,4281308,PDN
WC420,,1990,1984,,7208,32189452,5734868,,1464,11267753,2006402,,5744,20921699,3728466,PDN
WC420,,1991,1984,,7156,32189452,5734816,,1680,13013323,2317218,,5476,19176129,3417598,PDN
WC420,,1992,1984,,2474,17679693,3148327,,1797,13759703,2450143,,677,3919990,698184,PDN
WC420,,1993,1984,,2474,17679693,3148327,,1819,14079433,2507056,,655,3600260,641271,PDN
WC420,,1994,1984,,2474,17679693,3148327,,1873,14323297,2550502,,601,3356396,597825,PDN
WC420,,1995,1984,,3731,22197509,3953466,,2038,14677575,2613706,,1693,7519934,1339760,PDN
WC420,,1996,1984,,2403,18881092,3362028,,2141,16334500,2908636,,262,2546592,453392,PDN
WC420,,1997,1984,,2403,18881092,3362028,,2352,17782138,3166433,,51,1098954,195595,PDN
WC420,,1998,1984,,2359,18974364,3378580,,2359,18897163,3364844,,0,77201,13736,PDN
WC420,,1999,1984,,2359,18974364,3378580,,2359,18974364,3378580,,0,0,0,PDN
WC420,,2000,1984,,2359,18974364,3378580,,2359,18974364,3378580,,0,0,0,PDN
WC420,,2001,1984,,2359,18974364,3378580,,2359,18974364,3378580,,0,0,0,PDN
WC420,,2002,1984,,2359,18974364,3378580,,2359,18974364,3378580,,0,0,0,PDN
WC420,,2003,1984,,2359,18974364,3378580,,2359,18974364,3378580,,0,0,0,PDN
WC420,,2004,1984,,2359,18974364,3378580,,2359,18974364,3378580,,0,0,0,PDN
WC420,,2005,1984,,8808,28457811,5072475,,2588,19656010,3500099,,6220,8801801,1572376,PDN
WC420,,2006,1984,,5702,24937084,4442906,,4926,22227751,3960042,,776,2709333,482864,PDN
WC420,,2007,1984,,5702,24937084,4442906,,5093,23205805,4134240,,609,1731279,308666,PDN
WC420,,2008,1984,,5702,24937084,4442906,,5347,23403809,4169726,,355,1533275,273180,PDN
WC420,,2009,1984,,5424,23826401,4244998,,5424,23826401,4244998,,0,0,0,PDN
WC420,,2010,1984,,5424,23826401,4244998,,5424,23826401,4244998,,0,0,0,PDN
WC420,,2011,1984,,5424,23826401,4244998,,5424,23826401,4244998,,0,0,0,PDN
WC420,,2012,1984,,5424,23826401,4244998,,5424,23826401,4244998,,0,0,0,PDN
WC420,,2013,1984,,5424,23826401,4244998,,5424,23826401,4244998,,0,0,0,PDN
WC420,,2014,1984,,5424,23826401,4244998,,5424,23826401,4244998,,0,0,0,PDN
WC420,,2015,1984,,5424,23826401,4244998,,5424,23826401,4244998,,0,0,0,PDN
WC420,,2016,1984,,5424,23826401,4244998,,5424,23826401,4244998,,0,0,0,PDN
WC420,,2017,1984,,5424,23826401,4244998,,5424,23826401,4244998,,0,0,0,PDN
WC420,,2017,1984,,5424,23826401,4244998,,5424,23826401,4244998,,0,0,0,PDN
WC424,,2004,2004,,559,5586963,994681,,0,0,0,,559,5586963,994681,PDN
WC424,,2005,2004,,64,5570335,991227,,0,0,0,,64,5570335,991227,PDN
WC424,,2006,2004,,1832,11909400,2120942,,3,759547,135154,,1829,11149853,1985788,PDN
WC424,,2007,2004,,1832,11909400,2120942,,243,3606933,642046,,1589,8302467,1478896,PDN
WC424,,2008,2004,,1832,11909400,2120942,,483,5021984,894074,,1349,6887416,1226868,PDN
WC424,,2009,2004,,483,7317057,1302450,,483,5071201,902832,,0,2245856,399619,PDN
WC424,,2010,2004,,483,7317057,1302450,,483,6494359,1156063,,0,822698,146388,PDN
WC424,,2011,2004,,483,7317057,1302450,,483,7317057,1302450,,0,0,0,PDN
WC424,,2012,2004,,483,7317057,1302450,,483,7317057,1302450,,0,0,0,PDN
WC424,,2013,2004,,483,7317057,1302450,,483,7317057,1302450,,0,0,0,PDN
WC424,,2014,2004,,483,7317057,1302450,,483,7317057,1302450,,0,0,0,PDN
WC424,,2015,2004,,483,7317057,1302450,,483,7317057,1302450,,0,0,0,PDN
WC424,,2016,2004,,483,7317057,1302450,,483,7317057,1302450,,0,0,0,PDN
WC424,,2017,2004,,483,7317057,1302450,,483,7317057,1302450,,0,0,0,PDN
WC424,,2017,2004,,483,7317057,1302450,,483,7317057,1302450,,0,0,0,PDN
WC425,,1984,1982,,4173,4173304,746754,,0,0,0,,4173,4173304,746754,PDN
WC425,,1985,1982,,4173,4173304,746754,,0,0,0,,4173,4173304,746754,PDN
WC425,,1986,1982,,4173,4173304,746754,,0,0,0,,4173,4173304,746754,PDN
WC425,,1987,1982,,7330,14661198,2616084,,0,0,0,,7330,14661198,2616084,PDN
WC425,,1988,1982,,7330,14661198,2616084,,0,0,0,,7330,14661198,2616084,PDN
WC425,,1995,1982,,1457,14569442,2593884,,65,503982,89742,,1392,14065460,2504142,PDN
WC425,,1996,1982,,715,6035912,1074721,,65,833937,148452,,650,5201975,926269,PDN
WC425,,1997,1982,,715,6035912,1074721,,65,867257,154381,,650,5168655,920340,PDN
WC425,,1998,1982,,65,867665,154454,,65,867665,154454,,0,0,0,PDN
WC425,,1999,1982,,65,867665,154454,,65,867665,154454,,0,0,0,PDN
WC425,,2000,1982,,65,867665,154454,,65,867665,154454,,0,0,0,PDN
WC425,,2001,1982,,65,867665,154454,,65,867665,154454,,0,0,0,PDN
WC425,,2002,1982,,2909,10314912,1838303,,65,867665,154454,,2844,9447247,1683849,PDN
WC425,,2003,1982,,2173,9909234,1765382,,1245,4078502,726957,,928,5830732,1038425,PDN
WC425,,2004,1982,,2191,10747078,1914482,,1245,6207287,1105744,,946,4539791,808738,PDN
WC425,,2005,1982,,2197,10747078,1914488,,1342,6983378,1243936,,855,3763700,670552,PDN
WC425,,2006,1982,,2806,14170488,2524245,,1365,7178011,1278591,,1441,6992477,1245654,PDN
WC425,,2007,1982,,2806,14170488,2524245,,1590,8496313,1513389,,1216,5674175,1010856,PDN
WC425,,2008,1982,,2806,14170488,2524245,,1708,9397824,1673919,,1098,4772664,850326,PDN
WC425,,2009,1982,,1708,9487467,1689869,,1708,9441615,1681711,,0,45852,8159,PDN
WC425,,2010,1982,,1708,9487467,1689869,,1708,9487467,1689869,,0,0,0,PDN
WC425,,2011,1982,,1708,9487467,1689869,,1708,9487467,1689869,,0,0,0,PDN
WC425,,2012,1982,,1708,9487467,1689869,,1708,9487467,1689869,,0,0,0,PDN
WC425,,2013,1982,,1708,9487467,1689869,,1708,9487467,1689869,,0,0,0,PDN
WC425,,2014,1982,,1708,9487467,1689869,,1708,9487467,1689869,,0,0,0,PDN
WC425,,2015,1982,,1708,9487467,1689869,,1708,9487467,1689869,,0,0,0,PDN
WC425,,2016,1982,,1708,9487467,1689869,,1708,9487467,1689869,,0,0,0,PDN
WC425,,2017,1982,,1708,9487467,1689869,,1708,9487467,1689869,,0,0,0,PDN
WC425,,2017,1982,,1708,9487467,1689869,,1708,9487467,1689869,,0,0,0,PDN
WC427,,1979,1977,,18750,18750000,3355049,,0,0,0,,18750,18750000,3355049,PDN
WC427,,1980,1977,,18750,18750000,3355049,,0,0,0,,18750,18750000,3355049,PDN
WC427,,1981,1977,,18750,18750000,3355049,,364,1305823,232717,,18386,17444177,3122332,PDN
WC427,,1982,1977,,5580,5580000,998463,,1727,2967187,529696,,3853,2612813,468767,PDN
WC427,,1983,1977,,5580,5580000,998463,,3189,4068893,727191,,2391,1511107,271272,PDN
WC427,,1984,1977,,5894,8019987,1432938,,3765,5654190,1009849,,2129,2365797,423089,PDN
WC427,,1985,1977,,6136,10580000,1888698,,4258,7429813,1326289,,1878,3150187,562409,PDN
WC427,,1986,1977,,9745,11301761,2020735,,4534,8599882,1534762,,5211,2701879,485973,PDN
WC427,,1987,1977,,6571,13204064,2356049,,4679,9990022,1782263,,1892,3214042,573786,PDN
WC427,,1988,1977,,6525,19647877,3502589,,4832,12375807,2206933,,1693,7272070,1295656,PDN
WC427,,1989,1977,,6525,19647877,3502589,,4872,13849638,2469220,,1653,5798239,1033369,PDN
WC427,,1990,1977,,6021,21701928,3867574,,4926,15631570,2786344,,1095,6070358,1081230,PDN
WC427,,1991,1977,,6352,25016553,4457696,,4977,16955743,3022013,,1375,8060810,1435683,PDN
WC427,,1992,1977,,5024,24837079,4424433,,4987,19010743,3387681,,37,5826336,1036752,PDN
WC427,,1993,1977,,5024,24837079,4424433,,4987,21920780,3905482,,37,2916299,518951,PDN
WC427,,1994,1977,,5024,24837079,4424433,,4987,23772688,4235003,,37,1064391,189430,PDN
WC427,,1995,1977,,6343,30448443,5424215,,5181,24945081,4443808,,1162,5503362,980407,PDN
WC427,,1996,1977,,6279,30365496,5409392,,5356,26870074,4786508,,923,3495422,622884,PDN
WC427,,1997,1977,,10073,42093287,7499982,,5519,28733413,5118226,,4554,13359874,2381756,PDN
WC427,,1998,1977,,8002,40496039,7213703,,6559,32935598,5866986,,1443,7560441,1346717,PDN
WC427,,1999,1977,,8437,47517981,8463594,,6920,37328886,6649071,,1517,10189095,1814523,PDN
WC427,,2000,1977,,8841,53780746,9578369,,7296,43195364,7693304,,1545,10585382,1885065,PDN
WC427,,2001,1977,,9401,56147749,10000104,,8101,48391129,8618622,,1300,7756620,1381482,PDN
WC427,,2002,1977,,10272,57004363,10153397,,9028,51897210,9243407,,1244,5107153,909990,PDN
WC427,,2003,1977,,10407,61688671,10987039,,9535,53628852,9552035,,872,8059819,1435004,PDN
WC427,,2004,1977,,12960,60981951,10863841,,10678,57859095,10305891,,2282,3122856,557950,PDN
WC427,,2005,1977,,12818,65804935,11721881,,12356,60660942,10806118,,462,5143993,915763,PDN
WC427,,2006,1977,,12522,63629065,11334420,,12464,61790925,11007291,,58,1838140,327129,PDN
WC427,,2007,1977,,12522,63631260,11334810,,12478,62255064,11089892,,44,1376196,244918,PDN
WC427,,2008,1977,,12522,63631260,11334810,,12478,62441943,11123144,,44,1189317,211666,PDN
WC427,,2009,1977,,12478,63180240,11254514,,12478,63180240,11254514,,0,0,0,PDN
WC427,,2010,1977,,12478,63180240,11254514,,12478,63180240,11254514,,0,0,0,PDN
WC427,,2011,1977,,12478,63180240,11254514,,12478,63180240,11254514,,0,0,0,PDN
WC427,,2012,1977,,12478,63180240,11254514,,12478,63180240,11254514,,0,0,0,PDN
WC427,,2013,1977,,12478,63180240,11254514,,12478,63180240,11254514,,0,0,0,PDN
WC427,,2014,1977,,12478,63180240,11254514,,12478,63180240,11254514,,0,0,0,PDN
WC427,,2015,1977,,12478,63180240,11254514,,12478,63180240,11254514,,0,0,0,PDN
WC427,,2016,1977,,12478,63180240,11254514,,12478,63180240,11254514,,0,0,0,PDN
WC427,,2017,1977,,12478,63180240,11254514,,12478,63180240,11254514,,0,0,0,PDN
WC427,,2017,1977,,12478,63180240,11254514,,12478,63180240,11254514,,0,0,0,PDN
WC428,,2003,2003,,14466,3314443,604225,,9934,1768841,324674,,4532,1545602,279551,PDN
WC428,,2004,2003,,14015,3245587,591522,,13999,3245496,591489,,16,91,33,PDN
WC428,,2005,2003,,14015,3245587,591522,,14015,3245587,591522,,0,0,0,PDN
WC428,,2006,2003,,14015,3245587,591522,,14015,3245587,591522,,0,0,0,PDN
WC428,,2007,2003,,14018,3251442,592566,,14018,3251442,592566,,0,0,0,PDN
WC428,,2008,2003,,14018,3251442,592566,,14018,3251442,592566,,0,0,0,PDN
WC428,,2009,2003,,14018,3251442,592566,,14018,3251442,592566,,0,0,0,PDN
WC428,,2010,2003,,14018,3251442,592566,,14018,3251442,592566,,0,0,0,PDN
WC428,,2011,2003,,14018,3251442,592566,,14018,3251442,592566,,0,0,0,PDN
WC428,,2012,2003,,14018,3251442,592566,,14018,3251442,592566,,0,0,0,PDN
WC428,,2013,2003,,14018,3251442,592566,,14018,3251442,592566,,0,0,0,PDN
WC428,,2014,2003,,14018,3251442,592566,,14018,3251442,592566,,0,0,0,PDN
WC428,,2015,2003,,14018,3251442,592566,,14018,3251442,592566,,0,0,0,PDN
WC428,,2016,2003,,14018,3251442,592566,,14018,3251442,592566,,0,0,0,PDN
WC428,,2017,2003,,14018,3251442,592566,,14018,3251442,592566,,0,0,0,PDN
WC428,,2017,2003,,14018,3251442,592566,,14018,3251442,592566,,0,0,0,PDN
WC432,,1991,1990,,6327,52734133,9389625,,193,2214519,394236,,6134,50519614,8995389,PDN
WC432,,1992,1990,,6354,52734133,9389652,,285,9246240,1645523,,6069,43487893,7744129,PDN
WC432,,1993,1990,,6464,52734133,9389762,,397,14306435,2546026,,6067,38427698,6843736,PDN
WC432,,1994,1990,,6564,61992794,11037310,,550,17990145,3201643,,6014,44002649,7835667,PDN
WC432,,1995,1990,,6564,61992794,11037310,,570,24425135,4346679,,5994,37567659,6690631,PDN
WC432,,1996,1990,,3062,57396719,10216001,,598,31014723,5519232,,2464,26381996,4696769,PDN
WC432,,1997,1990,,92187,69581593,12473253,,598,33339914,5932967,,91589,36241679,6540286,PDN
WC432,,1998,1990,,92145,69165134,12399108,,9203,38840553,6920333,,82942,30324581,5478775,PDN
WC432,,1999,1990,,95474,54628383,9815827,,16501,45405408,8095755,,78973,9222975,1720072,PDN
WC432,,2000,1990,,91465,52102902,9362444,,17654,46177307,8234257,,73811,5925595,1128187,PDN
WC432,,2001,1990,,17623,46177322,8234228,,17623,46177322,8234228,,0,0,0,PDN
WC432,,2002,1990,,20305,58820024,10486501,,18028,48249270,8603307,,2277,10570754,1883194,PDN
WC432,,2003,1990,,20305,58820024,10486501,,18848,51044801,9101553,,1457,7775223,1384948,PDN
WC432,,2004,1990,,20029,57213090,10200294,,18909,52855549,9423811,,1120,4357541,776483,PDN
WC432,,2005,1990,,20007,62967556,11224198,,18961,54348440,9689502,,1046,8619116,1534696,PDN
WC432,,2006,1990,,21688,76341035,13605502,,19077,56151951,10010527,,2611,20189084,3594975,PDN
WC432,,2007,1990,,50854,82694141,14765114,,19083,58369495,10405114,,31771,24324646,4360000,PDN
WC432,,2008,1990,,50882,84029515,15002753,,19660,61636306,10986974,,31222,22393209,4015779,PDN
WC432,,2009,1990,,19920,69860196,12450560,,19674,65450411,11665655,,246,4409785,784905,PDN
WC432,,2010,1990,,26374,75160027,13400045,,19684,66950311,11932551,,6690,8209716,1467493,PDN
WC432,,2011,1990,,28215,76373062,13617728,,23577,69874701,12456798,,4638,6498361,1160930,PDN
WC432,,2012,1990,,27978,73954980,13187228,,27675,73465942,13099907,,303,489038,87321,PDN
WC432,,2013,1990,,27978,73954980,13187228,,27978,73954980,13187228,,0,0,0,PDN
WC432,,2014,1990,,27978,73954980,13187228,,27978,73954980,13187228,,0,0,0,PDN
WC432,,2015,1990,,27978,73954980,13187228,,27978,73954980,13187228,,0,0,0,PDN
WC432,,2016,1990,,27978,73954980,13187228,,27978,73954980,13187228,,0,0,0,PDN
WC432,,2017,1990,,27978,73954980,13187228,,27978,73954980,13187228,,0,0,0,PDN
WC432,,2017,1990,,27978,73954980,13187228,,27978,73954980,13187228,,0,0,0,PDN
WC436,,1976,1974,,1600000,7200000,2881139,,0,0,0,,1600000,7200000,2881139,PDN
WC436,,1977,1974,,610482,45875780,8773432,,0,0,0,,610482,45875780,8773432,PDN
WC436,,1978,1974,,610482,45875780,8773432,,0,0,0,,610482,45875780,8773432,PDN
WC436,,1979,1974,,1983807,95875780,19043554,,106731,5421206,1071358,,1877076,90454574,17972196,PDN
WC436,,1980,1974,,1504047,112297994,21485896,,222087,21517294,4050787,,1281960,90780700,17435109,PDN
WC436,,1981,1974,,1604647,107525594,20737315,,298203,37162876,6910814,,1306444,70362718,13826501,PDN
WC436,,1982,1974,,1499995,120857314,23004855,,314350,46547369,8596800,,1185645,74309945,14408055,PDN
WC436,,1983,1974,,464433,81178672,14909037,,320380,52460201,9654935,,144053,28718471,5254102,PDN
WC436,,1984,1974,,568469,82361228,15223492,,322974,56614331,10396698,,245495,25746897,4826794,PDN
WC436,,1985,1974,,574539,83515322,15434917,,325981,60511398,11093134,,248558,23003924,4341783,PDN
WC436,,1986,1974,,576664,85215322,15739533,,327386,62419657,11434087,,249278,22795665,4305446,PDN
WC436,,1987,1974,,577497,85715322,15829334,,328190,62992936,11536897,,249307,22722386,4292437,PDN
WC436,,1988,1974,,577497,85715322,15829334,,329537,64017713,11720589,,247960,21697609,4108745,PDN
WC436,,1989,1974,,517314,85392111,15711640,,330084,64286911,11769036,,187230,21105200,3942604,PDN
WC436,,1990,1974,,2366945,105546463,21147454,,330194,64582791,11821794,,2036751,40963672,9325660,PDN
WC436,,1991,1974,,330767,70617376,12896136,,330194,66107792,12093146,,573,4509584,802990,PDN
WC436,,1992,1974,,330767,70617376,12896136,,330194,66509915,12164698,,573,4107461,731438,PDN
WC436,,1993,1974,,330767,70617376,12896136,,330194,66777132,12212246,,573,3840244,683890,PDN
WC436,,1994,1974,,330767,70617376,12896136,,218598,62821212,11396750,,112169,7796164,1499386,PDN
WC436,,1995,1974,,218598,62821212,11396750,,218598,62821212,11396750,,0,0,0,PDN
WC436,,1996,1974,,218598,62821212,11396750,,218598,62821212,11396750,,0,0,0,PDN
WC436,,1997,1974,,218598,62821212,11396750,,218598,62821212,11396750,,0,0,0,PDN
WC436,,1998,1974,,218598,62821212,11396750,,218598,62821212,11396750,,0,0,0,PDN
WC436,,1999,1974,,218598,62821212,11396750,,218598,62821212,11396750,,0,0,0,PDN
WC436,,2000,1974,,218598,62821212,11396750,,218598,62821212,11396750,,0,0,0,PDN
WC436,,2001,1974,,218598,62854264,11402631,,218598,62854264,11402631,,0,0,0,PDN
WC436,,2002,1974,,218598,62854264,11402631,,218598,62854264,11402631,,0,0,0,PDN
WC436,,2003,1974,,218598,62854264,11402631,,218598,62854264,11402631,,0,0,0,PDN
WC436,,2004,1974,,218598,62854264,11402631,,218598,62854264,11402631,,0,0,0,PDN
WC436,,2005,1974,,218598,62854264,11402631,,218598,62854264,11402631,,0,0,0,PDN
WC436,,2006,1974,,218598,62854264,11402631,,218598,62854264,11402631,,0,0,0,PDN
WC436,,2007,1974,,218598,62854264,11402631,,218598,62854264,11402631,,0,0,0,PDN
WC436,,2008,1974,,218598,62854264,11402631,,218598,62854264,11402631,,0,0,0,PDN
WC436,,2009,1974,,218598,64113063,11626617,,218598,64113063,11626617,,0,0,0,PDN
WC436,,2010,1974,,218598,64113063,11626617,,218598,64113063,11626617,,0,0,0,PDN
WC436,,2011,1974,,218598,64113063,11626617,,218598,64113063,11626617,,0,0,0,PDN
WC436,,2012,1974,,218598,64113063,11626617,,218598,64113063,11626617,,0,0,0,PDN
WC436,,2013,1974,,218598,64113063,11626617,,218598,64113063,11626617,,0,0,0,PDN
WC436,,2014,1974,,330194,68283119,12480216,,330194,68283119,12480216,,0,0,0,PDN
WC436,,2015,1974,,330194,68283119,12480216,,330194,68283119,12480216,,0,0,0,PDN
WC436,,2016,1974,,330194,68283119,12480216,,330194,68283119,12480216,,0,0,0,PDN
WC436,,2017,1974,,330194,68283119,12480216,,330194,68283119,12480216,,0,0,0,PDN
WC436,,2017,1974,,330194,68283119,12480216,,330194,68283119,12480216,,0,0,0,PDN
WC442,,2004,2004,,0,185721,33046,,0,0,0,,0,185721,33046,PDN
WC442,,2005,2004,,105,301346,53725,,0,15144,2695,,105,286202,51030,PDN
WC442,,2006,2004,,2374,8678507,1546592,,159,563331,100396,,2215,8115176,1446196,PDN
WC442,,2007,2004,,2374,8678507,1546592,,245,1044351,186073,,2129,7634156,1360519,PDN
WC442,,2008,2004,,2374,8678507,1546592,,532,2512489,447594,,1842,6166018,1098998,PDN
WC442,,2009,2004,,532,2512489,447594,,532,2512489,447594,,0,0,0,PDN
WC442,,2010,2004,,532,2512489,447594,,532,2512489,447594,,0,0,0,PDN
WC442,,2011,2004,,532,2512489,447594,,532,2512489,447594,,0,0,0,PDN
WC442,,2012,2004,,532,2512489,447594,,532,2512489,447594,,0,0,0,PDN
WC442,,2013,2004,,532,2512489,447594,,532,2512489,447594,,0,0,0,PDN
WC442,,2014,2004,,532,2512489,447594,,532,2512489,447594,,0,0,0,PDN
WC442,,2015,2004,,532,2512489,447594,,532,2512489,447594,,0,0,0,PDN
WC442,,2016,2004,,532,2512489,447594,,532,2512489,447594,,0,0,0,PDN
WC442,,2017,2004,,532,2512489,447594,,532,2512489,447594,,0,0,0,PDN
WC442,,2017,2004,,532,2512489,447594,,532,2512489,447594,,0,0,0,PDN
WC459,,1981,1966,,33259,15280850,2752271,,5161,2497455,449548,,28098,12783395,2302723,PDN
WC459,,1982,1966,,30328,17602050,3162365,,19592,10201811,1834861,,10736,7400239,1327504,PDN
WC459,,1983,1966,,69687,40965851,7358984,,28517,17663434,3171477,,41170,23302417,4187507,PDN
WC459,,1984,1966,,74104,43376652,7792369,,32263,21822161,3915210,,41841,21554491,3877159,PDN
WC459,,1985,1966,,108274,43901834,7919988,,51854,23926453,4309230,,56420,19975381,3610758,PDN
WC459,,1986,1966,,133705,49576592,8955163,,74613,28375770,5123682,,59092,21200822,3831481,PDN
WC459,,1987,1966,,187917,52576592,9543182,,102228,32107337,5815277,,85689,20469255,3727905,PDN
WC459,,1988,1966,,269404,84388720,15285190,,106076,33157079,6005912,,163328,51231641,9279278,PDN
WC459,,1989,1966,,185641,123039438,22078779,,112249,51023744,9191207,,73392,72015694,12887572,PDN
WC459,,1990,1966,,197280,152508826,27334082,,121811,68568171,12322553,,75469,83940655,15011529,PDN
WC459,,1991,1966,,146083,93778459,16832642,,127646,76221916,13690265,,18437,17556543,3142377,PDN
WC459,,1992,1966,,146237,94135697,16896361,,130040,82615884,14830375,,16197,11519813,2065986,PDN
WC459,,1993,1966,,147243,94647621,16988457,,131385,86370023,15499716,,15858,8277598,1488741,PDN
WC459,,1994,1966,,254875,105392467,19007983,,131771,86841025,15583911,,123104,18551442,3424072,PDN
WC459,,1995,1966,,133129,94238039,16901463,,131771,90150930,16172862,,1358,4087109,728601,PDN
WC459,,1996,1966,,133098,93422241,16756273,,131909,90323595,16203723,,1189,3098646,552550,PDN
WC459,,1997,1966,,131909,90505279,16236051,,131909,90505279,16236051,,0,0,0,PDN
WC459,,1998,1966,,131909,90505279,16236051,,131909,90505279,16236051,,0,0,0,PDN
WC459,,1999,1966,,131909,90505279,16236051,,131909,90505279,16236051,,0,0,0,PDN
WC459,,2000,1966,,131909,90505279,16236051,,131909,90505279,16236051,,0,0,0,PDN
WC459,,2001,1966,,131909,90505279,16236051,,131909,90505279,16236051,,0,0,0,PDN
WC459,,2002,1966,,147592,97717781,17535098,,145793,95222495,17089297,,1799,2495286,445801,PDN
WC459,,2003,1966,,147592,97717781,17535098,,146588,95964077,17222047,,1004,1753704,313051,PDN
WC459,,2004,1966,,152187,107606593,19299268,,149035,100031224,17948185,,3152,7575369,1351083,PDN
WC459,,2005,1966,,167555,106720377,19156946,,149293,103116726,18497465,,18262,3603651,659481,PDN
WC459,,2006,1966,,150912,104219801,18695361,,150569,103769897,18614963,,343,449904,80398,PDN
WC459,,2007,1966,,150912,104219801,18695361,,150882,103887177,18636145,,30,332624,59216,PDN
WC459,,2008,1966,,150912,104219801,18695361,,150882,103912749,18640695,,30,307052,54666,PDN
WC459,,2009,1966,,150882,105725314,18963213,,150882,105725314,18963213,,0,0,0,PDN
WC459,,2010,1966,,150882,105725314,18963213,,150882,105725314,18963213,,0,0,0,PDN
WC459,,2011,1966,,150882,105725314,18963213,,150882,105725314,18963213,,0,0,0,PDN
WC459,,2012,1966,,150882,105725314,18963213,,150882,105725314,18963213,,0,0,0,PDN
WC459,,2013,1966,,150882,105725314,18963213,,150882,105725314,18963213,,0,0,0,PDN
WC459,,2014,1966,,150882,105725314,18963213,,150882,105725314,18963213,,0,0,0,PDN
WC459,,2015,1966,,150882,105725314,18963213,,150882,105725314,18963213,,0,0,0,PDN
WC459,,2016,1966,,150882,105725314,18963213,,150882,105725314,18963213,,0,0,0,PDN
WC459,,2017,1966,,150882,105725314,18963213,,150882,105725314,18963213,,0,0,0,PDN
WC459,,2017,1966,,150882,105725314,18963213,,150882,105725314,18963213,,0,0,0,PDN
WC464,,1979,1974,,4600,4600000,823105,,0,0,0,,4600,4600000,823105,PDN
WC464,,1980,1974,,4600,4600000,823105,,0,0,0,,4600,4600000,823105,PDN
WC464,,1981,1974,,4600,4600000,823105,,0,0,0,,4600,4600000,823105,PDN
WC464,,1982,1974,,4600,4600000,823105,,782,1322290,236065,,3818,3277710,587040,PDN
WC464,,1983,1974,,13500,25122000,4483607,,5050,12001051,2140468,,8450,13120949,2343139,PDN
WC464,,1984,1974,,16687,40371414,7200213,,6990,20562319,3665766,,9697,19809095,3534447,PDN
WC464,,1985,1974,,14085,68406248,12186015,,8376,32163132,5731353,,5709,36243116,6454662,PDN
WC464,,1986,1974,,14085,68406248,12186015,,9306,40516901,7218719,,4779,27889347,4967296,PDN
WC464,,1987,1974,,14982,74720957,13310526,,9780,48573077,8652676,,5202,26147880,4657850,PDN
WC464,,1988,1974,,21473,82871142,14767228,,10277,54886170,9776499,,11196,27984972,4990729,PDN
WC464,,1989,1974,,22008,90732529,16166586,,10588,60045769,10694889,,11420,30686760,5471697,PDN
WC464,,1990,1974,,22173,91828717,16361802,,10740,63022153,11224646,,11433,28806564,5137156,PDN
WC464,,1991,1974,,12146,81869507,14579674,,11063,66684588,11876648,,1083,15184919,2703026,PDN
WC464,,1992,1974,,12069,83864737,14934620,,11077,69874383,12444241,,992,13990354,2490379,PDN
WC464,,1993,1974,,12069,83864737,14934620,,11077,73829682,13148031,,992,10035055,1786589,PDN
WC464,,1994,1974,,13000,89666354,15967867,,11077,75811377,13500646,,1923,13854977,2467221,PDN
WC464,,1995,1974,,12741,84152499,14986495,,11077,76794486,13675576,,1664,7358013,1310919,PDN
WC464,,1996,1974,,13322,84931711,15125726,,11077,77299737,13765479,,2245,7631974,1360247,PDN
WC464,,1997,1974,,13322,84931711,15125726,,11077,77805983,13855558,,2245,7125728,1270168,PDN
WC464,,1998,1974,,13322,84931711,15125726,,11077,78190125,13923911,,2245,6741586,1201815,PDN
WC464,,1999,1974,,13322,84931711,15125726,,11077,78601785,13997160,,2245,6329926,1128566,PDN
WC464,,2000,1974,,12741,84309981,15014517,,11077,78888213,14048126,,1664,5421768,966391,PDN
WC464,,2001,1974,,11481,84613031,15067180,,11206,80012927,14248382,,275,4600104,818798,PDN
WC464,,2002,1974,,11481,84613031,15067180,,11280,81057467,14434317,,201,3555564,632863,PDN
WC464,,2003,1974,,11481,84613031,15067180,,11281,81083359,14438925,,200,3529672,628255,PDN
WC464,,2004,1974,,11481,84613031,15067180,,11281,81083359,14438925,,200,3529672,628255,PDN
WC464,,2005,1974,,11281,81083359,14438925,,11281,81083359,14438925,,0,0,0,PDN
WC464,,2006,1974,,11281,81083359,14438925,,11281,81083359,14438925,,0,0,0,PDN
WC464,,2007,1974,,11281,81083359,14438925,,11281,81083359,14438925,,0,0,0,PDN
WC464,,2008,1974,,11281,81083359,14438925,,11281,81083359,14438925,,0,0,0,PDN
WC464,,2009,1974,,11281,82646959,14717145,,11281,82646959,14717145,,0,0,0,PDN
WC464,,2010,1974,,11281,82646959,14717145,,11281,82646959,14717145,,0,0,0,PDN
WC464,,2011,1974,,11281,82646959,14717145,,11281,82646959,14717145,,0,0,0,PDN
WC464,,2012,1974,,11281,82646959,14717145,,11281,82646959,14717145,,0,0,0,PDN
WC464,,2013,1974,,11281,82646959,14717145,,11281,82646959,14717145,,0,0,0,PDN
WC464,,2014,1974,,11281,82646959,14717145,,11281,82646959,14717145,,0,0,0,PDN
WC464,,2015,1974,,11281,82646959,14717145,,11281,82646959,14717145,,0,0,0,PDN
WC464,,2016,1974,,11281,82646959,14717145,,11281,82646959,14717145,,0,0,0,PDN
WC464,,2017,1974,,11281,82646959,14717145,,11281,82646959,14717145,,0,0,0,PDN
WC464,,2017,1974,,11281,82646959,14717145,,11281,82646959,14717145,,0,0,0,PDN
WC472,,1990,1981,,1821,18213308,3242623,,0,950357,169103,,1821,17262951,3073520,PDN
WC472,,1991,1981,,1821,56912869,10128666,,0,7299102,1298773,,1821,49613767,8829893,PDN
WC472,,1992,1981,,0,8643848,1538051,,0,8643848,1538051,,0,0,0,PDN
WC472,,1993,1981,,0,8643848,1538051,,0,8643848,1538051,,0,0,0,PDN
WC472,,1994,1981,,0,8643848,1538051,,0,8643848,1538051,,0,0,0,PDN
WC472,,1995,1981,,0,8643848,1538051,,0,8643848,1538051,,0,0,0,PDN
WC472,,1996,1981,,8849,19076060,3403166,,954,9591476,1707622,,7895,9484584,1695544,PDN
WC472,,1997,1981,,8849,19076060,3403166,,2514,11951291,2129078,,6335,7124769,1274088,PDN
WC472,,1998,1981,,8849,19076060,3403166,,3657,12984172,2314008,,5192,6091888,1089158,PDN
WC472,,1999,1981,,8849,19076060,3403166,,4745,13657068,2434828,,4104,5418992,968338,PDN
WC472,,2000,1981,,8849,19076060,3403166,,5521,14155269,2524252,,3328,4920791,878914,PDN
WC472,,2001,1981,,7806,15794008,2818128,,5977,14482320,2582902,,1829,1311688,235226,PDN
WC472,,2002,1981,,7806,15794008,2818128,,6251,14612036,2606257,,1555,1181972,211871,PDN
WC472,,2003,1981,,11106,18240475,3256742,,6437,14782163,2636715,,4669,3458312,620027,PDN
WC472,,2004,1981,,8435,16311243,2910791,,7373,15744556,2808895,,1062,566687,101896,PDN
WC472,,2005,1981,,8701,16421669,2930706,,8114,16038732,2861981,,587,382937,68725,PDN
WC472,,2006,1981,,8293,16132643,2878870,,8293,16132643,2878870,,0,0,0,PDN
WC472,,2007,1981,,8293,16132643,2878870,,8293,16132643,2878870,,0,0,0,PDN
WC472,,2008,1981,,8293,16132643,2878870,,8293,16132643,2878870,,0,0,0,PDN
WC472,,2009,1981,,8293,16386612,2924061,,8293,16386612,2924061,,0,0,0,PDN
WC472,,2010,1981,,8293,16386612,2924061,,8293,16386612,2924061,,0,0,0,PDN
WC472,,2011,1981,,8293,16386612,2924061,,8293,16386612,2924061,,0,0,0,PDN
WC472,,2012,1981,,8293,16386612,2924061,,8293,16386612,2924061,,0,0,0,PDN
WC472,,2013,1981,,8293,16386612,2924061,,8293,16386612,2924061,,0,0,0,PDN
WC472,,2014,1981,,8293,16386612,2924061,,8293,16386612,2924061,,0,0,0,PDN
WC472,,2015,1981,,8293,16386612,2924061,,8293,16386612,2924061,,0,0,0,PDN
WC472,,2016,1981,,8293,16386612,2924061,,8293,16386612,2924061,,0,0,0,PDN
WC472,,2017,1981,,8293,16386612,2924061,,8293,16386612,2924061,,0,0,0,PDN
WC472,,2017,1981,,8293,16386612,2924061,,8293,16386612,2924061,,0,0,0,PDN
WC480,,1975,1973,,0,74504424,13257015,,0,0,0,,0,74504424,13257015,PDN
WC480,,1976,1973,,0,74504424,13257015,,329,960829,171295,,-329,73543595,13085720,PDN
WC480,,1977,1973,,120529,120531302,21567380,,17234,32500681,5800273,,103295,88030621,15767107,PDN
WC480,,1978,1973,,139024,132414498,23700323,,24910,58625245,10456448,,114114,73789253,13243875,PDN
WC480,,1979,1973,,139024,132414498,23700323,,28020,72836049,12988171,,111004,59578449,10712152,PDN
WC480,,1980,1973,,235974,229364498,41048162,,102319,99375919,17784867,,133655,129988579,23263295,PDN
WC480,,1981,1973,,474447,244304498,43944998,,186006,135714784,24334544,,288441,108589714,19610454,PDN
WC480,,1982,1973,,471197,248954498,44769150,,214480,157833977,28298818,,256717,91120521,16470332,PDN
WC480,,1983,1973,,477516,252113851,45337632,,226280,168288010,30170766,,251236,83825841,15166866,PDN
WC480,,1984,1973,,430260,263817574,47372889,,231770,176946263,31716870,,198490,86871311,15656019,PDN
WC480,,1985,1973,,375950,264234671,47392795,,234247,179957613,32255175,,141703,84277058,15137620,PDN
WC480,,1986,1973,,375950,264234671,47392795,,237693,183617684,32909879,,138257,80616987,14482916,PDN
WC480,,1987,1973,,383386,264234671,47400231,,239480,185788116,33297864,,143906,78446555,14102367,PDN
WC480,,1988,1973,,298734,211428169,37919405,,242021,187675399,33636220,,56713,23752770,4283185,PDN
WC480,,1989,1973,,296405,216519208,38822954,,244904,189410507,33947841,,51501,27108701,4875113,PDN
WC480,,1990,1973,,294009,215216671,38588790,,246208,190665605,34172472,,47801,24551066,4416318,PDN
WC480,,1991,1973,,246833,191237771,34274906,,246833,191237771,34274906,,0,0,0,PDN
WC480,,1992,1973,,246833,191237771,34274906,,246833,191237771,34274906,,0,0,0,PDN
WC480,,1993,1973,,246833,191237771,34274906,,246833,191237771,34274906,,0,0,0,PDN
WC480,,1994,1973,,246833,191237771,34274906,,246833,191237771,34274906,,0,0,0,PDN
WC480,,1995,1973,,246833,191237771,34274906,,246833,191237771,34274906,,0,0,0,PDN
WC480,,1996,1973,,246833,191237771,34274906,,246833,191237771,34274906,,0,0,0,PDN
WC480,,1997,1973,,260272,218917286,39213526,,249776,196352568,35187955,,10496,22564718,4025571,PDN
WC480,,1998,1973,,260272,218917286,39213526,,253940,201904757,36180053,,6332,17012529,3033473,PDN
WC480,,1999,1973,,255492,205927246,36897351,,254500,203683827,36497174,,992,2243419,400177,PDN
WC480,,2000,1973,,255162,206518343,37002198,,254714,204442784,36632434,,448,2075559,369764,PDN
WC480,,2001,1973,,255767,207697778,37212667,,255141,206362553,36974456,,626,1335225,238211,PDN
WC480,,2002,1973,,255767,207697778,37212667,,255141,206942403,37077633,,626,755375,135034,PDN
WC480,,2003,1973,,255533,209481405,37529804,,255210,207506277,37178035,,323,1975128,351769,PDN
WC480,,2004,1973,,255473,209802404,37586862,,255373,208973158,37439209,,100,829246,147653,PDN
WC480,,2005,1973,,255401,209479820,37529390,,255391,209334833,37503582,,10,144987,25808,PDN
WC480,,2006,1973,,255401,209488636,37530959,,255401,209488636,37530959,,0,0,0,PDN
WC480,,2007,1973,,263126,250184649,44779968,,251975,208324924,37320467,,11151,41859725,7459501,PDN
WC480,,2008,1973,,263125,250157633,44775160,,251974,208775911,37400713,,11151,41381722,7374447,PDN
WC480,,2009,1973,,259500,219476803,39312314,,254314,215454189,38591360,,5186,4022614,720954,PDN
WC480,,2010,1973,,264215,221668163,39706950,,255918,217126770,38890577,,8297,4541393,816374,PDN
WC480,,2011,1973,,282157,228196781,40886568,,258674,219782033,39365799,,23483,8414748,1520769,PDN
WC480,,2012,1973,,282157,228196781,40886568,,260103,221238694,39626420,,22054,6958087,1260148,PDN
WC480,,2013,1973,,282157,228196781,40886568,,260103,221238694,39626420,,22054,6958087,1260148,PDN
WC480,,2014,1973,,281690,228073584,40864180,,260384,221978690,39758373,,21306,6094894,1105807,PDN
WC480,,2015,1973,,281663,228723694,40979831,,261305,222261208,39809564,,20358,6462486,1170267,PDN
WC480,,2016,1973,,261305,222261892,39809686,,261305,222261892,39809686,,0,0,0,PDN
WC480,,2017,1973,,261305,222261892,39809686,,261305,222261892,39809686,,0,0,0,PDN
WC480,,2017,1973,,261305,222261892,39809686,,261305,222261892,39809686,,0,0,0,PDN
WC489,,2003,2003,,0,12238479,2177665,,0,0,0,,0,12238479,2177665,PDN
WC489,,2004,2003,,0,8693308,1546852,,0,1504159,267644,,0,7189149,1279208,PDN
WC489,,2005,2003,,0,7595770,1351560,,0,2321186,413022,,0,5274584,938538,PDN
WC489,,2006,2003,,69,3058452,544278,,0,2815186,500923,,69,243266,43355,PDN
WC489,,2007,2003,,69,3058452,544278,,69,3058452,544278,,0,0,0,PDN
WC489,,2008,2003,,69,3058452,544278,,69,3058452,544278,,0,0,0,PDN
WC489,,2009,2003,,69,3058452,544278,,69,3058452,544278,,0,0,0,PDN
WC489,,2010,2003,,69,3058452,544278,,69,3058452,544278,,0,0,0,PDN
WC489,,2011,2003,,69,3058452,544278,,69,3058452,544278,,0,0,0,PDN
WC489,,2012,2003,,69,3058452,544278,,69,3058452,544278,,0,0,0,PDN
WC489,,2013,2003,,69,3058452,544278,,69,3058452,544278,,0,0,0,PDN
WC489,,2014,2003,,69,3058452,544278,,69,3058452,544278,,0,0,0,PDN
WC489,,2015,2003,,69,3058452,544278,,69,3058452,544278,,0,0,0,PDN
WC489,,2016,2003,,69,3058452,544278,,69,3058452,544278,,0,0,0,PDN
WC489,,2017,2003,,69,3058452,544278,,69,3058452,544278,,0,0,0,PDN
WC489,,2017,2003,,69,3058452,544278,,69,3058452,544278,,0,0,0,PDN
WC491,,1993,1990,,127531,12753052,2396757,,404,231094,41524,,127127,12521958,2355233,PDN
WC491,,1994,1990,,127531,12753052,2396757,,1849,939583,169035,,125682,11813469,2227722,PDN
WC491,,1995,1990,,114528,11796407,2213533,,3516,2190605,393303,,111012,9605802,1820230,PDN
WC491,,1996,1990,,57295,14659529,2665752,,5692,5305544,949739,,51603,9353985,1716013,PDN
WC491,,1997,1990,,28363,12608003,2271780,,6098,9767583,1744102,,22265,2840420,527678,PDN
WC491,,1998,1990,,6134,10577470,1888246,,6134,10577470,1888246,,0,0,0,PDN
WC491,,1999,1990,,6134,10577470,1888246,,6134,10577470,1888246,,0,0,0,PDN
WC491,,2000,1990,,6134,10577470,1888246,,6134,10577470,1888246,,0,0,0,PDN
WC491,,2001,1990,,6134,10577470,1888246,,6134,10577470,1888246,,0,0,0,PDN
WC491,,2002,1990,,6134,10577470,1888246,,6134,10577470,1888246,,0,0,0,PDN
WC491,,2003,1990,,6134,10577470,1888246,,6134,10577470,1888246,,0,0,0,PDN
WC491,,2004,1990,,6134,10577470,1888246,,6134,10577470,1888246,,0,0,0,PDN
WC491,,2005,1990,,6134,10577470,1888246,,6134,10577470,1888246,,0,0,0,PDN
WC491,,2006,1990,,6134,10577470,1888246,,6134,10577470,1888246,,0,0,0,PDN
WC491,,2007,1990,,6134,10577470,1888246,,6134,10577470,1888246,,0,0,0,PDN
WC491,,2008,1990,,6134,10577470,1888246,,6134,10577470,1888246,,0,0,0,PDN
WC491,,2009,1990,,6134,10788979,1925882,,6134,10788979,1925882,,0,0,0,PDN
WC491,,2010,1990,,6134,10788979,1925882,,6134,10788979,1925882,,0,0,0,PDN
WC491,,2011,1990,,6134,10788979,1925882,,6134,10788979,1925882,,0,0,0,PDN
WC491,,2012,1990,,6134,10788979,1925882,,6134,10788979,1925882,,0,0,0,PDN
WC491,,2013,1990,,6134,10788979,1925882,,6134,10788979,1925882,,0,0,0,PDN
WC491,,2014,1990,,6134,10788979,1925882,,6134,10788979,1925882,,0,0,0,PDN
WC491,,2015,1990,,6134,10788979,1925882,,6134,10788979,1925882,,0,0,0,PDN
WC491,,2016,1990,,6134,10788979,1925882,,6134,10788979,1925882,,0,0,0,PDN
WC491,,2017,1990,,6134,10788979,1925882,,6134,10788979,1925882,,0,0,0,PDN
WC491,,2017,1990,,6134,10788979,1925882,,6134,10788979,1925882,,0,0,0,PDN
WC492,,1985,1983,,9260,926033,174035,,0,0,0,,9260,926033,174035,PDN
WC492,,1998,1983,,295069,7761186,1676063,,0,0,0,,295069,7761186,1676063,PDN
WC492,,1999,1983,,297383,8986296,1896368,,0,0,0,,297383,8986296,1896368,PDN
WC492,,2000,1983,,287304,7662836,1650798,,2362,435063,79775,,284942,7227773,1571023,PDN
WC492,,2001,1983,,251873,4471489,1047511,,2819,724206,131681,,249054,3747283,915830,PDN
WC492,,2002,1983,,249787,3613127,892692,,2819,780768,141746,,246968,2832359,750946,PDN
WC492,,2003,1983,,249787,3613127,892692,,2819,817223,148232,,246968,2795904,744460,PDN
WC492,,2004,1983,,250880,3648249,900035,,3316,866864,157562,,247564,2781385,742473,PDN
WC492,,2005,1983,,248570,3354843,845517,,4261,931915,170082,,244309,2422928,675435,PDN
WC492,,2006,1983,,247191,3184349,813801,,4261,931915,170082,,242930,2252434,643719,PDN
WC492,,2007,1983,,247191,3164798,810322,,4261,912364,166603,,242930,2252434,643719,PDN
WC492,,2008,1983,,4261,912364,166603,,4261,912364,166603,,0,0,0,PDN
WC492,,2009,1983,,4261,912364,166603,,4261,912364,166603,,0,0,0,PDN
WC492,,2010,1983,,4261,912364,166603,,4261,912364,166603,,0,0,0,PDN
WC492,,2011,1983,,4261,912364,166603,,4261,912364,166603,,0,0,0,PDN
WC492,,2012,1983,,4261,912364,166603,,4261,912364,166603,,0,0,0,PDN
WC492,,2013,1983,,4261,912364,166603,,4261,912364,166603,,0,0,0,PDN
WC492,,2014,1983,,4261,912364,166603,,4261,912364,166603,,0,0,0,PDN
WC492,,2015,1983,,4261,912364,166603,,4261,912364,166603,,0,0,0,PDN
WC492,,2016,1983,,4261,912364,166603,,4261,912364,166603,,0,0,0,PDN
WC492,,2017,1983,,4261,912364,166603,,4261,912364,166603,,0,0,0,PDN
WC492,,2017,1983,,4261,912364,166603,,4261,912364,166603,,0,0,0,PDN
WC498,,1979,1977,,22500,22500000,4026059,,0,0,0,,22500,22500000,4026059,PDP
WC498,,1980,1977,,22500,22500000,4026059,,1205,2991811,533556,,21295,19508189,3492503,PDP
WC498,,1981,1977,,696667,146300000,26728695,,166960,35623268,6505620,,529707,110676732,20223075,PDP
WC498,,1982,1977,,503479,144056318,26136276,,269927,59321811,10825409,,233552,84734507,15310867,PDP
WC498,,1983,1977,,507040,144056318,26139837,,280330,78286487,14210310,,226710,65769831,11929527,PDP
WC498,,1984,1977,,509056,152944057,27723301,,285898,93677082,16954418,,223158,59266975,10768883,PDP
WC498,,1985,1977,,512213,169691080,30706355,,288817,106459799,19231842,,223396,63231281,11474513,PDP
WC498,,1986,1977,,512213,171691080,31062227,,190342,112546042,20216328,,321871,59145038,10845899,PDP
WC498,,1987,1977,,512213,171691080,31062227,,68943,115175036,20562722,,443270,56516044,10499505,PDP
WC498,,1988,1977,,128477,166985188,29841144,,69047,118368334,21131028,,59430,48616854,8710116,PDP
WC498,,1989,1977,,122097,175139106,31285639,,69056,119211528,21281072,,53041,55927578,10004567,PDP
WC498,,1990,1977,,125045,181828768,32478918,,69064,122429879,21853740,,55981,59398889,10625178,PDP
WC498,,1991,1977,,69073,140202715,25016175,,69064,126604564,22596566,,9,13598151,2419609,PDP
WC498,,1992,1977,,69073,140202715,25016175,,69064,128736525,22975919,,9,11466190,2040256,PDP
WC498,,1993,1977,,91987,142494090,25446807,,69064,129588773,23127565,,22923,12905317,2319242,PDP
WC498,,1994,1977,,91986,142494090,25446806,,69064,129588773,23127565,,22922,12905317,2319241,PDP
WC498,,1995,1977,,91986,138151460,24674096,,69064,129588773,23127565,,22922,8562687,1546531,PDP
WC498,,1996,1977,,71670,130891836,23362032,,69064,129588773,23127565,,2606,1303063,234467,PDP
WC498,,1997,1977,,8017554,177427271,39588243,,73769,130192541,23239702,,7943785,47234730,16348541,PDP
WC498,,1998,1977,,8924242,173280392,39757052,,2369870,139999274,27280773,,6554372,33281118,12476279,PDP
WC498,,1999,1977,,7462160,166389419,37068818,,3267162,145444302,29146931,,4194998,20945117,7921887,PDP
WC498,,2000,1977,,8410927,188405030,41934954,,4591653,150032927,31287903,,3819274,38372103,10647051,PDP
WC498,,2001,1977,,8269091,182924802,40817988,,6012618,159582907,34408153,,2256473,23341895,6409835,PDP
WC498,,2002,1977,,8808436,177584207,40407049,,6615280,164319965,35853708,,2193156,13264242,4553341,PDP
WC498,,2003,1977,,8617663,178220036,40329413,,7028057,168956346,37091464,,1589606,9263690,3237949,PDP
WC498,,2004,1977,,8389456,176033582,39712157,,7423634,168962091,37488063,,965822,7071491,2224094,PDP
WC498,,2005,1977,,9576142,192500988,43828987,,7829008,171907200,38417478,,1747134,20593788,5411509,PDP
WC498,,2006,1977,,9076776,187950980,42520011,,8057375,173911244,39002436,,1019401,14039736,3517575,PDP
WC498,,2007,1977,,9154096,188346584,42667723,,7963315,172990373,38744520,,1190781,15356211,3923203,PDP
WC498,,2008,1977,,9276465,188232906,42769865,,8441167,177937353,40102618,,835298,10295553,2667247,PDP
WC498,,2009,1977,,9318639,185204980,42273261,,8628285,181448438,40914483,,690354,3756542,1358778,PDP
WC498,,2010,1977,,9318639,185204980,42273261,,8754379,181873528,41116218,,564260,3331452,1157044,PDP
WC498,,2011,1977,,9318639,185204980,42273261,,8843629,182276383,41277150,,475010,2928597,996111,PDP
WC498,,2012,1977,,9286712,185129673,42227935,,8918544,182445226,41382109,,368168,2684447,845826,PDP
WC498,,2013,1977,,9286712,185129673,42227935,,8988276,182618692,41482705,,298436,2510981,745229,PDP
WC498,,2014,1977,,9372803,185548942,42388628,,9054279,182788305,41578889,,318524,2760637,809740,PDP
WC498,,2015,1977,,9372803,185548942,42388628,,9115129,182955530,41669495,,257674,2593412,719135,PDP
WC498,,2016,1977,,9408383,186229834,42545362,,9167480,183106429,41748696,,240903,3123405,796669,PDP
WC498,,2017,1977,,9408383,186229834,42545362,,9204297,183228096,41807162,,204086,3001738,738203,PDP
WC498,,2017,1977,,9408383,186229834,42545362,,9204297,183228096,41807162,,204086,3001738,738203,PDP
WC504,,1975,1971,,608307,221749265,40065472,,0,570809,101567,,608307,221178456,39963905,PDN
WC504,,1976,1971,,608307,221749265,40065472,,13364,12172916,2179363,,594943,209576349,37886109,PDN
WC504,,1977,1971,,668571,90826025,16829785,,138222,22788997,4193204,,530349,68037028,12636581,PDN
WC504,,1978,1971,,668046,90920435,16846059,,197086,29020686,5360909,,470960,61899749,11485150,PDN
WC504,,1979,1971,,667046,90920435,16845059,,205824,30345786,5605430,,461222,60574649,11239629,PDN
WC504,,1980,1971,,668865,90826485,16830161,,207014,30786980,5685124,,461851,60039505,11145037,PDN
WC504,,1981,1971,,940692,111266485,20738999,,238214,36233361,6685431,,702478,75033124,14053568,PDN
WC504,,1982,1971,,772208,111324485,20580835,,298929,33913151,6333298,,473279,77411334,14247537,PDN
WC504,,1983,1971,,1067442,119105867,22260657,,351442,37763224,7070877,,716000,81342643,15189780,PDN
WC504,,1984,1971,,1077154,122172529,22816038,,340836,40876725,7614275,,736318,81295804,15201763,PDN
WC504,,1985,1971,,1076045,123402530,23033791,,345883,43054374,8006804,,730162,80348156,15026987,PDN
WC504,,1986,1971,,579972,76539824,14199158,,346847,44743838,8308384,,233125,31795986,5890774,PDN
WC504,,1987,1971,,395131,65977779,12134949,,348666,46251374,8578448,,46465,19726405,3556501,PDN
WC504,,1988,1971,,370189,61102893,11242590,,351681,48950702,9061770,,18508,12152191,2180820,PDN
WC504,,1989,1971,,370372,63764027,11716284,,354693,52522444,9700324,,15679,11241583,2015960,PDN
WC504,,1990,1971,,372869,63764027,11718781,,359456,55740261,10277652,,13413,8023766,1441129,PDN
WC504,,1991,1971,,366706,61834184,11369230,,360848,57291938,10555143,,5858,4542246,814087,PDN
WC504,,1992,1971,,369783,70555746,12924186,,362653,59796613,11002620,,7130,10759133,1921566,PDN
WC504,,1993,1971,,369783,70555746,12924186,,364392,61250164,11262998,,5391,9305582,1661188,PDN
WC504,,1994,1971,,387410,76352047,13973183,,367407,63535551,11672665,,20003,12816496,2300518,PDN
WC504,,1995,1971,,407918,91312735,16655736,,376761,69528314,12748347,,31157,21784421,3907389,PDN
WC504,,1996,1971,,403796,85050751,15537382,,381828,73150391,13397912,,21968,11900360,2139470,PDN
WC504,,1997,1971,,405491,87061109,15896792,,384642,76445604,13987063,,20849,10615505,1909729,PDN
WC504,,1998,1971,,1336802,136514851,25627701,,410777,85715293,15662608,,926025,50799558,9965093,PDN
WC504,,1999,1971,,1304996,136583628,25608133,,612548,105267065,19343342,,692448,31316563,6264791,PDN
WC504,,2000,1971,,1472139,198516336,36795331,,706032,118329656,21761131,,766107,80186680,15034200,PDN
WC504,,2001,1971,,1477160,218291375,40319042,,868786,163577802,29975156,,608374,54713573,10343886,PDN
WC504,,2002,1971,,1100141,197143513,36179058,,890578,177731704,32515436,,209563,19411809,3663622,PDN
WC504,,2003,1971,,1100416,196438687,36053919,,932625,182255762,33362476,,167791,14182925,2691443,PDN
WC504,,2004,1971,,1002808,190360225,34874735,,971130,184451116,33791613,,31678,5909109,1083122,PDN
WC504,,2005,1971,,1005739,199086283,36430345,,974396,186877726,34226660,,31343,12208557,2203685,PDN
WC504,,2006,1971,,1001001,197538313,36150167,,975185,187960817,34420170,,25816,9577496,1729997,PDN
WC504,,2007,1971,,1001001,197538313,36150167,,975742,188760122,34562952,,25259,8778191,1587215,PDN
WC504,,2008,1971,,979657,194563912,35599570,,976028,189134114,34629785,,3629,5429798,969785,PDN
WC504,,2009,1971,,980402,193560706,35421810,,976423,191360333,35026306,,3979,2200373,395503,PDN
WC504,,2010,1971,,980402,193560706,35421810,,976837,191829232,35110156,,3565,1731474,311656,PDN
WC504,,2011,1971,,980402,193560706,35421810,,977164,192261840,35187459,,3238,1298866,234352,PDN
WC504,,2012,1971,,980402,193268921,35369891,,977371,192483095,35227034,,3031,785826,142858,PDN
WC504,,2013,1971,,980402,193268921,35369891,,977371,192483095,35227034,,3031,785826,142858,PDN
WC504,,2014,1971,,980402,193268921,35369891,,977371,192483095,35227034,,3031,785826,142858,PDN
WC504,,2015,1971,,977371,192483095,35227034,,977371,192483095,35227034,,0,0,0,PDN
WC504,,2016,1971,,977371,192483095,35227034,,977371,192483095,35227034,,0,0,0,PDN
WC504,,2017,1971,,977371,192483095,35227034,,977371,192483095,35227034,,0,0,0,PDN
WC504,,2017,1971,,977371,192483095,35227034,,977371,192483095,35227034,,0,0,0,PDN
WC507,,1975,1973,,1587563,167144289,31328540,,0,0,0,,1587563,167144289,31328540,PDP
WC507,,1976,1973,,1614287,175257999,32798984,,70819,8492710,1581977,,1543468,166765289,31217007,PDP
WC507,,1977,1973,,1617287,175666071,32874595,,149882,20445007,3787784,,1467405,155221064,29086811,PDP
WC507,,1978,1973,,1617287,175666071,32874595,,188483,28494809,5258734,,1428804,147171262,27615861,PDP
WC507,,1979,1973,,1617287,175666071,32874595,,232588,35906477,6621641,,1384699,139759594,26252954,PDP
WC507,,1980,1973,,1629786,178565109,33402937,,261020,40700639,7503127,,1368766,137864470,25899810,PDP
WC507,,1981,1973,,1629786,178565109,33402937,,295659,47556677,8757701,,1334127,131008432,24645236,PDP
WC507,,1982,1973,,924936,143970684,26542495,,333166,53797279,9905636,,591770,90173405,16636859,PDP
WC507,,1983,1973,,967298,147582079,27227454,,361534,57569306,10605183,,605764,90012773,16622271,PDP
WC507,,1984,1973,,999651,151940080,28035252,,401350,62205838,11470004,,598301,89734242,16565248,PDP
WC507,,1985,1973,,1023554,154721080,28553995,,425683,66065017,12181024,,597871,88656063,16372971,PDP
WC507,,1986,1973,,1032892,156351079,28853369,,439298,69124726,12739071,,593594,87226353,16114298,PDP
WC507,,1987,1973,,616642,109251326,20056380,,446583,70967184,13074196,,170059,38284142,6982184,PDP
WC507,,1988,1973,,621444,108568927,19939758,,473149,76046822,14004612,,148295,32522105,5935146,PDP
WC507,,1989,1973,,1916786,191321748,35959802,,613162,91760693,16940687,,1303624,99561055,19019115,PDP
WC507,,1990,1973,,1556340,239687914,44205435,,723287,104927213,19393610,,833053,134760701,24811825,PDP
WC507,,1991,1973,,1556340,239687914,44205435,,894462,118028069,21895898,,661878,121659845,22309537,PDP
WC507,,1992,1973,,1806280,197985110,37034947,,1050613,130695024,24305955,,755667,67290086,12728992,PDP
WC507,,1993,1973,,1828356,203546870,38046660,,1211673,143485567,26742913,,616683,60061303,11303747,PDP
WC507,,1994,1973,,1972610,218986619,40938201,,1332054,153979917,28730616,,640556,65006702,12207585,PDP
WC507,,1995,1973,,2008271,218815528,40943418,,1431522,163108605,30454405,,576749,55706923,10489013,PDP
WC507,,1996,1973,,1685638,196483766,36647162,,1476225,168689229,31492102,,209413,27794537,5155060,PDP
WC507,,1997,1973,,1868221,211624567,39523838,,1529501,175882955,32825400,,338720,35741612,6698438,PDP
WC507,,1998,1973,,1868221,211624567,39523838,,1613851,188040613,35073035,,254370,23583954,4450803,PDP
WC507,,1999,1973,,1760974,213307346,39716018,,1640458,194775690,36298054,,120516,18531656,3417964,PDP
WC507,,2000,1973,,1829126,220571366,41076700,,1669562,199919803,37242481,,159564,20651563,3834219,PDP
WC507,,2001,1973,,1847008,224536525,41800126,,1699789,205334373,38236154,,147219,19202152,3563972,PDP
WC507,,2002,1973,,2445707,250732311,47059997,,1727943,209091449,38932827,,717764,41640862,8127170,PDP
WC507,,2003,1973,,2583133,255818997,48102527,,1862653,215264896,40166015,,720480,40554101,7936512,PDP
WC507,,2004,1973,,2536979,257887941,48424513,,1959217,221251532,41327817,,577762,36636409,7096696,PDP
WC507,,2005,1973,,2530829,271252519,50796402,,2019777,226643174,42347744,,511052,44609345,8448658,PDP
WC507,,2006,1973,,2485825,280349661,52370106,,2038446,230245924,43007472,,447379,50103737,9362634,PDP
WC507,,2007,1973,,2513213,283088456,52884824,,2052123,234929772,43854574,,461090,48158684,9030250,PDP
WC507,,2008,1973,,2515871,283842792,53021706,,2060455,239442156,44665821,,455416,44400636,8355885,PDP
WC507,,2009,1973,,2512733,294377613,54893091,,2068139,246248608,45884617,,444594,48129005,9008475,PDP
WC507,,2010,1973,,2512733,294377613,54893091,,2077153,250823790,46707718,,435580,43553823,8185372,PDP
WC507,,2011,1973,,2512733,294377613,54893091,,2082474,253538583,47196099,,430259,40839030,7696991,PDP
WC507,,2012,1973,,2512722,294376651,54892908,,2089934,257961815,47990612,,422788,36414836,6902298,PDP
WC507,,2013,1973,,2516315,294499841,54918421,,2095365,261524444,48629962,,420950,32975397,6288458,PDP
WC507,,2014,1973,,2504532,287830115,53719854,,2099451,263369725,48962390,,405081,24460390,4757463,PDP
WC507,,2015,1973,,2501778,288586181,53851631,,2102743,264907709,49239345,,399035,23678472,4612288,PDP
WC507,,2016,1973,,2501273,288965101,53918549,,2105144,266157800,49464181,,396129,22807301,4454368,PDP
WC507,,2017,1973,,2564318,298314969,55645272,,2109441,267187953,49651781,,454877,31127016,5993491,PDP
WC507,,2017,1973,,2564318,298314969,55645272,,2109441,267187953,49651781,,454877,31127016,5993491,PDP
WC518,,1985,1983,,3645,3645077,652235,,0,0,0,,3645,3645077,652235,PDN
WC518,,1986,1983,,19941,8534051,1538455,,0,0,0,,19941,8534051,1538455,PDN
WC518,,1987,1983,,19941,8534051,1538455,,0,0,0,,19941,8534051,1538455,PDN
WC518,,1988,1983,,39026,20047535,3606203,,0,0,0,,39026,20047535,3606203,PDN
WC518,,1989,1983,,52847,22241808,4010464,,8269,2047285,372555,,44578,20194523,3637909,PDN
WC518,,1990,1983,,52847,22241808,4010464,,19288,4256331,776642,,33559,17985477,3233822,PDN
WC518,,1991,1983,,99478,30959335,5608256,,27912,6196327,1130461,,71566,24763008,4477795,PDN
WC518,,1992,1983,,121526,28728573,5233372,,37600,8389097,1530322,,83926,20339476,3703050,PDN
WC518,,1993,1983,,96674,23939793,4356424,,40538,8930244,1629549,,56136,15009549,2726875,PDN
WC518,,1994,1983,,40538,8931454,1629765,,40538,8931454,1629765,,0,0,0,PDN
WC518,,1995,1983,,40538,8931454,1629765,,40538,8931454,1629765,,0,0,0,PDN
WC518,,1996,1983,,40538,8931454,1629765,,40538,8931454,1629765,,0,0,0,PDN
WC518,,1997,1983,,40538,8931454,1629765,,40538,8931454,1629765,,0,0,0,PDN
WC518,,1998,1983,,40538,8931454,1629765,,40538,8931454,1629765,,0,0,0,PDN
WC518,,1999,1983,,40538,8931454,1629765,,40538,8931454,1629765,,0,0,0,PDN
WC518,,2000,1983,,40538,8931454,1629765,,40538,8931454,1629765,,0,0,0,PDN
WC518,,2001,1983,,42643,15239737,2754340,,42129,12497345,2265856,,514,2742392,488484,PDN
WC518,,2002,1983,,42643,15239737,2754340,,42129,12741778,2309349,,514,2497959,444991,PDN
WC518,,2003,1983,,47511,17674038,3192358,,42129,12742439,2309467,,5382,4931599,882891,PDN
WC518,,2004,1983,,46997,15176740,2747485,,42129,12742439,2309467,,4868,2434301,438018,PDN
WC518,,2005,1983,,46997,15176740,2747485,,42129,12742439,2309467,,4868,2434301,438018,PDN
WC518,,2006,1983,,46997,15176740,2747485,,42129,12742439,2309467,,4868,2434301,438018,PDN
WC518,,2007,1983,,46997,15176740,2747485,,42129,12742439,2309467,,4868,2434301,438018,PDN
WC518,,2008,1983,,46997,15176740,2747485,,42129,12742439,2309467,,4868,2434301,438018,PDN
WC518,,2009,1983,,42129,12921310,2341293,,42129,12921310,2341293,,0,0,0,PDN
WC518,,2010,1983,,42129,12921310,2341293,,42129,12921310,2341293,,0,0,0,PDN
WC518,,2011,1983,,42129,12921310,2341293,,42129,12921310,2341293,,0,0,0,PDN
WC518,,2012,1983,,42129,12921310,2341293,,42129,12921310,2341293,,0,0,0,PDN
WC518,,2013,1983,,42129,12921310,2341293,,42129,12921310,2341293,,0,0,0,PDN
WC518,,2014,1983,,42129,12921310,2341293,,42129,12921310,2341293,,0,0,0,PDN
WC518,,2015,1983,,42129,12921310,2341293,,42129,12921310,2341293,,0,0,0,PDN
WC518,,2016,1983,,42129,12921310,2341293,,42129,12921310,2341293,,0,0,0,PDN
WC518,,2017,1983,,42129,12921310,2341293,,42129,12921310,2341293,,0,0,0,PDN
WC518,,2017,1983,,42129,12921310,2341293,,42129,12921310,2341293,,0,0,0,PDN
WC533,,1975,1973,,0,851502428,151512888,,0,0,0,,0,851502428,151512888,PDN
WC533,,1976,1973,,0,851502428,151512888,,0,73852318,13140982,,0,777650110,138371906,PDN
WC533,,1977,1973,,154400,750429215,133682730,,1143,187775017,33413068,,153257,562654198,100269662,PDN
WC533,,1978,1973,,315534,902551575,160911900,,2340,295207911,52530438,,313194,607343664,108381462,PDN
WC533,,1979,1973,,465304,860762882,153625959,,47482,398019208,70869405,,417822,462743674,82756554,PDN
WC533,,1980,1973,,612416,941770375,168187216,,125030,503444779,89705952,,487386,438325596,78481264,PDN
WC533,,1981,1973,,16366343,985318375,191689897,,7091900,571395208,108763645,,9274443,413923167,82926252,PDN
WC533,,1982,1973,,14516213,928169375,179670906,,6468507,635100559,119475724,,8047706,293068816,60195182,PDN
WC533,,1983,1973,,14522378,939501576,181693477,,6476478,677969709,127111658,,8045900,261531867,54581819,PDN
WC533,,1984,1973,,418442,905111511,161470312,,172353,708319122,126207784,,246089,196792389,35262528,PDN
WC533,,1985,1973,,440714,928538938,165661166,,173079,734781576,130917132,,267635,193757362,34744034,PDN
WC533,,1986,1973,,438545,945011927,168590133,,173151,752091964,133997344,,265394,192919963,34592789,PDN
WC533,,1987,1973,,438397,945277064,168637163,,172967,769129732,137028791,,265430,176147332,31608372,PDN
WC533,,1988,1973,,408915,954967295,170331921,,172967,785959293,140023375,,235948,169008002,30308546,PDN
WC533,,1989,1973,,378655,993213266,177106994,,172967,801449119,142779572,,205688,191764147,34327422,PDN
WC533,,1990,1973,,175476,1017333296,181195635,,172967,821304173,146312500,,2509,196029123,34883135,PDN
WC533,,1991,1973,,185208,1104661371,196744171,,172969,841726194,149946313,,12239,262935177,46797858,PDN
WC533,,1992,1973,,183166,1055313561,187961380,,172970,863351579,153794247,,10196,191961982,34167133,PDN
WC533,,1993,1973,,270212,1070963565,190833124,,172970,882664186,157230654,,97242,188299379,33602470,PDN
WC533,,1994,1973,,327547,1045531979,186365266,,174730,904980730,161203330,,152817,140551249,25161936,PDN
WC533,,1995,1973,,334456,1130391856,201471797,,179082,934779398,166509936,,155374,195612458,34961861,PDN
WC533,,1996,1973,,193344,1102267292,196326314,,179089,963015178,171534103,,14255,139252114,24792211,PDN
WC533,,1997,1973,,207778,1082695475,192858218,,179102,977995980,174199739,,28676,104699495,18658479,PDN
WC533,,1998,1973,,212122,1103853384,196627315,,179695,992283833,176742655,,32427,111569551,19884660,PDN
WC533,,1999,1973,,200272,1055997371,188100160,,181251,1004471471,178912829,,19021,51525900,9187331,PDN
WC533,,2000,1973,,200330,1079314900,192249245,,181277,1017911449,181304311,,19053,61403451,10944934,PDN
WC533,,2001,1973,,200935,1072207176,190985130,,181420,1026296959,182796537,,19515,45910217,8188593,PDN
WC533,,2002,1973,,202414,1094377520,194931510,,182374,1038470947,184963681,,20040,55906573,9967829,PDN
WC533,,2003,1973,,209825,1095609366,195158111,,183275,1050336278,187075851,,26550,45273088,8082260,PDN
WC533,,2004,1973,,201406,1088942232,193963369,,183876,1057409784,188335083,,17530,31532448,5628286,PDN
WC533,,2005,1973,,201862,1099683758,195875129,,184031,1062412760,189225447,,17831,37270998,6649682,PDN
WC533,,2006,1973,,255297,1105902537,197035108,,184896,1067209942,190079903,,70401,38692595,6955205,PDN
WC533,,2007,1973,,222688,1100971639,196125115,,190726,1070865627,190736211,,31962,30106012,5388904,PDN
WC533,,2008,1973,,237938,1101445429,196224669,,212039,1073484576,191223529,,25899,27960853,5001140,PDN
WC533,,2009,1973,,212260,1095399696,195123242,,212075,1094657103,194990923,,185,742593,132319,PDN
WC533,,2010,1973,,212075,1095399696,195123057,,212075,1095191002,195085923,,0,208694,37134,PDN
WC533,,2011,1973,,212075,1095399696,195123057,,212075,1095399696,195123057,,0,0,0,PDN
WC533,,2012,1973,,212075,1095399696,195123057,,212075,1095399696,195123057,,0,0,0,PDN
WC533,,2013,1973,,212075,1095399696,195123057,,212075,1095399696,195123057,,0,0,0,PDN
WC533,,2014,1973,,212075,1095399696,195123057,,212075,1095399696,195123057,,0,0,0,PDN
WC533,,2015,1973,,212075,1095399696,195123057,,212075,1095399696,195123057,,0,0,0,PDN
WC533,,2016,1973,,212075,1095399696,195123057,,212075,1095399696,195123057,,0,0,0,PDN
WC533,,2017,1973,,212075,1095399696,195123057,,212075,1095399696,195123057,,0,0,0,PDN
WC533,,2017,1973,,212075,1095399696,195123057,,212075,1095399696,195123057,,0,0,0,PDN
WC536,,1983,1981,,79298,29016982,5242462,,0,0,0,,79298,29016982,5242462,PDN
WC536,,1984,1981,,63943,31971841,5752883,,1469,304058,55572,,62474,31667783,5697311,PDN
WC536,,1985,1981,,154229,34002877,6204563,,27422,3388471,630353,,126807,30614406,5574210,PDN
WC536,,1986,1981,,224629,44301106,8107388,,100656,13362954,2478406,,123973,30938152,5628982,PDN
WC536,,1987,1981,,329578,48835560,9019179,,147966,20905151,3867744,,181612,27930409,5151435,PDN
WC536,,1988,1981,,329536,49219880,9087522,,181782,26081583,4822633,,147754,23138297,4264889,PDN
WC536,,1989,1981,,390087,79074396,14460264,,210242,31236499,5768338,,179845,47837897,8691926,PDN
WC536,,1990,1981,,390087,79074396,14460264,,238407,36770991,6781288,,151680,42303405,7678976,PDN
WC536,,1991,1981,,364245,68162924,12492879,,259699,41756583,7689696,,104546,26406341,4803183,PDN
WC536,,1992,1981,,364942,68162924,12493576,,276311,45386944,8352280,,88631,22775980,4141296,PDN
WC536,,1993,1981,,474862,83999136,15421327,,306991,50684272,9325545,,167871,33314864,6095782,PDN
WC536,,1994,1981,,476599,84959701,15593984,,362325,61023502,11220599,,114274,23936199,4373385,PDN
WC536,,1995,1981,,548620,104987251,19229626,,394242,70228250,12890372,,154378,34759001,6339254,PDN
WC536,,1996,1981,,548620,104987251,19229626,,408590,76443072,14010560,,140030,28544179,5219066,PDN
WC536,,1997,1981,,483540,94424000,17284963,,416619,80863672,14805173,,66921,13560328,2479790,PDN
WC536,,1998,1981,,483540,94424000,17284963,,419753,82479810,15095876,,63787,11944190,2189087,PDN
WC536,,1999,1981,,483659,99722926,18227952,,430560,86090222,15749105,,53099,13632704,2478847,PDN
WC536,,2000,1981,,484785,103724799,18941155,,439067,90824060,16599932,,45718,12900739,2341223,PDN
WC536,,2001,1981,,483463,104367721,19054232,,442171,93452037,17070647,,41292,10915684,1983585,PDN
WC536,,2002,1981,,503514,114919349,20951797,,456251,100023667,18254057,,47263,14895682,2697740,PDN
WC536,,2003,1981,,504794,115243976,21010840,,461725,104223663,19006861,,43069,11020313,2003979,PDN
WC536,,2004,1981,,497754,112860962,20579776,,463751,106609053,19433333,,34003,6251909,1146443,PDN
WC536,,2005,1981,,498082,117193231,21350970,,464351,107317280,19559952,,33731,9875951,1791018,PDN
WC536,,2006,1981,,498341,117053681,21326398,,465214,107892423,19663154,,33127,9161258,1663244,PDN
WC536,,2007,1981,,498341,117053681,21326398,,465803,108315259,19738981,,32538,8738422,1587417,PDN
WC536,,2008,1981,,498341,117053681,21326398,,466200,108639766,19797119,,32141,8413915,1529279,PDN
WC536,,2009,1981,,497918,116499652,21227393,,466746,110780636,20178603,,31172,5719016,1048790,PDN
WC536,,2010,1981,,497918,116614645,21247854,,467124,111189356,20251706,,30794,5425289,996148,PDN
WC536,,2011,1981,,467190,111274705,20266959,,467190,111274705,20266959,,0,0,0,PDN
WC536,,2012,1981,,467190,111274705,20266959,,467190,111274705,20266959,,0,0,0,PDN
WC536,,2013,1981,,467190,111274705,20266959,,467190,111274705,20266959,,0,0,0,PDN
WC536,,2014,1981,,467190,111274705,20266959,,467190,111274705,20266959,,0,0,0,PDN
WC536,,2015,1981,,467190,111274705,20266959,,467190,111274705,20266959,,0,0,0,PDN
WC536,,2016,1981,,467190,111274705,20266959,,467190,111274705,20266959,,0,0,0,PDN
WC536,,2017,1981,,467190,111274705,20266959,,467190,111274705,20266959,,0,0,0,PDN
WC536,,2017,1981,,467190,111274705,20266959,,467190,111274705,20266959,,0,0,0,PDN
WC537,,1977,1975,,144028,144027890,25771766,,0,0,0,,144028,144027890,25771766,PDN
WC537,,1978,1975,,61016,61015500,10917867,,0,0,0,,61016,61015500,10917867,PDN
WC537,,1979,1975,,61016,61015500,10917867,,0,0,0,,61016,61015500,10917867,PDN
WC537,,1980,1975,,61016,61015500,10917867,,4704,3245154,582134,,56312,57770346,10335733,PDN
WC537,,1981,1975,,62036,62035500,11100381,,11696,8471526,1519085,,50340,53563974,9581296,PDN
WC537,,1982,1975,,62036,62035500,11100381,,20321,14642344,2625720,,41715,47393156,8474661,PDN
WC537,,1983,1975,,251482,82539165,14938166,,56111,24827363,4473791,,195371,57711802,10464375,PDN
WC537,,1984,1975,,251482,82539165,14938166,,94123,35776531,6460054,,157359,46762634,8478112,PDN
WC537,,1985,1975,,289627,89452074,16206366,,126116,44029879,7960614,,163511,45422195,8245752,PDN
WC537,,1986,1975,,350692,116613336,21100396,,160323,54025066,9773324,,190369,62588270,11327072,PDN
WC537,,1987,1975,,335101,119849918,21660709,,193522,70428419,12725269,,141579,49421499,8935440,PDN
WC537,,1988,1975,,348936,105469938,19115829,,237079,74590427,13509397,,111857,30879511,5606432,PDN
WC537,,1989,1975,,827843,233355302,42350139,,269707,84371324,15282398,,558136,148983978,27067741,PDN
WC537,,1990,1975,,446924,150366879,27202596,,306069,98320175,17800762,,140855,52046704,9401834,PDN
WC537,,1991,1975,,446924,140385527,25426555,,334737,108330741,19610670,,112187,32054786,5815885,PDN
WC537,,1992,1975,,446924,140385527,25426555,,351904,118046002,21356531,,95020,22339525,4070024,PDN
WC537,,1993,1975,,458560,141549112,25645235,,364271,125095293,22623220,,94289,16453819,3022015,PDN
WC537,,1994,1975,,458640,150637954,27262546,,373581,131368505,23748760,,85059,19269449,3513786,PDN
WC537,,1995,1975,,424236,157897228,28519828,,376663,136296084,24628635,,47573,21601144,3891193,PDN
WC537,,1996,1975,,395204,156256375,28198829,,378038,141800890,25609513,,17166,14455485,2589316,PDN
WC537,,1997,1975,,580211,167968482,30467841,,412950,147775640,26707548,,167261,20192842,3760293,PDN
WC537,,1998,1975,,580211,167968482,30467841,,432494,152200607,27514453,,147717,15767875,2953388,PDN
WC537,,1999,1975,,511081,162444507,29415798,,433185,155388975,28082469,,77896,7055532,1333329,PDN
WC537,,2000,1975,,771079,182213313,33193377,,562943,163277950,29615959,,208136,18935363,3577418,PDN
WC537,,2001,1975,,843915,201671512,36728526,,651374,170585104,31004595,,192541,31086408,5723931,PDN
WC537,,2002,1975,,843832,202350051,36849180,,697160,176354539,32076971,,146672,25995512,4772209,PDN
WC537,,2003,1975,,843839,203650553,37080593,,712384,180147883,32767167,,131455,23502670,4313426,PDN
WC537,,2004,1975,,724747,198259932,36002315,,717889,182389458,33171529,,6858,15870474,2830786,PDN
WC537,,2005,1975,,721582,201133222,36510412,,718889,182951850,33272599,,2693,18181372,3237813,PDN
WC537,,2006,1975,,721075,200646415,36423284,,719463,183450140,33361837,,1612,17196275,3061447,PDN
WC537,,2007,1975,,721075,200646415,36423284,,719700,183873462,33437398,,1375,16772953,2985886,PDN
WC537,,2008,1975,,721076,200653059,36424467,,719751,184204114,33496284,,1325,16448945,2928183,PDN
WC537,,2009,1975,,720424,194224780,35279992,,719751,187492047,34081324,,673,6732733,1198668,PDN
WC537,,2010,1975,,720424,194224780,35279992,,719751,187492047,34081324,,673,6732733,1198668,PDN
WC537,,2011,1975,,720424,194224780,35279992,,719751,187492047,34081324,,673,6732733,1198668,PDN
WC537,,2012,1975,,720424,194224780,35279992,,719751,187492047,34081324,,673,6732733,1198668,PDN
WC537,,2013,1975,,720424,194224780,35279992,,719751,187492047,34081324,,673,6732733,1198668,PDN
WC537,,2014,1975,,719751,187492047,34081324,,719751,187492047,34081324,,0,0,0,PDN
WC537,,2015,1975,,719751,187492047,34081324,,719751,187492047,34081324,,0,0,0,PDN
WC537,,2016,1975,,719751,187492047,34081324,,719751,187492047,34081324,,0,0,0,PDN
WC537,,2017,1975,,719751,187492047,34081324,,719751,187492047,34081324,,0,0,0,PDN
WC537,,2017,1975,,719751,187492047,34081324,,719751,187492047,34081324,,0,0,0,PDN
WC540,,1976,1975,,0,56400000,10035587,,0,0,0,,0,56400000,10035587,PDN
WC540,,1977,1975,,87192,87192318,15601839,,0,0,0,,87192,87192318,15601839,PDN
WC540,,1978,1975,,87192,87192318,15601839,,0,0,0,,87192,87192318,15601839,PDN
WC540,,1979,1975,,105532,97192318,17399539,,182,156505,28030,,105350,97035813,17371509,PDN
WC540,,1980,1975,,105832,97807318,17509269,,15189,14865708,2660333,,90643,82941610,14848936,PDN
WC540,,1981,1975,,107562,99222318,17762779,,22777,26628525,4760949,,84785,72593793,13001830,PDN
WC540,,1982,1975,,107562,99222318,17762779,,26105,32264286,5767081,,81457,66958032,11995698,PDN
WC540,,1983,1975,,107159,101519486,18171124,,27500,37135469,6635235,,79659,64384017,11535889,PDN
WC540,,1984,1975,,108206,103489486,18522705,,28756,43512986,7771280,,79450,59976500,10751425,PDN
WC540,,1985,1975,,108858,103489486,18523357,,29517,47423552,8467871,,79341,56065934,10055486,PDN
WC540,,1986,1975,,108858,103489486,18523357,,29927,49228419,8789432,,78931,54261067,9733925,PDN
WC540,,1987,1975,,36221,80753323,14405140,,30271,51557633,9204227,,5950,29195690,5200913,PDN
WC540,,1988,1975,,36419,80753323,14405338,,30510,54234351,9680750,,5909,26518972,4724588,PDN
WC540,,1989,1975,,36591,82453326,14708001,,30669,56194876,10029757,,5922,26258450,4678244,PDN
WC540,,1990,1975,,38076,87306484,15573038,,30957,57976200,10347007,,7119,29330284,5226031,PDN
WC540,,1991,1975,,37169,70331235,12551624,,31530,59725812,10658899,,5639,10605423,1892725,PDN
WC540,,1992,1975,,33421,70474030,12573284,,31918,60790720,10848772,,1503,9683310,1724512,PDN
WC540,,1993,1975,,62664,73398375,13122873,,31933,61199437,10921513,,30731,12198938,2201360,PDN
WC540,,1994,1975,,31933,61240991,10928906,,31933,61240991,10928906,,0,0,0,PDN
WC540,,1995,1975,,34402,63877910,11400578,,34402,63877910,11400578,,0,0,0,PDN
WC540,,1996,1975,,56488,80336847,14351301,,39062,67699885,12085305,,17426,12636962,2265996,PDN
WC540,,1997,1975,,56488,80336847,14351301,,44959,71789133,12818826,,11529,8547714,1532475,PDN
WC540,,1998,1975,,82470,116513181,20814353,,51699,81745343,14597134,,30771,34767838,6217219,PDN
WC540,,1999,1975,,76963,114117037,20382485,,59858,91746345,16384830,,17105,22370692,3997655,PDN
WC540,,2000,1975,,1257955,164789795,30579982,,326450,110453529,19980103,,931505,54336266,10599879,PDN
WC540,,2001,1975,,919091,150845872,27759993,,651301,124769683,22852312,,267790,26076189,4907681,PDN
WC540,,2002,1975,,919161,150624696,27720708,,705229,127104368,23321665,,213932,23520328,4399043,PDN
WC540,,2003,1975,,716773,133641766,24496447,,708519,127510257,23397177,,8254,6131509,1099270,PDN
WC540,,2004,1975,,716635,130762949,23984064,,715587,129039886,23676421,,1048,1723063,307643,PDN
WC540,,2005,1975,,725640,158525584,28933039,,716427,129701172,23794927,,9213,28824412,5138112,PDN
WC540,,2006,1975,,722453,143137159,26191698,,717754,135684834,24860963,,4699,7452325,1330735,PDN
WC540,,2007,1975,,722453,143145374,26193160,,722290,142156207,26016989,,163,989167,176171,PDN
WC540,,2008,1975,,722721,144709610,26471762,,722337,142324670,26047011,,384,2384940,424751,PDN
WC540,,2009,1975,,724082,148485938,27145065,,722438,144540063,26441308,,1644,3945875,703757,PDN
WC540,,2010,1975,,724082,148485938,27145065,,722465,144667217,26463960,,1617,3818721,681105,PDN
WC540,,2011,1975,,722768,145282625,26573766,,722720,144909683,26507358,,48,372942,66408,PDN
WC540,,2012,1975,,722768,145282625,26573766,,722768,145282625,26573766,,0,0,0,PDN
WC540,,2013,1975,,722768,145282625,26573766,,722768,145282625,26573766,,0,0,0,PDN
WC540,,2014,1975,,722768,145282625,26573766,,722768,145282625,26573766,,0,0,0,PDN
WC540,,2015,1975,,722768,145282625,26573766,,722768,145282625,26573766,,0,0,0,PDN
WC540,,2016,1975,,722768,145282625,26573766,,722768,145282625,26573766,,0,0,0,PDN
WC540,,2017,1975,,722768,145282625,26573766,,722768,145282625,26573766,,0,0,0,PDN
WC540,,2017,1975,,722768,145282625,26573766,,722768,145282625,26573766,,0,0,0,PDN
WC543,,1975,1971,,0,130000000,23131673,,0,0,0,,0,130000000,23131673,PDP
WC543,,1976,1971,,0,130000000,23131673,,228413,26162118,4883594,,-228413,103837882,18248079,PDP
WC543,,1977,1971,,1130865,156459390,28970614,,389390,52130027,9665196,,741475,104329363,19305418,PDP
WC543,,1978,1971,,1441917,204030012,37746190,,577550,86221277,15919414,,864367,117808735,21826776,PDP
WC543,,1979,1971,,1441917,204030012,37746190,,686725,112600782,20722451,,755192,91429230,17023739,PDP
WC543,,1980,1971,,1441917,204030012,37746190,,765268,130136839,23921289,,676649,73893173,13824901,PDP
WC543,,1981,1971,,1526222,217055111,40148128,,812815,142398179,26150569,,713407,74656932,13997559,PDP
WC543,,1982,1971,,1526222,217055111,40148128,,861356,152232136,27948925,,664866,64822975,12199203,PDP
WC543,,1983,1971,,1544916,227620402,42046767,,910040,161992966,29734411,,634876,65627436,12312356,PDP
WC543,,1984,1971,,1538680,234168626,43205695,,929167,167320297,30701462,,609513,66848329,12504233,PDP
WC543,,1985,1971,,1538680,234168626,43205695,,948967,170300392,31251528,,589713,63868234,11954167,PDP
WC543,,1986,1971,,1538680,234168626,43205695,,964517,171553090,31489978,,574163,62615536,11715717,PDP
WC543,,1987,1971,,1014637,178079744,32701424,,968040,172077969,31586896,,46597,6001775,1114528,PDP
WC543,,1988,1971,,1014637,178079744,32701424,,977011,172752484,31715887,,37626,5327260,985537,PDP
WC543,,1989,1971,,1014819,178079744,32701606,,990744,173454838,31854594,,24075,4624906,847012,PDP
WC543,,1990,1971,,1043984,177370407,32604555,,998592,173617224,31891336,,45392,3753183,713219,PDP
WC543,,1991,1971,,1043984,177370407,32604555,,1004812,173696078,31911587,,39172,3674329,692968,PDP
WC543,,1992,1971,,1029613,174034585,31996621,,1016291,173848041,31950106,,13322,186544,46515,PDP
WC543,,1993,1971,,1017627,173860227,31953610,,1017627,173860227,31953610,,0,0,0,PDP
WC543,,1994,1971,,1017628,173860227,31953611,,1017628,173860227,31953611,,0,0,0,PDP
WC543,,1995,1971,,3928673,229877818,44832199,,1301969,179481789,33238230,,2626704,50396029,11593969,PDP
WC543,,1996,1971,,5703043,229918416,46613793,,2074994,186198742,35206443,,3628049,43719674,11407350,PDP
WC543,,1997,1971,,5276752,224545460,45231460,,2814002,200656637,38518030,,2462750,23888823,6713430,PDP
WC543,,1998,1971,,7237992,240536091,50038008,,3539261,210261896,40952410,,3698731,30274195,9085598,PDP
WC543,,1999,1971,,6198584,242437747,49336974,,4128430,215474033,42469005,,2070154,26963714,6867969,PDP
WC543,,2000,1971,,5684121,237707401,47980812,,4743688,221535793,44162868,,940433,16171608,3817944,PDP
WC543,,2001,1971,,6248900,241394305,49201624,,5202479,226022829,45420064,,1046421,15371476,3781560,PDP
WC543,,2002,1971,,6427057,243877263,49821588,,5555709,229188438,46336570,,871348,14688825,3485018,PDP
WC543,,2003,1971,,6441411,245564185,50136106,,5827461,231619656,47040923,,613950,13944529,3095183,PDP
WC543,,2004,1971,,6874360,242965303,50106621,,6097359,233908056,47718010,,777001,9057247,2388611,PDP
WC543,,2005,1971,,7274536,247159338,51253066,,6292737,234715227,48057012,,981799,12444111,3196054,PDP
WC543,,2006,1971,,7079192,243424563,50393171,,6521936,235450170,48416984,,557256,7974393,1976187,PDP
WC543,,2007,1971,,7078270,243412966,50390185,,6642389,235885740,48614941,,435881,7527226,1775244,PDP
WC543,,2008,1971,,7169064,244218637,50624337,,6723184,236097706,48733452,,445880,8120931,1890885,PDP
WC543,,2009,1971,,7099759,240949425,49973322,,6819522,240550375,49622080,,280237,399050,351242,PDP
WC543,,2010,1971,,7090259,240859403,49947804,,6880092,240647463,49699925,,210167,211940,247879,PDP
WC543,,2011,1971,,7090259,240859403,49947804,,6924844,240721507,49757852,,165415,137896,189952,PDP
WC543,,2012,1971,,7221702,241705141,50229734,,6941402,240734286,49776684,,280300,970855,453050,PDP
WC543,,2013,1971,,7221702,241705141,50229734,,6985138,240924239,49854220,,236564,780902,375514,PDP
WC543,,2014,1971,,7300184,241763655,50318628,,7058911,241075952,49954988,,241273,687703,363640,PDP
WC543,,2015,1971,,7171278,241298580,50106968,,7071729,241100602,49972192,,99549,197978,134776,PDP
WC543,,2016,1971,,7171278,241298580,50106968,,7089404,241110793,49991680,,81874,187787,115287,PDP
WC543,,2017,1971,,8557344,251976743,53393061,,7381832,242672701,50562026,,1175512,9304042,2831035,PDP
WC543,,2017,1971,,8557344,251976743,53393061,,7381832,242672701,50562026,,1175512,9304042,2831035,PDP
WC546,,2004,2004,,2198,21970861,3911604,,84,1043620,185782,,2114,20927241,3725822,PDN
WC546,,2005,2004,,2263,31233611,5559845,,284,2868152,510631,,1979,28365459,5049214,PDN
WC546,,2006,2004,,2263,29155920,5190149,,288,5483270,975959,,1975,23672650,4214190,PDN
WC546,,2007,2004,,2263,29155920,5190149,,288,6657940,1184975,,1975,22497980,4005174,PDN
WC546,,2008,2004,,2263,29155920,5190149,,288,6931340,1233623,,1975,22224580,3956526,PDN
WC546,,2009,2004,,288,6931339,1233623,,288,6931339,1233623,,0,0,0,PDN
WC546,,2010,2004,,288,6931339,1233623,,288,6931339,1233623,,0,0,0,PDN
WC546,,2011,2004,,288,6931339,1233623,,288,6931339,1233623,,0,0,0,PDN
WC546,,2012,2004,,288,6931339,1233623,,288,6931339,1233623,,0,0,0,PDN
WC546,,2013,2004,,288,6931339,1233623,,288,6931339,1233623,,0,0,0,PDN
WC546,,2014,2004,,288,6931339,1233623,,288,6931339,1233623,,0,0,0,PDN
WC546,,2015,2004,,288,6931339,1233623,,288,6931339,1233623,,0,0,0,PDN
WC546,,2016,2004,,288,6931339,1233623,,288,6931339,1233623,,0,0,0,PDN
WC546,,2017,2004,,288,6931339,1233623,,288,6931339,1233623,,0,0,0,PDN
WC546,,2017,2004,,288,6931339,1233623,,288,6931339,1233623,,0,0,0,PDN
WC547,,1983,1978,,171330,51398940,9317049,,0,0,0,,171330,51398940,9317049,PDN
WC547,,1984,1978,,732659,114639535,21131153,,2502,15561279,2771413,,730157,99078256,18359740,PDN
WC547,,1985,1978,,653271,162483525,29564930,,4453,46001741,8189816,,648818,116481784,21375114,PDN
WC547,,1986,1978,,653271,162483525,29564930,,5938,50003559,8903368,,647333,112479966,20661562,PDN
WC547,,1987,1978,,8201,52437914,9338791,,5942,49912818,8887226,,2259,2525096,451565,PDN
WC547,,1988,1978,,11523,55496182,9886288,,6186,50613003,9012058,,5337,4883179,874230,PDN
WC547,,1989,1978,,11480,55496182,9886245,,6177,51734982,9211690,,5303,3761200,674555,PDN
WC547,,1990,1978,,11480,55496182,9886245,,6205,52843246,9408918,,5275,2652936,477327,PDN
WC547,,1991,1978,,6551,62514041,11130046,,6205,54266522,9662170,,346,8247519,1467876,PDN
WC547,,1992,1978,,6401,62359213,11102346,,6205,56342451,10031552,,196,6016762,1070794,PDN
WC547,,1993,1978,,83339,70052974,12548281,,6205,57655789,10265242,,77134,12397185,2283039,PDN
WC547,,1994,1978,,132512,74971858,13472700,,6951,60647056,10798242,,125561,14324802,2674458,PDN
WC547,,1995,1978,,126644,100333709,17979617,,9155,65664645,11693256,,117489,34669064,6286361,PDN
WC547,,1996,1978,,22005,81391567,14504490,,15863,75740779,13492870,,6142,5650788,1011620,PDN
WC547,,1997,1978,,22005,81391567,14504490,,17228,77126284,13740766,,4777,4265283,763724,PDN
WC547,,1998,1978,,20180,79843853,14227271,,17711,77206934,13755600,,2469,2636919,471671,PDN
WC547,,1999,1978,,25795,84391380,15042055,,17720,77393773,13788854,,8075,6997607,1253201,PDN
WC547,,2000,1978,,25795,84391380,15042055,,17720,77393773,13788854,,8075,6997607,1253201,PDN
WC547,,2001,1978,,25795,84391380,15042055,,17720,77393773,13788854,,8075,6997607,1253201,PDN
WC547,,2002,1978,,25795,84391380,15042055,,17720,77393773,13788854,,8075,6997607,1253201,PDN
WC547,,2003,1978,,25795,84391380,15042055,,17720,77393773,13788854,,8075,6997607,1253201,PDN
WC547,,2004,1978,,25795,84391380,15042055,,17720,77393773,13788854,,8075,6997607,1253201,PDN
WC547,,2005,1978,,25755,84356402,15035791,,17720,77393773,13788854,,8035,6962629,1246937,PDN
WC547,,2006,1978,,25348,84003385,14972570,,17720,77393773,13788854,,7628,6609612,1183716,PDN
WC547,,2007,1978,,25348,84003385,14972570,,17720,77393773,13788854,,7628,6609612,1183716,PDN
WC547,,2008,1978,,17720,77393773,13788854,,17720,77393773,13788854,,0,0,0,PDN
WC547,,2009,1978,,17720,78939996,14063983,,17720,78939996,14063983,,0,0,0,PDN
WC547,,2010,1978,,17720,78939996,14063983,,17720,78939996,14063983,,0,0,0,PDN
WC547,,2011,1978,,17720,78939996,14063983,,17720,78939996,14063983,,0,0,0,PDN
WC547,,2012,1978,,17720,78939996,14063983,,17720,78939996,14063983,,0,0,0,PDN
WC547,,2013,1978,,17720,78939996,14063983,,17720,78939996,14063983,,0,0,0,PDN
WC547,,2014,1978,,17720,78939996,14063983,,17720,78939996,14063983,,0,0,0,PDN
WC547,,2015,1978,,17720,78939996,14063983,,17720,78939996,14063983,,0,0,0,PDN
WC547,,2016,1978,,17720,78939996,14063983,,17720,78939996,14063983,,0,0,0,PDN
WC547,,2017,1978,,17720,78939996,14063983,,17720,78939996,14063983,,0,0,0,PDN
WC547,,2017,1978,,17720,78939996,14063983,,17720,78939996,14063983,,0,0,0,PDN
WC576,,1975,1972,,0,20000000,3558719,,0,0,0,,0,20000000,3558719,PDN
WC576,,1976,1972,,0,20000000,3558719,,0,0,0,,0,20000000,3558719,PDN
WC576,,1977,1972,,83652,83650840,14968143,,0,0,0,,83652,83650840,14968143,PDN
WC576,,1978,1972,,83652,83650840,14968143,,0,0,0,,83652,83650840,14968143,PDN
WC576,,1979,1972,,83652,83650840,14968143,,4747,2932006,526456,,78905,80718834,14441687,PDN
WC576,,1980,1972,,1683652,403650840,73507645,,25258,14126301,2538835,,1658394,389524539,70968810,PDN
WC576,,1981,1972,,1776776,403650840,73600769,,56371,19010548,3439031,,1720405,384640292,70161738,PDN
WC576,,1982,1972,,2174897,403650840,73998890,,370048,31252643,5931017,,1804849,372398197,68067873,PDN
WC576,,1983,1972,,790047,104281029,19345390,,576593,37625242,7271476,,213454,66655787,12073914,PDN
WC576,,1984,1972,,581147,112763142,20645763,,446257,45023104,8457485,,134890,67740038,12188278,PDN
WC576,,1985,1972,,575564,117796200,21535742,,455367,51065166,9541695,,120197,66731034,11994047,PDN
WC576,,1986,1972,,590873,122265378,22346278,,213938,52709193,9592798,,376935,69556185,12753480,PDN
WC576,,1987,1972,,274109,84084559,15235774,,227570,58738289,10679223,,46539,25346270,4556551,PDN
WC576,,1988,1972,,340555,119125207,21537211,,247565,79662705,14422424,,92990,39462502,7114787,PDN
WC576,,1989,1972,,340396,189466137,34053232,,261339,91507848,16543874,,79057,97958289,17509358,PDN
WC576,,1990,1972,,293688,174655052,31371099,,267044,105457483,19031721,,26644,69197569,12339378,PDN
WC576,,1991,1972,,294201,168594299,30293187,,277996,119718810,21580275,,16205,48875489,8712912,PDN
WC576,,1992,1972,,339213,197109834,35412137,,290051,136005134,24490253,,49162,61104700,10921884,PDN
WC576,,1993,1972,,338524,199259934,35794028,,294127,145049704,26103683,,44397,54210230,9690345,PDN
WC576,,1994,1972,,339232,194465462,34941627,,296170,148694796,26754319,,43062,45770666,8187308,PDN
WC576,,1995,1972,,716466,192554517,34978836,,375445,157888405,28469467,,341021,34666112,6509369,PDN
WC576,,1996,1972,,987216,223527262,40760750,,631127,181557421,32936718,,356089,41969841,7824032,PDN
WC576,,1997,1972,,1147331,233949006,42775268,,843416,202997302,36963932,,303915,30951704,5811336,PDN
WC576,,1998,1972,,1136730,262303780,47810000,,943292,219422089,39986368,,193438,42881691,7823632,PDN
WC576,,1999,1972,,1104759,252582458,46048257,,967458,232144418,42274294,,137301,20438040,3773963,PDN
WC576,,2000,1972,,1103603,259426908,47264975,,971104,242495227,44119721,,132499,16931681,3145254,PDN
WC576,,2001,1972,,993602,273747605,49703141,,974589,249992904,45457312,,19013,23754701,4245829,PDN
WC576,,2002,1972,,981691,262866405,47755072,,975194,252294417,45867439,,6497,10571988,1887633,PDN
WC576,,2003,1972,,980698,261898721,47581894,,976166,255681651,46471122,,4532,6217070,1110772,PDN
WC576,,2004,1972,,977474,259172760,47093623,,976971,257508334,46796959,,503,1664426,296664,PDN
WC576,,2005,1972,,1120399,304750920,55346541,,985003,259899934,47230543,,135396,44850986,8115998,PDN
WC576,,2006,1972,,1086645,295042231,53585263,,1026917,269510585,48982537,,59728,25531646,4602726,PDN
WC576,,2007,1972,,1056124,287726273,52252970,,1039763,274268091,49841914,,16361,13458182,2411056,PDN
WC576,,2008,1972,,1173213,299438423,54454071,,1046318,276704241,50281948,,126895,22734182,4172123,PDN
WC576,,2009,1972,,1058002,298719042,54210859,,1046487,283387031,51471228,,11515,15332011,2739631,PDN
WC576,,2010,1972,,1058002,298719042,54210859,,1046881,286359158,52000471,,11121,12359884,2210389,PDN
WC576,,2011,1972,,1047085,290903359,52809249,,1047049,288180784,52324769,,36,2722575,484479,PDN
WC576,,2012,1972,,1047085,290903359,52809249,,1047063,289366612,52535785,,22,1536747,273465,PDN
WC576,,2013,1972,,1047085,290903359,52809249,,1047069,289786055,52610425,,16,1117304,198825,PDN
WC576,,2014,1972,,1047073,289801926,52613253,,1047073,289801926,52613253,,0,0,0,PDN
WC576,,2015,1972,,1047069,289801926,52613249,,1047069,289801926,52613249,,0,0,0,PDN
WC576,,2016,1972,,1047069,289801926,52613249,,1047069,289801926,52613249,,0,0,0,PDN
WC576,,2017,1972,,1047069,289801926,52613249,,1047069,289801926,52613249,,0,0,0,PDN
WC576,,2017,1972,,1047069,289801926,52613249,,1047069,289801926,52613249,,0,0,0,PDN
WC587,,1975,1971,,1000000,763818791,136910817,,612906,50889487,9667975,,387094,712929304,127242842,PDN
WC587,,1976,1971,,5160582,649317993,120697591,,1925940,114447542,22290271,,3234642,534870451,98407320,PDN
WC587,,1977,1971,,7548454,716027678,134955514,,3127287,201688192,39014866,,4421167,514339486,95940648,PDN
WC587,,1978,1971,,26975701,895000499,186228459,,4164208,304130919,58280030,,22811493,590869580,127948429,PDN
WC587,,1979,1971,,29140298,1388474986,276199904,,4209339,400669180,75502787,,24930959,987805806,200697117,PDN
WC587,,1980,1971,,29336681,1578065218,310131204,,5115978,488129623,91971783,,24220703,1089935595,218159421,PDN
WC587,,1981,1971,,30425019,1583914258,312260296,,5834942,559345593,105362628,,24590077,1024568665,206897668,PDN
WC587,,1982,1971,,26514839,1144211781,230111241,,6403080,623929880,117422632,,20111759,520281901,112688609,PDN
WC587,,1983,1971,,12820765,1049337987,199535709,,6732570,661353750,124411173,,6088195,387984237,75124536,PDN
WC587,,1984,1971,,13569718,1092840495,208025322,,7104567,700897608,131819444,,6465151,391942887,76205878,PDN
WC587,,1985,1971,,14118943,1139005278,216788921,,7648197,748887751,140902245,,6470746,390117527,75886676,PDN
WC587,,1986,1971,,14178397,1163222778,221157539,,7752084,789165860,148173056,,6426313,374056918,72984483,PDN
WC587,,1987,1971,,13086806,1091672390,207334562,,8037638,822756821,154435649,,5049168,268915569,52898913,PDN
WC587,,1988,1971,,13093987,1116571286,211772152,,8416659,878428635,164720687,,4677328,238142651,47051465,PDN
WC587,,1989,1971,,13674338,1330454705,250410051,,8774910,925264120,173412654,,4899428,405190585,76997397,PDN
WC587,,1990,1971,,12805374,1322894705,248195891,,9298425,978625173,183431018,,3506949,344269532,64764873,PDN
WC587,,1991,1971,,13928774,1351324937,254378051,,9729281,1035282676,193943280,,4199493,316042261,60434771,PDN
WC587,,1992,1971,,11834171,1482408047,275607845,,10125868,1118201914,209094180,,1708303,364206133,66513665,PDN
WC587,,1993,1971,,12162422,1559214697,289602760,,10333954,1197210024,223360649,,1828468,362004673,66242111,PDN
WC587,,1994,1971,,12871377,1596424938,296932754,,10639056,1267276255,236133052,,2232321,329148683,60799702,PDN
WC587,,1995,1971,,13370804,1618255684,301316655,,11033217,1219029918,227942455,,2337587,399225766,73374200,PDN
WC587,,1996,1971,,12845408,1557683894,290013361,,11390661,1356623887,252782812,,1454747,201060007,37230549,PDN
WC587,,1997,1971,,13025334,1565372021,291561281,,11692469,1388953425,258837207,,1332865,176418596,32724074,PDN
WC587,,1998,1971,,12808366,1567820014,291779899,,11907543,1410032488,262803003,,900823,157787526,28976896,PDN
WC587,,1999,1971,,13098748,1530170263,285371037,,12084982,1432105418,266908010,,1013766,98064845,18463027,PDN
WC587,,2000,1971,,12861067,1624039035,301835984,,12248811,1458696969,271803432,,612256,165342066,30032552,PDN
WC587,,2001,1971,,13099764,1594904802,296890654,,12374603,1487755076,277099705,,725161,107149726,19790949,PDN
WC587,,2002,1971,,13153329,1574923888,293388896,,12475644,1502990418,279911661,,677685,71933470,13477235,PDN
WC587,,2003,1971,,12844577,1553840832,289328710,,12565309,1512519094,281696820,,279268,41321738,7631890,PDN
WC587,,2004,1971,,12815069,1546856351,288056412,,12634774,1518134905,282765540,,180295,28721446,5290872,PDN
WC587,,2005,1971,,13183759,1562967014,291291768,,12705203,1525470806,284141289,,478556,37496208,7150479,PDN
WC587,,2006,1971,,14166962,1572825590,294029166,,12812714,1528527419,284792682,,1354248,44298171,9236484,PDN
WC587,,2007,1971,,14746441,1580201287,295921047,,12933224,1531453169,285433788,,1813217,48748118,10487259,PDN
WC587,,2008,1971,,14199175,1572418560,293988954,,13120374,1535482000,286337812,,1078801,36936560,7651142,PDN
WC587,,2009,1971,,13441463,1589666926,296300339,,13243578,1569941284,292592555,,197885,19725642,3707784,PDN
WC587,,2010,1971,,13441463,1589666926,296300339,,13328351,1576340610,293815997,,113112,13326316,2484342,PDN
WC587,,2011,1971,,13358205,1580705261,294622480,,13356404,1578601452,294246338,,1801,2103809,376145,PDN
WC587,,2012,1971,,13358207,1579843031,294469059,,13358119,1579207890,294355958,,88,635141,113102,PDN
WC587,,2013,1971,,13358207,1579843031,294469059,,13358119,1579448233,294398723,,88,394798,70337,PDN
WC587,,2014,1971,,13360119,1586295025,295619015,,13358327,1579642977,294433585,,1792,6652048,1185430,PDN
WC587,,2015,1971,,13360621,1583346031,295094784,,13358838,1580906689,294658954,,1783,2439342,435831,PDN
WC587,,2016,1971,,13359039,1581126381,294698246,,13359039,1581126381,294698246,,0,0,0,PDN
WC587,,2017,1971,,13359039,1581126381,294698246,,13359039,1581126381,294698246,,0,0,0,PDN
WC587,,2017,1971,,13359039,1581126381,294698246,,13359039,1581126381,294698246,,0,0,0,PDN
WC589,,1986,1984,,31387,9416063,1706843,,0,0,0,,31387,9416063,1706843,PDN
WC589,,1987,1984,,31387,9416063,1706843,,0,0,0,,31387,9416063,1706843,PDN
WC589,,1990,1984,,2326,23257952,4140752,,65,3411531,607099,,2261,19846421,3533653,PDN
WC589,,1991,1984,,42326,35257952,6315983,,330,10668296,1898603,,41996,24589656,4417380,PDN
WC589,,1992,1984,,2326,23257952,4140752,,393,12616797,2245375,,1933,10641155,1895377,PDN
WC589,,1993,1984,,393,12646030,2250576,,393,12646030,2250576,,0,0,0,PDN
WC589,,1994,1984,,393,12646030,2250576,,393,12646030,2250576,,0,0,0,PDN
WC589,,1995,1984,,393,12646030,2250576,,393,12646030,2250576,,0,0,0,PDN
WC589,,1996,1984,,393,12646030,2250576,,393,12646030,2250576,,0,0,0,PDN
WC589,,1997,1984,,393,12646030,2250576,,393,12646030,2250576,,0,0,0,PDN
WC589,,1998,1984,,393,12646030,2250576,,393,12646030,2250576,,0,0,0,PDN
WC589,,1999,1984,,393,12646030,2250576,,393,12646030,2250576,,0,0,0,PDN
WC589,,2000,1984,,393,12646030,2250576,,393,12646030,2250576,,0,0,0,PDN
WC589,,2001,1984,,393,12646030,2250576,,393,12646030,2250576,,0,0,0,PDN
WC589,,2002,1984,,393,12646030,2250576,,393,12646030,2250576,,0,0,0,PDN
WC589,,2003,1984,,393,12646030,2250576,,393,12646030,2250576,,0,0,0,PDN
WC589,,2004,1984,,393,12646030,2250576,,393,12646030,2250576,,0,0,0,PDN
WC589,,2005,1984,,393,12646030,2250576,,393,12646030,2250576,,0,0,0,PDN
WC589,,2006,1984,,393,12646030,2250576,,393,12646030,2250576,,0,0,0,PDN
WC589,,2007,1984,,393,12646030,2250576,,393,12646030,2250576,,0,0,0,PDN
WC589,,2008,1984,,393,12646030,2250576,,393,12646030,2250576,,0,0,0,PDN
WC589,,2009,1984,,393,12899292,2295641,,393,12899292,2295641,,0,0,0,PDN
WC589,,2010,1984,,393,12899292,2295641,,393,12899292,2295641,,0,0,0,PDN
WC589,,2011,1984,,393,12899292,2295641,,393,12899292,2295641,,0,0,0,PDN
WC589,,2012,1984,,393,12899292,2295641,,393,12899292,2295641,,0,0,0,PDN
WC589,,2013,1984,,393,12899292,2295641,,393,12899292,2295641,,0,0,0,PDN
WC589,,2014,1984,,393,12899292,2295641,,393,12899292,2295641,,0,0,0,PDN
WC589,,2015,1984,,393,12899292,2295641,,393,12899292,2295641,,0,0,0,PDN
WC589,,2016,1984,,393,12899292,2295641,,393,12899292,2295641,,0,0,0,PDN
WC589,,2017,1984,,393,12899292,2295641,,393,12899292,2295641,,0,0,0,PDN
WC589,,2017,1984,,393,12899292,2295641,,393,12899292,2295641,,0,0,0,PDN
WC592,,1994,1987,,13479,1347910,253321,,0,0,0,,13479,1347910,253321,PDN
WC592,,1995,1987,,3096,3319226,593706,,0,385964,68677,,3096,2933262,525029,PDN
WC592,,1996,1987,,0,2061489,366813,,0,2056529,365930,,0,4960,883,PDN
WC592,,1997,1987,,0,2061489,366813,,0,2061489,366813,,0,0,0,PDN
WC592,,1998,1987,,0,2061489,366813,,0,2061489,366813,,0,0,0,PDN
WC592,,1999,1987,,0,2061489,366813,,0,2061489,366813,,0,0,0,PDN
WC592,,2000,1987,,0,2061489,366813,,0,2061489,366813,,0,0,0,PDN
WC592,,2001,1987,,0,2061489,366813,,0,2061489,366813,,0,0,0,PDN
WC592,,2002,1987,,0,2061489,366813,,0,2061489,366813,,0,0,0,PDN
WC592,,2003,1987,,0,2061489,366813,,0,2061489,366813,,0,0,0,PDN
WC592,,2004,1987,,0,2061489,366813,,0,2061489,366813,,0,0,0,PDN
WC592,,2005,1987,,0,2061489,366813,,0,2061489,366813,,0,0,0,PDN
WC592,,2006,1987,,0,2061489,366813,,0,2061489,366813,,0,0,0,PDN
WC592,,2007,1987,,0,2061489,366813,,0,2061489,366813,,0,0,0,PDN
WC592,,2008,1987,,0,2061489,366813,,0,2061489,366813,,0,0,0,PDN
WC592,,2009,1987,,0,2102774,374159,,0,2102774,374159,,0,0,0,PDN
WC592,,2010,1987,,0,2102774,374159,,0,2102774,374159,,0,0,0,PDN
WC592,,2011,1987,,0,2102774,374159,,0,2102774,374159,,0,0,0,PDN
WC592,,2012,1987,,0,2102774,374159,,0,2102774,374159,,0,0,0,PDN
WC592,,2013,1987,,0,2102774,374159,,0,2102774,374159,,0,0,0,PDN
WC592,,2014,1987,,0,2102774,374159,,0,2102774,374159,,0,0,0,PDN
WC592,,2015,1987,,0,2102774,374159,,0,2102774,374159,,0,0,0,PDN
WC592,,2016,1987,,0,2102774,374159,,0,2102774,374159,,0,0,0,PDN
WC592,,2017,1987,,0,2102774,374159,,0,2102774,374159,,0,0,0,PDN
WC592,,2017,1987,,0,2102774,374159,,0,2102774,374159,,0,0,0,PDN
WC598,,1998,1997,,141052,17443498,3244877,,0,0,0,,141052,17443498,3244877,PDN
WC598,,1999,1997,,141052,17443498,3244877,,0,0,0,,141052,17443498,3244877,PDN
WC598,,2000,1997,,2796,27953109,4976659,,0,0,0,,2796,27953109,4976659,PDN
WC598,,2001,1997,,1196,27948469,4974233,,92,7508559,1336135,,1104,20439910,3638098,PDN
WC598,,2002,1997,,243,28892785,5141308,,92,13996806,2490627,,151,14895979,2650681,PDN
WC598,,2003,1997,,154,28297666,5035326,,92,18631133,3315240,,62,9666533,1720086,PDN
WC598,,2004,1997,,120,32305593,5748446,,92,22041866,3922132,,28,10263727,1826314,PDN
WC598,,2005,1997,,120,32782331,5833275,,92,24313393,4326319,,28,8468938,1506956,PDN
WC598,,2006,1997,,92,27281523,4854456,,92,25749386,4581833,,0,1532137,272623,PDN
WC598,,2007,1997,,92,27281523,4854456,,92,26378863,4693840,,0,902660,160616,PDN
WC598,,2008,1997,,92,27273577,4853042,,92,26395167,4696741,,0,878410,156301,PDN
WC598,,2009,1997,,92,26395167,4696742,,92,26395167,4696742,,0,0,0,PDN
WC598,,2010,1997,,92,26395167,4696742,,92,26395167,4696742,,0,0,0,PDN
WC598,,2011,1997,,92,26395167,4696742,,92,26395167,4696742,,0,0,0,PDN
WC598,,2012,1997,,92,26395167,4696742,,92,26395167,4696742,,0,0,0,PDN
WC598,,2013,1997,,92,26395167,4696742,,92,26395167,4696742,,0,0,0,PDN
WC598,,2014,1997,,92,26395167,4696742,,92,26395167,4696742,,0,0,0,PDN
WC598,,2015,1997,,92,26395167,4696742,,92,26395167,4696742,,0,0,0,PDN
WC598,,2016,1997,,92,26395167,4696742,,92,26395167,4696742,,0,0,0,PDN
WC598,,2017,1997,,92,26395167,4696742,,92,26395167,4696742,,0,0,0,PDN
WC598,,2017,1997,,92,26395167,4696742,,92,26395167,4696742,,0,0,0,PDN
WC599,,1996,1987,,426257,24079272,4710825,,30471,1668991,327444,,395786,22410281,4383381,PDN
WC599,,1997,1987,,426257,24079272,4710825,,123554,7336126,1428914,,302703,16743146,3281911,PDN
WC599,,1998,1987,,426257,24079272,4710825,,166388,10285384,1996528,,259869,13793888,2714297,PDN
WC599,,1999,1987,,426257,24079272,4710825,,202006,13152487,2542306,,224251,10926785,2168519,PDN
WC599,,2000,1987,,481523,32704787,6300880,,227984,16520401,3167557,,253539,16184386,3133323,PDN
WC599,,2001,1987,,325822,32705513,6145308,,240575,18384981,3511924,,85247,14320532,2633384,PDN
WC599,,2002,1987,,325822,32705513,6145308,,252999,19557938,3733059,,72823,13147575,2412249,PDN
WC599,,2003,1987,,325273,29051083,5494505,,263406,20318569,3878810,,61867,8732514,1615695,PDN
WC599,,2004,1987,,332463,25315299,4836965,,271099,21133988,4031595,,61364,4181311,805370,PDN
WC599,,2005,1987,,655439,55364136,10506709,,292800,22772944,4344925,,362639,32591192,6161784,PDN
WC599,,2006,1987,,389633,33460636,6343483,,347337,27278570,5201175,,42296,6182066,1142308,PDN
WC599,,2007,1987,,389633,33460636,6343483,,354153,28223020,5376043,,35480,5237616,967440,PDN
WC599,,2008,1987,,389633,33460636,6343483,,356938,28668761,5458141,,32695,4791875,885342,PDN
WC599,,2009,1987,,356938,28857855,5491787,,356938,28857855,5491787,,0,0,0,PDN
WC599,,2010,1987,,356938,28857855,5491787,,356938,28857855,5491787,,0,0,0,PDN
WC599,,2011,1987,,356938,28857855,5491787,,356938,28857855,5491787,,0,0,0,PDN
WC599,,2012,1987,,356938,28857855,5491787,,356938,28857855,5491787,,0,0,0,PDN
WC599,,2013,1987,,356938,28857855,5491787,,356938,28857855,5491787,,0,0,0,PDN
WC599,,2014,1987,,356938,28857855,5491787,,356938,28857855,5491787,,0,0,0,PDN
WC599,,2015,1987,,356938,28857855,5491787,,356938,28857855,5491787,,0,0,0,PDN
WC599,,2016,1987,,356938,28857855,5491787,,356938,28857855,5491787,,0,0,0,PDN
WC599,,2017,1987,,356938,28857855,5491787,,356938,28857855,5491787,,0,0,0,PDN
WC599,,2017,1987,,356938,28857855,5491787,,356938,28857855,5491787,,0,0,0,PDN
WC600,,1996,1987,,34350,17175168,3090430,,0,0,0,,34350,17175168,3090430,PDN
WC600,,1997,1987,,34350,17175168,3090430,,0,0,0,,34350,17175168,3090430,PDN
WC600,,1998,1987,,34350,17175168,3090430,,0,0,0,,34350,17175168,3090430,PDN
WC600,,1999,1987,,18946,9473022,1704537,,39,1914856,340761,,18907,7558166,1363776,PDN
WC600,,2000,1987,,10827,20570584,3671073,,193,5501579,979122,,10634,15069005,2691951,PDN
WC600,,2001,1987,,11115,23739654,4235253,,193,9145753,1627551,,10922,14593901,2607702,PDN
WC600,,2002,1987,,11115,23739654,4235253,,193,11773022,2095037,,10922,11966632,2140216,PDN
WC600,,2003,1987,,11115,23739654,4235253,,193,13937743,2480218,,10922,9801911,1755035,PDN
WC600,,2004,1987,,9439,20804703,3711343,,193,15510888,2760137,,9246,5293815,951206,PDN
WC600,,2005,1987,,8020,20099644,3584469,,193,16045029,2855180,,7827,4054615,729289,PDN
WC600,,2006,1987,,8020,20099644,3584469,,193,16045029,2855180,,7827,4054615,729289,PDN
WC600,,2007,1987,,8020,20099644,3584469,,193,16045029,2855180,,7827,4054615,729289,PDN
WC600,,2008,1987,,193,16045029,2855180,,193,16045029,2855180,,0,0,0,PDN
WC600,,2009,1987,,193,16045029,2855180,,193,16045029,2855180,,0,0,0,PDN
WC600,,2010,1987,,193,16045029,2855180,,193,16045029,2855180,,0,0,0,PDN
WC600,,2011,1987,,193,16045029,2855180,,193,16045029,2855180,,0,0,0,PDN
WC600,,2012,1987,,193,16045029,2855180,,193,16045029,2855180,,0,0,0,PDN
WC600,,2013,1987,,193,16045029,2855180,,193,16045029,2855180,,0,0,0,PDN
WC600,,2014,1987,,193,16045029,2855180,,193,16045029,2855180,,0,0,0,PDN
WC600,,2015,1987,,193,16045029,2855180,,193,16045029,2855180,,0,0,0,PDN
WC600,,2016,1987,,193,16045029,2855180,,193,16045029,2855180,,0,0,0,PDN
WC600,,2017,1987,,193,16045029,2855180,,193,16045029,2855180,,0,0,0,PDN
WC600,,2017,1987,,193,16045029,2855180,,193,16045029,2855180,,0,0,0,PDN
WC604,,1991,1984,,566,8661567,1541770,,46,1000652,178098,,520,7660915,1363672,PDN
WC604,,1992,1984,,1363,10845618,1931188,,203,2203381,392264,,1160,8642237,1538924,PDN
WC604,,1993,1984,,1468,11620826,2069231,,424,5366027,955233,,1044,6254799,1113998,PDN
WC604,,1994,1984,,1468,11620826,2069231,,499,6762539,1203798,,969,4858287,865433,PDN
WC604,,1995,1984,,1468,11620826,2069231,,499,6762539,1203798,,969,4858287,865433,PDN
WC604,,1996,1984,,482,6587895,1172705,,482,6587895,1172705,,0,0,0,PDN
WC604,,1997,1984,,482,6587895,1172705,,482,6587895,1172705,,0,0,0,PDN
WC604,,1998,1984,,482,6587895,1172705,,482,6587895,1172705,,0,0,0,PDN
WC604,,1999,1984,,482,6587895,1172705,,482,6587895,1172705,,0,0,0,PDN
WC604,,2000,1984,,482,6587895,1172705,,482,6587895,1172705,,0,0,0,PDN
WC604,,2001,1984,,482,6587895,1172705,,482,6587895,1172705,,0,0,0,PDN
WC604,,2002,1984,,482,6587895,1172705,,482,6587895,1172705,,0,0,0,PDN
WC604,,2003,1984,,482,6587895,1172705,,482,6587895,1172705,,0,0,0,PDN
WC604,,2004,1984,,482,6587895,1172705,,482,6587895,1172705,,0,0,0,PDN
WC604,,2005,1984,,482,6587895,1172705,,482,6587895,1172705,,0,0,0,PDN
WC604,,2006,1984,,482,6587895,1172705,,482,6587895,1172705,,0,0,0,PDN
WC604,,2007,1984,,482,6587895,1172705,,482,6587895,1172705,,0,0,0,PDN
WC604,,2008,1984,,482,6587895,1172705,,482,6587895,1172705,,0,0,0,PDN
WC604,,2009,1984,,482,6719833,1196181,,482,6719833,1196181,,0,0,0,PDN
WC604,,2010,1984,,482,6719833,1196181,,482,6719833,1196181,,0,0,0,PDN
WC604,,2011,1984,,482,6719833,1196181,,482,6719833,1196181,,0,0,0,PDN
WC604,,2012,1984,,482,6719833,1196181,,482,6719833,1196181,,0,0,0,PDN
WC604,,2013,1984,,482,6719833,1196181,,482,6719833,1196181,,0,0,0,PDN
WC604,,2014,1984,,482,6719833,1196181,,482,6719833,1196181,,0,0,0,PDN
WC604,,2015,1984,,482,6719833,1196181,,482,6719833,1196181,,0,0,0,PDN
WC604,,2016,1984,,482,6719833,1196181,,482,6719833,1196181,,0,0,0,PDN
WC604,,2017,1984,,482,6719833,1196181,,482,6719833,1196181,,0,0,0,PDN
WC604,,2017,1984,,482,6719833,1196181,,482,6719833,1196181,,0,0,0,PDN
WC607,,1990,1978,,2351,23514485,4186423,,0,67119,11943,,2351,23447366,4174480,PDN
WC607,,1991,1978,,2078,26119994,4649764,,20,8108531,1442819,,2058,18011463,3206945,PDN
WC607,,1992,1978,,1115,42165899,7503944,,61,15899154,2829092,,1054,26266745,4674852,PDN
WC607,,1993,1978,,317,46473572,8269636,,73,23322156,4149923,,244,23151416,4119713,PDN
WC607,,1994,1978,,317,46470492,8269088,,73,27126911,4826925,,244,19343581,3442163,PDN
WC607,,1995,1978,,218,42853830,7625455,,73,29981823,5334917,,145,12872007,2290538,PDN
WC607,,1996,1978,,218,42853830,7625455,,73,30287948,5389388,,145,12565882,2236067,PDN
WC607,,1997,1978,,24853,50750774,9055240,,73,32686016,5816090,,24780,18064758,3239150,PDN
WC607,,1998,1978,,24521,48507397,8655730,,73,33250633,5916556,,24448,15256764,2739174,PDN
WC607,,1999,1978,,73,33508374,5962417,,73,33508374,5962417,,0,0,0,PDN
WC607,,2000,1978,,73,33508374,5962417,,73,33508374,5962417,,0,0,0,PDN
WC607,,2001,1978,,73,33508374,5962417,,73,33508374,5962417,,0,0,0,PDN
WC607,,2002,1978,,73,33508374,5962417,,73,33508374,5962417,,0,0,0,PDN
WC607,,2003,1978,,73,33508374,5962417,,73,33508374,5962417,,0,0,0,PDN
WC607,,2004,1978,,73,33508374,5962417,,73,33508374,5962417,,0,0,0,PDN
WC607,,2005,1978,,73,33508374,5962417,,73,33508374,5962417,,0,0,0,PDN
WC607,,2006,1978,,73,33508374,5962417,,73,33508374,5962417,,0,0,0,PDN
WC607,,2007,1978,,73,33508374,5962417,,73,33508374,5962417,,0,0,0,PDN
WC607,,2008,1978,,73,33508374,5962417,,73,33508374,5962417,,0,0,0,PDN
WC607,,2009,1978,,73,34170675,6080265,,73,34170675,6080265,,0,0,0,PDN
WC607,,2010,1978,,73,34170675,6080265,,73,34170675,6080265,,0,0,0,PDN
WC607,,2011,1978,,73,34170675,6080265,,73,34170675,6080265,,0,0,0,PDN
WC607,,2012,1978,,73,34170675,6080265,,73,34170675,6080265,,0,0,0,PDN
WC607,,2013,1978,,73,34170675,6080265,,73,34170675,6080265,,0,0,0,PDN
WC607,,2014,1978,,73,34170675,6080265,,73,34170675,6080265,,0,0,0,PDN
WC607,,2015,1978,,73,34170675,6080265,,73,34170675,6080265,,0,0,0,PDN
WC607,,2016,1978,,73,34170675,6080265,,73,34170675,6080265,,0,0,0,PDN
WC607,,2017,1978,,73,34170675,6080265,,73,34170675,6080265,,0,0,0,PDN
WC607,,2017,1978,,73,34170675,6080265,,73,34170675,6080265,,0,0,0,PDN
WC615,,1997,1995,,185663,170656372,30551565,,9824,8158870,1461580,,175839,162497502,29089985,PDN
WC615,,1998,1995,,167753,150672298,26977770,,12668,10850820,1943419,,155085,139821478,25034351,PDN
WC615,,1999,1995,,140190,132093967,23644455,,20414,19596926,3507412,,119776,112497041,20137043,PDN
WC615,,2000,1995,,145016,136331912,24403363,,23512,23476884,4200893,,121504,112855028,20202470,PDN
WC615,,2001,1995,,156330,136084300,24370618,,28356,27481722,4918342,,127974,108602578,19452276,PDN
WC615,,2002,1995,,46547,48587527,8692015,,31658,31620614,5658102,,14889,16966913,3033913,PDN
WC615,,2003,1995,,46523,48496270,8675753,,32993,33981365,6079499,,13530,14514905,2596254,PDN
WC615,,2004,1995,,47013,46591517,8337319,,33517,35338755,6321552,,13496,11252762,2015767,PDN
WC615,,2005,1995,,52982,54734632,9792240,,35137,36293200,6493002,,17845,18441432,3299238,PDN
WC615,,2006,1995,,57987,52939492,9477825,,35591,37349915,6681483,,22396,15589577,2796342,PDN
WC615,,2007,1995,,57987,52939492,9477825,,36030,38158810,6825854,,21957,14780682,2651971,PDN
WC615,,2008,1995,,39358,41158900,7363006,,36141,38399458,6868785,,3217,2759442,494221,PDN
WC615,,2009,1995,,36142,38597463,6904019,,36142,38597463,6904019,,0,0,0,PDN
WC615,,2010,1995,,36142,38597463,6904019,,36142,38597463,6904019,,0,0,0,PDN
WC615,,2011,1995,,36142,38597463,6904019,,36142,38597463,6904019,,0,0,0,PDN
WC615,,2012,1995,,36142,38597463,6904019,,36142,38597463,6904019,,0,0,0,PDN
WC615,,2013,1995,,36142,38597463,6904019,,36142,38597463,6904019,,0,0,0,PDN
WC615,,2014,1995,,36142,38597463,6904019,,36142,38597463,6904019,,0,0,0,PDN
WC615,,2015,1995,,36142,38597463,6904019,,36142,38597463,6904019,,0,0,0,PDN
WC615,,2016,1995,,36142,38597463,6904019,,36142,38597463,6904019,,0,0,0,PDN
WC615,,2017,1995,,36142,38597463,6904019,,36142,38597463,6904019,,0,0,0,PDN
WC615,,2017,1995,,36142,38597463,6904019,,36142,38597463,6904019,,0,0,0,PDN
WC617,,1976,1974,,489454,489454000,87580913,,0,0,0,,489454,489454000,87580913,PDN
WC617,,1977,1974,,516030,516030000,92336315,,315,39516176,7031663,,515715,476513824,85304652,PDN
WC617,,1978,1974,,573834,584576074,104590929,,3081,166758744,29675455,,570753,417817330,74915474,PDN
WC617,,1979,1974,,1038209,728037392,130582229,,79264,339711030,60526066,,958945,388326362,70056163,PDN
WC617,,1980,1974,,1261983,898333157,161107740,,244256,473067669,84419998,,1017727,425265488,76687742,PDN
WC617,,1981,1974,,1461903,951603157,170786308,,342812,554832112,99067387,,1119091,396771045,71718921,PDN
WC617,,1982,1974,,1385703,1044091157,187167048,,493247,646379953,115507474,,892456,397711204,71659574,PDN
WC617,,1983,1974,,1529871,1127112280,202083657,,642399,691157024,123624076,,887472,435955256,78459581,PDN
WC617,,1984,1974,,1606025,1084268222,194536314,,764847,723543100,129509171,,841178,360725122,65027143,PDN
WC617,,1985,1974,,1653652,1091328498,195840217,,918063,756843873,135587791,,735589,334484625,60252426,PDN
WC617,,1986,1974,,1636709,941834026,169222835,,1030095,783004773,140354788,,606614,158829253,28868047,PDN
WC617,,1987,1974,,1638151,979118789,175858576,,1114635,803155891,144024936,,523516,175962898,31833640,PDN
WC617,,1988,1974,,1921733,1013593116,182276380,,1192499,828338755,148583737,,729234,185254361,33692643,PDN
WC617,,1989,1974,,1631055,1057116622,189730098,,1219554,858150304,153915338,,411501,198966318,35814760,PDN
WC617,,1990,1974,,1367157,934243380,167602634,,1239672,854437170,153274756,,127485,79806210,14327878,PDN
WC617,,1991,1974,,1435031,937218515,168199891,,1251341,861354838,154517326,,183690,75863677,13682565,PDN
WC617,,1992,1974,,1419087,920422399,165195315,,1269036,868490864,155804777,,150051,51931535,9390538,PDN
WC617,,1993,1974,,1469620,938616160,168483172,,1281468,875996135,157152666,,188152,62620025,11330506,PDN
WC617,,1994,1974,,1478783,940890984,168897108,,1286014,882048222,158234096,,192769,58842762,10663012,PDN
WC617,,1995,1974,,1352456,907854530,162892408,,1289347,885201844,158798572,,63109,22652686,4093836,PDN
WC617,,1996,1974,,1346129,908070855,162924573,,1293284,888325556,159358330,,52845,19745299,3566243,PDN
WC617,,1997,1974,,1601933,950810775,170785345,,1486845,914658855,164237531,,115088,36151920,6547814,PDN
WC617,,1998,1974,,1697656,980697118,176198923,,1548778,935388714,167988051,,148878,45308404,8210872,PDN
WC617,,1999,1974,,1583043,987183435,177238458,,1570733,958416739,172107519,,12310,28766696,5130939,PDN
WC617,,2000,1974,,1594268,987485365,177303407,,1575413,967416833,173713640,,18855,20068532,3589767,PDN
WC617,,2001,1974,,1652553,998811620,179377040,,1589395,973594090,174826778,,63158,25217530,4550262,PDN
WC617,,2002,1974,,1607733,996406736,178904305,,1596512,976716855,175389547,,11221,19689881,3514758,PDN
WC617,,2003,1974,,1610768,1032118434,185261734,,1601549,985230218,176909417,,9219,46888216,8352317,PDN
WC617,,2004,1974,,1609272,1034391694,185664733,,1604348,1004076143,180265583,,4924,30315551,5399150,PDN
WC617,,2005,1974,,1610503,1061294022,190452856,,1606374,1016414536,182463053,,4129,44879486,7989803,PDN
WC617,,2006,1974,,1613876,1064860751,191090878,,1606576,1025644281,184105558,,7300,39216470,6985320,PDN
WC617,,2007,1974,,1608660,1051087246,188634860,,1607139,1029489863,184790389,,1521,21597383,3844471,PDN
WC617,,2008,1974,,1608565,1049732237,188393660,,1607177,1032800637,185379532,,1388,16931600,3014128,PDN
WC617,,2009,1974,,1607385,1063820125,190899225,,1607177,1052711987,188922481,,208,11108138,1976745,PDN
WC617,,2010,1974,,1607342,1063717622,190880943,,1607177,1054395822,189222095,,165,9321800,1658847,PDN
WC617,,2011,1974,,1607342,1061152165,190424456,,1607177,1057949143,189854359,,165,3203022,570098,PDN
WC617,,2012,1974,,1607342,1061152165,190424456,,1607177,1059061449,190052277,,165,2090716,372179,PDN
WC617,,2013,1974,,1607342,1061152165,190424456,,1607177,1059699710,190165848,,165,1452455,258609,PDN
WC617,,2014,1974,,1607342,1061152165,190424456,,1607177,1059822812,190187751,,165,1329353,236704,PDN
WC617,,2015,1974,,1607177,1059825873,190188296,,1607177,1059825873,190188296,,0,0,0,PDN
WC617,,2016,1974,,1607177,1059825873,190188296,,1607177,1059825873,190188296,,0,0,0,PDN
WC617,,2017,1974,,1607177,1059825873,190188296,,1607177,1059825873,190188296,,0,0,0,PDN
WC617,,2017,1974,,1607177,1059825873,190188296,,1607177,1059825873,190188296,,0,0,0,PDN
WC618,,1990,1981,,393,56452866,10045387,,123,26598102,4732881,,270,29854764,5312506,PDN
WC618,,1991,1981,,393,56452866,10045387,,160,34920757,6213818,,233,21532109,3831569,PDN
WC618,,1992,1981,,457,70477039,12540855,,287,42035025,7479829,,170,28442014,5061026,PDN
WC618,,1993,1981,,126384,85872433,15406176,,415,52527460,9346938,,125969,33344973,6059238,PDN
WC618,,1994,1981,,126384,85872433,15406176,,430,60623340,10787501,,125954,25249093,4618675,PDN
WC618,,1995,1981,,1717,97391066,17331088,,430,64998793,11566052,,1287,32392273,5765036,PDN
WC618,,1996,1981,,1717,97391066,17331088,,430,67586001,12026409,,1287,29805065,5304679,PDN
WC618,,1997,1981,,1717,97391066,17331088,,430,68899355,12260102,,1287,28491711,5070986,PDN
WC618,,1998,1981,,1717,97391066,17331088,,430,70117921,12476928,,1287,27273145,4854160,PDN
WC618,,1999,1981,,520,73790015,13130416,,430,70930196,12621461,,90,2859819,508955,PDN
WC618,,2000,1981,,448,71712734,12760721,,430,71584328,12737855,,18,128406,22866,PDN
WC618,,2001,1981,,1266,84308023,15002694,,528,73885475,13147410,,738,10422548,1855284,PDN
WC618,,2002,1981,,1330,84480369,15033424,,710,78789296,14020158,,620,5691073,1013266,PDN
WC618,,2003,1981,,1330,84480369,15033424,,805,80736252,14366686,,525,3744117,666738,PDN
WC618,,2004,1981,,1125,81940369,14581262,,805,81403779,14485463,,320,536590,95799,PDN
WC618,,2005,1981,,805,81795675,14555196,,805,81599775,14520338,,0,195900,34858,PDN
WC618,,2006,1981,,805,81661233,14531274,,805,81660837,14531203,,0,396,71,PDN
WC618,,2007,1981,,805,81660854,14531206,,805,81660854,14531206,,0,0,0,PDN
WC618,,2008,1981,,805,81886906,14571429,,805,81886906,14571429,,0,0,0,PDN
WC618,,2009,1981,,805,83285330,14820259,,805,83285330,14820259,,0,0,0,PDN
WC618,,2010,1981,,805,83285330,14820259,,805,83285330,14820259,,0,0,0,PDN
WC618,,2011,1981,,805,83285330,14820259,,805,83285330,14820259,,0,0,0,PDN
WC618,,2012,1981,,805,83285330,14820259,,805,83285330,14820259,,0,0,0,PDN
WC618,,2013,1981,,805,83285330,14820259,,805,83285330,14820259,,0,0,0,PDN
WC618,,2014,1981,,805,83285330,14820259,,805,83285330,14820259,,0,0,0,PDN
WC618,,2015,1981,,805,83285330,14820259,,805,83285330,14820259,,0,0,0,PDN
WC618,,2016,1981,,805,83285330,14820259,,805,83285330,14820259,,0,0,0,PDN
WC618,,2017,1981,,805,83285330,14820259,,805,83285330,14820259,,0,0,0,PDN
WC618,,2017,1981,,805,83285330,14820259,,805,83285330,14820259,,0,0,0,PDN
WC620,,1975,1973,,800000,74700000,14091815,,0,0,0,,800000,74700000,14091815,PDN
WC620,,1976,1973,,107987,107985599,19322506,,0,0,0,,107987,107985599,19322506,PDN
WC620,,1977,1973,,107987,107985599,19322506,,0,0,0,,107987,107985599,19322506,PDN
WC620,,1978,1973,,107987,107985599,19322506,,1831,5787280,1031596,,106156,102198319,18290910,PDN
WC620,,1979,1973,,206529,124489599,22357703,,47257,42585906,7624820,,159272,81903693,14732883,PDN
WC620,,1980,1973,,250741,189025900,33885243,,84871,73618406,13184231,,165870,115407494,20701012,PDN
WC620,,1981,1973,,399751,222535900,39996886,,130614,99347895,17808175,,269137,123188005,22188711,PDN
WC620,,1982,1973,,399751,222535900,39996886,,238020,139421262,25046074,,161731,83114638,14950812,PDN
WC620,,1983,1973,,404962,228464486,41057006,,271558,152621219,27428359,,133404,75843267,13628647,PDN
WC620,,1984,1973,,505705,247409441,44528737,,290780,164700557,29596929,,214925,82708884,14931808,PDN
WC620,,1985,1973,,501351,266449144,47912231,,306559,175861241,31598595,,194792,90587903,16313636,PDN
WC620,,1986,1973,,501351,266449144,47912231,,324899,185092141,33259444,,176452,81357003,14652787,PDN
WC620,,1987,1973,,501351,266449144,47912231,,337898,191755190,34458039,,163453,74693954,13454192,PDN
WC620,,1988,1973,,520547,269057570,48395559,,351785,196871278,35382262,,168762,72186292,13013297,PDN
WC620,,1989,1973,,555180,274547668,49407078,,393829,204417091,36766977,,161351,70130577,12640101,PDN
WC620,,1990,1973,,608898,276615442,49828728,,443059,210010602,37811494,,165839,66604840,12017234,PDN
WC620,,1991,1973,,767930,277388324,50125283,,475866,213742304,38508304,,292064,63646020,11616979,PDN
WC620,,1992,1973,,572096,226225647,40825770,,505355,216629035,39051447,,66741,9596612,1774323,PDN
WC620,,1993,1973,,665657,235831378,42628536,,543486,219647666,39626701,,122171,16183712,3001835,PDN
WC620,,1994,1973,,1097401,245486156,44778212,,615309,224302589,40526802,,482092,21183567,4251410,PDN
WC620,,1995,1973,,1060232,244714313,44603704,,646871,227144470,41064036,,413361,17569843,3539668,PDN
WC620,,1996,1973,,1130068,253604691,46255458,,754182,232637847,42148817,,375886,20966844,4106641,PDN
WC620,,1997,1973,,1130068,253604691,46255458,,841055,238688566,43312330,,289013,14916125,2943128,PDN
WC620,,1998,1973,,1130995,262870177,47905048,,845961,240443499,43629502,,285034,22426678,4275546,PDN
WC620,,1999,1973,,847674,254462515,46125702,,846782,248734014,45105503,,892,5728501,1020199,PDN
WC620,,2000,1973,,847810,269278722,48762173,,847150,256883655,46555985,,660,12395067,2206188,PDN
WC620,,2001,1973,,847766,268913817,48697200,,847279,260388291,47179715,,487,8525526,1517485,PDN
WC620,,2002,1973,,847845,268796847,48676465,,847405,261357676,47352330,,440,7439171,1324135,PDN
WC620,,2003,1973,,847437,261362850,47353282,,847413,261361225,47352969,,24,1625,313,PDN
WC620,,2004,1973,,847413,261361225,47352969,,847413,261361225,47352969,,0,0,0,PDN
WC620,,2005,1973,,847413,261361225,47352969,,847413,261361225,47352969,,0,0,0,PDN
WC620,,2006,1973,,847413,261361225,47352969,,847413,261361225,47352969,,0,0,0,PDN
WC620,,2007,1973,,847413,261361225,47352969,,847413,261361225,47352969,,0,0,0,PDN
WC620,,2008,1973,,878069,264426813,47929103,,847413,261361225,47352969,,30656,3065588,576134,PDN
WC620,,2009,1973,,847412,269226521,48752487,,847412,266157969,48206481,,0,3068552,546006,PDN
WC620,,2010,1973,,847412,269226521,48752487,,847412,269099771,48729933,,0,126750,22553,PDN
WC620,,2011,1973,,847412,269226521,48752487,,847412,269226521,48752487,,0,0,0,PDN
WC620,,2012,1973,,847412,269226521,48752487,,847412,269226521,48752487,,0,0,0,PDN
WC620,,2013,1973,,847412,269226521,48752487,,847412,269226521,48752487,,0,0,0,PDN
WC620,,2014,1973,,847412,269226521,48752487,,847412,269226521,48752487,,0,0,0,PDN
WC620,,2015,1973,,847412,269226521,48752487,,847412,269226521,48752487,,0,0,0,PDN
WC620,,2016,1973,,847412,269226521,48752487,,847412,269226521,48752487,,0,0,0,PDN
WC620,,2017,1973,,847412,269226521,48752487,,847412,269226521,48752487,,0,0,0,PDN
WC620,,2017,1973,,847412,269226521,48752487,,847412,269226521,48752487,,0,0,0,PDN
WC635,,1995,1995,,87851,21962625,3995791,,0,0,0,,87851,21962625,3995791,PDN
WC635,,1996,1995,,87851,21962625,3995791,,0,0,0,,87851,21962625,3995791,PDN
WC635,,2001,1995,,18262,8001778,1442066,,0,3114597,554199,,18262,4887181,887867,PDN
WC635,,2002,1995,,18262,8749040,1575031,,0,4183521,744399,,18262,4565519,830632,PDN
WC635,,2003,1995,,0,4338668,772005,,0,4338668,772005,,0,0,0,PDN
WC635,,2004,1995,,0,4338668,772005,,0,4338668,772005,,0,0,0,PDN
WC635,,2005,1995,,0,4338668,772005,,0,4338668,772005,,0,0,0,PDN
WC635,,2006,1995,,0,4338668,772005,,0,4338668,772005,,0,0,0,PDN
WC635,,2007,1995,,0,4338668,772005,,0,4338668,772005,,0,0,0,PDN
WC635,,2008,1995,,0,4338668,772005,,0,4338668,772005,,0,0,0,PDN
WC635,,2009,1995,,0,4338668,772005,,0,4338668,772005,,0,0,0,PDN
WC635,,2010,1995,,0,4338668,772005,,0,4338668,772005,,0,0,0,PDN
WC635,,2011,1995,,0,4338668,772005,,0,4338668,772005,,0,0,0,PDN
WC635,,2012,1995,,0,4338668,772005,,0,4338668,772005,,0,0,0,PDN
WC635,,2013,1995,,0,4338668,772005,,0,4338668,772005,,0,0,0,PDN
WC635,,2014,1995,,0,4338668,772005,,0,4338668,772005,,0,0,0,PDN
WC635,,2015,1995,,0,4338668,772005,,0,4338668,772005,,0,0,0,PDN
WC635,,2016,1995,,0,4338668,772005,,0,4338668,772005,,0,0,0,PDN
WC635,,2017,1995,,0,4338668,772005,,0,4338668,772005,,0,0,0,PDN
WC635,,2017,1995,,0,4338668,772005,,0,4338668,772005,,0,0,0,PDN
WC639,,1975,1971,,170434,170430250,30496101,,0,0,0,,170434,170430250,30496101,PDN
WC639,,1976,1971,,170434,170430250,30496101,,21550,20792813,3721339,,148884,149637437,26774762,PDN
WC639,,1977,1971,,7951358,201690450,43839338,,40491,61401385,10966004,,7910867,140289065,32873334,PDN
WC639,,1978,1971,,278202,258484972,46271969,,52853,90871443,16222149,,225349,167613529,30049820,PDN
WC639,,1979,1971,,279202,258484972,46272969,,62728,120403185,21486782,,216474,138081787,24786187,PDN
WC639,,1980,1971,,267881,268091722,47971034,,73524,146009628,26053885,,194357,122082094,21917149,PDN
WC639,,1981,1971,,277526,276288712,49439219,,73667,158950726,28356714,,203859,117337986,21082505,PDN
WC639,,1982,1971,,231187,283231702,50628287,,78661,173219917,30900710,,152526,110011785,19727577,PDN
WC639,,1983,1971,,549231,318614521,57242206,,120840,179657482,32088363,,428391,138957039,25153843,PDN
WC639,,1984,1971,,669867,361219392,64943780,,333092,214237579,38453658,,336775,146981813,26490122,PDN
WC639,,1985,1971,,1493440,447696130,81154673,,467757,246145124,44265822,,1025683,201551006,36888851,PDN
WC639,,1986,1971,,1493622,453911156,82260732,,485985,267497815,48083461,,1007637,186413341,34177271,PDN
WC639,,1987,1971,,1560761,483533251,87598706,,581503,297099260,53446140,,979258,186433991,34152566,PDN
WC639,,1988,1971,,1715255,498630444,90439533,,671393,320119980,57632244,,1043862,178510464,32807289,PDN
WC639,,1989,1971,,2222775,576043421,104721604,,751847,337956577,60886469,,1470928,238086844,43835135,PDN
WC639,,1990,1971,,1388472,489989730,88575257,,855311,356626516,64311986,,533161,133363214,24263271,PDN
WC639,,1991,1971,,1371888,469541918,84920272,,928819,374360074,67540932,,443069,95181844,17379340,PDN
WC639,,1992,1971,,1426190,456547355,82662374,,965552,384036046,69299368,,460638,72511309,13363006,PDN
WC639,,1993,1971,,1142127,439258585,79302018,,1008180,391114476,70601503,,133947,48144109,8700515,PDN
WC639,,1994,1971,,1169965,453511475,81865957,,1051610,402778903,72720454,,118355,50732572,9145503,PDN
WC639,,1995,1971,,1170008,452629561,81709076,,1094540,409505937,73960365,,75468,43123624,7748711,PDN
WC639,,1996,1971,,1343197,445702894,80649762,,1146444,416257132,75213549,,196753,29445762,5436213,PDN
WC639,,1997,1971,,1342100,446762801,80837260,,1189737,421224053,76140636,,152363,25538748,4696624,PDN
WC639,,1998,1971,,1795940,455877870,82912999,,1224299,424779044,76807759,,571641,31098826,6105240,PDN
WC639,,1999,1971,,1774796,449931359,81833757,,1346878,430597030,77965567,,427918,19334329,3868190,PDN
WC639,,2000,1971,,1721734,461568824,83851418,,1378141,432937770,78413331,,343593,28631054,5438087,PDN
WC639,,2001,1971,,1548685,466444378,84545905,,1402475,435980342,78979048,,146210,30464036,5566857,PDN
WC639,,2002,1971,,1459729,487871232,88269556,,1424539,444994006,80604967,,35190,42877226,7664589,PDN
WC639,,2003,1971,,1459778,487753722,88248696,,1434180,454813672,82361880,,25598,32940050,5886816,PDN
WC639,,2004,1971,,1480195,480207014,86926282,,1439615,457727500,82885789,,40580,22479514,4040493,PDN
WC639,,2005,1971,,1491962,491400951,88929854,,1442656,459154744,83142788,,49306,32246207,5787066,PDN
WC639,,2006,1971,,1475621,484009588,87598324,,1450710,462790724,83797814,,24911,21218864,3800510,PDN
WC639,,2007,1971,,1475621,484009588,87598324,,1454495,464103256,84035146,,21126,19906332,3563178,PDN
WC639,,2008,1971,,1475621,484010238,87598439,,1456877,464499283,84107995,,18744,19510955,3490444,PDN
WC639,,2009,1971,,1456880,472992108,85619180,,1456880,472992108,85619180,,0,0,0,PDN
WC639,,2010,1971,,1456880,472992108,85619180,,1456880,472992108,85619180,,0,0,0,PDN
WC639,,2011,1971,,1456880,472992108,85619180,,1456880,472992108,85619180,,0,0,0,PDN
WC639,,2012,1971,,1456880,472992108,85619180,,1456880,472992108,85619180,,0,0,0,PDN
WC639,,2013,1971,,1456880,472992108,85619180,,1456880,472992108,85619180,,0,0,0,PDN
WC639,,2014,1971,,1456880,472992108,85619180,,1456880,472992108,85619180,,0,0,0,PDN
WC639,,2015,1971,,1456880,472992108,85619180,,1456880,472992108,85619180,,0,0,0,PDN
WC639,,2016,1971,,1456880,472992108,85619180,,1456880,472992108,85619180,,0,0,0,PDN
WC639,,2017,1971,,1456880,472992108,85619180,,1456880,472992108,85619180,,0,0,0,PDN
WC639,,2017,1971,,1456880,472992108,85619180,,1456880,472992108,85619180,,0,0,0,PDN
WC643,,1975,1973,,0,76619705,13633399,,0,0,0,,0,76619705,13633399,PDP
WC643,,1976,1973,,0,76619705,13633399,,0,0,0,,0,76619705,13633399,PDP
WC643,,1977,1973,,126387,120147215,21504895,,14463,14955209,2675532,,111924,105192006,18829363,PDP
WC643,,1978,1973,,126387,120147215,21504895,,27403,34915022,6240040,,98984,85232193,15264855,PDP
WC643,,1979,1973,,127637,121397215,21728565,,36177,59670618,10653725,,91460,61726597,11074840,PDP
WC643,,1980,1973,,126017,149812975,26783130,,42592,83662035,14929075,,83425,66150940,11854055,PDP
WC643,,1981,1973,,159127,182922975,32707699,,52517,123865810,22092697,,106610,59057165,10615002,PDP
WC643,,1982,1973,,126057,227939975,40684771,,60785,165476479,29504998,,65272,62463496,11179773,PDP
WC643,,1983,1973,,128914,246195661,43935971,,63467,183486295,32712274,,65447,62709366,11223697,PDP
WC643,,1984,1973,,144883,259782233,46369480,,65434,200791879,35793526,,79449,58990354,10575954,PDP
WC643,,1985,1973,,147071,275787794,49219632,,66990,214340070,38205792,,80081,61447724,11013840,PDP
WC643,,1986,1973,,150012,285203183,50897909,,68916,223392471,39818466,,81096,61810712,11079443,PDP
WC643,,1987,1973,,153369,299655943,53472932,,71708,236017340,42067676,,81661,63638603,11405256,PDP
WC643,,1988,1973,,147795,339485653,60554495,,74169,247557865,44123611,,73626,91927788,16430884,PDP
WC643,,1989,1973,,325055,371741271,66471189,,107282,264297914,47135381,,217773,107443357,19335808,PDP
WC643,,1990,1973,,272591,345150932,61687348,,121401,275037014,49060371,,151190,70113918,12626977,PDP
WC643,,1991,1973,,276870,345933004,61830785,,128834,283653347,50600960,,148036,62279657,11229825,PDP
WC643,,1992,1973,,172021,323635032,57758326,,132441,289263505,51602816,,39580,34371527,6155510,PDP
WC643,,1993,1973,,294950,336396193,60151924,,139631,296680184,52929699,,155319,39716009,7222225,PDP
WC643,,1994,1973,,355634,356437101,63778606,,145673,303457451,54141661,,209961,52979650,9636945,PDP
WC643,,1995,1973,,183890,341397803,60930830,,150182,308409930,55027394,,33708,32987873,5903436,PDP
WC643,,1996,1973,,212337,376841976,67266069,,165591,326230497,58213722,,46746,50611479,9052347,PDP
WC643,,1997,1973,,212105,375044284,66945963,,173446,337012407,60140066,,38659,38031877,6805897,PDP
WC643,,1998,1973,,2357447,494389823,90327166,,1136168,367980005,66613037,,1221279,126409818,23714129,PDP
WC643,,1999,1973,,3089595,474228674,87471921,,1884876,401691197,73360178,,1204719,72537477,14111743,PDP
WC643,,2000,1973,,3368187,470766602,87134486,,2262731,425157710,77913569,,1105456,45608892,9220917,PDP
WC643,,2001,1973,,2765735,453808808,83514633,,2367675,434436257,79669500,,398060,19372551,3845133,PDP
WC643,,2002,1973,,2776238,459613903,84558071,,2423067,440042029,80722360,,353171,19571874,3835711,PDP
WC643,,2003,1973,,2587732,455662551,83666478,,2459746,443665980,81403871,,127986,11996571,2262607,PDP
WC643,,2004,1973,,2524137,457848063,83991764,,2473117,445345466,81716082,,51020,12502597,2275682,PDP
WC643,,2005,1973,,2593595,489514461,89695812,,2477278,447337853,82074761,,116317,42176608,7621051,PDP
WC643,,2006,1973,,2698038,512465743,93884113,,2491280,454637956,83387713,,206758,57827787,10496400,PDP
WC643,,2007,1973,,2646070,499877927,91592320,,2535233,465712023,85402141,,110837,34165904,6190179,PDP
WC643,,2008,1973,,2646070,499877927,91592320,,2550250,472128442,86558870,,95820,27749485,5033450,PDP
WC643,,2009,1973,,2565761,487257071,89266305,,2550335,479228018,87822223,,15426,8029053,1444083,PDP
WC643,,2010,1973,,2568275,479882714,87956657,,2557931,479493214,87877006,,10344,389500,79650,PDP
WC643,,2011,1973,,2568275,479882714,87956657,,2560632,479647432,87907148,,7643,235282,49508,PDP
WC643,,2012,1973,,2568275,479882714,87956657,,2562633,479715724,87921301,,5642,166990,35356,PDP
WC643,,2013,1973,,2568275,479882714,87956657,,2563124,479735939,87925389,,5151,146775,31268,PDP
WC643,,2014,1973,,2568275,479882714,87956657,,2565228,479766757,87932977,,3047,115957,23680,PDP
WC643,,2015,1973,,2568275,479882714,87956657,,2567751,479804141,87942152,,524,78573,14505,PDP
WC643,,2016,1973,,2570568,479882714,87958950,,2568285,479819967,87945502,,2283,62747,13448,PDP
WC643,,2017,1973,,2570568,479882714,87958950,,2569671,479853077,87952779,,897,29637,6170,PDP
WC643,,2017,1973,,2570568,479882714,87958950,,2569671,479853077,87952779,,897,29637,6170,PDP
WC661,,2000,1973,,16510541,7192620,17790367,,0,0,0,,16510541,7192620,17790367,PDN
WC661,,2001,1973,,16510541,7192620,17790367,,0,0,0,,16510541,7192620,17790367,PDN
WC661,,2002,1973,,9632289,10745879,11544367,,0,0,0,,9632289,10745879,11544367,PDN
WC661,,2003,1973,,7630649,8744239,9186564,,614388,1031401,797911,,7016261,7712838,8388653,PDN
WC661,,2004,1973,,7630649,8744239,9186564,,1391375,1562038,1669318,,6239274,7182201,7517246,PDN
WC661,,2005,1973,,12492266,13339088,14865769,,2100856,1910743,2440846,,10391410,11428345,12424923,PDN
WC661,,2006,1973,,12492266,12030537,14632931,,2624480,2390495,3049835,,9867786,9640042,11583096,PDN
WC661,,2007,1973,,12492266,11945954,14617881,,3304003,2686228,3781980,,9188263,9259726,10835901,PDN
WC661,,2008,1973,,12492266,11945954,14617881,,3756331,2895288,4271507,,8735935,9050666,10346374,PDN
WC661,,2009,1973,,4975480,3229087,5550051,,4082745,3020687,4620234,,892735,208400,929817,PDN
WC661,,2010,1973,,4975480,3229087,5550051,,4250300,3099334,4801783,,725180,129753,748268,PDN
WC661,,2011,1973,,4975480,3229087,5550051,,4370904,3178746,4936517,,604576,50341,613533,PDN
WC661,,2012,1973,,4975480,3592297,5614679,,4476650,3267471,5058051,,498830,324826,556628,PDN
WC661,,2013,1973,,4975480,3592297,5614679,,4554980,3320920,5145891,,420500,271377,468788,PDN
WC661,,2014,1973,,4975480,3592297,5614679,,4877912,3473127,5495906,,97568,119170,118773,PDN
WC661,,2015,1973,,5349820,3718125,6011408,,5083561,3584065,5721295,,266259,134060,290113,PDN
WC661,,2016,1973,,5349820,3718125,6011408,,5161536,3627442,5806988,,188284,90683,204420,PDN
WC661,,2017,1973,,5161536,3627442,5806988,,5161536,3627442,5806988,,0,0,0,PDN
WC661,,2017,1973,,5161536,3627442,5806988,,5161536,3627442,5806988,,0,0,0,PDN
WC663,,1987,1985,,26547,7963906,1443612,,0,0,0,,26547,7963906,1443612,PDN
WC663,,2006,1985,,84268,31124761,5622482,,7,982857,174893,,84261,30141904,5447589,PDN
WC663,,2007,1985,,84268,31124761,5622482,,7,3186816,567056,,84261,27937945,5055426,PDN
WC663,,2008,1985,,84153,31090367,5616247,,7,4017307,714830,,84146,27073060,4901417,PDN
WC663,,2009,1985,,316,5811282,1034352,,7,5181216,921931,,309,630066,112420,PDN
WC663,,2010,1985,,82,6618811,1177806,,50,6084984,1082787,,32,533827,95019,PDN
WC663,,2011,1985,,82,6618811,1177806,,55,6381113,1135484,,27,237698,42322,PDN
WC663,,2012,1985,,82,6618811,1177806,,82,6618811,1177806,,0,0,0,PDN
WC663,,2013,1985,,82,6618811,1177806,,82,6618811,1177806,,0,0,0,PDN
WC663,,2014,1985,,82,6618811,1177806,,82,6618811,1177806,,0,0,0,PDN
WC663,,2015,1985,,82,6618811,1177806,,82,6618811,1177806,,0,0,0,PDN
WC663,,2016,1985,,82,6618811,1177806,,82,6618811,1177806,,0,0,0,PDN
WC663,,2017,1985,,82,6618811,1177806,,82,6618811,1177806,,0,0,0,PDN
WC663,,2017,1985,,82,6618811,1177806,,82,6618811,1177806,,0,0,0,PDN
WD027,,1975,1949,,31000886,910000000,192922594,,19199022,593452964,124795635,,11801864,316547036,68126959,PDN
WD027,,1976,1949,,23666667,710000000,150001187,,19263780,593482184,124865592,,4402887,116517816,25135595,PDN
WD027,,1977,1949,,23666667,710000000,150001187,,20347260,595281569,126269247,,3319407,114718431,23731940,PDN
WD027,,1978,1949,,23666667,710000000,150001187,,20472214,605736084,128254435,,3194453,104263916,21746752,PDN
WD027,,1979,1949,,23666667,710000000,150001187,,12273077,568840481,113490244,,11393590,141159519,36510943,PDN
WD027,,1980,1949,,23666667,710000000,150001187,,12456990,579711724,115608542,,11209677,130288276,34392645,PDN
WD027,,1981,1949,,17020067,937964078,183917590,,12580333,586961400,117021863,,4439734,351002678,66895727,PDN
WD027,,1982,1949,,17048852,938992028,184129284,,12639263,588409262,117338420,,4409589,350582766,66790864,PDN
WD027,,1983,1949,,17048852,938992028,184129284,,12676275,589568497,117581702,,4372577,349423531,66547582,PDN
WD027,,1984,1949,,17389255,939332431,184530257,,12707095,590404086,117761203,,4682160,348928345,66769054,PDN
WD027,,1985,1949,,17389255,939332431,184530257,,12729209,590548941,117809092,,4660046,348783490,66721165,PDN
WD027,,1986,1949,,17422037,942774522,185175511,,12718547,592038872,118063542,,4703490,350735650,67111969,PDN
WD027,,1987,1949,,12745811,594902977,118600433,,12728207,592868600,118220840,,17604,2034377,379593,PDN
WD027,,1988,1949,,13195589,610061431,121747445,,12799921,596099756,118867493,,395668,13961675,2879952,PDN
WD027,,1989,1949,,13061057,605122591,120734116,,12859054,598775909,119402810,,202003,6346682,1331306,PDN
WD027,,1990,1949,,13061057,605122591,120734116,,12911044,601026046,119855180,,150013,4096545,878936,PDN
WD027,,1991,1949,,13273169,608560109,121557886,,12949777,602541429,120163554,,323392,6018680,1394332,PDN
WD027,,1992,1949,,13273169,608560109,121557886,,12986213,604140449,120484514,,286956,4419660,1073372,PDN
WD027,,1993,1949,,13295638,610132927,121860216,,13028153,605721724,120807819,,267485,4411203,1052397,PDN
WD027,,1994,1949,,13291870,619482587,123520088,,13097278,608820424,121428314,,194592,10662163,2091774,PDN
WD027,,1995,1949,,13958660,618376891,123990135,,13298298,612254634,122240404,,660362,6122257,1749731,PDN
WD027,,1996,1949,,13947549,619617858,124199837,,13541979,614727829,122924155,,405570,4890029,1275682,PDN
WD027,,1997,1949,,13957549,620117858,124298805,,13718025,616672364,123446204,,239524,3445494,852601,PDN
WD027,,1998,1949,,19835049,629349709,131818983,,14407695,618551922,124470315,,5427354,10797787,7348668,PDN
WD027,,1999,1949,,15103417,647325821,130285948,,13940727,619021478,124086897,,1162690,28304343,6199051,PDN
WD027,,2000,1949,,15094309,667545726,133874687,,14102429,625996500,125489707,,991880,41549226,8384980,PDN
WD027,,2001,1949,,15231855,668046235,134101292,,14224665,627432364,125867434,,1007190,40613871,8233858,PDN
WD027,,2002,1949,,15310324,669388456,134418590,,14346403,628303888,126144248,,963921,41084568,8274342,PDN
WD027,,2003,1949,,15046762,669500221,134174915,,14467084,629408060,126461401,,579678,40092161,7713514,PDN
WD027,,2004,1949,,15152857,666328070,133716570,,14558593,630054299,126667899,,594264,36273771,7048671,PDN
WD027,,2005,1949,,15117894,666032649,133629041,,14621481,630406195,126793402,,496413,35626454,6835639,PDN
WD027,,2006,1949,,15075215,666117531,133601466,,14683737,630946017,126951712,,391478,35171514,6649754,PDN
WD027,,2007,1949,,15085312,667147353,133794805,,14736497,632185089,127224947,,348815,34962264,6569858,PDN
WD027,,2008,1949,,15884813,667906751,134729431,,14779926,632604433,127342992,,1104887,35302318,7386439,PDN
WD027,,2009,1949,,15058082,652972000,131245270,,14823865,645206407,129629275,,234217,7765593,1615995,PDN
WD027,,2010,1949,,15074984,654971698,131617990,,14864684,645438976,129711475,,210300,9532722,1906515,PDN
WD027,,2011,1949,,15060397,653805890,131395963,,14900197,645670610,129788204,,160200,8135280,1607759,PDN
WD027,,2012,1949,,15060397,653805890,131395963,,14927948,645857263,129849168,,132449,7948627,1546796,PDN
WD027,,2013,1949,,15120936,654085070,131506179,,15004176,646218335,129989643,,116760,7866735,1516535,PDN
WD027,,2014,1949,,15049255,653232975,131282880,,15012463,646377353,130026225,,36792,6855622,1256653,PDN
WD027,,2015,1949,,15015874,646402838,130034172,,15014467,646393736,130031145,,1407,9102,3027,PDN
WD027,,2016,1949,,15015874,646402838,130034172,,15014515,646393736,130031193,,1359,9102,2979,PDN
WD027,,2017,1949,,15014515,646393736,130031193,,15014515,646393736,130031193,,0,0,0,PDN
WD027,,2017,1949,,15014515,646393736,130031193,,15014515,646393736,130031193,,0,0,0,PDN
WD030,,1975,1949,,500000000,650000000,615658363,,336132586,457520905,417542000,,163867414,192479095,198116363,PDP
WD030,,1976,1949,,500000000,650000000,615658363,,353245474,493062467,440979009,,146754526,156937533,174679354,PDP
WD030,,1977,1949,,500000000,650000000,615658363,,371323375,525136648,464764060,,128676625,124863352,150894303,PDP
WD030,,1978,1949,,500000000,650000000,615658363,,384553806,544660198,481468432,,115446194,105339802,134189931,PDP
WD030,,1979,1949,,500000000,650000000,615658363,,386154822,575392064,488537752,,113845178,74607936,127120611,PDP
WD030,,1980,1949,,500000000,650000000,615658363,,398423576,587452801,502952544,,101576424,62547199,112705819,PDP
WD030,,1981,1949,,472827093,735689870,603732764,,403706602,618022388,513674998,,69120491,117667482,90057766,PDP
WD030,,1982,1949,,476196082,742109049,608243955,,412511411,604369116,520050400,,63684671,137739933,88193555,PDP
WD030,,1983,1949,,459913607,715329956,587196517,,420983285,613923900,530222413,,38930322,101406056,56974104,PDP
WD030,,1984,1949,,472788781,736651759,603865606,,431514767,623991269,542545242,,41274014,112660490,61320364,PDP
WD030,,1985,1949,,486728914,744188202,619146744,,441180563,631686401,553580278,,45548351,112501801,65566466,PDP
WD030,,1986,1949,,500696904,798655729,642806464,,448719471,637185082,562097599,,51977433,161470647,80708865,PDP
WD030,,1987,1949,,505495742,806252869,648957107,,455807062,645551401,570673859,,49688680,160701468,78283248,PDP
WD030,,1988,1949,,500560900,807108490,644174510,,462259867,656052266,578995146,,38301033,151056224,65179364,PDP
WD030,,1989,1949,,506568732,826281026,653593826,,467777377,666055127,586292524,,38791355,160225899,67301302,PDP
WD030,,1990,1949,,512381953,744998903,644944035,,473457323,675093474,593580717,,38924630,69905429,51363318,PDP
WD030,,1991,1949,,514261609,750588743,647818325,,479527079,686761207,601726582,,34734530,63827536,46091743,PDP
WD030,,1992,1949,,515783919,770384473,652863007,,485392437,699267912,609817332,,30391482,71116561,43045675,PDP
WD030,,1993,1949,,517478097,772668440,654963585,,491136473,712347502,617888698,,26341624,60320938,37074887,PDP
WD030,,1994,1949,,521033611,778229330,659508581,,497042094,724338211,625927897,,23991517,53891119,33580684,PDP
WD030,,1995,1949,,526371976,797272147,668235347,,502830963,735113929,633634153,,23541013,62158218,34601194,PDP
WD030,,1996,1949,,541316547,808438855,685166877,,508645963,744488715,641117265,,32670584,63950140,44049612,PDP
WD030,,1997,1949,,542422157,814665967,687380514,,515171338,753317174,649213540,,27250819,61348793,38166974,PDP
WD030,,1998,1949,,555716408,864479264,709538341,,522653409,766478184,659037428,,33062999,98001080,50500913,PDP
WD030,,1999,1949,,564106685,858007285,716777021,,531110919,784428056,670688865,,32995766,73579229,46088156,PDP
WD030,,2000,1949,,565614604,837509967,714637729,,537511549,787587229,677651625,,28103055,49922738,36986104,PDP
WD030,,2001,1949,,565790867,840337585,715317128,,542744899,794685234,684147966,,23045968,45652351,31169162,PDP
WD030,,2002,1949,,573075081,855657181,725327249,,547861019,801289998,690439310,,25214062,54367183,34887939,PDP
WD030,,2003,1949,,567393426,855759862,719663864,,552109060,811255619,696460594,,15284366,44504243,23203270,PDP
WD030,,2004,1949,,567862044,855745520,720129930,,555517140,822823881,701927083,,12344904,32921639,18202847,PDP
WD030,,2005,1949,,571437289,898577066,731326447,,558047492,835954003,706793756,,13389797,62623063,24532691,PDP
WD030,,2006,1949,,574462829,932009287,740300780,,561763439,867831621,716181877,,12699390,64177666,24118903,PDP
WD030,,2007,1949,,574991371,935743734,741493815,,564960874,892072565,723692647,,10030497,43671169,17801168,PDP
WD030,,2008,1949,,580724981,953924222,750462387,,567506622,907553631,728993033,,13218359,46370591,21469354,PDP
WD030,,2009,1949,,641477356,968854476,813871391,,570380254,930403723,735932518,,71097102,38450753,77938873,PDP
WD030,,2010,1949,,644784577,973177452,817947825,,572720420,937858086,739599083,,72064157,35319366,78348742,PDP
WD030,,2011,1949,,649298327,970431774,821973020,,575118810,942894001,742893543,,74179517,27537773,79079477,PDP
WD030,,2012,1949,,652058897,972373338,825079064,,577807889,946714226,746262378,,74251008,25659112,78816686,PDP
WD030,,2013,1949,,654175415,975924636,827827486,,581563831,952082482,750973525,,72611584,23842154,76853961,PDP
WD030,,2014,1949,,594928632,980743132,769438089,,584720926,958754904,755317890,,10207706,21988228,14120201,PDP
WD030,,2015,1949,,593835950,987141021,769483820,,587058302,965857147,758919004,,6777648,21283874,10564814,PDP
WD030,,2016,1949,,593504975,987467793,769210988,,589270963,970553331,761967290,,4234012,16914462,7243700,PDP
WD030,,2017,1949,,594511488,983164335,769451763,,590686965,973271047,763866867,,3824523,9893288,5584898,PDP
WD030,,2017,1949,,594496488,983267622,769455142,,590686965,973271047,763866867,,3809523,9996575,5588276,PDP
WD035,,1975,1968,,7000350,120000000,28352663,,2743319,61401928,13668929,,4257031,58598072,14683734,PDN
WD035,,1976,1968,,4250000,170000000,34499110,,3109403,88812168,18912280,,1140597,81187832,15586830,PDN
WD035,,1977,1968,,4250000,170000000,34499110,,4050019,109631117,23557335,,199981,60368883,10941775,PDN
WD035,,1978,1968,,9224441,215903593,47641450,,4718416,119872633,26048066,,4506025,96030960,21593384,PDN
WD035,,1979,1968,,6707441,215903593,45124450,,3159605,130917905,26454606,,3547836,84985688,18669844,PDN
WD035,,1980,1968,,6710441,215903593,45127450,,3579389,153214525,30841760,,3131052,62689068,14285690,PDN
WD035,,1981,1968,,6710441,215903593,45127450,,3771176,170128577,34043165,,2939265,45775016,11084285,PDN
WD035,,1982,1968,,5003060,185010477,37923074,,4124859,177331998,35678595,,878201,7678479,2244479,PDN
WD035,,1983,1968,,6811820,249199655,51153396,,4194244,181763806,36536558,,2617576,67435849,14616838,PDN
WD035,,1984,1968,,6815808,257175807,52576628,,4248406,187058644,37532862,,2567402,70117163,15043766,PDN
WD035,,1985,1968,,7431950,274481834,56272134,,4381997,193672585,38843311,,3049953,80809249,17428823,PDN
WD035,,1986,1968,,8091909,321894717,65368549,,4475521,220196688,43656426,,3616388,101698029,21712123,PDN
WD035,,1987,1968,,7955884,322859748,65404238,,4595969,236115865,46609468,,3359915,86743883,18794770,PDN
WD035,,1988,1968,,6450539,328493898,64901411,,4691495,251591472,49458661,,1759044,76902426,15442750,PDN
WD035,,1989,1968,,6395957,364179842,71196641,,4732669,268592655,52524956,,1663288,95587187,18671685,PDN
WD035,,1990,1968,,5328484,328650294,63807184,,4763803,284533401,55392522,,564681,44116893,8414662,PDN
WD035,,1991,1968,,5328484,328650294,63807184,,4772615,292753474,56863980,,555869,35896820,6943204,PDN
WD035,,1992,1968,,4839311,325066313,62680292,,4781232,298553937,57904708,,58079,26512376,4775584,PDN
WD035,,1993,1968,,4871532,336056474,64668058,,4789726,305614491,59169529,,81806,30441983,5498529,PDN
WD035,,1994,1968,,4910846,336150161,64724042,,4816882,311358054,60218671,,93964,24792107,4505371,PDN
WD035,,1995,1968,,5687253,333780188,65078746,,4855456,314726345,60856585,,831797,19053843,4222161,PDN
WD035,,1996,1968,,5438132,338515248,65672162,,4920348,319366901,61747199,,517784,19148347,3924963,PDN
WD035,,1997,1968,,5359844,333365495,64677548,,4950136,323367519,62488840,,409708,9997976,2188708,PDN
WD035,,1998,1968,,5027395,343122441,66081210,,4970025,327015872,63157903,,57370,16106569,2923307,PDN
WD035,,1999,1968,,5036052,349418730,67210204,,4989610,332704696,64189734,,46442,16714034,3020470,PDN
WD035,,2000,1968,,5049414,355608595,68324965,,4998280,337577660,65065479,,51134,18030935,3259486,PDN
WD035,,2001,1968,,5056545,357628377,68691488,,5014241,340827377,65659682,,42304,16801000,3031806,PDN
WD035,,2002,1968,,5056573,357628687,68691571,,5018454,344368843,66294049,,38119,13259844,2397522,PDN
WD035,,2003,1968,,5052012,356705953,68522822,,5020330,346209643,66623469,,31682,10496310,1899353,PDN
WD035,,2004,1968,,5044889,359727347,69053314,,5021096,347176790,66796326,,23793,12550557,2256988,PDN
WD035,,2005,1968,,5044785,359875995,69079660,,5025655,348598348,67053831,,19130,11277647,2025829,PDN
WD035,,2006,1968,,5252079,365659510,70316049,,5027885,348752113,67083421,,224194,16907397,3232628,PDN
WD035,,2007,1968,,5253769,364305583,70076827,,5121314,351184608,67609678,,132455,13120975,2467149,PDN
WD035,,2008,1968,,5274993,364897718,70203413,,5177086,353092017,68004847,,97907,11805701,2198566,PDN
WD035,,2009,1968,,5242473,368254304,70768149,,5213484,361117041,69469184,,28989,7137263,1298964,PDN
WD035,,2010,1968,,5249500,368445964,70809279,,5237187,362207996,69687007,,12313,6237968,1122271,PDN
WD035,,2011,1968,,5262495,369874009,71076374,,5251853,363716302,69970055,,10642,6157707,1106319,PDN
WD035,,2012,1968,,5265036,369953473,71093055,,5254898,364421450,70098572,,10138,5532023,994483,PDN
WD035,,2013,1968,,5303864,372932098,71661888,,5274331,365324597,70278708,,29533,7607501,1383180,PDN
WD035,,2014,1968,,5348044,373692806,71841425,,5296649,367188520,70632684,,51395,6504286,1208741,PDN
WD035,,2015,1968,,5353292,373788737,71863743,,5310853,368649370,70906826,,42439,5139367,956917,PDN
WD035,,2016,1968,,5353227,373788737,71863678,,5311619,369042920,70977619,,41608,4745817,886059,PDN
WD035,,2017,1968,,5311619,369036595,70976493,,5311619,369036595,70976493,,0,0,0,PDN
WD035,,2017,1968,,5311619,369036595,70976493,,5311619,369036595,70976493,,0,0,0,PDN
WD038,,1988,1987,,18074,7229615,1304482,,0,0,0,,18074,7229615,1304482,PDN
WD038,,1989,1987,,18074,7229615,1304482,,9395,700592,134055,,8679,6529023,1170427,PDN
WD038,,1990,1987,,111225,7229615,1397633,,38595,2404368,466418,,72630,4825247,931215,PDN
WD038,,1991,1987,,39252,2436841,472854,,39252,2436841,472854,,0,0,0,PDN
WD038,,1992,1987,,39252,2436841,472854,,39252,2436841,472854,,0,0,0,PDN
WD038,,1993,1987,,39252,2436841,472854,,39252,2436841,472854,,0,0,0,PDN
WD038,,1994,1987,,39252,2436841,472854,,39252,2436841,472854,,0,0,0,PDN
WD038,,1995,1987,,39252,2436841,472854,,39252,2436841,472854,,0,0,0,PDN
WD038,,1996,1987,,39252,2436841,472854,,39252,2436841,472854,,0,0,0,PDN
WD038,,1997,1987,,39252,2436841,472854,,39252,2436841,472854,,0,0,0,PDN
WD038,,1998,1987,,39252,2436841,472854,,39252,2436841,472854,,0,0,0,PDN
WD038,,1999,1987,,39252,2436841,472854,,39252,2436841,472854,,0,0,0,PDN
WD038,,2000,1987,,1867759,7761682,3248841,,56274,3109160,609505,,1811485,4652522,2639336,PDN
WD038,,2001,1987,,1867537,7761237,3248540,,156975,3522562,783765,,1710562,4238675,2464775,PDN
WD038,,2002,1987,,632107,6441652,1778308,,340469,5771522,1367430,,291638,670130,410878,PDN
WD038,,2003,1987,,621990,6429715,1766067,,417420,5975646,1480702,,204570,454069,285365,PDN
WD038,,2004,1987,,628413,6429715,1772490,,441276,6098109,1526349,,187137,331606,246141,PDN
WD038,,2005,1987,,628413,6429715,1772490,,463164,6193315,1565177,,165249,236400,207313,PDN
WD038,,2006,1987,,643194,6440139,1789126,,511646,6274793,1628157,,131548,165346,160969,PDN
WD038,,2007,1987,,645363,6534388,1808065,,561809,6409121,1702222,,83554,125267,105843,PDN
WD038,,2008,1987,,646773,6536032,1809768,,563682,6412831,1704755,,83091,123201,105013,PDN
WD038,,2009,1987,,578261,6618188,1755875,,578261,6618188,1755875,,0,0,0,PDN
WD038,,2010,1987,,642950,6773342,1848172,,617789,6699206,1809819,,25161,74136,38352,PDN
WD038,,2011,1987,,640175,6769791,1844765,,631391,6747848,1832076,,8784,21943,12688,PDN
WD038,,2012,1987,,640175,6769791,1844765,,639957,6768884,1844386,,218,907,379,PDN
WD038,,2013,1987,,640175,6769791,1844765,,640175,6769791,1844765,,0,0,0,PDN
WD038,,2014,1987,,640175,6769791,1844765,,640175,6769791,1844765,,0,0,0,PDN
WD038,,2015,1987,,640175,6769791,1844765,,640175,6769791,1844765,,0,0,0,PDN
WD038,,2016,1987,,640175,6769791,1844765,,640175,6769791,1844765,,0,0,0,PDN
WD038,,2017,1987,,640175,6769791,1844765,,640175,6769791,1844765,,0,0,0,PDN
WD038,,2017,1987,,640175,6769791,1844765,,640175,6769791,1844765,,0,0,0,PDN
WD041,,1975,1963,,50000000,233000000,91459075,,42186580,137380052,66631429,,7813420,95619948,24827646,PDN
WD041,,1976,1963,,65000000,195000000,99697509,,44826585,147436634,71060862,,20173415,47563366,28636647,PDN
WD041,,1977,1963,,65000000,195000000,99697509,,47678331,153454731,74983443,,17321669,41545269,24714066,PDN
WD041,,1978,1963,,65000000,195000000,99697509,,49179294,158024190,77297477,,15820706,36975810,22400032,PDN
WD041,,1979,1963,,57590745,203000029,93711747,,47668715,133122699,71356028,,9922030,69877330,22355719,PDN
WD041,,1980,1963,,57604278,203798613,93867376,,48637018,139423039,73445388,,8967260,64375574,20421988,PDN
WD041,,1981,1963,,57774855,205797974,94393712,,49563151,143965892,75179858,,8211704,61832082,19213854,PDN
WD041,,1982,1963,,59419625,252895443,104418814,,50825171,184728579,83695025,,8594454,68166864,20723789,PDN
WD041,,1983,1963,,59534672,253046854,104560803,,51861397,188609259,85421763,,7673275,64437595,19139040,PDN
WD041,,1984,1963,,59994918,255350032,105430867,,52832988,191927448,86983779,,7161930,63422584,18447088,PDN
WD041,,1985,1963,,59994918,255737032,105499728,,53473867,194313776,88049272,,6521051,61423256,17450456,PDN
WD041,,1986,1963,,61104881,255729807,106608405,,54136564,197687490,89312274,,6968317,58042317,17296131,PDN
WD041,,1987,1963,,61584286,239782610,104250231,,54737399,201329241,90561107,,6846887,38453369,13689124,PDN
WD041,,1988,1963,,60662008,237202211,102868807,,55244597,203822360,91511921,,5417411,33379851,11356886,PDN
WD041,,1989,1963,,60711250,238283821,103110506,,55701578,205725153,92307477,,5009672,32558668,10803029,PDN
WD041,,1990,1963,,60878123,238483821,103312967,,55883637,206171388,92568937,,4994486,32312433,10744030,PDN
WD041,,1991,1963,,58279204,220254375,97470374,,56009710,206593498,92770119,,2269494,13660877,4700255,PDN
WD041,,1992,1963,,58115518,218836814,97054453,,56174840,207616610,93117297,,1940678,11220204,3937156,PDN
WD041,,1993,1963,,58115518,218836814,97054453,,56420353,210713541,93913866,,1695165,8123273,3140587,PDN
WD041,,1994,1963,,60544303,223498912,100312793,,56648308,213423057,94623941,,3895995,10075855,5688852,PDN
WD041,,1995,1963,,60533190,223449882,100292955,,56798086,215252272,95099202,,3735104,8197610,5193753,PDN
WD041,,1996,1963,,62033803,220579174,101282766,,56879803,216130828,95337246,,5154000,4448346,5945520,PDN
WD041,,1997,1963,,58703789,221873463,98183053,,56918311,216997713,95530004,,1785478,4875750,2653049,PDN
WD041,,1998,1963,,59545303,243573550,102885792,,57170877,226995255,97561492,,2374426,16578295,5324300,PDN
WD041,,1999,1963,,60467212,291457146,112327914,,57739301,246813092,101656221,,2727911,44644054,10671693,PDN
WD041,,2000,1963,,60632807,306301951,115134934,,58095377,261239217,104579223,,2537430,45062734,10555711,PDN
WD041,,2001,1963,,59500247,311249219,114882670,,58337172,273959015,107084328,,1163075,37290204,7798342,PDN
WD041,,2002,1963,,59643918,323797638,117259156,,58487709,280921981,108473827,,1156209,42875657,8785329,PDN
WD041,,2003,1963,,59588735,303612932,113612388,,58642216,285975202,109527483,,946519,17637730,4084905,PDN
WD041,,2004,1963,,59594837,300110939,112995360,,58742610,288342738,110049147,,852227,11768201,2946213,PDN
WD041,,2005,1963,,59412084,303122530,113348477,,58819849,289502657,110332777,,592235,13619873,3015700,PDN
WD041,,2006,1963,,59517472,307533246,114238690,,58911387,294269530,111272513,,606085,13263716,2966177,PDN
WD041,,2007,1963,,59551819,310597519,114818281,,59004760,299453640,112288326,,547059,11143879,2529955,PDN
WD041,,2008,1963,,59896812,311918002,115398236,,59099251,302752797,112969855,,797561,9165205,2428381,PDN
WD041,,2009,1963,,59928479,315217636,116017025,,59149567,309917525,114295031,,778912,5300111,1721992,PDN
WD041,,2010,1963,,60095903,316448478,116403459,,59219169,310981959,114554034,,876734,5466519,1849424,PDN
WD041,,2011,1963,,60900977,317037903,117313414,,59293128,311942683,114798942,,1607849,5095220,2514470,PDN
WD041,,2012,1963,,60452561,316880700,116837027,,59345001,312633682,114973767,,1107560,4247018,1863256,PDN
WD041,,2013,1963,,59688309,315067306,115750107,,59367135,312791964,115024066,,321174,2275342,726038,PDN
WD041,,2014,1963,,59367136,312794352,115024492,,59367136,312794352,115024492,,0,0,0,PDN
WD041,,2015,1963,,59367136,312794352,115024492,,59367136,312794352,115024492,,0,0,0,PDN
WD041,,2016,1963,,59367136,312794352,115024492,,59367136,312794352,115024492,,0,0,0,PDN
WD041,,2017,1963,,59367136,312794352,115024492,,59367136,312794352,115024492,,0,0,0,PDN
WD041,,2017,1963,,59367136,312794352,115024492,,59367136,312794352,115024492,,0,0,0,PDN
WD049,,1995,1994,,8344589,28628780,13438678,,0,0,0,,8344589,28628780,13438678,PDN
WD049,,1996,1994,,7768337,17629351,10905232,,0,2186132,388991,,7768337,15443219,10516241,PDN
WD049,,1997,1994,,7769401,28271167,12799858,,69,8784484,1563144,,7769332,19486683,11236714,PDN
WD049,,1998,1994,,7176628,30013931,12517185,,407,12832968,2283853,,7176221,17180963,10233332,PDN
WD049,,1999,1994,,7176628,30013931,12517185,,439,14402467,2563156,,7176189,15611464,9954029,PDN
WD049,,2000,1994,,7175944,23174777,11299570,,439,14992815,2668200,,7175505,8181962,8631370,PDN
WD049,,2001,1994,,7175944,23174777,11299570,,439,15554511,2768146,,7175505,7620266,8531424,PDN
WD049,,2002,1994,,7176243,26160801,11831190,,439,15871604,2824568,,7175804,10289197,9006622,PDN
WD049,,2003,1994,,7176243,26160801,11831190,,439,16101367,2865451,,7175804,10059434,8965739,PDN
WD049,,2004,1994,,439,16376700,2914443,,439,16218457,2886285,,0,158243,28158,PDN
WD049,,2005,1994,,439,16376700,2914443,,439,16236531,2889501,,0,140169,24942,PDN
WD049,,2006,1994,,439,16376700,2914443,,439,16236531,2889501,,0,140169,24942,PDN
WD049,,2007,1994,,439,16376700,2914443,,439,16236531,2889501,,0,140169,24942,PDN
WD049,,2008,1994,,439,16376700,2914443,,439,16236531,2889501,,0,140169,24942,PDN
WD049,,2009,1994,,439,16662740,2965339,,439,16475939,2932101,,0,186801,33239,PDN
WD049,,2010,1994,,439,16475939,2932101,,439,16475939,2932101,,0,0,0,PDN
WD049,,2011,1994,,439,16475939,2932101,,439,16475939,2932101,,0,0,0,PDN
WD049,,2012,1994,,439,16475939,2932101,,439,16475939,2932101,,0,0,0,PDN
WD049,,2013,1994,,439,16475939,2932101,,439,16475939,2932101,,0,0,0,PDN
WD049,,2014,1994,,439,16475939,2932101,,439,16475939,2932101,,0,0,0,PDN
WD049,,2015,1994,,439,16475939,2932101,,439,16475939,2932101,,0,0,0,PDN
WD049,,2016,1994,,439,16475939,2932101,,439,16475939,2932101,,0,0,0,PDN
WD049,,2017,1994,,439,16475939,2932101,,439,16475939,2932101,,0,0,0,PDN
WD049,,2017,1994,,439,16475939,2932101,,439,16475939,2932101,,0,0,0,PDN
WD050,,1986,1984,,392,3912730,696607,,0,145775,25939,,392,3766955,670668,PDN
WD050,,1987,1984,,392,3912730,696607,,0,1186997,211209,,392,2725733,485398,PDN
WD050,,1988,1984,,3365,33650861,5991063,,0,1766172,314265,,3365,31884689,5676798,PDN
WD050,,1989,1984,,3365,33650861,5991063,,0,1841000,327580,,3365,31809861,5663483,PDN
WD050,,1990,1984,,2783,27826998,4954206,,0,2139378,380672,,2783,25687620,4573534,PDN
WD050,,1991,1984,,256,2556123,455082,,0,2220967,395190,,256,335156,59892,PDN
WD050,,1992,1984,,256,2556123,455082,,0,2276386,405051,,256,279737,50031,PDN
WD050,,1993,1984,,256,2556123,455082,,0,2323250,413390,,256,232873,41692,PDN
WD050,,1994,1984,,256,2556123,455082,,0,2363744,420595,,256,192379,34487,PDN
WD050,,1995,1984,,255,2552749,454481,,0,2388867,425065,,255,163882,29416,PDN
WD050,,1996,1984,,263,2630236,468277,,0,2407238,428334,,263,222998,39943,PDN
WD050,,1997,1984,,263,2630236,468277,,0,2434132,433120,,263,196104,35157,PDN
WD050,,1998,1984,,263,2630236,468277,,0,2449442,435844,,263,180794,32433,PDN
WD050,,1999,1984,,263,2630236,468277,,0,2457604,437296,,263,172632,30981,PDN
WD050,,2000,1984,,263,2630236,468277,,0,2469395,439394,,263,160841,28883,PDN
WD050,,2001,1984,,263,2630236,468277,,0,2477863,440901,,263,152373,27376,PDN
WD050,,2002,1984,,263,2630236,468277,,0,2483579,441918,,263,146657,26359,PDN
WD050,,2003,1984,,263,2630236,468277,,0,2493386,443663,,263,136850,24614,PDN
WD050,,2004,1984,,0,2629538,467889,,0,2500864,444994,,0,128674,22895,PDN
WD050,,2005,1984,,0,2629538,467889,,0,2503500,445463,,0,126038,22426,PDN
WD050,,2006,1984,,0,2550213,453775,,0,2503578,445477,,0,46635,8298,PDN
WD050,,2007,1984,,0,2503788,445514,,0,2503788,445514,,0,0,0,PDN
WD050,,2008,1984,,0,2503788,445514,,0,2503788,445514,,0,0,0,PDN
WD050,,2009,1984,,0,2552763,454229,,0,2552763,454229,,0,0,0,PDN
WD050,,2010,1984,,0,2552763,454229,,0,2552763,454229,,0,0,0,PDN
WD050,,2011,1984,,0,2552763,454229,,0,2552763,454229,,0,0,0,PDN
WD050,,2012,1984,,0,2552763,454229,,0,2552763,454229,,0,0,0,PDN
WD050,,2013,1984,,0,2552763,454229,,0,2552763,454229,,0,0,0,PDN
WD050,,2014,1984,,0,2552763,454229,,0,2552763,454229,,0,0,0,PDN
WD050,,2015,1984,,0,2552763,454229,,0,2552763,454229,,0,0,0,PDN
WD050,,2016,1984,,0,2552763,454229,,0,2552763,454229,,0,0,0,PDN
WD050,,2017,1984,,0,2552763,454229,,0,2552763,454229,,0,0,0,PDN
WD050,,2017,1984,,0,2552763,454229,,0,2552763,454229,,0,0,0,PDN
WD058,,1975,1954,,5801345,77487279,19589117,,5324319,70992704,17956473,,477026,6494575,1632644,PDN
WD058,,1976,1954,,5801345,77487279,19589117,,5650888,73655351,18756822,,150457,3831928,832295,PDN
WD058,,1977,1954,,5743682,77023163,19448871,,5556407,74527003,18817440,,187275,2496160,631431,PDN
WD058,,1978,1954,,5743682,77023163,19448871,,5601908,75046759,18955424,,141774,1976404,493447,PDN
WD058,,1979,1954,,5743682,77023163,19448871,,5640208,75333516,19044748,,103474,1689647,404123,PDN
WD058,,1980,1954,,5786860,77200924,19523679,,5644162,75393170,19059317,,142698,1807754,464362,PDN
WD058,,1981,1954,,8414916,116336701,29115397,,6255443,84794861,21343497,,2159473,31541840,7771900,PDN
WD058,,1982,1954,,8514916,116336701,29215397,,6656173,89170499,22522810,,1858743,27166202,6692587,PDN
WD058,,1983,1954,,9210470,120448629,30642610,,6920626,92431125,23367445,,2289844,28017504,7275165,PDN
WD058,,1984,1954,,9867490,131460053,33258959,,7725109,103309934,26107660,,2142381,28150119,7151299,PDN
WD058,,1985,1954,,10790797,149171772,37333817,,8249364,114650494,28649808,,2541433,34521278,8684009,PDN
WD058,,1986,1954,,10874031,150563908,37664762,,8533078,120576822,29988029,,2340953,29987086,7676733,PDN
WD058,,1987,1954,,11238066,157844596,39324293,,8806332,127361025,31468436,,2431734,30483571,7855857,PDN
WD058,,1988,1954,,11651566,159835957,40092128,,8953515,128605262,31837014,,2698051,31230695,8255114,PDN
WD058,,1989,1954,,11651566,162253762,40522342,,9078503,129662742,32150165,,2573063,32591020,8372177,PDN
WD058,,1990,1954,,11651566,162253762,40522342,,9156456,130493389,32375920,,2495110,31760373,8146422,PDN
WD058,,1991,1954,,9504590,133100337,33187924,,9186816,130929487,32483878,,317774,2170850,704046,PDN
WD058,,1992,1954,,9504590,133100337,33187924,,9239012,131450085,32628707,,265578,1650252,559217,PDN
WD058,,1993,1954,,9504590,133100337,33187924,,9290280,132165381,32807252,,214310,934956,380672,PDN
WD058,,1994,1954,,9504557,133100040,33187838,,9315779,132596963,32909545,,188778,503077,278293,PDN
WD058,,1995,1954,,10084880,141696270,35297739,,9543157,135428688,33640788,,541723,6267582,1656951,PDN
WD058,,1996,1954,,10359584,145691975,36283423,,9710237,137566890,34188331,,649347,8125085,2095092,PDN
WD058,,1997,1954,,10359584,145691975,36283423,,9889338,139671934,34741995,,470246,6020041,1541428,PDN
WD058,,1998,1954,,10466320,148918492,36964272,,10100952,142794094,35509154,,365368,6124398,1455118,PDN
WD058,,1999,1954,,10345748,147056406,36512368,,10253956,144694150,36000246,,91792,2362256,512122,PDN
WD058,,2000,1954,,11471702,161728401,40248998,,10604937,149573104,37219368,,866765,12155297,3029630,PDN
WD058,,2001,1954,,11794374,166391029,41401319,,11123801,156799028,39023984,,670573,9592001,2377335,PDN
WD058,,2002,1954,,12044950,169505821,42206128,,11384182,159920016,39839701,,660768,9585805,2366427,PDN
WD058,,2003,1954,,11881996,166974034,41592678,,11698020,163978156,40875628,,183976,2995878,717050,PDN
WD058,,2004,1954,,12261260,177209973,43793284,,11834269,166664733,41489915,,426991,10545240,2303369,PDN
WD058,,2005,1954,,12044661,171130810,42494983,,11882582,167644096,41712492,,162079,3486714,782491,PDN
WD058,,2006,1954,,12038032,171325087,42522923,,11918343,168308353,41866449,,119689,3016734,656474,PDN
WD058,,2007,1954,,12104392,173545185,42984318,,11974713,169447441,42125503,,129679,4097744,858815,PDN
WD058,,2008,1954,,12158731,174273953,43168331,,12004191,170192747,42287598,,154540,4081206,880733,PDN
WD058,,2009,1954,,12220045,177186517,43747897,,12060096,174344972,43082334,,159949,2841545,665562,PDN
WD058,,2010,1954,,12237770,177747061,43865362,,12165346,176258205,43528018,,72424,1488856,337346,PDN
WD058,,2011,1954,,12308477,180536032,44432328,,12200333,177419789,43769692,,108144,3116243,662636,PDN
WD058,,2012,1954,,12268230,180767252,44433223,,12244102,179283285,44145044,,24128,1483967,288179,PDN
WD058,,2013,1954,,12293128,182297800,44730460,,12253762,180218642,44321137,,39366,2079158,409323,PDN
WD058,,2014,1954,,12309046,181375204,44582215,,12266388,180805458,44438179,,42658,569746,144036,PDN
WD058,,2015,1954,,12266508,180805458,44438299,,12266508,180805458,44438299,,0,0,0,PDN
WD058,,2016,1954,,12266508,180805458,44438299,,12266508,180805458,44438299,,0,0,0,PDN
WD058,,2017,1954,,12266508,180805458,44438299,,12266508,180805458,44438299,,0,0,0,PDN
WD058,,2017,1954,,12266508,180805458,44438299,,12266508,180805458,44438299,,0,0,0,PDN
WD060,,1996,1996,,295320,1476600,558060,,1650,4750,2495,,293670,1471850,555565,PDN
WD060,,1997,1996,,295320,1476600,558060,,200816,948024,369504,,94504,528576,188556,PDN
WD060,,1998,1996,,359963,1911097,700016,,359963,1911097,700016,,0,0,0,PDN
WD060,,1999,1996,,605015,3545390,1235867,,382964,2249302,783196,,222051,1296088,452671,PDN
WD060,,2000,1996,,605015,3545390,1235867,,418657,2684808,896381,,186358,860582,339486,PDN
WD060,,2001,1996,,420759,2701422,901439,,420759,2701422,901439,,0,0,0,PDN
WD060,,2002,1996,,420759,2701422,901439,,420759,2701422,901439,,0,0,0,PDN
WD060,,2003,1996,,420759,2701422,901439,,420759,2701422,901439,,0,0,0,PDN
WD060,,2004,1996,,420759,2701422,901439,,420759,2701422,901439,,0,0,0,PDN
WD060,,2005,1996,,420759,2701422,901439,,420759,2701422,901439,,0,0,0,PDN
WD060,,2006,1996,,420759,2701422,901439,,420759,2701422,901439,,0,0,0,PDN
WD060,,2007,1996,,420759,2701422,901439,,420759,2701422,901439,,0,0,0,PDN
WD060,,2008,1996,,420759,2701422,901439,,420759,2701422,901439,,0,0,0,PDN
WD060,,2009,1996,,420759,2735618,907524,,420759,2735618,907524,,0,0,0,PDN
WD060,,2010,1996,,420759,2735618,907524,,420759,2735618,907524,,0,0,0,PDN
WD060,,2011,1996,,420759,2735618,907524,,420759,2735618,907524,,0,0,0,PDN
WD060,,2012,1996,,420759,2735618,907524,,420759,2735618,907524,,0,0,0,PDN
WD060,,2013,1996,,420759,2735618,907524,,420759,2735618,907524,,0,0,0,PDN
WD060,,2014,1996,,420759,2735618,907524,,420759,2735618,907524,,0,0,0,PDN
WD060,,2015,1996,,420759,2735618,907524,,420759,2735618,907524,,0,0,0,PDN
WD060,,2016,1996,,420759,2735618,907524,,420759,2735618,907524,,0,0,0,PDN
WD060,,2017,1996,,420759,2735618,907524,,420759,2735618,907524,,0,0,0,PDN
WD060,,2017,1996,,420759,2735618,907524,,420759,2735618,907524,,0,0,0,PDN
WD061,,1979,1964,,157872,74200000,13360719,,40786,18961123,3414651,,117086,55238877,9946068,PDN
WD061,,1980,1964,,136978,53522849,9660617,,32542,15776931,2839825,,104436,37745918,6820792,PDN
WD061,,1981,1964,,136978,53522849,9660617,,40339,22018256,3958178,,96639,31504593,5702439,PDN
WD061,,1982,1964,,136978,53522849,9660617,,42341,26348522,4730690,,94637,27174327,4929927,PDN
WD061,,1983,1964,,143137,54754720,9885970,,46938,28234629,5070893,,96199,26520091,4815077,PDN
WD061,,1984,1964,,144631,56248785,10153312,,53780,31323157,5627295,,90851,24925628,4526017,PDN
WD061,,1985,1964,,146422,58039836,10473795,,55489,32188071,5782904,,90933,25851765,4690891,PDN
WD061,,1986,1964,,159939,58039836,10487312,,58341,33170241,5960519,,101598,24869595,4526793,PDN
WD061,,1987,1964,,174999,59724684,10802167,,82526,36618126,6598207,,92473,23106558,4203960,PDN
WD061,,1988,1964,,4590723,80547285,18922980,,102358,43150194,7780328,,4488365,37397091,11142652,PDN
WD061,,1989,1964,,4590723,80547285,18922980,,113003,45520211,8212685,,4477720,35027074,10710295,PDN
WD061,,1990,1964,,5096274,95345410,22061649,,239318,50840735,9285712,,4856956,44504675,12775937,PDN
WD061,,1991,1964,,1709165,78115580,15608734,,355022,57226494,10537672,,1354143,20889086,5071062,PDN
WD061,,1992,1964,,1750787,84317209,16753849,,464736,62272501,11545252,,1286051,22044708,5208597,PDN
WD061,,1993,1964,,1764736,93728088,18442332,,523629,66656989,12384303,,1241107,27071099,6058029,PDN
WD061,,1994,1964,,661490,89736967,16628922,,487489,67819642,12555041,,174001,21917325,4073881,PDN
WD061,,1995,1964,,680706,79027301,14742503,,539869,71116753,13194096,,140837,7910548,1548407,PDN
WD061,,1996,1964,,599084,82291988,15241786,,557953,73809081,13691241,,41131,8482907,1550545,PDN
WD061,,1997,1964,,3689149,84379603,18703313,,1001778,76130244,14548085,,2687371,8249359,4155228,PDN
WD061,,1998,1964,,3689149,84379697,18703330,,1108995,77453262,14890714,,2580154,6926435,3812616,PDN
WD061,,1999,1964,,4284745,98502501,21811881,,1535165,84507779,16572136,,2749580,13994722,5239745,PDN
WD061,,2000,1964,,4375749,99178838,22023230,,2099388,86580988,17505258,,2276361,12597850,4517972,PDN
WD061,,2001,1964,,2843348,99679809,20579969,,2286709,88060302,17955802,,556639,11619507,2624167,PDN
WD061,,2002,1964,,3017063,100653228,20926890,,2303897,88168158,17992181,,713166,12485070,2934709,PDN
WD061,,2003,1964,,2901281,91043098,19101121,,2456941,88940203,18282600,,444340,2102895,818521,PDN
WD061,,2004,1964,,3344589,99372140,21026464,,2597806,89923259,18598386,,746783,9448881,2428078,PDN
WD061,,2005,1964,,3344589,99372140,21026464,,2728085,91867426,19074602,,616504,7504714,1951862,PDN
WD061,,2006,1964,,3342093,100921231,21299607,,2731060,93036950,19285677,,611033,7884281,2013930,PDN
WD061,,2007,1964,,3342117,100216936,21174312,,2763777,93989699,19487923,,578340,6227237,1686389,PDN
WD061,,2008,1964,,3342739,103665769,21788605,,2819451,94624900,19656622,,523288,9040869,2131983,PDN
WD061,,2009,1964,,3043523,100563685,20937415,,2882482,97518340,20234500,,161041,3045345,702916,PDN
WD061,,2010,1964,,3031680,100414766,20899076,,2935121,98501379,20462058,,96559,1913387,437017,PDN
WD061,,2011,1964,,3092210,100789580,21026300,,2977573,98825328,20562151,,114637,1964252,464147,PDN
WD061,,2012,1964,,3092210,100789580,21026300,,2990793,99147983,20632783,,101417,1641597,393516,PDN
WD061,,2013,1964,,3092210,100979923,21060168,,3011894,99264038,20674534,,80316,1715885,385633,PDN
WD061,,2014,1964,,3037020,100705836,20956209,,3016524,99354541,20695269,,20496,1351295,260939,PDN
WD061,,2015,1964,,3037076,100705836,20956265,,3016580,99392462,20702072,,20496,1313374,254192,PDN
WD061,,2016,1964,,3016580,99394028,20702351,,3016580,99394028,20702351,,0,0,0,PDN
WD061,,2017,1964,,3016580,99394028,20702351,,3016580,99394028,20702351,,0,0,0,PDN
WD061,,2017,1964,,3016580,99394028,20702351,,3016580,99394028,20702351,,0,0,0,PDN
WD064,,1975,1963,,28485,15221512,2736939,,15376,7457411,1342317,,13109,7764101,1394622,PDN
WD064,,1976,1963,,28485,15221512,2736939,,17623,10157494,1825006,,10862,5064018,911933,PDN
WD064,,1977,1963,,34381,19292560,3467221,,18992,11477990,2061339,,15389,7814570,1405882,PDN
WD064,,1978,1963,,34381,19292560,3467221,,19934,12119370,2176406,,14447,7173190,1290815,PDN
WD064,,1979,1963,,34381,19292560,3467221,,20219,12254845,2200796,,14162,7037715,1266425,PDN
WD064,,1980,1963,,33125,19293833,3466191,,20219,12254845,2200796,,12906,7038988,1265395,PDN
WD064,,1981,1963,,33125,19293833,3466191,,20219,12254845,2200796,,12906,7038988,1265395,PDN
WD064,,1982,1963,,24249,16399609,2942329,,20219,13686684,2455572,,4030,2712925,486757,PDN
WD064,,1983,1963,,25409,22776355,4078141,,20556,14640941,2625706,,4853,8135414,1452435,PDN
WD064,,1984,1963,,26705,24072500,4310068,,20556,14989755,2687772,,6149,9082745,1622296,PDN
WD064,,1985,1963,,26705,24072500,4310068,,20556,15194751,2724248,,6149,8877749,1585820,PDN
WD064,,1986,1963,,4389650,27236346,9235975,,20556,15223826,2729422,,4369094,12012520,6506553,PDN
WD064,,1987,1963,,4389650,27236346,9235975,,20556,15223826,2729422,,4369094,12012520,6506553,PDN
WD064,,1988,1963,,20219,12253895,2200627,,20219,12253895,2200627,,0,0,0,PDN
WD064,,1989,1963,,20219,12253895,2200627,,20219,12253895,2200627,,0,0,0,PDN
WD064,,1990,1963,,20219,12253895,2200627,,20219,12253895,2200627,,0,0,0,PDN
WD064,,1991,1963,,20219,12253895,2200627,,20219,12253895,2200627,,0,0,0,PDN
WD064,,1992,1963,,20219,12253895,2200627,,20219,12253895,2200627,,0,0,0,PDN
WD064,,1993,1963,,20219,12253895,2200627,,20219,12253895,2200627,,0,0,0,PDN
WD064,,1994,1963,,1272245,29830199,6580110,,190618,15553226,2958096,,1081627,14276973,3622014,PDN
WD064,,1995,1963,,1223623,23749966,5449596,,210988,15581734,2983539,,1012635,8168232,2466057,PDN
WD064,,1996,1963,,20556,15223826,2729422,,20556,15223826,2729422,,0,0,0,PDN
WD064,,1997,1963,,20556,15223826,2729422,,20556,15223826,2729422,,0,0,0,PDN
WD064,,1998,1963,,20556,15223826,2729422,,20556,15223826,2729422,,0,0,0,PDN
WD064,,1999,1963,,20556,15223826,2729422,,20556,15223826,2729422,,0,0,0,PDN
WD064,,2000,1963,,20556,15223826,2729422,,20556,15223826,2729422,,0,0,0,PDN
WD064,,2001,1963,,20556,15223826,2729422,,20556,15223826,2729422,,0,0,0,PDN
WD064,,2002,1963,,20556,15223826,2729422,,20556,15223826,2729422,,0,0,0,PDN
WD064,,2003,1963,,20556,15223826,2729422,,20556,15223826,2729422,,0,0,0,PDN
WD064,,2004,1963,,20556,15223826,2729422,,20556,15223826,2729422,,0,0,0,PDN
WD064,,2005,1963,,20556,15223826,2729422,,20556,15223826,2729422,,0,0,0,PDN
WD064,,2006,1963,,20556,15223826,2729422,,20556,15223826,2729422,,0,0,0,PDN
WD064,,2007,1963,,20556,15223826,2729422,,20556,15223826,2729422,,0,0,0,PDN
WD064,,2008,1963,,20556,15223826,2729422,,20556,15223826,2729422,,0,0,0,PDN
WD064,,2009,1963,,20556,15528707,2783671,,20556,15528707,2783671,,0,0,0,PDN
WD064,,2010,1963,,20556,15528707,2783671,,20556,15528707,2783671,,0,0,0,PDN
WD064,,2011,1963,,20556,15528707,2783671,,20556,15528707,2783671,,0,0,0,PDN
WD064,,2012,1963,,20556,15528707,2783671,,20556,15528707,2783671,,0,0,0,PDN
WD064,,2013,1963,,20556,15528707,2783671,,20556,15528707,2783671,,0,0,0,PDN
WD064,,2014,1963,,20556,15528707,2783671,,20556,15528707,2783671,,0,0,0,PDN
WD064,,2015,1963,,20556,15528707,2783671,,20556,15528707,2783671,,0,0,0,PDN
WD064,,2016,1963,,20556,15528707,2783671,,20556,15528707,2783671,,0,0,0,PDN
WD064,,2017,1963,,20556,15528707,2783671,,20556,15528707,2783671,,0,0,0,PDN
WD064,,2017,1963,,20556,15528707,2783671,,20556,15528707,2783671,,0,0,0,PDN
WD065,,1997,1997,,1236,12345148,2197882,,0,0,0,,1236,12345148,2197882,PDN
WD065,,1998,1997,,1236,12345148,2197882,,0,7353246,1308407,,1236,4991902,889475,PDN
WD065,,1999,1997,,1396,13946626,2483002,,0,9267467,1649015,,1396,4679159,833987,PDN
WD065,,2000,1997,,1540,15394162,2740715,,0,10516830,1871322,,1540,4877332,869393,PDN
WD065,,2001,1997,,1186,19293318,3434161,,0,11979632,2131607,,1186,7313686,1302554,PDN
WD065,,2002,1997,,1206,19505524,3471940,,0,13211628,2350823,,1206,6293896,1121117,PDN
WD065,,2003,1997,,1246,19888326,3540094,,0,14488954,2578106,,1246,5399372,961988,PDN
WD065,,2004,1997,,2377,31208908,5555563,,0,15627752,2780739,,2377,15581156,2774824,PDN
WD065,,2005,1997,,2376,36408705,6480793,,0,16354075,2909978,,2376,20054630,3570815,PDN
WD065,,2006,1997,,33675,31749858,5683116,,3855,17804288,3171878,,29820,13945570,2511238,PDN
WD065,,2007,1997,,34330,31749858,5683771,,16574,21382302,3821254,,17756,10367556,1862517,PDN
WD065,,2008,1997,,34517,31749858,5683958,,21525,22906641,4097440,,12992,8843217,1586518,PDN
WD065,,2009,1997,,32684,32035491,5732950,,23340,24583643,4397653,,9344,7451848,1335296,PDN
WD065,,2010,1997,,27390,30902573,5526068,,25078,25735171,4604290,,2312,5167402,921778,PDN
WD065,,2011,1997,,27360,31171833,5573949,,26321,26512423,4743834,,1039,4659410,830115,PDN
WD065,,2012,1997,,27373,32336813,5781254,,26361,27424810,4906220,,1012,4912003,875034,PDN
WD065,,2013,1997,,27373,32336813,5781254,,26368,28346919,5070303,,1005,3989894,710951,PDN
WD065,,2014,1997,,27373,33069548,5911634,,26368,29159080,5214816,,1005,3910468,696818,PDN
WD065,,2015,1997,,27373,33069548,5911634,,26368,29640248,5300433,,1005,3429300,611201,PDN
WD065,,2016,1997,,27229,33391452,5968769,,26224,29890562,5344829,,1005,3500890,623939,PDN
WD065,,2017,1997,,26224,29890562,5344829,,26224,29890562,5344829,,0,0,0,PDN
WD065,,2017,1997,,26224,29890562,5344829,,26224,29890562,5344829,,0,0,0,PDN
WD067,,1984,1982,,1000000,2000000,1355872,,199395,879222,355840,,800605,1120778,1000032,PDN
WD067,,1985,1982,,3802164,18386970,7073867,,268194,1124500,468283,,3533970,17262470,6605584,PDN
WD067,,1986,1982,,3802164,18386970,7073867,,292630,1194346,505147,,3509534,17192624,6568720,PDN
WD067,,1987,1982,,3802164,18386970,7073867,,309639,1196738,522582,,3492525,17190232,6551285,PDN
WD067,,1988,1982,,3802164,18386970,7073867,,322997,1199170,536372,,3479167,17187800,6537495,PDN
WD067,,1989,1982,,325810,1201434,539588,,325810,1201434,539588,,0,0,0,PDN
WD067,,1990,1982,,325810,1201434,539588,,325810,1201434,539588,,0,0,0,PDN
WD067,,1991,1982,,325810,1201434,539588,,325810,1201434,539588,,0,0,0,PDN
WD067,,1992,1982,,325810,1201434,539588,,325810,1201434,539588,,0,0,0,PDN
WD067,,1993,1982,,325810,1201434,539588,,325810,1201434,539588,,0,0,0,PDN
WD067,,1994,1982,,325810,1201434,539588,,325810,1201434,539588,,0,0,0,PDN
WD067,,1995,1982,,325810,1201434,539588,,325810,1201434,539588,,0,0,0,PDN
WD067,,1996,1982,,325810,1201434,539588,,325810,1201434,539588,,0,0,0,PDN
WD067,,1997,1982,,325810,1201434,539588,,325810,1201434,539588,,0,0,0,PDN
WD067,,1998,1982,,325810,1201434,539588,,325810,1201434,539588,,0,0,0,PDN
WD067,,1999,1982,,325810,1201434,539588,,325810,1201434,539588,,0,0,0,PDN
WD067,,2000,1982,,325810,1201434,539588,,325810,1201434,539588,,0,0,0,PDN
WD067,,2001,1982,,325810,1201434,539588,,325810,1201434,539588,,0,0,0,PDN
WD067,,2002,1982,,325810,1201434,539588,,325810,1201434,539588,,0,0,0,PDN
WD067,,2003,1982,,325810,1201434,539588,,325810,1201434,539588,,0,0,0,PDN
WD067,,2004,1982,,325810,1201434,539588,,325810,1201434,539588,,0,0,0,PDN
WD067,,2005,1982,,325810,1201434,539588,,325810,1201434,539588,,0,0,0,PDN
WD067,,2006,1982,,463366,1352746,704068,,325810,1201434,539588,,137556,151312,164480,PDN
WD067,,2007,1982,,1135284,3814968,1814104,,325810,1201434,539588,,809474,2613534,1274516,PDN
WD067,,2008,1982,,1065524,4261474,1823793,,384410,1783977,701844,,681114,2477497,1121949,PDN
WD067,,2009,1982,,950495,4022388,1666223,,422179,3124511,978141,,528316,897877,688080,PDN
WD067,,2010,1982,,966071,4283821,1728317,,439458,3493901,1061149,,526613,789920,667168,PDN
WD067,,2011,1982,,912835,4137097,1648974,,478132,3543640,1108673,,434703,593457,540301,PDN
WD067,,2012,1982,,912835,4137097,1648974,,502106,3556898,1135006,,410729,580199,513967,PDN
WD067,,2013,1982,,1017904,4244632,1773176,,513651,3567038,1148355,,504253,677594,624822,PDN
WD067,,2014,1982,,1079547,4515469,1883011,,592579,3717912,1254129,,486968,797557,628882,PDN
WD067,,2015,1982,,1079547,4515469,1883011,,607145,3735467,1271818,,472402,780002,611193,PDN
WD067,,2016,1982,,607145,3735467,1271818,,607145,3735467,1271818,,0,0,0,PDN
WD067,,2017,1982,,607145,3735467,1271818,,607145,3735467,1271818,,0,0,0,PDN
WD067,,2017,1982,,607145,3735467,1271818,,607145,3735467,1271818,,0,0,0,PDN
WD073,,1975,1962,,200000000,265000000,247153025,,138449483,169618516,168630714,,61550517,95381484,78522311,PDP
WD073,,1976,1962,,200000000,265000000,247153025,,144735228,184844974,177625793,,55264772,80155026,69527232,PDP
WD073,,1977,1962,,200000000,265000000,247153025,,152302949,200795205,188031633,,47697051,64204795,59121392,PDP
WD073,,1978,1962,,237105483,480958228,322685239,,148105808,226008057,188320765,,88999675,254950171,134364474,PDP
WD073,,1979,1962,,227490531,481005941,313078777,,147017775,234163267,188683837,,80472756,246842674,124394940,PDP
WD073,,1980,1962,,230165013,492140708,317734534,,149614427,240498127,192407688,,80550586,251642581,125326846,PDP
WD073,,1981,1962,,230516296,493925998,318403484,,152401255,246288553,196224841,,78115041,247637445,122178643,PDP
WD073,,1982,1962,,233144720,487160019,319827997,,173452431,288418150,224772387,,59692289,198741869,95055610,PDP
WD073,,1983,1962,,203215218,437206335,281009940,,176037852,296818105,228852461,,27177366,140388230,52157479,PDP
WD073,,1984,1962,,203300936,449283242,283244573,,178773165,304867249,233020006,,24527771,144415993,50224567,PDP
WD073,,1985,1962,,205468485,450756563,285674279,,181353243,309387737,236404442,,24115242,141368826,49269837,PDP
WD073,,1986,1962,,207155817,457309925,288527690,,184785174,314164391,240686311,,22370643,143145534,47841379,PDP
WD073,,1987,1962,,210186257,463099377,292588281,,189402513,324453382,247134432,,20783744,138645995,45453849,PDP
WD073,,1988,1962,,211795505,466496218,294801949,,193907362,334323941,253395608,,17888143,132172277,41406341,PDP
WD073,,1989,1962,,214533780,384654665,282977671,,197447882,341531430,258218599,,17085898,43123235,24759072,PDP
WD073,,1990,1962,,215219147,385390484,283793966,,200397083,347054515,262150555,,14822064,38335969,21643411,PDP
WD073,,1991,1962,,230145203,437081833,307917771,,207002843,363131943,271617068,,23142360,73949890,36300703,PDP
WD073,,1992,1962,,236285185,448394839,316070744,,211856407,375508380,278672845,,24428778,72886459,37397899,PDP
WD073,,1993,1962,,237144516,447635778,316795010,,218484597,388821579,287669931,,18659919,58814199,29125079,PDP
WD073,,1994,1962,,239173188,460159979,321052188,,225526147,405670631,297709533,,13647041,54489348,23342655,PDP
WD073,,1995,1962,,253270550,485972837,339742585,,230060174,423387066,305395951,,23210376,62585771,34346634,PDP
WD073,,1996,1962,,251047121,499656067,339953894,,232779034,443194324,311639234,,18268087,56461743,28314660,PDP
WD073,,1997,1962,,254529311,531901139,349173642,,238056078,477957074,323101821,,16473233,53944065,26071821,PDP
WD073,,1998,1962,,257054450,577166453,359753107,,241639660,507203408,331889377,,15414790,69963045,27863730,PDP
WD073,,1999,1962,,272885783,670476590,392187667,,245054323,532587963,339820864,,27831460,137888627,52366803,PDP
WD073,,2000,1962,,271416496,702310758,396382823,,248039826,559414363,347579748,,23376670,142896395,48803075,PDP
WD073,,2001,1962,,269795150,714358555,396905213,,250677761,583199450,354449905,,19117389,131159105,42455308,PDP
WD073,,2002,1962,,270044808,717397906,397695681,,253188816,602390177,360375680,,16855992,115007729,37320001,PDP
WD073,,2003,1962,,272384825,714679864,399552060,,255382140,617786881,365308631,,17002685,96892983,34243429,PDP
WD073,,2004,1962,,264208485,650414619,379940624,,257356891,627141228,368947857,,6851594,23273391,10992767,PDP
WD073,,2005,1962,,264380693,654961536,380921891,,258456468,630383808,370624405,,5924225,24577728,10297486,PDP
WD073,,2006,1962,,265152894,656327766,381937194,,259267898,631979074,371719691,,5884996,24348692,10217503,PDP
WD073,,2007,1962,,265258909,658848181,382491681,,260441470,635917053,373593971,,4817439,22931128,8897710,PDP
WD073,,2008,1962,,266175690,665783158,384642444,,261836790,640729645,375845624,,4338900,25053513,8796820,PDP
WD073,,2009,1962,,265193416,674149434,385148832,,263438340,661631975,381166449,,1755076,12517459,3982381,PDP
WD073,,2010,1962,,271671141,683587304,393305894,,264622645,664447403,382851721,,7048496,19139901,10454172,PDP
WD073,,2011,1962,,276864078,697741751,401017414,,265652130,666494303,384245422,,11211948,31247448,16771993,PDP
WD073,,2012,1962,,277988541,699942451,402533459,,266796589,668616506,385767496,,11191952,31325945,16765962,PDP
WD073,,2013,1962,,277601193,703113334,402710326,,269140976,673525833,388985430,,8460217,29587501,13724897,PDP
WD073,,2014,1962,,278504937,696652039,402464373,,271261146,678110969,391921462,,7243791,18541070,10542912,PDP
WD073,,2015,1962,,279154467,699365485,403596725,,273803505,682044758,395163781,,5350962,17320727,8432938,PDP
WD073,,2016,1962,,277798917,700911331,402516235,,275764659,685756836,397785450,,2034258,15154495,4730785,PDP
WD073,,2017,1962,,279116118,702816855,404172496,,277265878,689675051,399983856,,1850240,13141804,4188640,PDP
WD073,,2017,1962,,279116118,702816855,404172496,,277265878,689675051,399983856,,1850240,13141804,4188640,PDP
WD079,,1975,1966,,125000000,600000000,231761566,,50678746,189409963,84381586,,74321254,410590037,147379980,PDP
WD079,,1976,1966,,125000000,600000000,231761566,,60715909,227231967,101148643,,64284091,372768033,130612923,PDP
WD079,,1977,1966,,125000000,600000000,231761566,,74280965,258369752,120254230,,50719035,341630248,111507336,PDP
WD079,,1978,1966,,125000000,600000000,231761566,,82280612,288229676,133567031,,42719388,311770324,98194535,PDP
WD079,,1979,1966,,121253582,435555488,198754559,,86280453,318167730,142893928,,34973129,117387758,55860631,PDP
WD079,,1980,1966,,154756607,438360992,232756784,,93618569,346634242,155297260,,61138038,91726750,77459524,PDP
WD079,,1981,1966,,154756607,438360992,232756784,,100922075,376227092,167866397,,53834532,62133900,64890387,PDP
WD079,,1982,1966,,144549648,533705022,239514954,,108028370,410883459,181139306,,36521278,122821563,58375648,PDP
WD079,,1983,1966,,145465844,551889864,243666887,,114516122,439640902,192744041,,30949722,112248962,50922846,PDP
WD079,,1984,1966,,162068934,609946508,270600341,,119631339,460689591,201604576,,42437595,149256917,68995765,PDP
WD079,,1985,1966,,166626314,620243065,276989849,,125306200,479626219,210648944,,41320114,140616846,66340905,PDP
WD079,,1986,1966,,183004027,625781047,294352968,,130449103,497686612,219005440,,52554924,128094435,75347528,PDP
WD079,,1987,1966,,183054549,630466978,295237285,,134424277,510958868,225342225,,48630272,119508110,69895060,PDP
WD079,,1988,1966,,183747637,631474080,296109573,,137663796,520905802,230351661,,46083841,110568278,65757912,PDP
WD079,,1989,1966,,156857586,590393581,261909825,,141122824,531731500,235736970,,15734762,58662081,26172855,PDP
WD079,,1990,1966,,158077924,592537618,263511664,,144472677,544674571,241389860,,13605247,47863047,22121804,PDP
WD079,,1991,1966,,159125980,596643150,265290242,,147644674,556281060,246627069,,11481306,40362090,18663173,PDP
WD079,,1992,1966,,166580443,630567090,278780993,,150083475,565347870,250679181,,16496968,65219220,28101812,PDP
WD079,,1993,1966,,166581923,630812062,278826062,,151935517,572143516,253740413,,14646406,58668546,25085649,PDP
WD079,,1994,1966,,166609275,630820760,278854962,,152747159,574315184,254938473,,13862116,56505576,23916489,PDP
WD079,,1995,1966,,170913356,650619996,286682039,,154360003,581763013,257876553,,16553353,68856983,28805486,PDP
WD079,,1996,1966,,171684549,649884164,287322301,,155665896,589114174,260490482,,16018653,60769990,26831819,PDP
WD079,,1997,1966,,173654065,660202110,291127750,,156657633,594463378,262434035,,16996432,65738732,28693715,PDP
WD079,,1998,1966,,173809033,660079158,291260840,,157411974,598172039,263848280,,16397059,61907119,27412560,PDP
WD079,,1999,1966,,162948864,620222516,273308742,,158012163,600124793,264795934,,4936701,20097723,8512808,PDP
WD079,,2000,1966,,162656310,618602699,272727964,,158483343,601767633,265559434,,4172967,16835066,7168530,PDP
WD079,,2001,1966,,162822715,618938488,272954118,,158901337,603259549,266242894,,3921378,15678939,6711224,PDP
WD079,,2002,1966,,163070131,620069171,273402724,,159313743,604773955,266924767,,3756388,15295216,6477957,PDP
WD079,,2003,1966,,162802518,621253910,273345918,,159702986,606424350,267607675,,3099532,14829560,5738243,PDP
WD079,,2004,1966,,162758193,619908507,273062198,,159998423,607474799,268090024,,2759770,12433708,4972174,PDP
WD079,,2005,1966,,162773716,619345738,272977584,,160169386,608160979,268383083,,2604330,11184759,4594501,PDP
WD079,,2006,1966,,164032901,619803123,274318155,,160481980,609074605,268858244,,3550921,10728518,5459911,PDP
WD079,,2007,1966,,163877862,620377812,274265373,,160816440,610920616,269521176,,3061422,9457196,4744197,PDP
WD079,,2008,1966,,164811890,622364099,275552832,,161146572,612094324,270060153,,3665318,10269775,5492679,PDP
WD079,,2009,1966,,164978174,636017262,278148502,,161566417,624831854,272746462,,3411757,11185408,5402043,PDP
WD079,,2010,1966,,166435975,641311446,280548328,,162026470,625657724,273353467,,4409505,15653722,7194865,PDP
WD079,,2011,1966,,167704645,641116071,281782235,,162524162,626551666,274010222,,5180483,14564405,7772012,PDP
WD079,,2012,1966,,168447113,649282695,283977838,,163847364,633632139,276593295,,4599749,15650556,7384545,PDP
WD079,,2013,1966,,168397295,647206672,283558621,,164269541,635931976,277424697,,4127754,11274696,6133927,PDP
WD079,,2014,1966,,168397673,648962867,283871490,,164577403,637331506,277981587,,3820270,11631361,5889905,PDP
WD079,,2015,1966,,168462288,650434718,284198000,,164864534,638313952,278443529,,3597754,12120766,5754472,PDP
WD079,,2016,1966,,168390504,651814255,284371687,,165105303,639130583,278829605,,3285201,12683672,5542081,PDP
WD079,,2017,1966,,168355268,650196803,284048647,,165332489,639822661,279179938,,3022779,10374142,4868709,PDP
WD079,,2017,1966,,168355268,652095421,284386479,,165332489,639822661,279179938,,3022779,12272760,5206542,PDP
WD086,,1981,1979,,1162000,58100000,11500078,,0,0,0,,1162000,58100000,11500078,PDP
WD086,,1982,1979,,1162000,58100000,11500078,,10967,140432,35955,,1151033,57959568,11464123,PDP
WD086,,1983,1979,,16993661,390898871,86548620,,799265,11803549,2899541,,16194396,379095322,83649079,PDP
WD086,,1984,1979,,17032105,393944164,87128931,,2259952,45774639,10404906,,14772153,348169525,76724025,PDP
WD086,,1985,1979,,17136340,404104533,89041061,,2993349,82318384,17640748,,14142991,321786149,71400313,PDP
WD086,,1986,1979,,17136340,404104533,89041061,,3544715,118985546,24716520,,13591625,285118987,64324541,PDP
WD086,,1987,1979,,17136340,404104533,89041061,,3903984,153396025,31198650,,13232356,250708508,57842411,PDP
WD086,,1988,1979,,17130830,425742869,92885789,,4175122,185171271,37123747,,12955708,240571598,55762042,PDP
WD086,,1989,1979,,5300849,248018785,49432305,,4332187,210037448,41705398,,968662,37981337,7726907,PDP
WD086,,1990,1979,,5353739,282503713,55621304,,4413022,232532702,45788948,,940717,49971011,9832356,PDP
WD086,,1991,1979,,5359652,284277712,55942875,,4477753,255053910,49861011,,881899,29223802,6081864,PDP
WD086,,1992,1979,,5928419,308623172,60843574,,4546757,279174074,54221859,,1381662,29449098,6621715,PDP
WD086,,1993,1979,,5980276,360238336,70079624,,4587796,297355279,57497988,,1392480,62883057,12581636,PDP
WD086,,1994,1979,,4784026,358599654,68591794,,4629023,310242388,59832295,,155003,48357266,8759499,PDP
WD086,,1995,1979,,4798894,359888615,68836014,,4650385,318984735,61409235,,148509,40903880,7426779,PDP
WD086,,1996,1979,,4853044,367690079,70278325,,4666846,327953574,63021574,,186198,39736505,7256751,PDP
WD086,,1997,1979,,4853210,371268392,70915201,,4710131,334812620,64285330,,143079,36455772,6629871,PDP
WD086,,1998,1979,,4855208,371528436,70963471,,4723764,340814034,65366831,,131444,30714402,5596640,PDP
WD086,,1999,1979,,4794363,359773877,68811067,,4732701,342569307,65688094,,61662,17204570,3122973,PDP
WD086,,2000,1979,,4794363,359773877,68811067,,4740986,343689030,65895618,,53377,16084847,2915449,PDP
WD086,,2001,1979,,4794868,359787918,68814070,,4749501,344741121,66091337,,45367,15046797,2722733,PDP
WD086,,2002,1979,,4792947,353249539,67648737,,4756876,345628316,66256576,,36071,7621223,1392161,PDP
WD086,,2003,1979,,4792862,354043869,67789992,,4762528,346347423,66390183,,30334,7696446,1399809,PDP
WD086,,2004,1979,,4786778,353688313,67720642,,4768832,347085138,66527753,,17946,6603175,1192889,PDP
WD086,,2005,1979,,4786778,353698588,67722470,,4771917,347264278,66562714,,14861,6434310,1159756,PDP
WD086,,2006,1979,,4858276,364129257,69649959,,4793657,350589536,67176137,,64619,13539721,2473822,PDP
WD086,,2007,1979,,4917720,368320681,70455208,,4840564,356900331,68345961,,77156,11420350,2109247,PDP
WD086,,2008,1979,,4955595,369993656,70790765,,4870623,360384875,68996046,,84972,9608781,1794719,PDP
WD086,,2009,1979,,4974792,376043295,71886410,,4899715,368199194,70415586,,75077,7844101,1470825,PDP
WD086,,2010,1979,,5167977,377859379,72402742,,4977000,369200145,70670976,,190977,8659234,1731766,PDP
WD086,,2011,1979,,5095141,376415701,72073024,,5043420,370201500,70915574,,51721,6214201,1157451,PDP
WD086,,2012,1979,,5107542,376522309,72104395,,5086666,371223727,71140711,,20876,5298582,963685,PDP
WD086,,2013,1979,,5162488,384564030,73590250,,5093677,371357964,71171606,,68811,13206066,2418645,PDP
WD086,,2014,1979,,5174209,384760481,73636928,,5118329,375177093,71875818,,55880,9583388,1761110,PDP
WD086,,2015,1979,,5201925,385613772,73816475,,5138893,377271839,72269113,,63032,8341933,1547361,PDP
WD086,,2016,1979,,5180271,385612920,73794669,,5151057,381424137,73020120,,29214,4188783,774549,PDP
WD086,,2017,1979,,5170174,393634836,75211959,,5159536,385826869,73812003,,10638,7807967,1399956,PDP
WD086,,2017,1979,,5170174,393634836,75211959,,5159536,385826869,73812003,,10638,7807967,1399956,PDP
WD098,,1991,1986,,396645,60014881,11075449,,74415,2100975,448254,,322230,57913906,10627195,PDN
WD098,,1992,1986,,790118,68285391,12940543,,464505,13141949,2802930,,325613,55143442,10137613,PDN
WD098,,1993,1986,,1443338,73022952,14436746,,660036,22697918,4698811,,783302,50325034,9737935,PDN
WD098,,1994,1986,,2538452,75212710,15921496,,701307,29785608,6001237,,1837145,45427102,9920259,PDN
WD098,,1995,1986,,1443968,72940860,14422769,,719086,35822709,7093234,,724882,37118151,7329535,PDN
WD098,,1996,1986,,1444092,81435899,15934465,,727655,40690076,7967882,,716437,40745823,7966583,PDN
WD098,,1997,1986,,1444092,81435899,15934465,,732684,43918674,8547395,,711408,37517225,7387070,PDN
WD098,,1998,1986,,1448118,80418393,15757441,,741553,45197269,8783772,,706565,35221124,6973669,PDN
WD098,,1999,1986,,1705684,57371886,11914205,,748521,45709409,8881868,,957163,11662477,3032337,PDN
WD098,,2000,1986,,2595985,56743378,12692671,,811100,45905233,8979291,,1784885,10838145,3713380,PDN
WD098,,2001,1986,,2594500,56797454,12700809,,1084126,46172054,9299794,,1510374,10625400,3401015,PDN
WD098,,2002,1986,,2593559,56867737,12712373,,1447679,46504975,9722586,,1145880,10362762,2989787,PDN
WD098,,2003,1986,,2593003,51305719,11722134,,1779136,47018776,10145466,,813867,4286943,1576668,PDN
WD098,,2004,1986,,2592742,48701789,11258541,,2085886,47656689,10565724,,506856,1045100,692817,PDN
WD098,,2005,1986,,2592742,48701789,11258541,,2214053,47870482,10731932,,378689,831307,526609,PDN
WD098,,2006,1986,,2591871,48880896,11289539,,2352976,48053414,10903406,,238895,827482,386133,PDN
WD098,,2007,1986,,2591871,48880896,11289539,,2449028,48153761,11017313,,142843,727135,272226,PDN
WD098,,2008,1986,,2591890,49174295,11341765,,2506985,48227705,11088427,,84905,946590,253338,PDN
WD098,,2009,1986,,2514502,49583284,11337150,,2514425,49135179,11257339,,77,448105,79811,PDN
WD098,,2010,1986,,2514425,49135179,11257339,,2514425,49135179,11257339,,0,0,0,PDN
WD098,,2011,1986,,2514425,49135179,11257339,,2514425,49135179,11257339,,0,0,0,PDN
WD098,,2012,1986,,2514425,49135179,11257339,,2514425,49135179,11257339,,0,0,0,PDN
WD098,,2013,1986,,2514425,49135179,11257339,,2514425,49135179,11257339,,0,0,0,PDN
WD098,,2014,1986,,2514425,49135179,11257339,,2514425,49135179,11257339,,0,0,0,PDN
WD098,,2015,1986,,2514425,49135179,11257339,,2514425,49135179,11257339,,0,0,0,PDN
WD098,,2016,1986,,2514425,49135179,11257339,,2514425,49135179,11257339,,0,0,0,PDN
WD098,,2017,1986,,2514425,49135179,11257339,,2514425,49135179,11257339,,0,0,0,PDN
WD098,,2017,1986,,2514425,49135179,11257339,,2514425,49135179,11257339,,0,0,0,PDN
WD105,,1975,1963,,45000000,299970000,98375445,,24486147,174747330,55579978,,20513853,125222670,42795467,PDP
WD105,,1976,1963,,35000000,260015000,81266014,,25767082,185751470,58818945,,9232918,74263530,22447069,PDP
WD105,,1977,1963,,35000000,260015000,81266014,,26851824,193368744,61259074,,8148176,66646256,20006940,PDP
WD105,,1978,1963,,37129828,258063650,83048627,,27105420,207268313,63985903,,10024408,50795337,19062724,PDP
WD105,,1979,1963,,37135515,259000703,83221049,,27668162,212188272,65424082,,9467353,46812431,17796967,PDP
WD105,,1980,1963,,37192840,263113840,84010249,,28136794,215148974,66419530,,9056046,47964866,17590719,PDP
WD105,,1981,1963,,37917142,265594748,85175994,,28774231,218332055,67623351,,9142911,47262693,17552643,PDP
WD105,,1982,1963,,38242956,271781289,86602616,,29489105,222010857,68992816,,8753851,49770432,17609800,PDP
WD105,,1983,1963,,39815281,276075845,88939097,,30227743,223639533,70021254,,9587538,52436312,18917843,PDP
WD105,,1984,1963,,40213763,276482747,89409981,,30772593,224833264,70778512,,9441170,51649483,18631469,PDP
WD105,,1985,1963,,41398863,280311920,91276429,,31465620,226522226,71772066,,9933243,53789694,19504363,PDP
WD105,,1986,1963,,41574889,282350239,91815145,,32061088,226056494,72284663,,9513801,56293745,19530482,PDP
WD105,,1987,1963,,44354878,286861265,95397808,,33219453,230769139,74281577,,11135425,56092126,21116231,PDP
WD105,,1988,1963,,46695251,297767810,99678847,,34923525,243286519,78212941,,11771726,54481291,21465906,PDP
WD105,,1989,1963,,47660863,306430848,102185925,,36189402,252123002,81051146,,11471461,54307846,21134779,PDP
WD105,,1990,1963,,48237642,316860049,104618434,,37208935,259291226,83346164,,11028707,57568823,21272270,PDP
WD105,,1991,1963,,43365843,303574977,97382743,,37978024,264169218,84983223,,5387819,39405759,12399520,PDP
WD105,,1992,1963,,44826668,304786156,99059080,,38994957,267578598,86606807,,5831711,37207558,12452273,PDP
WD105,,1993,1963,,46848810,310688706,102131498,,40312749,271922497,88697535,,6536061,38766209,13433963,PDP
WD105,,1994,1963,,50571122,327674250,108876149,,42163140,283469015,92602467,,8407982,44205235,16273682,PDP
WD105,,1995,1963,,54785384,346720196,116479369,,44227004,295734516,96848804,,10558380,50985680,19630565,PDP
WD105,,1996,1963,,54288042,357101695,117829269,,46068882,310328223,101287427,,8219160,46773472,16541842,PDP
WD105,,1997,1963,,54263119,371875293,120433100,,47529426,327913222,105876974,,6733693,43962071,14556126,PDP
WD105,,1998,1963,,54941716,381456518,122816541,,48767738,344905126,110138757,,6173978,36551392,12677784,PDP
WD105,,1999,1963,,55391325,386441806,124153212,,49946686,353724556,112886998,,5444639,32717250,11266214,PDP
WD105,,2000,1963,,55638668,395814831,126068353,,50927858,360806994,115128391,,4710810,35007837,10939962,PDP
WD105,,2001,1963,,57842218,402814079,129517321,,51962049,368149674,117469108,,5880169,34664405,12048213,PDP
WD105,,2002,1963,,59789801,411476149,133006198,,53126315,372288328,119369790,,6663486,39187821,13636408,PDP
WD105,,2003,1963,,59653883,418570047,134132539,,54313533,373855356,120835838,,5340350,44714691,13296701,PDP
WD105,,2004,1963,,59508659,417351185,133770436,,55530115,377903213,122772680,,3978544,39447972,10997756,PDP
WD105,,2005,1963,,59562188,414810679,133371918,,56116931,382368095,124153959,,3445257,32442584,9217959,PDP
WD105,,2006,1963,,59568202,415021089,133415371,,56130432,384601798,124564916,,3437770,30419291,8850455,PDP
WD105,,2007,1963,,60020658,414126418,133708633,,56716287,386613333,125508695,,3304371,27513085,8199938,PDP
WD105,,2008,1963,,60709310,416252955,134775672,,57400831,388393768,126510042,,3308479,27859187,8265630,PDP
WD105,,2009,1963,,61132191,417473430,135415724,,58063028,397570700,128805148,,3069163,19902730,6610576,PDP
WD105,,2010,1963,,61798877,418097808,136193510,,58690804,399548932,129784925,,3108073,18548876,6408586,PDP
WD105,,2011,1963,,61610141,417772398,135946870,,59169107,400965219,130515237,,2441034,16807179,5431637,PDP
WD105,,2012,1963,,61759621,418527606,136230729,,59506148,401909179,131020241,,2253473,16618427,5210490,PDP
WD105,,2013,1963,,61985819,418833094,136511285,,59870517,402903499,131561537,,2115302,15929595,4949748,PDP
WD105,,2014,1963,,61845831,416359845,135931216,,60177333,403928697,132050769,,1668498,12431148,3880446,PDP
WD105,,2015,1963,,61952542,416729819,136103759,,60425337,404612111,132420381,,1527205,12117708,3683382,PDP
WD105,,2016,1963,,62407152,415890205,136408970,,60703365,405250342,132811970,,1703787,10639863,3597001,PDP
WD105,,2017,1963,,62532999,416185711,136587401,,61032049,405842352,133245994,,1500950,10343359,3341405,PDP
WD105,,2017,1963,,62532999,416185711,136587401,,61032049,405842352,133245994,,1500950,10343359,3341405,PDP
WD109,,1980,1975,,52633000,223265000,92359868,,0,0,0,,52633000,223265000,92359868,PDP
WD109,,1981,1975,,52633000,223265000,92359868,,271728,261001,318169,,52361272,223003999,92041699,PDP
WD109,,1982,1975,,15311600,47670600,23793913,,2705763,4041703,3424927,,12605837,43628897,20368986,PDP
WD109,,1983,1975,,19084354,62537602,30212041,,7634457,12820012,9915598,,11449897,49717590,20296443,PDP
WD109,,1984,1975,,34496634,84399168,49514280,,13907271,23085407,18014995,,20589363,61313761,31499285,PDP
WD109,,1985,1975,,41892937,102634532,60155309,,20649896,35687697,27000020,,21243041,66946835,33155289,PDP
WD109,,1986,1975,,54529550,131393789,77909228,,27010062,48938279,35717941,,27519488,82455510,42191287,PDP
WD109,,1987,1975,,55412944,132860223,79053553,,29050675,53399755,38552411,,26362269,79460468,40501142,PDP
WD109,,1988,1975,,56326539,134253992,80215150,,30857313,58385126,41246125,,25469226,75868866,38969025,PDP
WD109,,1989,1975,,56792018,137231817,81210491,,33501944,64409918,44962784,,23290074,72821899,36247707,PDP
WD109,,1990,1975,,51851171,127315408,74505158,,37466215,72222468,50317188,,14384956,55092940,24187970,PDP
WD109,,1991,1975,,53999811,126698111,76543959,,41768987,80561851,56103836,,12230824,46136260,20440123,PDP
WD109,,1992,1975,,58572185,135867324,82747865,,44792137,86728633,60224278,,13780048,49138691,22523587,PDP
WD109,,1993,1975,,63432774,138394623,88058152,,47619072,93865351,64321092,,15813702,44529272,23737060,PDP
WD109,,1994,1975,,65920034,150704135,92735716,,50043514,100268238,67884837,,15876520,50435897,24850879,PDP
WD109,,1995,1975,,70827146,158345673,99002533,,52734991,106895531,71755548,,18092155,51450142,27246985,PDP
WD109,,1996,1975,,70212859,178701366,102010255,,56555001,121310676,78140531,,13657858,57390690,23869724,PDP
WD109,,1997,1975,,67137267,178792387,98950859,,59589100,136190768,83822333,,7548167,42601619,15128526,PDP
WD109,,1998,1975,,68173568,192793450,102478452,,62183299,152571879,89331320,,5990269,40221571,13147132,PDP
WD109,,1999,1975,,73799387,225401776,113906465,,65762877,172902496,96528446,,8036510,52499280,17378019,PDP
WD109,,2000,1975,,75724704,240681093,118550521,,68559699,191426894,102621424,,7165005,49254199,15929097,PDP
WD109,,2001,1975,,79519269,272323990,127975495,,70523576,210536061,107985509,,8995693,61787929,19989986,PDP
WD109,,2002,1975,,80270445,284032837,130810095,,72234997,222438541,111814809,,8035448,61594296,18995286,PDP
WD109,,2003,1975,,80102023,279161442,129774877,,73665514,230452876,114671364,,6436509,48708566,15103513,PDP
WD109,,2004,1975,,77821610,255505721,123285261,,74493511,234402733,116202182,,3328099,21102988,7083079,PDP
WD109,,2005,1975,,79236066,257373010,125031975,,74933105,236037426,116932647,,4302961,21335584,8099328,PDP
WD109,,2006,1975,,80133899,265658540,127404102,,74944456,236895814,117096736,,5189443,28762726,10307366,PDP
WD109,,2007,1975,,80640225,268538040,128422794,,76172674,246087510,119960487,,4467551,22450530,8462307,PDP
WD109,,2008,1975,,80713628,266967540,128216749,,76754303,247521843,120797336,,3959325,19445697,7419413,PDP
WD109,,2009,1975,,79822132,262508389,126531806,,77580057,252243940,122463318,,2242075,10264449,4068489,PDP
WD109,,2010,1975,,80750553,264892303,127884411,,78102198,253628263,123231779,,2648355,11264040,4652630,PDP
WD109,,2011,1975,,82913537,268342401,130661292,,78712864,254721977,124037057,,4200673,13620424,6624234,PDP
WD109,,2012,1975,,83940084,271540391,132256876,,79244178,256938612,124962791,,4695906,14601779,7294087,PDP
WD109,,2013,1975,,81723121,268947478,129578541,,79635601,258214693,125581273,,2087520,10732785,3997266,PDP
WD109,,2014,1975,,82219588,268309162,129961426,,80012452,259004768,126098706,,2207136,9304394,3862720,PDP
WD109,,2015,1975,,81789984,267604400,129406421,,80374095,259729115,126589236,,1415889,7875285,2817184,PDP
WD109,,2016,1975,,81572641,267336711,129141446,,80677293,260229907,126981544,,895348,7106804,2159904,PDP
WD109,,2017,1975,,81730429,267105676,129258126,,80935614,260619924,127309263,,794815,6485752,1948863,PDP
WD109,,2017,1975,,81730429,267105676,129258126,,80935614,260619924,127309263,,794815,6485752,1948863,PDP
WD112,,1994,1967,,704769,5081134,1608885,,0,0,0,,704769,5081134,1608885,PDP
WD112,,1995,1967,,13166212,61908534,24181965,,2231410,6251904,3343848,,10934802,55656630,20838117,PDP
WD112,,1996,1967,,16682183,65676193,28368338,,5390113,16124054,8259162,,11292070,49552139,20109176,PDP
WD112,,1997,1967,,11743929,47571147,20208546,,7168896,22140222,11108437,,4575033,25430925,9100109,PDP
WD112,,1998,1967,,12908312,57936345,23217270,,8041018,26678537,12788089,,4867294,31257808,10429181,PDP
WD112,,1999,1967,,12764723,59720401,23391129,,9215417,35280610,15493106,,3549306,24439791,7898023,PDP
WD112,,2000,1967,,19956162,112802067,40027704,,10152466,47692213,18638625,,9803696,65109854,21389079,PDP
WD112,,2001,1967,,21065484,125324551,43365226,,11280562,64549234,22766191,,9784922,60775317,20599035,PDP
WD112,,2002,1967,,20566795,132587125,44158810,,11861435,74345748,25090216,,8705360,58241377,19068594,PDP
WD112,,2003,1967,,18669441,109720172,38192603,,12381260,82235398,27013893,,6288181,27484774,11178710,PDP
WD112,,2004,1967,,18532054,113270312,38686914,,12906136,88704619,28689876,,5625918,24565693,9997038,PDP
WD112,,2005,1967,,18531982,114748251,38949820,,13183379,93797859,29873389,,5348603,20950392,9076431,PDP
WD112,,2006,1967,,18386180,113750514,38626485,,13425685,96467753,30590766,,4960495,17282761,8035719,PDP
WD112,,2007,1967,,18733748,114182637,39050943,,13766910,98963292,31376037,,4966838,15219345,7674906,PDP
WD112,,2008,1967,,18864609,121340258,40455402,,13916870,100744831,31842997,,4947739,20595427,8612405,PDP
WD112,,2009,1967,,18400631,115941410,39030774,,14235221,103287911,32613851,,4165410,12653499,6416923,PDP
WD112,,2010,1967,,19491206,116985478,40307126,,14462934,104582548,33071927,,5028272,12402930,7235200,PDP
WD112,,2011,1967,,20247013,121797459,41919158,,14911516,105707095,33720605,,5335497,16090364,8198551,PDP
WD112,,2012,1967,,20296594,121852494,41978532,,16384549,109023670,35783776,,3912045,12828824,6194755,PDP
WD112,,2013,1967,,21418928,125817619,43806404,,17220308,112056366,37159161,,4198620,13761253,6647242,PDP
WD112,,2014,1967,,21310993,125329797,43611668,,17726639,113971878,38006329,,3584354,11357919,5605338,PDP
WD112,,2015,1967,,20963458,124525741,43121062,,18169475,115589003,38736912,,2793983,8936738,4384150,PDP
WD112,,2016,1967,,20703596,124991672,42944107,,18691303,117298971,39563004,,2012293,7692701,3381102,PDP
WD112,,2017,1967,,20997496,125521365,43332257,,19131092,118815324,40272606,,1866404,6706041,3059651,PDP
WD112,,2017,1967,,20997496,125521365,43332257,,19131092,118815324,40272606,,1866404,6706041,3059651,PDP
WD117,,1975,1963,,45000000,64980000,56562278,,22524034,39351549,29526089,,22475966,25628451,27036189,PDP
WD117,,1976,1963,,45000000,85005000,60125445,,26070041,48356553,34674410,,18929959,36648447,25451035,PDP
WD117,,1977,1963,,44658952,98092209,62113082,,25994370,42809141,33611655,,18664582,55283068,28501427,PDP
WD117,,1978,1963,,45377491,100923294,63335372,,28924223,50056452,37831065,,16453268,50866842,25504307,PDP
WD117,,1979,1963,,45377491,100923294,63335372,,31260450,58053325,41590223,,14117041,42869969,21745149,PDP
WD117,,1980,1963,,46623903,105222622,65346789,,33527590,66168865,45301409,,13096313,39053757,20045380,PDP
WD117,,1981,1963,,49780803,109118540,69196913,,36079576,74280043,49296666,,13701227,34838497,19900247,PDP
WD117,,1982,1963,,52385196,120913251,73900009,,42912205,97720048,60300114,,9472991,23193203,13599895,PDP
WD117,,1983,1963,,66478467,190414375,100360028,,46205684,110808400,65922481,,20272783,79605975,34437547,PDP
WD117,,1984,1963,,70441150,213138020,108366065,,49084701,127691672,71805639,,21356449,85446348,36560426,PDP
WD117,,1985,1963,,69623930,222515670,109217466,,51275674,140389904,76256084,,18348256,82125766,32961382,PDP
WD117,,1986,1963,,70505500,229390975,111322399,,53118733,151115703,80007648,,17386767,78275272,31314751,PDP
WD117,,1987,1963,,73998061,238033327,116352746,,54760941,159847218,83203506,,19237120,78186109,33149240,PDP
WD117,,1988,1963,,74413582,251114210,119095826,,56268584,166796305,85947642,,18144998,84317905,33148184,PDP
WD117,,1989,1963,,76693222,265544830,123943192,,58036663,175506341,89265549,,18656559,90038489,34677643,PDP
WD117,,1990,1963,,78817360,283479312,129258519,,59625576,188381926,93145492,,19191784,95097386,36113027,PDP
WD117,,1991,1963,,66481346,231147343,107610766,,60987979,197334673,96100910,,5493367,33812670,11509856,PDP
WD117,,1992,1963,,66821137,231813454,108069083,,62609374,209814172,99942857,,4211763,21999282,8126226,PDP
WD117,,1993,1963,,67803906,252856515,112796168,,64112218,223353466,103854828,,3691688,29503049,8941340,PDP
WD117,,1994,1963,,70862183,257269888,116639743,,65269801,230103253,106213440,,5592382,27166635,10426303,PDP
WD117,,1995,1963,,72275936,274828041,121177723,,66417325,237322604,108645546,,5858611,37505437,12532177,PDP
WD117,,1996,1963,,77706456,279102308,127368788,,67770738,243748463,111142351,,9935718,35353845,16226437,PDP
WD117,,1997,1963,,76846660,283009506,127204223,,68940926,249436926,113324721,,7905734,33572580,13879502,PDP
WD117,,1998,1963,,81309915,287462193,132459771,,69777143,256573107,115430721,,11532772,30889086,17029050,PDP
WD117,,1999,1963,,79049390,296319759,131775326,,70601085,263059717,117408864,,8448305,33260042,14366462,PDP
WD117,,2000,1963,,77308214,314521648,133272920,,71889998,275235350,120864260,,5418216,39286298,12408660,PDP
WD117,,2001,1963,,78290347,317021098,134699795,,73213547,283758527,123704388,,5076800,33262571,10995407,PDP
WD117,,2002,1963,,79143093,317812395,135693341,,73951805,287243113,125062679,,5191288,30569282,10630662,PDP
WD117,,2003,1963,,77814651,330238743,136575993,,74493104,293921887,126792372,,3321547,36316856,9783621,PDP
WD117,,2004,1963,,77632639,327038338,135824514,,74908725,298814333,128078535,,2723914,28224005,7745979,PDP
WD117,,2005,1963,,77753132,328980346,136290560,,75283007,302577773,129122468,,2470125,26402573,7168092,PDP
WD117,,2006,1963,,78182222,328384679,136613659,,75814323,307966510,130612634,,2367899,20418169,6001025,PDP
WD117,,2007,1963,,78130428,328285399,136544200,,76427608,311574776,131867960,,1702820,16710623,4676240,PDP
WD117,,2008,1963,,78266646,330366355,137050695,,76738211,313149606,132458781,,1528435,17216749,4591914,PDP
WD117,,2009,1963,,78650995,334739297,138213149,,77027620,320443084,134045964,,1623375,14296213,4167186,PDP
WD117,,2010,1963,,78632737,336196968,138454263,,77282310,322322854,134635132,,1350427,13874114,3819132,PDP
WD117,,2011,1963,,78835277,336978409,138795848,,77514036,323476350,135072106,,1321241,13502059,3723741,PDP
WD117,,2012,1963,,78855764,337106128,138839060,,77676681,324251015,135372592,,1179083,12855113,3466470,PDP
WD117,,2013,1963,,78907202,336588502,138798393,,77817853,324725947,135598274,,1089349,11862555,3200123,PDP
WD117,,2014,1963,,78854290,336934328,138807018,,77961918,325353220,135853952,,892372,11581108,2953065,PDP
WD117,,2015,1963,,78775018,336843177,138711527,,78047540,325742117,136008772,,727478,11101060,2702754,PDP
WD117,,2016,1963,,78351223,335478822,138044963,,78287907,326244135,136338466,,63316,9234687,1706496,PDP
WD117,,2017,1963,,78339434,334802188,137912778,,78287907,326649225,136410547,,51527,8152963,1502231,PDP
WD117,,2017,1963,,78339493,335389569,138017353,,78287907,326649225,136410547,,51586,8740344,1606806,PDP
WD133,,1975,1962,,10000000,20000000,13558719,,7486619,16949534,10502550,,2513381,3050466,3056169,PDP
WD133,,1976,1962,,10000000,20000000,13558719,,7670900,17372236,10762045,,2329100,2627764,2796674,PDP
WD133,,1977,1962,,10000000,20000000,13558719,,7799031,17799966,10966285,,2200969,2200034,2592434,PDP
WD133,,1978,1962,,10000000,20000000,13558719,,7876533,18012751,11081649,,2123467,1987249,2477070,PDP
WD133,,1979,1962,,11714931,31578761,17333928,,7938374,19610705,11427823,,3776557,11968056,5906105,PDP
WD133,,1980,1962,,11428088,36757972,17968652,,8125005,21684390,11983437,,3303083,15073582,5985215,PDP
WD133,,1981,1962,,11532400,39917508,18635159,,8397553,23762283,12625717,,3134847,16155225,6009442,PDP
WD133,,1982,1962,,11618397,38049988,18388857,,8563857,24289640,12885857,,3054540,13760348,5503000,PDP
WD133,,1983,1962,,11632953,38103503,18412936,,8768508,24926755,13203874,,2864445,13176748,5209062,PDP
WD133,,1984,1962,,15267723,51373444,24408905,,8966287,26459010,13674296,,6301436,24914434,10734609,PDP
WD133,,1985,1962,,15297769,53084680,24743442,,9226898,27469076,14114634,,6070871,25615604,10628808,PDP
WD133,,1986,1962,,15372360,55206571,25195593,,9461576,28312405,14499370,,5910784,26894166,10696223,PDP
WD133,,1987,1962,,16610807,59113549,27129232,,9731607,29293546,14943982,,6879200,29820003,12185250,PDP
WD133,,1988,1962,,16556606,58783313,27016270,,9957983,30283975,15346591,,6598623,28499338,11669679,PDP
WD133,,1989,1962,,16556606,58783313,27016270,,10159959,31420433,15750783,,6396647,27362880,11265487,PDP
WD133,,1990,1962,,16882734,59103276,27399331,,10428665,32379402,16190124,,6454069,26723874,11209207,PDP
WD133,,1991,1962,,17897020,59645919,28510173,,10678707,33470651,16634339,,7218313,26175268,11875834,PDP
WD133,,1992,1962,,14063069,40556028,21279444,,11788057,34901497,17998288,,2275012,5654531,3281156,PDP
WD133,,1993,1962,,14160086,42651603,21749339,,12317722,35983881,18720548,,1842364,6667722,3028791,PDP
WD133,,1994,1962,,14148917,42581216,21725646,,11775302,34794082,17966420,,2373615,7787134,3759226,PDP
WD133,,1995,1962,,13994120,43796048,21787011,,12171254,37435454,18832367,,1822866,6360594,2954644,PDP
WD133,,1996,1962,,13558772,45365982,21631011,,12342652,38470402,19187919,,1216120,6895580,2443092,PDP
WD133,,1997,1962,,12973014,41311531,20323820,,12398598,38831981,19308203,,574416,2479550,1015617,PDP
WD133,,1998,1962,,12882834,40997154,20177701,,12412885,39047234,19360791,,469949,1949920,816910,PDP
WD133,,1999,1962,,13212242,41655970,20624336,,12504037,39156679,19471418,,708205,2499291,1152918,PDP
WD133,,2000,1962,,17073923,49032874,25798633,,13105666,40107852,20242294,,3968257,8925022,5556339,PDP
WD133,,2001,1962,,22099615,74681015,35388052,,13988003,48116848,22549720,,8111612,26564167,12838332,PDP
WD133,,2002,1962,,22102822,76900734,35786227,,14944052,57430993,25163090,,7158770,19469741,10623137,PDP
WD133,,2003,1962,,19504705,67819588,31572248,,15488134,56504069,25542239,,4016571,11315519,6030009,PDP
WD133,,2004,1962,,19570501,68303452,31724141,,15822103,57858241,26117164,,3748398,10445211,5606977,PDP
WD133,,2005,1962,,19660842,67358302,31646305,,15977330,58363810,26362350,,3683512,8994492,5283955,PDP
WD133,,2006,1962,,19927318,71780770,32699697,,15977330,58363810,26362350,,3949988,13416960,6337347,PDP
WD133,,2007,1962,,20182329,72619364,33103924,,16220530,61398794,27145582,,3961799,11220570,5958342,PDP
WD133,,2008,1962,,20460356,73706215,33575341,,16585401,63797856,27937333,,3874955,9908359,5638008,PDP
WD133,,2009,1962,,18009423,71135178,30666927,,16895277,65422488,28536287,,1114146,5712690,2130639,PDP
WD133,,2010,1962,,18289717,73147168,31305225,,17149612,65918517,28878883,,1140105,7228651,2426343,PDP
WD133,,2011,1962,,18177895,72783340,31128666,,17372704,67064354,29305860,,805191,5718986,1822804,PDP
WD133,,2012,1962,,18207098,72922782,31182679,,17560423,67925468,29646804,,646675,4997314,1535875,PDP
WD133,,2013,1962,,18873022,75641093,32332289,,17724595,68679709,29945181,,1148427,6961384,2387108,PDP
WD133,,2014,1962,,18493810,70650681,31065103,,17885811,69282086,30213583,,607999,1368595,851519,PDP
WD133,,2015,1962,,19394929,72263028,32253117,,18290588,69993354,30744920,,1104341,2269674,1508198,PDP
WD133,,2016,1962,,20241654,73782114,33370141,,19398060,72215448,32247782,,843594,1566666,1122360,PDP
WD133,,2017,1962,,20864291,74840056,34181023,,19815720,73054741,32814779,,1048571,1785315,1366243,PDP
WD133,,2017,1962,,20864291,74840056,34181023,,19815720,73054741,32814779,,1048571,1785315,1366243,PDP
WD143,,1987,1985,,1096075,6576453,2266262,,0,0,0,,1096075,6576453,2266262,PDN
WD143,,1990,1985,,1709041,6010102,2778454,,40450,65558,52115,,1668591,5944544,2726339,PDN
WD143,,1991,1985,,2018416,10971320,3970608,,630602,4771588,1479639,,1387814,6199732,2490969,PDN
WD143,,1992,1985,,2018416,10971320,3970608,,729571,7758343,2110059,,1288845,3212977,1860549,PDN
WD143,,1993,1985,,2481480,15601947,5257627,,764157,9579739,2468737,,1717323,6022208,2788890,PDN
WD143,,1994,1985,,764809,9579739,2469389,,764809,9579739,2469389,,0,0,0,PDN
WD143,,1995,1985,,764809,9579739,2469389,,764809,9579739,2469389,,0,0,0,PDN
WD143,,1996,1985,,764809,9579739,2469389,,764809,9579739,2469389,,0,0,0,PDN
WD143,,1997,1985,,764809,9579739,2469389,,764809,9579739,2469389,,0,0,0,PDN
WD143,,1998,1985,,764809,9579739,2469389,,764809,9579739,2469389,,0,0,0,PDN
WD143,,1999,1985,,764809,9579739,2469389,,764809,9579739,2469389,,0,0,0,PDN
WD143,,2000,1985,,764809,9579739,2469389,,764809,9579739,2469389,,0,0,0,PDN
WD143,,2001,1985,,764809,9579739,2469389,,764809,9579739,2469389,,0,0,0,PDN
WD143,,2002,1985,,764809,9579739,2469389,,764809,9579739,2469389,,0,0,0,PDN
WD143,,2003,1985,,764809,9579739,2469389,,764809,9579739,2469389,,0,0,0,PDN
WD143,,2004,1985,,764809,9579739,2469389,,764809,9579739,2469389,,0,0,0,PDN
WD143,,2005,1985,,764809,9579739,2469389,,764809,9579739,2469389,,0,0,0,PDN
WD143,,2006,1985,,764809,9579739,2469389,,764809,9579739,2469389,,0,0,0,PDN
WD143,,2007,1985,,764809,9579739,2469389,,764809,9579739,2469389,,0,0,0,PDN
WD143,,2008,1985,,764809,9579739,2469389,,764809,9579739,2469389,,0,0,0,PDN
WD143,,2009,1985,,764809,9771592,2503526,,764809,9771592,2503526,,0,0,0,PDN
WD143,,2010,1985,,764809,9771592,2503526,,764809,9771592,2503526,,0,0,0,PDN
WD143,,2011,1985,,764809,9771592,2503526,,764809,9771592,2503526,,0,0,0,PDN
WD143,,2012,1985,,764809,9771592,2503526,,764809,9771592,2503526,,0,0,0,PDN
WD143,,2013,1985,,764809,9771592,2503526,,764809,9771592,2503526,,0,0,0,PDN
WD143,,2014,1985,,764809,9771592,2503526,,764809,9771592,2503526,,0,0,0,PDN
WD143,,2015,1985,,764809,9771592,2503526,,764809,9771592,2503526,,0,0,0,PDN
WD143,,2016,1985,,764809,9771592,2503526,,764809,9771592,2503526,,0,0,0,PDN
WD143,,2017,1985,,764809,9771592,2503526,,764809,9771592,2503526,,0,0,0,PDN
WD143,,2017,1985,,764809,9771592,2503526,,764809,9771592,2503526,,0,0,0,PDN
WD152,,1975,1968,,20000000,50000000,28896797,,8747893,18198503,11986061,,11252107,31801497,16910736,PDP
WD152,,1976,1968,,15000000,30000000,20338078,,9665978,20298076,13277735,,5334022,9701924,7060343,PDP
WD152,,1977,1968,,15000000,30000000,20338078,,10176323,22328370,14149343,,4823677,7671630,6188735,PDP
WD152,,1978,1968,,14090633,81522885,28596484,,10505399,23945767,14766212,,3585234,57577118,13830272,PDP
WD152,,1979,1968,,14090633,81522885,28596484,,11092983,25729443,15671176,,2997650,55793442,12925308,PDP
WD152,,1980,1968,,14456896,83119614,29246863,,11627808,27867035,16586355,,2829088,55252579,12660508,PDP
WD152,,1981,1968,,20508464,100500288,38391078,,12581515,34339337,18691717,,7926949,66160951,19699361,PDP
WD152,,1982,1968,,20503669,100548458,38394854,,12932044,34030671,18987324,,7571625,66517787,19407530,PDP
WD152,,1983,1968,,20863670,102769462,39150051,,13284448,35704729,19637603,,7579222,67064733,19512448,PDP
WD152,,1984,1968,,20863670,102769462,39150051,,13648951,37457723,20314026,,7214719,65311739,18836025,PDP
WD152,,1985,1968,,20977271,102905783,39287909,,13941480,38767441,20839601,,7035791,64138342,18448308,PDP
WD152,,1986,1968,,20977271,102905783,39287909,,14119214,39407079,21131150,,6858057,63498704,18156759,PDP
WD152,,1987,1968,,21334852,60812624,32155604,,14458252,40329337,21634291,,6876600,20483287,10521313,PDP
WD152,,1988,1968,,21999950,61332573,32913219,,14865616,40808481,22126912,,7134334,20524092,10786307,PDP
WD152,,1989,1968,,21999950,61332573,32913219,,15147022,41165664,22471873,,6852928,20166909,10441346,PDP
WD152,,1990,1968,,17464833,72510752,30367102,,15505566,46405005,23762684,,1959267,26105747,6604418,PDP
WD152,,1991,1968,,17470923,73438626,30538294,,15919925,51992052,25171180,,1550998,21446574,5367114,PDP
WD152,,1992,1968,,17992792,73875761,31137945,,16529501,54560505,26237776,,1463291,19315256,4900169,PDP
WD152,,1993,1968,,19221523,129583380,42279064,,17469780,61010822,28325798,,1751743,68572558,13953266,PDP
WD152,,1994,1968,,19427310,129581354,42484490,,18193582,72530260,31099322,,1233728,57051094,11385168,PDP
WD152,,1995,1968,,21943102,101137907,39939171,,18520264,76891358,32202000,,3422838,24246549,7737171,PDP
WD152,,1996,1968,,24304892,115895991,44926954,,18874041,81817472,33432310,,5430851,34078519,11494644,PDP
WD152,,1997,1968,,24545717,128622257,47432240,,19711067,88528177,35463412,,4834650,40094080,11968828,PDP
WD152,,1998,1968,,25774444,135975121,49969305,,20812318,98340705,38310664,,4962126,37634416,11658641,PDP
WD152,,1999,1968,,25853394,140605865,50872231,,21637145,106822758,40644753,,4216249,33783107,10227478,PDP
WD152,,2000,1968,,25886858,138579414,50545117,,22235158,111508755,42076573,,3651700,27070659,8468544,PDP
WD152,,2001,1968,,28795874,145097560,54613945,,22681237,114428020,43042095,,6114637,30669540,11571850,PDP
WD152,,2002,1968,,28845411,147688860,55124568,,23008916,116572596,43751371,,5836495,31116264,11373197,PDP
WD152,,2003,1968,,25126978,146907121,51267035,,23275730,120970831,44800789,,1851248,25936290,6466246,PDP
WD152,,2004,1968,,24167034,129566912,47221645,,23447974,123233065,45375566,,719060,6333847,1846079,PDP
WD152,,2005,1968,,24882549,129497245,47924763,,23550125,124049540,45622997,,1332424,5447705,2301766,PDP
WD152,,2006,1968,,24882549,129497245,47924763,,23561281,124054153,45634974,,1321268,5443092,2289789,PDP
WD152,,2007,1968,,26511842,131038025,49828217,,23899005,125378271,46208306,,2612837,5659754,3619911,PDP
WD152,,2008,1968,,26520572,132482808,50094025,,24381863,126454859,46882728,,2138709,6027949,3211297,PDP
WD152,,2009,1968,,26732768,132079081,50234386,,24968752,129345655,47983995,,1764016,2733426,2250392,PDP
WD152,,2010,1968,,26738226,132543286,50322443,,25520748,130171165,48682879,,1217478,2372121,1639564,PDP
WD152,,2011,1968,,27620808,133868576,51440842,,26031550,130779747,49301969,,1589258,3088829,2138874,PDP
WD152,,2012,1968,,27545085,133490497,51297846,,26336993,131020774,49650300,,1208092,2469723,1647546,PDP
WD152,,2013,1968,,28320967,135682964,52463848,,26723955,132227331,50251953,,1597012,3455633,2211895,PDP
WD152,,2014,1968,,27789165,136606521,52096379,,27062140,134499063,50994361,,727025,2107458,1102017,PDP
WD152,,2015,1968,,27827119,136740876,52158240,,27198455,135453318,51300471,,628664,1287558,857767,PDP
WD152,,2016,1968,,27672092,136607517,51979484,,27298693,135979197,51494282,,373399,628320,485200,PDP
WD152,,2017,1968,,27579219,136939709,51945718,,27381559,136244908,51624426,,197660,694801,321290,PDP
WD152,,2017,1968,,27579219,136939709,51945718,,27381559,136244908,51624426,,197660,694801,321290,PDP
WR029,,2005,2005,,188458486,56537546,198518548,,0,0,0,,188458486,56537546,198518548,RJD
WR029,,2006,2005,,188458486,56537546,198518548,,0,0,0,,188458486,56537546,198518548,RJD
WR029,,2007,2005,,188458486,56537546,198518548,,0,0,0,,188458486,56537546,198518548,RJD
WR029,,2008,2005,,188458486,56537546,198518548,,0,0,0,,188458486,56537546,198518548,RJD
WR029,,2011,2005,,80368753,25130448,84840362,,0,0,0,,80368753,25130448,84840362,RJD
WR029,,2012,2005,,84553999,26277205,89229657,,0,0,0,,84553999,26277205,89229657,RJD
WR029,,2013,2005,,84553999,26277205,89229657,,0,0,0,,84553999,26277205,89229657,RJD
WR029,,2014,2005,,84553999,26277205,89229657,,0,0,0,,84553999,26277205,89229657,RJD
WR029,,2015,2005,,84553999,26277205,89229657,,0,0,0,,84553999,26277205,89229657,RJD
WR029,,2016,2005,,84553999,26277205,89229657,,0,0,0,,84553999,26277205,89229657,RJD
WR029,,2017,2005,,84553999,26277205,89229657,,0,0,0,,84553999,26277205,89229657,RJD
WR029,,2017,2005,,84553999,26277205,89229657,,0,0,0,,84553999,26277205,89229657,RJD
WR206,,2003,2002,,34676677,27741342,39612859,,0,0,0,,34676677,27741342,39612859,PDP
WR206,,2005,2002,,25060666,4009707,25774137,,0,0,0,,25060666,4009707,25774137,PDP
WR206,,2006,2002,,25060666,4009707,25774137,,0,0,0,,25060666,4009707,25774137,PDP
WR206,,2007,2002,,32882342,5261175,33818494,,0,0,0,,32882342,5261175,33818494,PDP
WR206,,2008,2002,,32882342,5261175,33818494,,0,0,0,,32882342,5261175,33818494,PDP
WR206,,2009,2002,,17895894,3861404,18582976,,0,0,0,,17895894,3861404,18582976,PDP
WR206,,2010,2002,,17895894,3861404,18582976,,0,0,0,,17895894,3861404,18582976,PDP
WR206,,2011,2002,,17895894,3861404,18582976,,0,0,0,,17895894,3861404,18582976,PDP
WR206,,2012,2002,,14966152,2424938,15397635,,1380348,301577,1434009,,13585804,2123361,13963626,PDP
WR206,,2013,2002,,14966152,2424938,15397635,,3287356,609295,3395772,,11678796,1815643,12001864,PDP
WR206,,2014,2002,,18425822,3804353,19102753,,7699642,1511282,7968554,,10726180,2293071,11134200,PDP
WR206,,2015,2002,,18425822,3804353,19102753,,10137666,2026932,10498330,,8288156,1777421,8604423,PDP
WR206,,2016,2002,,20720548,4286245,21483225,,11821484,2382150,12245354,,8899064,1904095,9237871,PDP
WR206,,2017,2002,,20720548,4286245,21483225,,12941827,2650400,13413428,,7778721,1635845,8069797,PDP
WR206,,2017,2002,,20720548,4286245,21483225,,12941827,2650400,13413428,,7778721,1635845,8069797,PDP
WR469,,2005,2003,,62381897,9981104,64157894,,0,0,0,,62381897,9981104,64157894,PDP
WR469,,2006,2003,,62381897,9981104,64157894,,0,0,0,,62381897,9981104,64157894,PDP
WR469,,2007,2003,,62381897,9981104,64157894,,0,0,0,,62381897,9981104,64157894,PDP
WR469,,2008,2003,,62381897,9981104,64157894,,0,0,0,,62381897,9981104,64157894,PDP
WR469,,2009,2003,,31221056,4995369,32109912,,0,0,0,,31221056,4995369,32109912,PDP
WR469,,2010,2003,,31221056,4995369,32109912,,0,0,0,,31221056,4995369,32109912,PDP
WR469,,2011,2003,,31221056,4995369,32109912,,0,0,0,,31221056,4995369,32109912,PDP
WR469,,2012,2003,,21795335,3487254,22415843,,874581,124461,896727,,20920754,3362793,21519116,PDP
WR469,,2013,2003,,21795335,3487254,22415843,,3222523,498990,3311311,,18572812,2988264,19104532,PDP
WR469,,2014,2003,,24217038,3874726,24906491,,10225156,1566024,10503808,,13991882,2308702,14402683,PDP
WR469,,2015,2003,,24217038,3874726,24906491,,14107352,2055315,14473066,,10109686,1819411,10433425,PDP
WR469,,2016,2003,,27035003,3676760,27689231,,16864096,2393758,17290032,,10170907,1283002,10399199,PDP
WR469,,2017,2003,,27035003,3676760,27689231,,20002647,2794741,20499932,,7032356,882019,7189299,PDP
WR469,,2017,2003,,27035003,3676760,27689231,,20002647,2794741,20499932,,7032356,882019,7189299,PDP
WR508,,2005,2005,,118865334,16165685,121741790,,0,0,0,,118865334,16165685,121741790,PDP
WR508,,2006,2005,,118865334,16165685,121741790,,0,0,0,,118865334,16165685,121741790,PDP
WR508,,2007,2005,,138749341,19069756,142142536,,0,0,0,,138749341,19069756,142142536,PDP
WR508,,2008,2005,,138749341,19069756,142142536,,0,0,0,,138749341,19069756,142142536,PDP
WR508,,2012,2005,,43601519,7467221,44930206,,0,0,0,,43601519,7467221,44930206,PDP
WR508,,2013,2005,,43601519,7467221,44930206,,0,0,0,,43601519,7467221,44930206,PDP
WR508,,2014,2005,,43601519,7467221,44930206,,0,0,0,,43601519,7467221,44930206,PDP
WR508,,2015,2005,,38524162,6334970,39651381,,0,0,0,,38524162,6334970,39651381,PDP
WR508,,2016,2005,,63076496,10008381,64857347,,734141,144038,759771,,62342355,9864343,64097576,PDP
WR508,,2017,2005,,67808755,10776881,69726351,,7905551,1232733,8124899,,59903204,9544148,61601452,PDP
WR508,,2017,2005,,67808755,10776881,69726351,,7905551,1232733,8124899,,59903204,9544148,61601452,PDP
WR627,,2006,2007,,11209485,1345138,11448833,,0,0,0,,11209485,1345138,11448833,PDP
WR627,,2007,2007,,81683739,9821868,83431402,,0,0,0,,81683739,9821868,83431402,PDP
WR627,,2008,2007,,81683739,9821868,83431402,,0,0,0,,81683739,9821868,83431402,PDP
WR627,,2014,2007,,30293877,3645175,30942484,,0,0,0,,30293877,3645175,30942484,PDP
WR627,,2015,2007,,39741247,5406313,40703224,,0,0,0,,39741247,5406313,40703224,PDP
WR627,,2016,2007,,46072392,6236408,47182073,,3665204,366654,3730444,,42407188,5869754,43451629,PDP
WR627,,2017,2007,,59635961,8114947,61079901,,7681437,738546,7812850,,51954524,7376401,53267051,PDP
WR627,,2017,2007,,59635961,8114947,61079901,,7681437,738546,7812850,,51954524,7376401,53267051,PDP
WR678,,2005,2003,,244485436,38357598,251310631,,0,0,0,,244485436,38357598,251310631,PDP
WR678,,2006,2003,,244485436,38357598,251310631,,0,0,0,,244485436,38357598,251310631,PDP
WR678,,2007,2003,,244485436,38357598,251310631,,0,0,0,,244485436,38357598,251310631,PDP
WR678,,2008,2003,,244485436,38357598,251310631,,0,0,0,,244485436,38357598,251310631,PDP
WR678,,2011,2003,,80837117,19404634,84289899,,0,0,0,,80837117,19404634,84289899,PDP
WR678,,2012,2003,,89127307,21423753,92939362,,0,0,0,,89127307,21423753,92939362,PDP
WR678,,2013,2003,,89127307,21423753,92939362,,0,0,0,,89127307,21423753,92939362,PDP
WR678,,2014,2003,,99030341,23804170,103265958,,340877,100294,358723,,98689464,23703876,102907235,PDP
WR678,,2015,2003,,143086850,37202581,149706526,,12464111,3261648,13044476,,130622739,33940933,136662052,PDP
WR678,,2016,2003,,143086850,37202581,149706526,,32161444,8255767,33630441,,110925406,28946814,116076084,PDP
WR678,,2017,2003,,233376982,57181771,243551674,,60952563,15104882,63640264,,172424419,42076889,179911411,PDP
WR678,,2017,2003,,233376982,57181771,243551674,,60952563,15104882,63640264,,172424419,42076889,179911411,PDP
WR759,,2005,2004,,211505590,33840895,217527102,,0,0,0,,211505590,33840895,217527102,PDP
WR759,,2006,2004,,211505590,33840895,217527102,,0,0,0,,211505590,33840895,217527102,PDP
WR759,,2007,2004,,211505590,33840895,217527102,,0,0,0,,211505590,33840895,217527102,PDP
WR759,,2008,2004,,211505590,33840895,217527102,,0,0,0,,211505590,33840895,217527102,PDP
WR759,,2011,2004,,59001078,14918940,61655692,,0,0,0,,59001078,14918940,61655692,PDP
WR759,,2012,2004,,73697526,18592003,77005710,,0,0,0,,73697526,18592003,77005710,PDP
WR759,,2013,2004,,73697526,18592003,77005710,,76878,18686,80203,,73620648,18573317,76925508,PDP
WR759,,2014,2004,,81886139,20657781,85561899,,296351,83260,311165,,81589788,20574521,85250734,PDP
WR759,,2015,2004,,81886139,20657781,85561899,,9392865,2260445,9795080,,72493274,18397336,75766820,PDP
WR759,,2016,2004,,81886139,20657781,85561899,,22043468,5277122,22982457,,59842671,15380659,62579442,PDP
WR759,,2017,2004,,155758912,35178935,162018509,,33381828,7817554,34772850,,122377084,27361381,127245657,PDP
WR759,,2017,2004,,155758912,35178935,162018509,,33381828,7817554,34772850,,122377084,27361381,127245657,PDP
